ctid,date,nginx-access-*,ssh-*,telnet-*,ftp-*,total
615,2019-08-01,290,19701,48,1,20040
615,2019-08-02,444,22596,250,0,23290
615,2019-08-03,1038,6622,469,1,8130
615,2019-08-04,1306,1124,352,0,2782
615,2019-08-05,987,850,353,0,2190
615,2019-08-06,1116,4983,338,0,6437
615,2019-08-07,1099,23884,450,0,25433
615,2019-08-08,740,9167,158,0,10065
615,2019-08-09,955,2220,86,0,3261
615,2019-08-10,682,1400,407,1,2490
615,2019-08-11,493,1312,133,1,1939
615,2019-08-12,459,1628,106,0,2193
615,2019-08-13,479,5747,99,0,6325
615,2019-08-14,588,5592,213,1,6394
615,2019-08-15,447,1184,7,3,1641
615,2019-08-16,220,4916,93,0,5229
615,2019-08-17,390,3716,762,1,4869
615,2019-08-18,391,4021,854,0,5266
615,2019-08-19,1163,3296,1304,1,5764
615,2019-08-20,433,4766,1006,1,6206
615,2019-08-21,415,2395,1131,0,3941
615,2019-08-22,1235,15640,936,1,17812
615,2019-08-23,420,23111,1552,1,25084
615,2019-08-24,953,8324,1894,2,11173
615,2019-08-25,880,13789,2021,3,16693
615,2019-08-26,1775,25084,1842,1,28702
615,2019-08-27,1408,16040,1980,1,19429
615,2019-08-28,868,22145,1262,1,24276
615,2019-08-29,1166,16344,1723,2,19235
615,2019-08-30,873,4054,596,2,5525
615,2019-08-31,324,556,10,0,890
615,2019-09-01,139,1112,270,0,1521
615,2019-09-02,130,547,50,0,727
615,2019-09-03,711,4778,714,1,6204
615,2019-09-04,431,11777,2274,2,14484
615,2019-09-05,436,15401,1362,3,17202
615,2019-09-06,497,19136,2038,1,21672
615,2019-09-07,555,13951,2205,0,16711
615,2019-09-08,821,7065,1552,0,9438
615,2019-09-09,442,7007,1714,1,9164
615,2019-09-10,1133,8976,1504,0,11613
615,2019-09-11,386,7023,1653,3,9065
615,2019-09-12,369,7526,1760,1,9656
615,2019-09-13,653,5133,1372,3,7161
615,2019-09-14,2226,7625,2309,0,12160
615,2019-09-15,385,9201,2435,11,12032
615,2019-09-16,408,15068,2508,21,18005
615,2019-09-17,616,8875,1631,6,11128
615,2019-09-18,442,12170,1559,11,14182
615,2019-09-19,615,6639,2430,8,9692
615,2019-09-20,418,10423,2402,12,13255
615,2019-09-21,330,9460,1012,9,10811
615,2019-09-22,1246,13802,2101,5,17154
615,2019-09-23,1315,13275,1812,2,16404
615,2019-09-24,473,11428,2254,3,14158
615,2019-09-25,380,9761,1256,16,11413
615,2019-09-26,1099,14078,1204,1,16382
615,2019-09-27,200,9911,1785,2,11898
615,2019-09-28,252,25728,2066,3,28049
615,2019-09-29,287,20042,1764,1,22094
615,2019-09-30,227,18801,2106,1,21135
615,2019-10-01,247,18009,1728,0,19984
615,2019-10-02,257,13201,1302,1,14761
615,2019-10-03,1519,14885,1620,1,18025
615,2019-10-04,2463,12389,1120,2,15974
615,2019-10-05,312,15424,1183,0,16919
615,2019-10-06,239,12059,2265,1,14564
615,2019-10-07,217,6646,2138,2,9003
615,2019-10-08,430,13317,1520,3,15270
615,2019-10-09,339,16018,1107,1,17465
615,2019-10-10,661,11816,1819,18,14314
615,2019-10-11,452,14451,1941,0,16844
615,2019-10-12,1861,9821,2453,3,14138
615,2019-10-13,737,9207,1748,2,11694
615,2019-10-14,1195,9082,2278,1,12556
615,2019-10-15,360,15653,1978,1,17992
615,2019-10-16,931,24511,1556,0,26998
615,2019-10-17,617,9019,2030,2,11668
615,2019-10-18,990,15494,2007,1,18492
615,2019-10-19,378,8943,1656,1,10978
615,2019-10-20,496,3344,1781,1,5622
615,2019-10-21,677,10883,1546,1,13107
615,2019-10-22,372,7059,2328,1,9760
615,2019-10-23,383,9160,1308,4,10855
615,2019-10-24,459,14142,2377,1,16979
615,2019-10-25,494,11430,1479,2,13405
615,2019-10-26,620,14169,1701,1,16491
615,2019-10-27,2352,16927,1423,0,20702
615,2019-10-28,685,14772,1738,1,17196
615,2019-10-29,1435,27671,1608,1,30715
615,2019-10-30,658,21648,1354,1,23661
615,2019-10-31,744,20801,1893,0,23438
615,2019-11-01,378,39910,1474,1,41763
615,2019-11-02,1594,20036,1219,4,22853
615,2019-11-03,429,38248,1110,0,39787
615,2019-11-04,403,15244,1553,75,17275
615,2019-11-05,371,3494,1150,0,5015
615,2019-11-06,421,15228,1085,2,16736
615,2019-11-07,457,17605,1382,2,19446
615,2019-11-08,399,10770,974,0,12143
615,2019-11-09,449,9794,2133,0,12376
615,2019-11-10,325,25830,896,0,27051
615,2019-11-11,377,17875,1571,0,19823
615,2019-11-12,475,23088,2583,5,26151
615,2019-11-13,1249,14907,1796,2,17954
615,2019-11-14,392,13771,2040,0,16203
615,2019-11-15,302,5269,2973,2,8546
615,2019-11-16,1752,2769,3126,1,7648
615,2019-11-17,1408,4984,3293,4,9689
615,2019-11-18,1112,2851,2991,1,6955
615,2019-11-19,493,3757,2936,1,7187
615,2019-11-20,1599,2041,2463,0,6103
615,2019-11-21,361,4292,1582,0,6235
615,2019-11-22,356,9664,1486,8,11514
615,2019-11-23,960,7550,2224,0,10734
615,2019-11-24,439,10959,1768,1,13167
615,2019-11-25,1298,11809,1912,2,15021
615,2019-11-26,869,7145,2145,0,10159
615,2019-11-27,268,7088,1083,4,8443
615,2019-11-28,792,9375,750,1,10918
615,2019-11-29,30,847,2,0,879
615,2019-08-01,290,19701,48,1,20040
615,2019-08-02,444,22596,250,0,23290
615,2019-08-03,1038,6622,469,1,8130
615,2019-08-04,1306,1124,352,0,2782
615,2019-08-05,987,850,353,0,2190
615,2019-08-06,1116,4983,338,0,6437
615,2019-08-07,1099,23884,450,0,25433
615,2019-08-08,740,9167,158,0,10065
615,2019-08-09,955,2220,86,0,3261
615,2019-08-10,682,1400,407,1,2490
615,2019-08-11,493,1312,133,1,1939
615,2019-08-12,459,1628,106,0,2193
615,2019-08-13,479,5747,99,0,6325
615,2019-08-14,588,5592,213,1,6394
615,2019-08-15,447,1184,7,3,1641
615,2019-08-16,220,4916,93,0,5229
615,2019-08-17,390,3716,762,1,4869
615,2019-08-18,391,4021,854,0,5266
615,2019-08-19,1163,3296,1304,1,5764
615,2019-08-20,433,4766,1006,1,6206
615,2019-08-21,415,2395,1131,0,3941
615,2019-08-22,1235,15640,936,1,17812
615,2019-08-23,420,23111,1552,1,25084
615,2019-08-24,953,8324,1894,2,11173
615,2019-08-25,880,13789,2021,3,16693
615,2019-08-26,1775,25084,1842,1,28702
615,2019-08-27,1408,16040,1980,1,19429
615,2019-08-28,868,22145,1262,1,24276
615,2019-08-29,1166,16344,1723,2,19235
615,2019-08-30,873,4054,596,2,5525
615,2019-08-31,324,556,10,0,890
615,2019-09-01,139,1112,270,0,1521
615,2019-09-02,130,547,50,0,727
615,2019-09-03,711,4778,714,1,6204
615,2019-09-04,431,11777,2274,2,14484
615,2019-09-05,436,15401,1362,3,17202
615,2019-09-06,497,19136,2038,1,21672
615,2019-09-07,555,13951,2205,0,16711
615,2019-09-08,821,7065,1552,0,9438
615,2019-09-09,442,7007,1714,1,9164
615,2019-09-10,1133,8976,1504,0,11613
615,2019-09-11,386,7023,1653,3,9065
615,2019-09-12,369,7526,1760,1,9656
615,2019-09-13,653,5133,1372,3,7161
615,2019-09-14,2226,7625,2309,0,12160
615,2019-09-15,385,9201,2435,11,12032
615,2019-09-16,408,15068,2508,21,18005
615,2019-09-17,616,8875,1631,6,11128
615,2019-09-18,442,12170,1559,11,14182
615,2019-09-19,615,6639,2430,8,9692
615,2019-09-20,418,10423,2402,12,13255
615,2019-09-21,330,9460,1012,9,10811
615,2019-09-22,1246,13802,2101,5,17154
615,2019-09-23,1315,13275,1812,2,16404
615,2019-09-24,473,11428,2254,3,14158
615,2019-09-25,380,9761,1256,16,11413
615,2019-09-26,1099,14078,1204,1,16382
615,2019-09-27,200,9911,1785,2,11898
615,2019-09-28,252,25728,2066,3,28049
615,2019-09-29,287,20042,1764,1,22094
615,2019-09-30,227,18801,2106,1,21135
615,2019-10-01,247,18009,1728,0,19984
615,2019-10-02,257,13201,1302,1,14761
615,2019-10-03,1519,14885,1620,1,18025
615,2019-10-04,2463,12389,1120,2,15974
615,2019-10-05,312,15424,1183,0,16919
615,2019-10-06,239,12059,2265,1,14564
615,2019-10-07,217,6646,2138,2,9003
615,2019-10-08,430,13317,1520,3,15270
615,2019-10-09,339,16018,1107,1,17465
615,2019-10-10,661,11816,1819,18,14314
615,2019-10-11,452,14451,1941,0,16844
615,2019-10-12,1861,9821,2453,3,14138
615,2019-10-13,737,9207,1748,2,11694
615,2019-10-14,1195,9082,2278,1,12556
615,2019-10-15,360,15653,1978,1,17992
615,2019-10-16,931,24511,1556,0,26998
615,2019-10-17,617,9019,2030,2,11668
615,2019-10-18,990,15494,2007,1,18492
615,2019-10-19,378,8943,1656,1,10978
615,2019-10-20,496,3344,1781,1,5622
615,2019-10-21,677,10883,1546,1,13107
615,2019-10-22,372,7059,2328,1,9760
615,2019-10-23,383,9160,1308,4,10855
615,2019-10-24,459,14142,2377,1,16979
615,2019-10-25,494,11430,1479,2,13405
615,2019-10-26,620,14169,1701,1,16491
615,2019-10-27,2352,16927,1423,0,20702
615,2019-10-28,685,14772,1738,1,17196
615,2019-10-29,1435,27671,1608,1,30715
615,2019-10-30,658,21648,1354,1,23661
615,2019-10-31,744,20801,1893,0,23438
615,2019-11-01,378,39910,1474,1,41763
615,2019-11-02,1594,20036,1219,4,22853
615,2019-11-03,429,38248,1110,0,39787
615,2019-11-04,403,15244,1553,75,17275
615,2019-11-05,371,3494,1150,0,5015
615,2019-11-06,421,15228,1085,2,16736
615,2019-11-07,457,17605,1382,2,19446
615,2019-11-08,399,10770,974,0,12143
615,2019-11-09,449,9794,2133,0,12376
615,2019-11-10,325,25830,896,0,27051
615,2019-11-11,377,17875,1571,0,19823
615,2019-11-12,475,23088,2583,5,26151
615,2019-11-13,1249,14907,1796,2,17954
615,2019-11-14,392,13771,2040,0,16203
615,2019-11-15,302,5269,2973,2,8546
615,2019-11-16,1752,2769,3126,1,7648
615,2019-11-17,1408,4984,3293,4,9689
615,2019-11-18,1112,2851,2991,1,6955
615,2019-11-19,493,3757,2936,1,7187
615,2019-11-20,1599,2041,2463,0,6103
615,2019-11-21,361,4292,1582,0,6235
615,2019-11-22,356,9664,1486,8,11514
615,2019-11-23,960,7550,2224,0,10734
615,2019-11-24,439,10959,1768,1,13167
615,2019-11-25,1298,11809,1912,2,15021
615,2019-11-26,869,7145,2145,0,10159
615,2019-11-27,268,7088,1083,4,8443
615,2019-11-28,792,9375,750,1,10918
615,2019-11-29,30,847,2,0,879
615,2019-08-01,290,19701,48,1,20040
615,2019-08-02,444,22596,250,0,23290
615,2019-08-03,1038,6622,469,1,8130
615,2019-08-04,1306,1124,352,0,2782
615,2019-08-05,987,850,353,0,2190
615,2019-08-06,1116,4983,338,0,6437
615,2019-08-07,1099,23884,450,0,25433
615,2019-08-08,740,9167,158,0,10065
615,2019-08-09,955,2220,86,0,3261
615,2019-08-10,682,1400,407,1,2490
615,2019-08-11,493,1312,133,1,1939
615,2019-08-12,459,1628,106,0,2193
615,2019-08-13,479,5747,99,0,6325
615,2019-08-14,588,5592,213,1,6394
615,2019-08-15,447,1184,7,3,1641
615,2019-08-16,220,4916,93,0,5229
615,2019-08-17,390,3716,762,1,4869
615,2019-08-18,391,4021,854,0,5266
615,2019-08-19,1163,3296,1304,1,5764
615,2019-08-20,433,4766,1006,1,6206
615,2019-08-21,415,2395,1131,0,3941
615,2019-08-22,1235,15640,936,1,17812
615,2019-08-23,420,23111,1552,1,25084
615,2019-08-24,953,8324,1894,2,11173
615,2019-08-25,880,13789,2021,3,16693
615,2019-08-26,1775,25084,1842,1,28702
615,2019-08-27,1408,16040,1980,1,19429
615,2019-08-28,868,22145,1262,1,24276
615,2019-08-29,1166,16344,1723,2,19235
615,2019-08-30,873,4054,596,2,5525
615,2019-08-31,324,556,10,0,890
615,2019-09-01,139,1112,270,0,1521
615,2019-09-02,130,547,50,0,727
615,2019-09-03,711,4778,714,1,6204
615,2019-09-04,431,11777,2274,2,14484
615,2019-09-05,436,15401,1362,3,17202
615,2019-09-06,497,19136,2038,1,21672
615,2019-09-07,555,13951,2205,0,16711
615,2019-09-08,821,7065,1552,0,9438
615,2019-09-09,442,7007,1714,1,9164
615,2019-09-10,1133,8976,1504,0,11613
615,2019-09-11,386,7023,1653,3,9065
615,2019-09-12,369,7526,1760,1,9656
615,2019-09-13,653,5133,1372,3,7161
615,2019-09-14,2226,7625,2309,0,12160
615,2019-09-15,385,9201,2435,11,12032
615,2019-09-16,408,15068,2508,21,18005
615,2019-09-17,616,8875,1631,6,11128
615,2019-09-18,442,12170,1559,11,14182
615,2019-09-19,615,6639,2430,8,9692
615,2019-09-20,418,10423,2402,12,13255
615,2019-09-21,330,9460,1012,9,10811
615,2019-09-22,1246,13802,2101,5,17154
615,2019-09-23,1315,13275,1812,2,16404
615,2019-09-24,473,11428,2254,3,14158
615,2019-09-25,380,9761,1256,16,11413
615,2019-09-26,1099,14078,1204,1,16382
615,2019-09-27,200,9911,1785,2,11898
615,2019-09-28,252,25728,2066,3,28049
615,2019-09-29,287,20042,1764,1,22094
615,2019-09-30,227,18801,2106,1,21135
615,2019-10-01,247,18009,1728,0,19984
615,2019-10-02,257,13201,1302,1,14761
615,2019-10-03,1519,14885,1620,1,18025
615,2019-10-04,2463,12389,1120,2,15974
615,2019-10-05,312,15424,1183,0,16919
615,2019-10-06,239,12059,2265,1,14564
615,2019-10-07,217,6646,2138,2,9003
615,2019-10-08,430,13317,1520,3,15270
615,2019-10-09,339,16018,1107,1,17465
615,2019-10-10,661,11816,1819,18,14314
615,2019-10-11,452,14451,1941,0,16844
615,2019-10-12,1861,9821,2453,3,14138
615,2019-10-13,737,9207,1748,2,11694
615,2019-10-14,1195,9082,2278,1,12556
615,2019-10-15,360,15653,1978,1,17992
615,2019-10-16,931,24511,1556,0,26998
615,2019-10-17,617,9019,2030,2,11668
615,2019-10-18,990,15494,2007,1,18492
615,2019-10-19,378,8943,1656,1,10978
615,2019-10-20,496,3344,1781,1,5622
615,2019-10-21,677,10883,1546,1,13107
615,2019-10-22,372,7059,2328,1,9760
615,2019-10-23,383,9160,1308,4,10855
615,2019-10-24,459,14142,2377,1,16979
615,2019-10-25,494,11430,1479,2,13405
615,2019-10-26,620,14169,1701,1,16491
615,2019-10-27,2352,16927,1423,0,20702
615,2019-10-28,685,14772,1738,1,17196
615,2019-10-29,1435,27671,1608,1,30715
615,2019-10-30,658,21648,1354,1,23661
615,2019-10-31,744,20801,1893,0,23438
615,2019-11-01,378,39910,1474,1,41763
615,2019-11-02,1594,20036,1219,4,22853
615,2019-11-03,429,38248,1110,0,39787
615,2019-11-04,403,15244,1553,75,17275
615,2019-11-05,371,3494,1150,0,5015
615,2019-11-06,421,15228,1085,2,16736
615,2019-11-07,457,17605,1382,2,19446
615,2019-11-08,399,10770,974,0,12143
615,2019-11-09,449,9794,2133,0,12376
615,2019-11-10,325,25830,896,0,27051
615,2019-11-11,377,17875,1571,0,19823
615,2019-11-12,475,23088,2583,5,26151
615,2019-11-13,1249,14907,1796,2,17954
615,2019-11-14,392,13771,2040,0,16203
615,2019-11-15,302,5269,2973,2,8546
615,2019-11-16,1752,2769,3126,1,7648
615,2019-11-17,1408,4984,3293,4,9689
615,2019-11-18,1112,2851,2991,1,6955
615,2019-11-19,493,3757,2936,1,7187
615,2019-11-20,1599,2041,2463,0,6103
615,2019-11-21,361,4292,1582,0,6235
615,2019-11-22,356,9664,1486,8,11514
615,2019-11-23,960,7550,2224,0,10734
615,2019-11-24,439,10959,1768,1,13167
615,2019-11-25,1298,11809,1912,2,15021
615,2019-11-26,869,7145,2145,0,10159
615,2019-11-27,268,7088,1083,4,8443
615,2019-11-28,792,9375,750,1,10918
615,2019-11-29,30,847,2,0,879
615,2019-08-01,290,19701,48,1,20040
615,2019-08-02,444,22596,250,0,23290
615,2019-08-03,1038,6622,469,1,8130
615,2019-08-04,1306,1124,352,0,2782
615,2019-08-05,987,850,353,0,2190
615,2019-08-06,1116,4983,338,0,6437
615,2019-08-07,1099,23884,450,0,25433
615,2019-08-08,740,9167,158,0,10065
615,2019-08-09,955,2220,86,0,3261
615,2019-08-10,682,1400,407,1,2490
615,2019-08-11,493,1312,133,1,1939
615,2019-08-12,459,1628,106,0,2193
615,2019-08-13,479,5747,99,0,6325
615,2019-08-14,588,5592,213,1,6394
615,2019-08-15,447,1184,7,3,1641
615,2019-08-16,220,4916,93,0,5229
615,2019-08-17,390,3716,762,1,4869
615,2019-08-18,391,4021,854,0,5266
615,2019-08-19,1163,3296,1304,1,5764
615,2019-08-20,433,4766,1006,1,6206
615,2019-08-21,415,2395,1131,0,3941
615,2019-08-22,1235,15640,936,1,17812
615,2019-08-23,420,23111,1552,1,25084
615,2019-08-24,953,8324,1894,2,11173
615,2019-08-25,880,13789,2021,3,16693
615,2019-08-26,1775,25084,1842,1,28702
615,2019-08-27,1408,16040,1980,1,19429
615,2019-08-28,868,22145,1262,1,24276
615,2019-08-29,1166,16344,1723,2,19235
615,2019-08-30,873,4054,596,2,5525
615,2019-08-31,324,556,10,0,890
615,2019-09-01,139,1112,270,0,1521
615,2019-09-02,130,547,50,0,727
615,2019-09-03,711,4778,714,1,6204
615,2019-09-04,431,11777,2274,2,14484
615,2019-09-05,436,15401,1362,3,17202
615,2019-09-06,497,19136,2038,1,21672
615,2019-09-07,555,13951,2205,0,16711
615,2019-09-08,821,7065,1552,0,9438
615,2019-09-09,442,7007,1714,1,9164
615,2019-09-10,1133,8976,1504,0,11613
615,2019-09-11,386,7023,1653,3,9065
615,2019-09-12,369,7526,1760,1,9656
615,2019-09-13,653,5133,1372,3,7161
615,2019-09-14,2226,7625,2309,0,12160
615,2019-09-15,385,9201,2435,11,12032
615,2019-09-16,408,15068,2508,21,18005
615,2019-09-17,616,8875,1631,6,11128
615,2019-09-18,442,12170,1559,11,14182
615,2019-09-19,615,6639,2430,8,9692
615,2019-09-20,418,10423,2402,12,13255
615,2019-09-21,330,9460,1012,9,10811
615,2019-09-22,1246,13802,2101,5,17154
615,2019-09-23,1315,13275,1812,2,16404
615,2019-09-24,473,11428,2254,3,14158
615,2019-09-25,380,9761,1256,16,11413
615,2019-09-26,1099,14078,1204,1,16382
615,2019-09-27,200,9911,1785,2,11898
615,2019-09-28,252,25728,2066,3,28049
615,2019-09-29,287,20042,1764,1,22094
615,2019-09-30,227,18801,2106,1,21135
615,2019-10-01,247,18009,1728,0,19984
615,2019-10-02,257,13201,1302,1,14761
615,2019-10-03,1519,14885,1620,1,18025
615,2019-10-04,2463,12389,1120,2,15974
615,2019-10-05,312,15424,1183,0,16919
615,2019-10-06,239,12059,2265,1,14564
615,2019-10-07,217,6646,2138,2,9003
615,2019-10-08,430,13317,1520,3,15270
615,2019-10-09,339,16018,1107,1,17465
615,2019-10-10,661,11816,1819,18,14314
615,2019-10-11,452,14451,1941,0,16844
615,2019-10-12,1861,9821,2453,3,14138
615,2019-10-13,737,9207,1748,2,11694
615,2019-10-14,1195,9082,2278,1,12556
615,2019-10-15,360,15653,1978,1,17992
615,2019-10-16,931,24511,1556,0,26998
615,2019-10-17,617,9019,2030,2,11668
615,2019-10-18,990,15494,2007,1,18492
615,2019-10-19,378,8943,1656,1,10978
615,2019-10-20,496,3344,1781,1,5622
615,2019-10-21,677,10883,1546,1,13107
615,2019-10-22,372,7059,2328,1,9760
615,2019-10-23,383,9160,1308,4,10855
615,2019-10-24,459,14142,2377,1,16979
615,2019-10-25,494,11430,1479,2,13405
615,2019-10-26,620,14169,1701,1,16491
615,2019-10-27,2352,16927,1423,0,20702
615,2019-10-28,685,14772,1738,1,17196
615,2019-10-29,1435,27671,1608,1,30715
615,2019-10-30,658,21648,1354,1,23661
615,2019-10-31,744,20801,1893,0,23438
615,2019-11-01,378,39910,1474,1,41763
615,2019-11-02,1594,20036,1219,4,22853
615,2019-11-03,429,38248,1110,0,39787
615,2019-11-04,403,15244,1553,75,17275
615,2019-11-05,371,3494,1150,0,5015
615,2019-11-06,421,15228,1085,2,16736
615,2019-11-07,457,17605,1382,2,19446
615,2019-11-08,399,10770,974,0,12143
615,2019-11-09,449,9794,2133,0,12376
615,2019-11-10,325,25830,896,0,27051
615,2019-11-11,377,17875,1571,0,19823
615,2019-11-12,475,23088,2583,5,26151
615,2019-11-13,1249,14907,1796,2,17954
615,2019-11-14,392,13771,2040,0,16203
615,2019-11-15,302,5269,2973,2,8546
615,2019-11-16,1752,2769,3126,1,7648
615,2019-11-17,1408,4984,3293,4,9689
615,2019-11-18,1112,2851,2991,1,6955
615,2019-11-19,493,3757,2936,1,7187
615,2019-11-20,1599,2041,2463,0,6103
615,2019-11-21,361,4292,1582,0,6235
615,2019-11-22,356,9664,1486,8,11514
615,2019-11-23,960,7550,2224,0,10734
615,2019-11-24,439,10959,1768,1,13167
615,2019-11-25,1298,11809,1912,2,15021
615,2019-11-26,869,7145,2145,0,10159
615,2019-11-27,268,7088,1083,4,8443
615,2019-11-28,792,9375,750,1,10918
616,2019-08-01,48,38896,304,0,39248
616,2019-08-02,79,37576,462,0,38117
616,2019-08-03,235,9765,66,0,10066
616,2019-08-04,52,1249,291,1,1593
616,2019-08-05,308,14137,385,1,14831
616,2019-08-06,405,5868,555,2,6830
616,2019-08-07,89,6652,322,1,7064
616,2019-08-08,345,2957,320,0,3622
616,2019-08-09,59,2051,333,1,2444
616,2019-08-10,58,1424,123,0,1605
616,2019-08-11,111,1548,156,1,1816
616,2019-08-12,48,15821,106,0,15975
616,2019-08-13,48,18309,195,0,18552
616,2019-08-14,75,3635,151,1,3862
616,2019-08-15,44,1988,3,0,2035
616,2019-08-16,52,4197,120,1,4370
616,2019-08-17,193,3764,125,0,4082
616,2019-08-18,104,3662,1491,2,5259
616,2019-08-19,914,16154,1264,2,18334
616,2019-08-20,292,19441,1385,1,21119
616,2019-08-21,1265,13334,1442,0,16041
616,2019-08-22,937,19146,1095,0,21178
616,2019-08-23,90,24707,991,1,25789
616,2019-08-24,113,18870,1360,0,20343
616,2019-08-25,108,28661,1921,2,30692
616,2019-08-26,100,28400,1624,1,30125
616,2019-08-27,90,22953,2613,0,25656
616,2019-08-28,407,21338,1350,4,23099
616,2019-08-29,134,13992,2048,1,16175
616,2019-08-30,122,4949,1262,1,6334
616,2019-08-31,22,527,1,0,550
616,2019-09-01,155,873,93,0,1121
616,2019-09-02,17,1143,8,0,1168
616,2019-09-03,89,1390,1342,1,2822
616,2019-09-04,92,13198,3018,2,16310
616,2019-09-05,127,8382,1913,1,10423
616,2019-09-06,144,17268,2400,1,19813
616,2019-09-07,1903,7517,2561,0,11981
616,2019-09-08,312,31217,2794,0,34323
616,2019-09-09,1912,10548,2355,0,14815
616,2019-09-10,88,9796,1603,0,11487
616,2019-09-11,111,13677,1546,2,15336
616,2019-09-12,64,8859,2177,2,11102
616,2019-09-13,131,6460,2251,2,8844
616,2019-09-14,450,6736,1374,1,8561
616,2019-09-15,81,14714,2200,1,16996
616,2019-09-16,1022,17335,2368,6,20731
616,2019-09-17,915,13080,2150,15,16160
616,2019-09-18,73,12794,1032,10,13909
616,2019-09-19,285,12836,1712,8,14841
616,2019-09-20,214,14564,769,7,15554
616,2019-09-21,64,5736,1317,4,7121
616,2019-09-22,71,14546,2345,7,16969
616,2019-09-23,1068,11676,2114,1,14859
616,2019-09-24,125,35608,1415,2,37150
616,2019-09-25,180,18791,1561,3,20535
616,2019-09-26,949,15426,1656,0,18031
616,2019-09-27,203,10628,1782,3,12616
616,2019-09-28,127,16910,2573,10,19620
616,2019-09-29,100,23643,1510,2,25255
616,2019-09-30,926,16422,2319,3,19670
616,2019-10-01,558,16593,2203,1,19355
616,2019-10-02,937,13096,1798,3,15834
616,2019-10-03,103,15361,881,2,16347
616,2019-10-04,112,21920,863,0,22895
616,2019-10-05,857,24177,1922,3,26959
616,2019-10-06,1133,17519,2601,0,21253
616,2019-10-07,1300,20527,1788,5,23620
616,2019-10-08,103,35060,2421,0,37584
616,2019-10-09,1869,17776,1354,1,21000
616,2019-10-10,144,11963,2626,0,14733
616,2019-10-11,1009,11687,1115,2,13813
616,2019-10-12,78,8086,1567,4,9735
616,2019-10-13,964,11313,1590,2,13869
616,2019-10-14,484,7544,1557,2,9587
616,2019-10-15,187,8777,2204,0,11168
616,2019-10-16,178,13305,1435,1,14919
616,2019-10-17,658,9772,1709,2,12141
616,2019-10-18,198,19935,1232,2,21367
616,2019-10-19,194,6265,2612,0,9071
616,2019-10-20,122,4382,1747,0,6251
616,2019-10-21,110,11565,1023,1,12699
616,2019-10-22,1076,9991,1614,5,12686
616,2019-10-23,745,9256,1781,2,11784
616,2019-10-24,130,14650,1468,2,16250
616,2019-10-25,123,12120,867,1,13111
616,2019-10-26,1009,15342,2097,0,18448
616,2019-10-27,108,17516,1558,11,19193
616,2019-10-28,776,14822,1098,1,16697
616,2019-10-29,554,28104,1768,1,30427
616,2019-10-30,95,21726,1421,1,23243
616,2019-10-31,650,13133,1612,1,15396
616,2019-11-01,65,15656,953,2,16676
616,2019-11-02,474,14597,1517,1,16589
616,2019-11-03,101,23200,1505,0,24806
616,2019-11-04,103,11692,2166,0,13961
616,2019-11-05,1041,3880,1815,2,6738
616,2019-11-06,116,8965,1441,5,10527
616,2019-11-07,299,14548,1406,3,16256
616,2019-11-08,456,10494,1236,0,12186
616,2019-11-09,117,9769,1221,1,11108
616,2019-11-10,95,25834,1138,2,27069
616,2019-11-11,643,17280,790,3,18716
616,2019-11-12,129,18678,2762,0,21569
616,2019-11-13,198,15950,1592,0,17740
616,2019-11-14,158,13889,2416,1,16464
616,2019-11-15,110,5856,2535,2,8503
616,2019-11-16,717,2773,2441,1,5932
616,2019-11-17,205,3953,4149,0,8307
616,2019-11-18,149,2770,3142,2,6063
616,2019-11-19,1092,5849,2619,0,9560
616,2019-11-20,964,1696,2217,1,4878
616,2019-11-21,128,4241,1527,2,5898
616,2019-11-22,114,5948,1242,1,7305
616,2019-11-23,131,10126,2484,0,12741
616,2019-11-24,125,9270,1454,0,10849
616,2019-11-25,939,11568,2027,0,14534
616,2019-11-26,184,9549,1836,0,11569
616,2019-11-27,569,6913,1632,0,9114
616,2019-11-28,52,11896,424,0,12372
616,2019-11-29,10,169,1,0,180
616,2019-08-01,48,38896,304,0,39248
616,2019-08-02,79,37576,462,0,38117
616,2019-08-03,235,9765,66,0,10066
616,2019-08-04,52,1249,291,1,1593
616,2019-08-05,308,14137,385,1,14831
616,2019-08-06,405,5868,555,2,6830
616,2019-08-07,89,6652,322,1,7064
616,2019-08-08,345,2957,320,0,3622
616,2019-08-09,59,2051,333,1,2444
616,2019-08-10,58,1424,123,0,1605
616,2019-08-11,111,1548,156,1,1816
616,2019-08-12,48,15821,106,0,15975
616,2019-08-13,48,18309,195,0,18552
616,2019-08-14,75,3635,151,1,3862
616,2019-08-15,44,1988,3,0,2035
616,2019-08-16,52,4197,120,1,4370
616,2019-08-17,193,3764,125,0,4082
616,2019-08-18,104,3662,1491,2,5259
616,2019-08-19,914,16154,1264,2,18334
616,2019-08-20,292,19441,1385,1,21119
616,2019-08-21,1265,13334,1442,0,16041
616,2019-08-22,937,19146,1095,0,21178
616,2019-08-23,90,24707,991,1,25789
616,2019-08-24,113,18870,1360,0,20343
616,2019-08-25,108,28661,1921,2,30692
616,2019-08-26,100,28400,1624,1,30125
616,2019-08-27,90,22953,2613,0,25656
616,2019-08-28,407,21338,1350,4,23099
616,2019-08-29,134,13992,2048,1,16175
616,2019-08-30,122,4949,1262,1,6334
616,2019-08-31,22,527,1,0,550
616,2019-09-01,155,873,93,0,1121
616,2019-09-02,17,1143,8,0,1168
616,2019-09-03,89,1390,1342,1,2822
616,2019-09-04,92,13198,3018,2,16310
616,2019-09-05,127,8382,1913,1,10423
616,2019-09-06,144,17268,2400,1,19813
616,2019-09-07,1903,7517,2561,0,11981
616,2019-09-08,312,31217,2794,0,34323
616,2019-09-09,1912,10548,2355,0,14815
616,2019-09-10,88,9796,1603,0,11487
616,2019-09-11,111,13677,1546,2,15336
616,2019-09-12,64,8859,2177,2,11102
616,2019-09-13,131,6460,2251,2,8844
616,2019-09-14,450,6736,1374,1,8561
616,2019-09-15,81,14714,2200,1,16996
616,2019-09-16,1022,17335,2368,6,20731
616,2019-09-17,915,13080,2150,15,16160
616,2019-09-18,73,12794,1032,10,13909
616,2019-09-19,285,12836,1712,8,14841
616,2019-09-20,214,14564,769,7,15554
616,2019-09-21,64,5736,1317,4,7121
616,2019-09-22,71,14546,2345,7,16969
616,2019-09-23,1068,11676,2114,1,14859
616,2019-09-24,125,35608,1415,2,37150
616,2019-09-25,180,18791,1561,3,20535
616,2019-09-26,949,15426,1656,0,18031
616,2019-09-27,203,10628,1782,3,12616
616,2019-09-28,127,16910,2573,10,19620
616,2019-09-29,100,23643,1510,2,25255
616,2019-09-30,926,16422,2319,3,19670
616,2019-10-01,558,16593,2203,1,19355
616,2019-10-02,937,13096,1798,3,15834
616,2019-10-03,103,15361,881,2,16347
616,2019-10-04,112,21920,863,0,22895
616,2019-10-05,857,24177,1922,3,26959
616,2019-10-06,1133,17519,2601,0,21253
616,2019-10-07,1300,20527,1788,5,23620
616,2019-10-08,103,35060,2421,0,37584
616,2019-10-09,1869,17776,1354,1,21000
616,2019-10-10,144,11963,2626,0,14733
616,2019-10-11,1009,11687,1115,2,13813
616,2019-10-12,78,8086,1567,4,9735
616,2019-10-13,964,11313,1590,2,13869
616,2019-10-14,484,7544,1557,2,9587
616,2019-10-15,187,8777,2204,0,11168
616,2019-10-16,178,13305,1435,1,14919
616,2019-10-17,658,9772,1709,2,12141
616,2019-10-18,198,19935,1232,2,21367
616,2019-10-19,194,6265,2612,0,9071
616,2019-10-20,122,4382,1747,0,6251
616,2019-10-21,110,11565,1023,1,12699
616,2019-10-22,1076,9991,1614,5,12686
616,2019-10-23,745,9256,1781,2,11784
616,2019-10-24,130,14650,1468,2,16250
616,2019-10-25,123,12120,867,1,13111
616,2019-10-26,1009,15342,2097,0,18448
616,2019-10-27,108,17516,1558,11,19193
616,2019-10-28,776,14822,1098,1,16697
616,2019-10-29,554,28104,1768,1,30427
616,2019-10-30,95,21726,1421,1,23243
616,2019-10-31,650,13133,1612,1,15396
616,2019-11-01,65,15656,953,2,16676
616,2019-11-02,474,14597,1517,1,16589
616,2019-11-03,101,23200,1505,0,24806
616,2019-11-04,103,11692,2166,0,13961
616,2019-11-05,1041,3880,1815,2,6738
616,2019-11-06,116,8965,1441,5,10527
616,2019-11-07,299,14548,1406,3,16256
616,2019-11-08,456,10494,1236,0,12186
616,2019-11-09,117,9769,1221,1,11108
616,2019-11-10,95,25834,1138,2,27069
616,2019-11-11,643,17280,790,3,18716
616,2019-11-12,129,18678,2762,0,21569
616,2019-11-13,198,15950,1592,0,17740
616,2019-11-14,158,13889,2416,1,16464
616,2019-11-15,110,5856,2535,2,8503
616,2019-11-16,717,2773,2441,1,5932
616,2019-11-17,205,3953,4149,0,8307
616,2019-11-18,149,2770,3142,2,6063
616,2019-11-19,1092,5849,2619,0,9560
616,2019-11-20,964,1696,2217,1,4878
616,2019-11-21,128,4241,1527,2,5898
616,2019-11-22,114,5948,1242,1,7305
616,2019-11-23,131,10126,2484,0,12741
616,2019-11-24,125,9270,1454,0,10849
616,2019-11-25,939,11568,2027,0,14534
616,2019-11-26,184,9549,1836,0,11569
616,2019-11-27,569,6913,1632,0,9114
616,2019-11-28,52,11896,424,0,12372
616,2019-11-29,10,169,1,0,180
616,2019-08-01,48,38896,304,0,39248
616,2019-08-02,79,37576,462,0,38117
616,2019-08-03,235,9765,66,0,10066
616,2019-08-04,52,1249,291,1,1593
616,2019-08-05,308,14137,385,1,14831
616,2019-08-06,405,5868,555,2,6830
616,2019-08-07,89,6652,322,1,7064
616,2019-08-08,345,2957,320,0,3622
616,2019-08-09,59,2051,333,1,2444
616,2019-08-10,58,1424,123,0,1605
616,2019-08-11,111,1548,156,1,1816
616,2019-08-12,48,15821,106,0,15975
616,2019-08-13,48,18309,195,0,18552
616,2019-08-14,75,3635,151,1,3862
616,2019-08-15,44,1988,3,0,2035
616,2019-08-16,52,4197,120,1,4370
616,2019-08-17,193,3764,125,0,4082
616,2019-08-18,104,3662,1491,2,5259
616,2019-08-19,914,16154,1264,2,18334
616,2019-08-20,292,19441,1385,1,21119
616,2019-08-21,1265,13334,1442,0,16041
616,2019-08-22,937,19146,1095,0,21178
616,2019-08-23,90,24707,991,1,25789
616,2019-08-24,113,18870,1360,0,20343
616,2019-08-25,108,28661,1921,2,30692
616,2019-08-26,100,28400,1624,1,30125
616,2019-08-27,90,22953,2613,0,25656
616,2019-08-28,407,21338,1350,4,23099
616,2019-08-29,134,13992,2048,1,16175
616,2019-08-30,122,4949,1262,1,6334
616,2019-08-31,22,527,1,0,550
616,2019-09-01,155,873,93,0,1121
616,2019-09-02,17,1143,8,0,1168
616,2019-09-03,89,1390,1342,1,2822
616,2019-09-04,92,13198,3018,2,16310
616,2019-09-05,127,8382,1913,1,10423
616,2019-09-06,144,17268,2400,1,19813
616,2019-09-07,1903,7517,2561,0,11981
616,2019-09-08,312,31217,2794,0,34323
616,2019-09-09,1912,10548,2355,0,14815
616,2019-09-10,88,9796,1603,0,11487
616,2019-09-11,111,13677,1546,2,15336
616,2019-09-12,64,8859,2177,2,11102
616,2019-09-13,131,6460,2251,2,8844
616,2019-09-14,450,6736,1374,1,8561
616,2019-09-15,81,14714,2200,1,16996
616,2019-09-16,1022,17335,2368,6,20731
616,2019-09-17,915,13080,2150,15,16160
616,2019-09-18,73,12794,1032,10,13909
616,2019-09-19,285,12836,1712,8,14841
616,2019-09-20,214,14564,769,7,15554
616,2019-09-21,64,5736,1317,4,7121
616,2019-09-22,71,14546,2345,7,16969
616,2019-09-23,1068,11676,2114,1,14859
616,2019-09-24,125,35608,1415,2,37150
616,2019-09-25,180,18791,1561,3,20535
616,2019-09-26,949,15426,1656,0,18031
616,2019-09-27,203,10628,1782,3,12616
616,2019-09-28,127,16910,2573,10,19620
616,2019-09-29,100,23643,1510,2,25255
616,2019-09-30,926,16422,2319,3,19670
616,2019-10-01,558,16593,2203,1,19355
616,2019-10-02,937,13096,1798,3,15834
616,2019-10-03,103,15361,881,2,16347
616,2019-10-04,112,21920,863,0,22895
616,2019-10-05,857,24177,1922,3,26959
616,2019-10-06,1133,17519,2601,0,21253
616,2019-10-07,1300,20527,1788,5,23620
616,2019-10-08,103,35060,2421,0,37584
616,2019-10-09,1869,17776,1354,1,21000
616,2019-10-10,144,11963,2626,0,14733
616,2019-10-11,1009,11687,1115,2,13813
616,2019-10-12,78,8086,1567,4,9735
616,2019-10-13,964,11313,1590,2,13869
616,2019-10-14,484,7544,1557,2,9587
616,2019-10-15,187,8777,2204,0,11168
616,2019-10-16,178,13305,1435,1,14919
616,2019-10-17,658,9772,1709,2,12141
616,2019-10-18,198,19935,1232,2,21367
616,2019-10-19,194,6265,2612,0,9071
616,2019-10-20,122,4382,1747,0,6251
616,2019-10-21,110,11565,1023,1,12699
616,2019-10-22,1076,9991,1614,5,12686
616,2019-10-23,745,9256,1781,2,11784
616,2019-10-24,130,14650,1468,2,16250
616,2019-10-25,123,12120,867,1,13111
616,2019-10-26,1009,15342,2097,0,18448
616,2019-10-27,108,17516,1558,11,19193
616,2019-10-28,776,14822,1098,1,16697
616,2019-10-29,554,28104,1768,1,30427
616,2019-10-30,95,21726,1421,1,23243
616,2019-10-31,650,13133,1612,1,15396
616,2019-11-01,65,15656,953,2,16676
616,2019-11-02,474,14597,1517,1,16589
616,2019-11-03,101,23200,1505,0,24806
616,2019-11-04,103,11692,2166,0,13961
616,2019-11-05,1041,3880,1815,2,6738
616,2019-11-06,116,8965,1441,5,10527
616,2019-11-07,299,14548,1406,3,16256
616,2019-11-08,456,10494,1236,0,12186
616,2019-11-09,117,9769,1221,1,11108
616,2019-11-10,95,25834,1138,2,27069
616,2019-11-11,643,17280,790,3,18716
616,2019-11-12,129,18678,2762,0,21569
616,2019-11-13,198,15950,1592,0,17740
616,2019-11-14,158,13889,2416,1,16464
616,2019-11-15,110,5856,2535,2,8503
616,2019-11-16,717,2773,2441,1,5932
616,2019-11-17,205,3953,4149,0,8307
616,2019-11-18,149,2770,3142,2,6063
616,2019-11-19,1092,5849,2619,0,9560
616,2019-11-20,964,1696,2217,1,4878
616,2019-11-21,128,4241,1527,2,5898
616,2019-11-22,114,5948,1242,1,7305
616,2019-11-23,131,10126,2484,0,12741
616,2019-11-24,125,9270,1454,0,10849
616,2019-11-25,939,11568,2027,0,14534
616,2019-11-26,184,9549,1836,0,11569
616,2019-11-27,569,6913,1632,0,9114
616,2019-11-28,52,11896,424,0,12372
616,2019-11-29,10,169,1,0,180
616,2019-08-04,52,1249,291,1,1593
616,2019-08-05,308,14137,385,1,14831
616,2019-08-06,405,5868,555,2,6830
616,2019-08-07,89,6652,322,1,7064
616,2019-08-08,345,2957,320,0,3622
616,2019-08-09,59,2051,333,1,2444
616,2019-08-10,58,1424,123,0,1605
616,2019-08-11,111,1548,156,1,1816
616,2019-08-12,48,15821,106,0,15975
616,2019-08-13,48,18309,195,0,18552
616,2019-08-14,75,3635,151,1,3862
616,2019-08-15,44,1988,3,0,2035
616,2019-08-16,52,4197,120,1,4370
616,2019-08-17,193,3764,125,0,4082
616,2019-08-18,104,3662,1491,2,5259
616,2019-08-19,914,16154,1264,2,18334
616,2019-08-20,292,19441,1385,1,21119
616,2019-08-21,1265,13334,1442,0,16041
616,2019-08-22,937,19146,1095,0,21178
616,2019-08-23,90,24707,991,1,25789
616,2019-08-24,113,18870,1360,0,20343
616,2019-08-25,108,28661,1921,2,30692
616,2019-08-26,100,28400,1624,1,30125
616,2019-08-27,90,22953,2613,0,25656
616,2019-08-28,407,21338,1350,4,23099
616,2019-08-29,134,13992,2048,1,16175
616,2019-08-30,122,4949,1262,1,6334
616,2019-08-31,22,527,1,0,550
616,2019-09-01,155,873,93,0,1121
616,2019-09-02,17,1143,8,0,1168
616,2019-09-03,89,1390,1342,1,2822
616,2019-09-04,92,13198,3018,2,16310
616,2019-09-05,127,8382,1913,1,10423
616,2019-09-06,144,17268,2400,1,19813
616,2019-09-07,1903,7517,2561,0,11981
616,2019-09-08,312,31217,2794,0,34323
616,2019-09-09,1912,10548,2355,0,14815
616,2019-09-10,88,9796,1603,0,11487
616,2019-09-11,111,13677,1546,2,15336
616,2019-09-12,64,8859,2177,2,11102
616,2019-09-13,131,6460,2251,2,8844
616,2019-09-14,450,6736,1374,1,8561
616,2019-09-15,81,14714,2200,1,16996
616,2019-09-16,1022,17335,2368,6,20731
616,2019-09-17,915,13080,2150,15,16160
616,2019-09-18,73,12794,1032,10,13909
616,2019-09-19,285,12836,1712,8,14841
616,2019-09-20,214,14564,769,7,15554
616,2019-09-21,64,5736,1317,4,7121
616,2019-09-22,71,14546,2345,7,16969
616,2019-09-23,1068,11676,2114,1,14859
616,2019-09-24,125,35608,1415,2,37150
616,2019-09-25,180,18791,1561,3,20535
616,2019-09-26,949,15426,1656,0,18031
616,2019-09-27,203,10628,1782,3,12616
616,2019-09-28,127,16910,2573,10,19620
616,2019-09-29,100,23643,1510,2,25255
616,2019-09-30,926,16422,2319,3,19670
616,2019-10-01,558,16593,2203,1,19355
616,2019-10-02,937,13096,1798,3,15834
616,2019-10-03,103,15361,881,2,16347
616,2019-10-04,112,21920,863,0,22895
616,2019-10-05,857,24177,1922,3,26959
616,2019-10-06,1133,17519,2601,0,21253
616,2019-10-07,1300,20527,1788,5,23620
616,2019-10-08,103,35060,2421,0,37584
616,2019-10-09,1869,17776,1354,1,21000
616,2019-10-10,144,11963,2626,0,14733
616,2019-10-11,1009,11687,1115,2,13813
616,2019-10-12,78,8086,1567,4,9735
616,2019-10-13,964,11313,1590,2,13869
616,2019-10-14,484,7544,1557,2,9587
616,2019-10-15,187,8777,2204,0,11168
616,2019-10-16,178,13305,1435,1,14919
616,2019-10-17,658,9772,1709,2,12141
616,2019-10-18,198,19935,1232,2,21367
616,2019-10-19,194,6265,2612,0,9071
616,2019-10-20,122,4382,1747,0,6251
616,2019-10-21,110,11565,1023,1,12699
616,2019-10-22,1076,9991,1614,5,12686
616,2019-10-23,745,9256,1781,2,11784
616,2019-10-24,130,14650,1468,2,16250
616,2019-10-25,123,12120,867,1,13111
616,2019-10-26,1009,15342,2097,0,18448
616,2019-10-27,108,17516,1558,11,19193
616,2019-10-28,776,14822,1098,1,16697
616,2019-10-29,554,28104,1768,1,30427
616,2019-10-30,95,21726,1421,1,23243
616,2019-10-31,650,13133,1612,1,15396
616,2019-11-01,65,15656,953,2,16676
616,2019-11-02,474,14597,1517,1,16589
616,2019-11-03,101,23200,1505,0,24806
616,2019-11-04,103,11692,2166,0,13961
616,2019-11-05,1041,3880,1815,2,6738
616,2019-11-06,116,8965,1441,5,10527
616,2019-11-07,299,14548,1406,3,16256
616,2019-11-08,456,10494,1236,0,12186
616,2019-11-09,117,9769,1221,1,11108
616,2019-11-10,95,25834,1138,2,27069
616,2019-11-11,643,17280,790,3,18716
616,2019-11-12,129,18678,2762,0,21569
616,2019-11-13,198,15950,1592,0,17740
616,2019-11-14,158,13889,2416,1,16464
616,2019-11-15,110,5856,2535,2,8503
616,2019-11-16,717,2773,2441,1,5932
616,2019-11-17,205,3953,4149,0,8307
616,2019-11-18,149,2770,3142,2,6063
616,2019-11-19,1092,5849,2619,0,9560
616,2019-11-20,964,1696,2217,1,4878
616,2019-11-21,128,4241,1527,2,5898
616,2019-11-22,114,5948,1242,1,7305
617,2019-08-01,38,0,286,1,325
617,2019-08-02,98,0,595,0,693
617,2019-08-03,78,0,457,1,536
617,2019-08-04,386,0,287,1,674
617,2019-08-05,307,0,266,2,575
617,2019-08-06,411,0,742,1,1154
617,2019-08-07,547,0,703,0,1250
617,2019-08-08,258,0,301,0,559
617,2019-08-09,259,0,266,0,525
617,2019-08-10,566,0,282,0,848
617,2019-08-11,230,0,140,0,370
617,2019-08-12,390,0,124,0,514
617,2019-08-13,429,0,179,2,610
617,2019-08-14,223,0,291,0,514
617,2019-08-15,213,0,57,1,271
617,2019-08-16,155,0,186,0,341
617,2019-08-17,433,0,950,1,1384
617,2019-08-18,287,0,906,2,1195
617,2019-08-19,295,0,1549,0,1844
617,2019-08-20,324,0,1040,1,1365
617,2019-08-21,808,0,1037,1,1846
617,2019-08-22,314,0,1140,2,1456
617,2019-08-23,417,0,1005,1,1423
617,2019-08-24,416,0,1673,1,2090
617,2019-08-25,419,0,2524,2,2945
617,2019-08-26,1674,0,1172,0,2846
617,2019-08-27,627,0,2160,0,2787
617,2019-08-28,877,0,1620,3,2500
617,2019-08-29,1508,0,1635,1,3144
617,2019-08-30,648,0,479,1,1128
617,2019-08-31,126,0,1,0,127
617,2019-09-01,155,0,201,0,356
617,2019-09-02,121,0,13,0,134
617,2019-09-03,239,0,761,1,1001
617,2019-09-04,370,0,2052,0,2422
617,2019-09-05,1652,0,2053,2,3707
617,2019-09-06,387,0,1933,1,2321
617,2019-09-07,441,0,2207,0,2648
617,2019-09-08,617,0,1663,1,2281
617,2019-09-09,1120,0,2179,1,3300
617,2019-09-10,536,0,1998,1,2535
617,2019-09-11,1341,0,2019,2,3362
617,2019-09-12,1218,0,2072,0,3290
617,2019-09-13,297,0,2762,12,3071
617,2019-09-14,314,0,1842,0,2156
617,2019-09-15,387,0,2585,3,2975
617,2019-09-16,1178,0,1630,2,2810
617,2019-09-17,1206,0,2190,1,3397
617,2019-09-18,1172,0,2220,0,3392
617,2019-09-19,566,0,1520,3,2089
617,2019-09-20,298,0,1440,0,1738
617,2019-09-21,146,0,1679,0,1825
617,2019-09-22,1901,0,1621,4,3526
617,2019-09-23,326,0,2345,3,2674
617,2019-09-24,324,0,2634,2,2960
617,2019-09-25,1072,0,2430,1,3503
617,2019-09-26,241,0,2349,0,2590
617,2019-09-27,339,0,2381,2,2722
617,2019-09-28,296,0,1231,0,1527
617,2019-09-29,1000,0,2273,2,3275
617,2019-09-30,989,0,1289,1,2279
617,2019-10-01,116,0,2321,0,2437
617,2019-10-02,995,0,2012,1,3008
617,2019-10-03,117,0,1877,0,1994
617,2019-10-04,141,0,1538,819,2498
617,2019-10-05,852,0,1805,0,2657
617,2019-10-06,832,0,1356,1,2189
617,2019-10-07,1060,0,2575,4,3639
617,2019-10-08,996,0,1721,0,2717
617,2019-10-09,274,0,1728,2,2004
617,2019-10-10,167,0,2420,1,2588
617,2019-10-11,185,0,2123,0,2308
617,2019-10-12,619,0,2391,6,3016
617,2019-10-13,231,0,1994,11,2236
617,2019-10-14,1079,0,2485,3,3567
617,2019-10-15,259,0,1683,1,1943
617,2019-10-16,201,0,2047,0,2248
617,2019-10-17,100,0,2285,4,2389
617,2019-10-18,1102,0,2382,0,3484
617,2019-10-19,103,0,1805,0,1908
617,2019-10-20,95,0,2078,0,2173
617,2019-10-21,792,0,1601,0,2393
617,2019-10-22,113,0,2721,5,2839
617,2019-10-23,107,0,1975,0,2082
617,2019-10-24,889,0,1891,0,2780
617,2019-10-25,116,0,1618,2,1736
617,2019-10-26,1742,0,1758,0,3500
617,2019-10-27,219,0,1856,1,2076
617,2019-10-28,248,0,1561,2,1811
617,2019-10-29,246,0,1987,0,2233
617,2019-10-30,846,0,1566,0,2412
617,2019-10-31,199,0,1800,1,2000
617,2019-11-01,520,0,2972,2,3494
617,2019-11-02,108,0,1333,1,1442
617,2019-11-03,111,0,2015,1,2127
617,2019-11-04,142,0,1587,0,1729
617,2019-11-05,168,0,1335,0,1503
617,2019-11-06,1000,0,1103,4,2107
617,2019-11-07,788,0,1657,4,2449
617,2019-11-08,129,0,1828,0,1957
617,2019-11-09,145,0,1427,0,1572
617,2019-11-10,519,0,1331,0,1850
617,2019-11-11,592,0,1349,4,1945
617,2019-11-12,132,0,3835,2,3969
617,2019-11-13,198,0,2772,0,2970
617,2019-11-14,176,0,2648,0,2824
617,2019-11-15,111,0,2627,2,2740
617,2019-11-16,649,0,3479,2,4130
617,2019-11-17,228,0,4062,0,4290
617,2019-11-18,138,0,4304,1,4443
617,2019-11-19,207,0,3328,1,3536
617,2019-11-20,570,0,2588,1,3159
617,2019-11-21,1052,0,1992,2,3046
617,2019-11-22,146,0,2553,2,2701
617,2019-11-23,128,0,2860,0,2988
617,2019-11-24,121,0,785,0,906
617,2019-11-25,101,0,0,0,101
617,2019-11-26,455,0,0,0,455
617,2019-11-27,424,0,0,0,424
617,2019-11-28,4,0,0,0,4
617,2019-08-01,38,0,286,1,325
617,2019-08-02,98,0,595,0,693
617,2019-08-03,78,0,457,1,536
617,2019-08-04,386,0,287,1,674
617,2019-08-05,307,0,266,2,575
617,2019-08-06,411,0,742,1,1154
617,2019-08-07,547,0,703,0,1250
617,2019-08-08,258,0,301,0,559
617,2019-08-09,259,0,266,0,525
617,2019-08-10,566,0,282,0,848
617,2019-08-11,230,0,140,0,370
617,2019-08-12,390,0,124,0,514
617,2019-08-13,429,0,179,2,610
617,2019-08-14,223,0,291,0,514
617,2019-08-15,213,0,57,1,271
617,2019-08-16,155,0,186,0,341
617,2019-08-17,433,0,950,1,1384
617,2019-08-18,287,0,906,2,1195
617,2019-08-19,295,0,1549,0,1844
617,2019-08-20,324,0,1040,1,1365
617,2019-08-21,808,0,1037,1,1846
617,2019-08-22,314,0,1140,2,1456
617,2019-08-23,417,0,1005,1,1423
617,2019-08-24,416,0,1673,1,2090
617,2019-08-25,419,0,2524,2,2945
617,2019-08-26,1674,0,1172,0,2846
617,2019-08-27,627,0,2160,0,2787
617,2019-08-28,877,0,1620,3,2500
617,2019-08-29,1508,0,1635,1,3144
617,2019-08-30,648,0,479,1,1128
617,2019-08-31,126,0,1,0,127
617,2019-09-01,155,0,201,0,356
617,2019-09-02,121,0,13,0,134
617,2019-09-03,239,0,761,1,1001
617,2019-09-04,370,0,2052,0,2422
617,2019-09-05,1652,0,2053,2,3707
617,2019-09-06,387,0,1933,1,2321
617,2019-09-07,441,0,2207,0,2648
617,2019-09-08,617,0,1663,1,2281
617,2019-09-09,1120,0,2179,1,3300
617,2019-09-10,536,0,1998,1,2535
617,2019-09-11,1341,0,2019,2,3362
617,2019-09-12,1218,0,2072,0,3290
617,2019-09-13,297,0,2762,12,3071
617,2019-09-14,314,0,1842,0,2156
617,2019-09-15,387,0,2585,3,2975
617,2019-09-16,1178,0,1630,2,2810
617,2019-09-17,1206,0,2190,1,3397
617,2019-09-18,1172,0,2220,0,3392
617,2019-09-19,566,0,1520,3,2089
617,2019-09-20,298,0,1440,0,1738
617,2019-09-21,146,0,1679,0,1825
617,2019-09-22,1901,0,1621,4,3526
617,2019-09-23,326,0,2345,3,2674
617,2019-09-24,324,0,2634,2,2960
617,2019-09-25,1072,0,2430,1,3503
617,2019-09-26,241,0,2349,0,2590
617,2019-09-27,339,0,2381,2,2722
617,2019-09-28,296,0,1231,0,1527
617,2019-09-29,1000,0,2273,2,3275
617,2019-09-30,989,0,1289,1,2279
617,2019-10-01,116,0,2321,0,2437
617,2019-10-02,995,0,2012,1,3008
617,2019-10-03,117,0,1877,0,1994
617,2019-10-04,141,0,1538,819,2498
617,2019-10-05,852,0,1805,0,2657
617,2019-10-06,832,0,1356,1,2189
617,2019-10-07,1060,0,2575,4,3639
617,2019-10-08,996,0,1721,0,2717
617,2019-10-09,274,0,1728,2,2004
617,2019-10-10,167,0,2420,1,2588
617,2019-10-11,185,0,2123,0,2308
617,2019-10-12,619,0,2391,6,3016
617,2019-10-13,231,0,1994,11,2236
617,2019-10-14,1079,0,2485,3,3567
617,2019-10-15,259,0,1683,1,1943
617,2019-10-16,201,0,2047,0,2248
617,2019-10-17,100,0,2285,4,2389
617,2019-10-18,1102,0,2382,0,3484
617,2019-10-19,103,0,1805,0,1908
617,2019-10-20,95,0,2078,0,2173
617,2019-10-21,792,0,1601,0,2393
617,2019-10-22,113,0,2721,5,2839
617,2019-10-23,107,0,1975,0,2082
617,2019-10-24,889,0,1891,0,2780
617,2019-10-25,116,0,1618,2,1736
617,2019-10-26,1742,0,1758,0,3500
617,2019-10-27,219,0,1856,1,2076
617,2019-10-28,248,0,1561,2,1811
617,2019-10-29,246,0,1987,0,2233
617,2019-10-30,846,0,1566,0,2412
617,2019-10-31,199,0,1800,1,2000
617,2019-11-01,520,0,2972,2,3494
617,2019-11-02,108,0,1333,1,1442
617,2019-11-03,111,0,2015,1,2127
617,2019-11-04,142,0,1587,0,1729
617,2019-11-05,168,0,1335,0,1503
617,2019-11-06,1000,0,1103,4,2107
617,2019-11-07,788,0,1657,4,2449
617,2019-11-08,129,0,1828,0,1957
617,2019-11-09,145,0,1427,0,1572
617,2019-11-10,519,0,1331,0,1850
617,2019-11-11,592,0,1349,4,1945
617,2019-11-12,132,0,3835,2,3969
617,2019-11-13,198,0,2772,0,2970
617,2019-11-14,176,0,2648,0,2824
617,2019-11-15,111,0,2627,2,2740
617,2019-11-16,649,0,3479,2,4130
617,2019-11-17,228,0,4062,0,4290
617,2019-11-18,138,0,4304,1,4443
617,2019-11-19,207,0,3328,1,3536
617,2019-11-20,570,0,2588,1,3159
617,2019-11-21,1052,0,1992,2,3046
617,2019-11-22,146,0,2553,2,2701
617,2019-11-23,128,0,2860,0,2988
617,2019-11-24,121,0,785,0,906
617,2019-08-01,38,0,286,1,325
617,2019-08-02,98,0,595,0,693
617,2019-08-03,78,0,457,1,536
617,2019-08-04,386,0,287,1,674
617,2019-08-05,307,0,266,2,575
617,2019-08-06,411,0,742,1,1154
617,2019-08-07,547,0,703,0,1250
617,2019-08-08,258,0,301,0,559
617,2019-08-09,259,0,266,0,525
617,2019-08-10,566,0,282,0,848
617,2019-08-11,230,0,140,0,370
617,2019-08-12,390,0,124,0,514
617,2019-08-13,429,0,179,2,610
617,2019-08-14,223,0,291,0,514
617,2019-08-15,213,0,57,1,271
617,2019-08-16,155,0,186,0,341
617,2019-08-17,433,0,950,1,1384
617,2019-08-18,287,0,906,2,1195
617,2019-08-19,295,0,1549,0,1844
617,2019-08-20,324,0,1040,1,1365
617,2019-08-21,808,0,1037,1,1846
617,2019-08-22,314,0,1140,2,1456
617,2019-08-23,417,0,1005,1,1423
617,2019-08-24,416,0,1673,1,2090
617,2019-08-25,419,0,2524,2,2945
617,2019-08-26,1674,0,1172,0,2846
617,2019-08-27,627,0,2160,0,2787
617,2019-08-28,877,0,1620,3,2500
617,2019-08-29,1508,0,1635,1,3144
617,2019-08-30,648,0,479,1,1128
617,2019-08-31,126,0,1,0,127
617,2019-09-01,155,0,201,0,356
617,2019-09-02,121,0,13,0,134
617,2019-09-03,239,0,761,1,1001
617,2019-09-04,370,0,2052,0,2422
617,2019-09-05,1652,0,2053,2,3707
617,2019-09-06,387,0,1933,1,2321
617,2019-09-07,441,0,2207,0,2648
617,2019-09-08,617,0,1663,1,2281
617,2019-09-09,1120,0,2179,1,3300
617,2019-09-10,536,0,1998,1,2535
617,2019-09-11,1341,0,2019,2,3362
617,2019-09-12,1218,0,2072,0,3290
617,2019-09-13,297,0,2762,12,3071
617,2019-09-14,314,0,1842,0,2156
617,2019-09-15,387,0,2585,3,2975
617,2019-09-16,1178,0,1630,2,2810
617,2019-09-17,1206,0,2190,1,3397
617,2019-09-18,1172,0,2220,0,3392
617,2019-09-19,566,0,1520,3,2089
617,2019-09-20,298,0,1440,0,1738
617,2019-09-21,146,0,1679,0,1825
617,2019-09-22,1901,0,1621,4,3526
617,2019-09-23,326,0,2345,3,2674
617,2019-09-24,324,0,2634,2,2960
617,2019-09-25,1072,0,2430,1,3503
617,2019-09-26,241,0,2349,0,2590
617,2019-09-27,339,0,2381,2,2722
617,2019-09-28,296,0,1231,0,1527
617,2019-09-29,1000,0,2273,2,3275
617,2019-09-30,989,0,1289,1,2279
617,2019-10-01,116,0,2321,0,2437
617,2019-10-02,995,0,2012,1,3008
617,2019-10-03,117,0,1877,0,1994
617,2019-10-04,141,0,1538,819,2498
617,2019-10-05,852,0,1805,0,2657
617,2019-10-06,832,0,1356,1,2189
617,2019-10-07,1060,0,2575,4,3639
617,2019-10-08,996,0,1721,0,2717
617,2019-10-09,274,0,1728,2,2004
617,2019-10-10,167,0,2420,1,2588
617,2019-10-11,185,0,2123,0,2308
617,2019-10-12,619,0,2391,6,3016
617,2019-10-13,231,0,1994,11,2236
617,2019-10-14,1079,0,2485,3,3567
617,2019-10-15,259,0,1683,1,1943
617,2019-10-16,201,0,2047,0,2248
617,2019-10-17,100,0,2285,4,2389
617,2019-10-18,1102,0,2382,0,3484
617,2019-10-19,103,0,1805,0,1908
617,2019-10-20,95,0,2078,0,2173
617,2019-10-21,792,0,1601,0,2393
617,2019-10-22,113,0,2721,5,2839
617,2019-10-23,107,0,1975,0,2082
617,2019-10-24,889,0,1891,0,2780
617,2019-10-25,116,0,1618,2,1736
617,2019-10-26,1742,0,1758,0,3500
617,2019-10-27,219,0,1856,1,2076
617,2019-10-28,248,0,1561,2,1811
617,2019-10-29,246,0,1987,0,2233
617,2019-10-30,846,0,1566,0,2412
617,2019-10-31,199,0,1800,1,2000
617,2019-11-01,520,0,2972,2,3494
617,2019-11-02,108,0,1333,1,1442
617,2019-11-03,111,0,2015,1,2127
617,2019-11-04,142,0,1587,0,1729
617,2019-11-05,168,0,1335,0,1503
617,2019-11-06,1000,0,1103,4,2107
617,2019-11-07,788,0,1657,4,2449
617,2019-11-08,129,0,1828,0,1957
617,2019-11-09,145,0,1427,0,1572
617,2019-11-10,519,0,1331,0,1850
617,2019-11-11,592,0,1349,4,1945
617,2019-11-12,132,0,3835,2,3969
617,2019-11-13,198,0,2772,0,2970
617,2019-11-14,176,0,2648,0,2824
617,2019-11-15,111,0,2627,2,2740
617,2019-11-16,649,0,3479,2,4130
617,2019-11-17,228,0,4062,0,4290
617,2019-11-18,138,0,4304,1,4443
617,2019-11-19,207,0,3328,1,3536
617,2019-11-20,570,0,2588,1,3159
617,2019-11-21,1052,0,1992,2,3046
617,2019-11-22,146,0,2553,2,2701
618,2019-08-01,266,32776,423,0,33465
618,2019-08-02,258,33861,255,0,34374
618,2019-08-03,283,9763,337,2,10385
618,2019-08-04,1064,1532,635,0,3231
618,2019-08-05,325,7790,292,1,8408
618,2019-08-06,272,12262,593,0,13127
618,2019-08-07,356,6503,311,0,7170
618,2019-08-08,342,1951,663,0,2956
618,2019-08-09,245,2481,167,0,2893
618,2019-08-10,259,2285,140,1,2685
618,2019-08-11,282,1554,236,2,2074
618,2019-08-12,209,6759,118,0,7086
618,2019-08-13,219,10566,270,1,11056
618,2019-08-14,207,3000,111,0,3318
618,2019-08-15,137,1359,136,0,1632
618,2019-08-16,196,3558,38,0,3792
618,2019-08-17,432,3862,420,2,4716
618,2019-08-18,821,4094,1099,0,6014
618,2019-08-19,394,6444,1377,0,8215
618,2019-08-20,415,4656,1266,0,6337
618,2019-08-21,392,2837,1112,0,4341
618,2019-08-22,402,15533,1978,2,17915
618,2019-08-23,379,6834,1570,1,8784
618,2019-08-24,8573,13637,2165,1,24376
618,2019-08-25,5569,19447,1810,2,26828
618,2019-08-26,6296,15661,901,3,22861
618,2019-08-27,14542,13769,2148,3,30462
618,2019-08-28,1682,19300,1444,3,22429
618,2019-08-29,9052,9448,1631,1,20132
618,2019-08-30,8419,2200,708,1,11328
618,2019-08-31,669,518,24,0,1211
618,2019-09-01,92,1551,161,1,1805
618,2019-09-02,100,629,20,0,749
618,2019-09-03,239,790,919,0,1948
618,2019-09-04,423,7638,1605,2,9668
618,2019-09-05,434,11200,2271,0,13905
618,2019-09-06,1260,9336,2045,1,12642
618,2019-09-07,1312,8840,2136,1,12289
618,2019-09-08,445,5050,1896,0,7391
618,2019-09-09,1283,7273,1797,0,10353
618,2019-09-10,247,7703,1819,1,9770
618,2019-09-11,383,9084,2653,4,12124
618,2019-09-12,855,8975,1717,0,11547
618,2019-09-13,1276,6149,2053,3,9481
618,2019-09-14,330,6836,1650,0,8816
618,2019-09-15,295,6408,2183,13,8899
618,2019-09-16,2842,13401,2093,17,18353
618,2019-09-17,239,8541,2137,8,10925
618,2019-09-18,363,12133,1430,10,13936
618,2019-09-19,494,11119,1350,9,12972
618,2019-09-20,438,10233,1459,9,12139
618,2019-09-21,1219,11087,1922,10,14238
618,2019-09-22,328,13121,1886,10,15345
618,2019-09-23,454,11446,1918,10,13828
618,2019-09-24,395,10530,2106,13,13044
618,2019-09-25,1932,8882,901,12,11727
618,2019-09-26,203,11276,1685,10,13174
618,2019-09-27,151,13489,1394,2,15036
618,2019-09-28,178,16254,1635,2,18069
618,2019-09-29,243,17197,2063,2,19505
618,2019-09-30,1884,18850,1848,4,22586
618,2019-10-01,210,17144,1571,0,18925
618,2019-10-02,1069,13418,2513,8,17008
618,2019-10-03,202,14615,1546,12,16375
618,2019-10-04,1422,19099,1267,19,21807
618,2019-10-05,276,23872,1519,10,25677
618,2019-10-06,705,17526,2435,17,20683
618,2019-10-07,298,7227,2151,14,9690
618,2019-10-08,1096,12850,1172,12,15130
618,2019-10-09,241,14964,1657,10,16872
618,2019-10-10,1767,11364,2101,10,15242
618,2019-10-11,435,12606,2269,10,15320
618,2019-10-12,286,8030,2132,4,10452
618,2019-10-13,263,9491,1952,1,11707
618,2019-10-14,1173,6722,2768,1,10664
618,2019-10-15,351,9050,2163,20,11584
618,2019-10-16,659,18577,1958,9,21203
618,2019-10-17,414,8912,2180,3,11509
618,2019-10-18,503,9458,1658,1,11620
618,2019-10-19,311,6548,1913,1,8773
618,2019-10-20,1663,4901,1952,0,8516
618,2019-10-21,1151,11410,1310,0,13871
618,2019-10-22,357,7862,1895,4,10118
618,2019-10-23,331,9207,2020,1,11559
618,2019-10-24,1081,14063,1422,1,16567
618,2019-10-25,1007,11809,1138,13,13967
618,2019-10-26,1610,14116,1024,7,16757
618,2019-10-27,1665,18926,1788,0,22379
618,2019-10-28,2739,14269,1210,2,18220
618,2019-10-29,3956,18013,1686,1,23656
618,2019-10-30,3444,16067,1105,2,20618
618,2019-10-31,2050,16913,1372,1,20336
618,2019-11-01,688,26486,1809,2,28985
618,2019-11-02,316,17612,936,0,18864
618,2019-11-03,964,23180,1161,0,25305
618,2019-11-04,1369,9026,1862,0,12257
618,2019-11-05,1214,3755,1523,0,6492
618,2019-11-06,1001,9042,1451,4,11498
618,2019-11-07,367,14213,1125,2,15707
618,2019-11-08,649,10380,959,1,11989
618,2019-11-09,527,14003,1996,1,16527
618,2019-11-10,1507,25736,675,1,27919
618,2019-11-11,297,17342,1767,4,19410
618,2019-11-12,363,18553,2469,0,21385
618,2019-11-13,474,13724,1739,0,15937
618,2019-11-14,360,9249,2721,0,12330
618,2019-11-15,272,6111,3216,0,9599
618,2019-11-16,320,2647,2646,0,5613
618,2019-11-17,448,4597,3866,0,8911
618,2019-11-18,387,3603,2705,0,6695
618,2019-11-19,471,3575,2409,0,6455
618,2019-11-20,1338,2476,2203,0,6017
618,2019-11-21,1353,4200,1844,0,7397
618,2019-11-22,498,9695,1924,0,12117
618,2019-11-23,468,7580,2136,0,10184
618,2019-11-24,1505,6270,1280,0,9055
618,2019-11-25,1393,7034,2586,0,11013
618,2019-11-26,282,6664,1311,0,8257
618,2019-11-27,534,6853,1780,0,9167
618,2019-11-28,111,8874,316,0,9301
618,2019-08-01,266,32776,423,0,33465
618,2019-08-02,258,33861,255,0,34374
618,2019-08-03,283,9763,337,2,10385
618,2019-08-04,1064,1532,635,0,3231
618,2019-08-05,325,7790,292,1,8408
618,2019-08-06,272,12262,593,0,13127
618,2019-08-07,356,6503,311,0,7170
618,2019-08-08,342,1951,663,0,2956
618,2019-08-09,245,2481,167,0,2893
618,2019-08-10,259,2285,140,1,2685
618,2019-08-11,282,1554,236,2,2074
618,2019-08-12,209,6759,118,0,7086
618,2019-08-13,219,10566,270,1,11056
618,2019-08-14,207,3000,111,0,3318
618,2019-08-15,137,1359,136,0,1632
618,2019-08-16,196,3558,38,0,3792
618,2019-08-17,432,3862,420,2,4716
618,2019-08-18,821,4094,1099,0,6014
618,2019-08-19,394,6444,1377,0,8215
618,2019-08-20,415,4656,1266,0,6337
618,2019-08-21,392,2837,1112,0,4341
618,2019-08-22,402,15533,1978,2,17915
618,2019-08-23,379,6834,1570,1,8784
618,2019-08-24,8573,13637,2165,1,24376
618,2019-08-25,5569,19447,1810,2,26828
618,2019-08-26,6296,15661,901,3,22861
618,2019-08-27,14542,13769,2148,3,30462
618,2019-08-28,1682,19300,1444,3,22429
618,2019-08-29,9052,9448,1631,1,20132
618,2019-08-30,8419,2200,708,1,11328
618,2019-08-31,669,518,24,0,1211
618,2019-09-01,92,1551,161,1,1805
618,2019-09-02,100,629,20,0,749
618,2019-09-03,239,790,919,0,1948
618,2019-09-04,423,7638,1605,2,9668
618,2019-09-05,434,11200,2271,0,13905
618,2019-09-06,1260,9336,2045,1,12642
618,2019-09-07,1312,8840,2136,1,12289
618,2019-09-08,445,5050,1896,0,7391
618,2019-09-09,1283,7273,1797,0,10353
618,2019-09-10,247,7703,1819,1,9770
618,2019-09-11,383,9084,2653,4,12124
618,2019-09-12,855,8975,1717,0,11547
618,2019-09-13,1276,6149,2053,3,9481
618,2019-09-14,330,6836,1650,0,8816
618,2019-09-15,295,6408,2183,13,8899
618,2019-09-16,2842,13401,2093,17,18353
618,2019-09-17,239,8541,2137,8,10925
618,2019-09-18,363,12133,1430,10,13936
618,2019-09-19,494,11119,1350,9,12972
618,2019-09-20,438,10233,1459,9,12139
618,2019-09-21,1219,11087,1922,10,14238
618,2019-09-22,328,13121,1886,10,15345
618,2019-09-23,454,11446,1918,10,13828
618,2019-09-24,395,10530,2106,13,13044
618,2019-09-25,1932,8882,901,12,11727
618,2019-09-26,203,11276,1685,10,13174
618,2019-09-27,151,13489,1394,2,15036
618,2019-09-28,178,16254,1635,2,18069
618,2019-09-29,243,17197,2063,2,19505
618,2019-09-30,1884,18850,1848,4,22586
618,2019-10-01,210,17144,1571,0,18925
618,2019-10-02,1069,13418,2513,8,17008
618,2019-10-03,202,14615,1546,12,16375
618,2019-10-04,1422,19099,1267,19,21807
618,2019-10-05,276,23872,1519,10,25677
618,2019-10-06,705,17526,2435,17,20683
618,2019-10-07,298,7227,2151,14,9690
618,2019-10-08,1096,12850,1172,12,15130
618,2019-10-09,241,14964,1657,10,16872
618,2019-10-10,1767,11364,2101,10,15242
618,2019-10-11,435,12606,2269,10,15320
618,2019-10-12,286,8030,2132,4,10452
618,2019-10-13,263,9491,1952,1,11707
618,2019-10-14,1173,6722,2768,1,10664
618,2019-10-15,351,9050,2163,20,11584
618,2019-10-16,659,18577,1958,9,21203
618,2019-10-17,414,8912,2180,3,11509
618,2019-10-18,503,9458,1658,1,11620
618,2019-10-19,311,6548,1913,1,8773
618,2019-10-20,1663,4901,1952,0,8516
618,2019-10-21,1151,11410,1310,0,13871
618,2019-10-22,357,7862,1895,4,10118
618,2019-10-23,331,9207,2020,1,11559
618,2019-10-24,1081,14063,1422,1,16567
618,2019-10-25,1007,11809,1138,13,13967
618,2019-10-26,1610,14116,1024,7,16757
618,2019-10-27,1665,18926,1788,0,22379
618,2019-10-28,2739,14269,1210,2,18220
618,2019-10-29,3956,18013,1686,1,23656
618,2019-10-30,3444,16067,1105,2,20618
618,2019-10-31,2050,16913,1372,1,20336
618,2019-11-01,688,26486,1809,2,28985
618,2019-11-02,316,17612,936,0,18864
618,2019-11-03,964,23180,1161,0,25305
618,2019-11-04,1369,9026,1862,0,12257
618,2019-11-05,1214,3755,1523,0,6492
618,2019-11-06,1001,9042,1451,4,11498
618,2019-11-07,367,14213,1125,2,15707
618,2019-11-08,649,10380,959,1,11989
618,2019-11-09,527,14003,1996,1,16527
618,2019-11-10,1507,25736,675,1,27919
618,2019-11-11,297,17342,1767,4,19410
618,2019-11-12,363,18553,2469,0,21385
618,2019-11-13,474,13724,1739,0,15937
618,2019-11-14,360,9249,2721,0,12330
618,2019-11-15,272,6111,3216,0,9599
618,2019-11-16,320,2647,2646,0,5613
618,2019-11-17,448,4597,3866,0,8911
618,2019-11-18,387,3603,2705,0,6695
618,2019-11-19,471,3575,2409,0,6455
618,2019-11-20,1338,2476,2203,0,6017
618,2019-11-21,1353,4200,1844,0,7397
618,2019-11-22,498,9695,1924,0,12117
618,2019-11-23,468,7580,2136,0,10184
618,2019-11-24,1505,6270,1280,0,9055
618,2019-11-25,1393,7034,2586,0,11013
618,2019-11-26,282,6664,1311,0,8257
618,2019-11-27,534,6853,1780,0,9167
618,2019-11-28,111,8874,316,0,9301
618,2019-11-29,0,24,0,0,24
618,2019-08-01,266,32776,423,0,33465
618,2019-08-02,258,33861,255,0,34374
618,2019-08-03,283,9763,337,2,10385
618,2019-08-04,1064,1532,635,0,3231
618,2019-08-05,325,7790,292,1,8408
618,2019-08-06,272,12262,593,0,13127
618,2019-08-07,356,6503,311,0,7170
618,2019-08-08,342,1951,663,0,2956
618,2019-08-09,245,2481,167,0,2893
618,2019-08-10,259,2285,140,1,2685
618,2019-08-11,282,1554,236,2,2074
618,2019-08-12,209,6759,118,0,7086
618,2019-08-13,219,10566,270,1,11056
618,2019-08-14,207,3000,111,0,3318
618,2019-08-15,137,1359,136,0,1632
618,2019-08-16,196,3558,38,0,3792
618,2019-08-17,432,3862,420,2,4716
618,2019-08-18,821,4094,1099,0,6014
618,2019-08-19,394,6444,1377,0,8215
618,2019-08-20,415,4656,1266,0,6337
618,2019-08-21,392,2837,1112,0,4341
618,2019-08-22,402,15533,1978,2,17915
618,2019-08-23,379,6834,1570,1,8784
618,2019-08-24,8573,13637,2165,1,24376
618,2019-08-25,5569,19447,1810,2,26828
618,2019-08-26,6296,15661,901,3,22861
618,2019-08-27,14542,13769,2148,3,30462
618,2019-08-28,1682,19300,1444,3,22429
618,2019-08-29,9052,9448,1631,1,20132
618,2019-08-30,8419,2200,708,1,11328
618,2019-08-31,669,518,24,0,1211
618,2019-09-01,92,1551,161,1,1805
618,2019-09-02,100,629,20,0,749
618,2019-09-03,239,790,919,0,1948
618,2019-09-04,423,7638,1605,2,9668
618,2019-09-05,434,11200,2271,0,13905
618,2019-09-06,1260,9336,2045,1,12642
618,2019-09-07,1312,8840,2136,1,12289
618,2019-09-08,445,5050,1896,0,7391
618,2019-09-09,1283,7273,1797,0,10353
618,2019-09-10,247,7703,1819,1,9770
618,2019-09-11,383,9084,2653,4,12124
618,2019-09-12,855,8975,1717,0,11547
618,2019-09-13,1276,6149,2053,3,9481
618,2019-09-14,330,6836,1650,0,8816
618,2019-09-15,295,6408,2183,13,8899
618,2019-09-16,2842,13401,2093,17,18353
618,2019-09-17,239,8541,2137,8,10925
618,2019-09-18,363,12133,1430,10,13936
618,2019-09-19,494,11119,1350,9,12972
618,2019-09-20,438,10233,1459,9,12139
618,2019-09-21,1219,11087,1922,10,14238
618,2019-09-22,328,13121,1886,10,15345
618,2019-09-23,454,11446,1918,10,13828
618,2019-09-24,395,10530,2106,13,13044
618,2019-09-25,1932,8882,901,12,11727
618,2019-09-26,203,11276,1685,10,13174
618,2019-09-27,151,13489,1394,2,15036
618,2019-09-28,178,16254,1635,2,18069
618,2019-09-29,243,17197,2063,2,19505
618,2019-09-30,1884,18850,1848,4,22586
618,2019-10-01,210,17144,1571,0,18925
618,2019-10-02,1069,13418,2513,8,17008
618,2019-10-03,202,14615,1546,12,16375
618,2019-10-04,1422,19099,1267,19,21807
618,2019-10-05,276,23872,1519,10,25677
618,2019-10-06,705,17526,2435,17,20683
618,2019-10-07,298,7227,2151,14,9690
618,2019-10-08,1096,12850,1172,12,15130
618,2019-10-09,241,14964,1657,10,16872
618,2019-10-10,1767,11364,2101,10,15242
618,2019-10-11,435,12606,2269,10,15320
618,2019-10-12,286,8030,2132,4,10452
618,2019-10-13,263,9491,1952,1,11707
618,2019-10-14,1173,6722,2768,1,10664
618,2019-10-15,351,9050,2163,20,11584
618,2019-10-16,659,18577,1958,9,21203
618,2019-10-17,414,8912,2180,3,11509
618,2019-10-18,503,9458,1658,1,11620
618,2019-10-19,311,6548,1913,1,8773
618,2019-10-20,1663,4901,1952,0,8516
618,2019-10-21,1151,11410,1310,0,13871
618,2019-10-22,357,7862,1895,4,10118
618,2019-10-23,331,9207,2020,1,11559
618,2019-10-24,1081,14063,1422,1,16567
618,2019-10-25,1007,11809,1138,13,13967
618,2019-10-26,1610,14116,1024,7,16757
618,2019-10-27,1665,18926,1788,0,22379
618,2019-10-28,2739,14269,1210,2,18220
618,2019-10-29,3956,18013,1686,1,23656
618,2019-10-30,3444,16067,1105,2,20618
618,2019-10-31,2050,16913,1372,1,20336
618,2019-11-01,688,26486,1809,2,28985
618,2019-11-02,316,17612,936,0,18864
618,2019-11-03,964,23180,1161,0,25305
618,2019-11-04,1369,9026,1862,0,12257
618,2019-11-05,1214,3755,1523,0,6492
618,2019-11-06,1001,9042,1451,4,11498
618,2019-11-07,367,14213,1125,2,15707
618,2019-11-08,649,10380,959,1,11989
618,2019-11-09,527,14003,1996,1,16527
618,2019-11-10,1507,25736,675,1,27919
618,2019-11-11,297,17342,1767,4,19410
618,2019-11-12,363,18553,2469,0,21385
618,2019-11-13,474,13724,1739,0,15937
618,2019-11-14,360,9249,2721,0,12330
618,2019-11-15,272,6111,3216,0,9599
618,2019-11-16,320,2647,2646,0,5613
618,2019-11-17,448,4597,3866,0,8911
618,2019-11-18,387,3603,2705,0,6695
618,2019-11-19,471,3575,2409,0,6455
618,2019-11-20,1338,2476,2203,0,6017
618,2019-11-21,1353,4200,1844,0,7397
618,2019-11-22,498,9695,1924,0,12117
618,2019-11-23,468,7580,2136,0,10184
618,2019-11-24,1505,6270,1280,0,9055
618,2019-11-25,1393,7034,2586,0,11013
618,2019-11-26,282,6664,1311,0,8257
618,2019-11-27,534,6853,1780,0,9167
618,2019-11-28,111,8874,316,0,9301
618,2019-08-03,283,9763,337,2,10385
618,2019-08-04,1064,1532,635,0,3231
618,2019-08-05,325,7790,292,1,8408
618,2019-08-06,272,12262,593,0,13127
618,2019-08-07,356,6503,311,0,7170
618,2019-08-08,342,1951,663,0,2956
618,2019-08-09,245,2481,167,0,2893
618,2019-08-10,259,2285,140,1,2685
618,2019-08-11,282,1554,236,2,2074
618,2019-08-12,209,6759,118,0,7086
618,2019-08-13,219,10566,270,1,11056
618,2019-08-14,207,3000,111,0,3318
618,2019-08-15,137,1359,136,0,1632
618,2019-08-16,196,3558,38,0,3792
618,2019-08-17,432,3862,420,2,4716
618,2019-08-18,821,4094,1099,0,6014
618,2019-08-19,394,6444,1377,0,8215
618,2019-08-20,415,4656,1266,0,6337
618,2019-08-21,392,2837,1112,0,4341
618,2019-08-22,402,15533,1978,2,17915
618,2019-08-23,379,6834,1570,1,8784
618,2019-08-24,8573,13637,2165,1,24376
618,2019-08-25,5569,19447,1810,2,26828
618,2019-08-26,6296,15661,901,3,22861
618,2019-08-27,14542,13769,2148,3,30462
618,2019-08-28,1682,19300,1444,3,22429
618,2019-08-29,9052,9448,1631,1,20132
618,2019-08-30,8419,2200,708,1,11328
618,2019-08-31,669,518,24,0,1211
618,2019-09-01,92,1551,161,1,1805
618,2019-09-02,100,629,20,0,749
618,2019-09-03,239,790,919,0,1948
618,2019-09-04,423,7638,1605,2,9668
618,2019-09-05,434,11200,2271,0,13905
618,2019-09-06,1260,9336,2045,1,12642
618,2019-09-07,1312,8840,2136,1,12289
618,2019-09-08,445,5050,1896,0,7391
618,2019-09-09,1283,7273,1797,0,10353
618,2019-09-10,247,7703,1819,1,9770
618,2019-09-11,383,9084,2653,4,12124
618,2019-09-12,855,8975,1717,0,11547
618,2019-09-13,1276,6149,2053,3,9481
618,2019-09-14,330,6836,1650,0,8816
618,2019-09-15,295,6408,2183,13,8899
618,2019-09-16,2842,13401,2093,17,18353
618,2019-09-17,239,8541,2137,8,10925
618,2019-09-18,363,12133,1430,10,13936
618,2019-09-19,494,11119,1350,9,12972
618,2019-09-20,438,10233,1459,9,12139
618,2019-09-21,1219,11087,1922,10,14238
618,2019-09-22,328,13121,1886,10,15345
618,2019-09-23,454,11446,1918,10,13828
618,2019-09-24,395,10530,2106,13,13044
618,2019-09-25,1932,8882,901,12,11727
618,2019-09-26,203,11276,1685,10,13174
618,2019-09-27,151,13489,1394,2,15036
618,2019-09-28,178,16254,1635,2,18069
618,2019-09-29,243,17197,2063,2,19505
618,2019-09-30,1884,18850,1848,4,22586
618,2019-10-01,210,17144,1571,0,18925
618,2019-10-02,1069,13418,2513,8,17008
618,2019-10-03,202,14615,1546,12,16375
618,2019-10-04,1422,19099,1267,19,21807
618,2019-10-05,276,23872,1519,10,25677
618,2019-10-06,705,17526,2435,17,20683
618,2019-10-07,298,7227,2151,14,9690
618,2019-10-08,1096,12850,1172,12,15130
618,2019-10-09,241,14964,1657,10,16872
618,2019-10-10,1767,11364,2101,10,15242
618,2019-10-11,435,12606,2269,10,15320
618,2019-10-12,286,8030,2132,4,10452
618,2019-10-13,263,9491,1952,1,11707
618,2019-10-14,1173,6722,2768,1,10664
618,2019-10-15,351,9050,2163,20,11584
618,2019-10-16,659,18577,1958,9,21203
618,2019-10-17,414,8912,2180,3,11509
618,2019-10-18,503,9458,1658,1,11620
618,2019-10-19,311,6548,1913,1,8773
618,2019-10-20,1663,4901,1952,0,8516
618,2019-10-21,1151,11410,1310,0,13871
618,2019-10-22,357,7862,1895,4,10118
618,2019-10-23,331,9207,2020,1,11559
618,2019-10-24,1081,14063,1422,1,16567
618,2019-10-25,1007,11809,1138,13,13967
618,2019-10-26,1610,14116,1024,7,16757
618,2019-10-27,1665,18926,1788,0,22379
618,2019-10-28,2739,14269,1210,2,18220
618,2019-10-29,3956,18013,1686,1,23656
618,2019-10-30,3444,16067,1105,2,20618
618,2019-10-31,2050,16913,1372,1,20336
618,2019-11-01,688,26486,1809,2,28985
618,2019-11-02,316,17612,936,0,18864
618,2019-11-03,964,23180,1161,0,25305
618,2019-11-04,1369,9026,1862,0,12257
618,2019-11-05,1214,3755,1523,0,6492
618,2019-11-06,1001,9042,1451,4,11498
618,2019-11-07,367,14213,1125,2,15707
618,2019-11-08,649,10380,959,1,11989
618,2019-11-09,527,14003,1996,1,16527
618,2019-11-10,1507,25736,675,1,27919
618,2019-11-11,297,17342,1767,4,19410
619,2019-08-01,72,32754,127,0,32953
619,2019-08-02,244,34347,341,0,34932
619,2019-08-03,339,9438,188,2,9967
619,2019-08-04,455,1993,374,1,2823
619,2019-08-05,650,1571,282,0,2503
619,2019-08-06,559,9453,157,1,10170
619,2019-08-07,548,6791,566,0,7905
619,2019-08-08,586,1658,373,1,2618
619,2019-08-09,564,1801,351,0,2716
619,2019-08-10,475,1875,115,0,2465
619,2019-08-11,392,2189,99,0,2680
619,2019-08-12,241,2470,193,0,2904
619,2019-08-13,605,6030,120,1,6756
619,2019-08-14,324,5762,66,0,6152
619,2019-08-15,407,1422,69,1,1899
619,2019-08-16,450,2749,102,1,3302
619,2019-08-17,748,5026,1217,0,6991
619,2019-08-18,2156,2201,1073,0,5430
619,2019-08-19,556,55383,391,1,56331
619,2019-08-20,710,73149,1085,1,74945
619,2019-08-21,1271,13417,1105,1,15794
619,2019-08-22,1313,19001,863,0,21177
619,2019-08-23,946,21664,1377,1,23988
619,2019-08-24,584,17337,1750,2,19673
619,2019-08-25,749,48068,1636,3,50456
619,2019-08-26,451,35905,1710,4,38070
619,2019-08-27,719,24069,1984,0,26772
619,2019-08-28,2395,18531,1890,1,22817
619,2019-08-29,702,16341,1767,4,18814
619,2019-08-30,362,8632,836,1,9831
619,2019-08-31,161,855,83,0,1099
619,2019-09-01,211,2062,281,0,2554
619,2019-09-02,196,1170,2,0,1368
619,2019-09-03,365,2655,1365,1,4386
619,2019-09-04,744,11565,1407,1,13717
619,2019-09-05,1448,13572,1875,0,16895
619,2019-09-06,786,11601,2432,1,14820
619,2019-09-07,941,41700,2383,0,45024
619,2019-09-08,2798,19116,1318,2,23234
619,2019-09-09,1488,6948,1666,0,10102
619,2019-09-10,801,11807,1635,0,14243
619,2019-09-11,511,16255,2271,5,19042
619,2019-09-12,1219,6989,1330,2,9540
619,2019-09-13,562,15549,2198,40,18349
619,2019-09-14,734,52980,1973,1,55688
619,2019-09-15,617,15053,1877,2,17549
619,2019-09-16,1380,13321,1804,3,16508
619,2019-09-17,519,26977,1436,1,28933
619,2019-09-18,583,28676,1787,1,31047
619,2019-09-19,865,12193,1354,1,14413
619,2019-09-20,634,25362,998,1,26995
619,2019-09-21,425,10987,1733,1,13146
619,2019-09-22,425,9110,2270,0,11805
619,2019-09-23,396,9906,1764,13,12079
619,2019-09-24,1246,15322,1594,6,18168
619,2019-09-25,432,9903,990,2,11327
619,2019-09-26,475,14361,1542,2,16380
619,2019-09-27,439,36460,1762,2,38663
619,2019-09-28,417,22438,1225,3,24083
619,2019-09-29,1027,17936,1082,0,20045
619,2019-09-30,397,27679,1350,0,29426
619,2019-10-01,1111,23118,1104,0,25333
619,2019-10-02,1271,20031,1244,1,22547
619,2019-10-03,2268,23364,1454,2,27088
619,2019-10-04,903,14645,1162,0,16710
619,2019-10-05,602,14724,1361,2,16689
619,2019-10-06,444,12128,1628,1,14201
619,2019-10-07,2760,7434,1888,2,12084
619,2019-10-08,2697,27192,1082,2,30973
619,2019-10-09,267,18505,1098,2,19872
619,2019-10-10,683,12042,1699,1,14425
619,2019-10-11,1477,13280,1510,0,16267
619,2019-10-12,793,8355,1422,0,10570
619,2019-10-13,1175,9596,1605,4,12380
619,2019-10-14,170,6806,957,0,7933
619,2019-10-15,1931,9251,1793,807,13782
619,2019-10-16,312,13344,777,0,14433
619,2019-10-17,229,6150,2108,1,8488
619,2019-10-18,435,9358,1395,2,11190
619,2019-10-19,188,27585,2173,1,29947
619,2019-10-20,1422,3577,1847,1,6847
619,2019-10-21,905,11086,1524,2,13517
619,2019-10-22,1218,7332,2284,1,10835
619,2019-10-23,367,15774,1577,4,17722
619,2019-10-24,506,26036,1418,1,27961
619,2019-10-25,1111,15655,1734,2,18502
619,2019-10-26,313,14272,1346,0,15931
619,2019-10-27,879,16998,1280,0,19157
619,2019-10-28,225,19371,1692,1,21289
619,2019-10-29,251,32137,1011,1,33400
619,2019-10-30,185,21169,922,0,22276
619,2019-10-31,200,12914,1203,0,14317
619,2019-11-01,152,15305,888,0,16345
619,2019-11-02,171,14718,1021,4,15914
619,2019-11-03,1172,22864,1233,1,25270
619,2019-11-04,243,8642,1783,1,10669
619,2019-11-05,1936,3918,1569,1,7424
619,2019-11-06,245,8988,1420,1,10654
619,2019-11-07,409,14268,949,3,15629
619,2019-11-08,477,10420,1244,0,12141
619,2019-11-09,974,9365,1585,0,11924
619,2019-11-10,165,15147,1083,1,16396
619,2019-11-11,207,10608,1324,0,12139
619,2019-11-12,203,11596,2691,3,14493
619,2019-11-13,125,12127,1869,1,14122
619,2019-11-14,125,13344,2162,0,15631
619,2019-11-15,136,5466,3077,1,8680
619,2019-11-16,94,3156,2728,0,5978
619,2019-11-17,196,4225,3799,4,8224
619,2019-11-18,544,2904,2688,1,6137
619,2019-11-19,161,3667,2491,1,6320
619,2019-11-20,1091,2443,1547,0,5081
619,2019-11-21,178,6132,2224,1,8535
619,2019-11-22,195,9298,1798,4,11295
619,2019-11-23,144,7629,1917,0,9690
619,2019-11-24,365,6707,1585,0,8657
619,2019-11-25,100,7294,1890,0,9284
619,2019-11-26,88,5921,1257,0,7266
619,2019-11-27,103,9775,1418,2,11298
619,2019-11-28,152,8097,866,2,9117
619,2019-11-29,11,254,2,0,267
619,2019-08-01,72,32754,127,0,32953
619,2019-08-02,244,34347,341,0,34932
619,2019-08-03,339,9438,188,2,9967
619,2019-08-04,455,1993,374,1,2823
619,2019-08-05,650,1571,282,0,2503
619,2019-08-06,559,9453,157,1,10170
619,2019-08-07,548,6791,566,0,7905
619,2019-08-08,586,1658,373,1,2618
619,2019-08-09,564,1801,351,0,2716
619,2019-08-10,475,1875,115,0,2465
619,2019-08-11,392,2189,99,0,2680
619,2019-08-12,241,2470,193,0,2904
619,2019-08-13,605,6030,120,1,6756
619,2019-08-14,324,5762,66,0,6152
619,2019-08-15,407,1422,69,1,1899
619,2019-08-16,450,2749,102,1,3302
619,2019-08-17,748,5026,1217,0,6991
619,2019-08-18,2156,2201,1073,0,5430
619,2019-08-19,556,55383,391,1,56331
619,2019-08-20,710,73149,1085,1,74945
619,2019-08-21,1271,13417,1105,1,15794
619,2019-08-22,1313,19001,863,0,21177
619,2019-08-23,946,21664,1377,1,23988
619,2019-08-24,584,17337,1750,2,19673
619,2019-08-25,749,48068,1636,3,50456
619,2019-08-26,451,35905,1710,4,38070
619,2019-08-27,719,24069,1984,0,26772
619,2019-08-28,2395,18531,1890,1,22817
619,2019-08-29,702,16341,1767,4,18814
619,2019-08-30,362,8632,836,1,9831
619,2019-08-31,161,855,83,0,1099
619,2019-09-01,211,2062,281,0,2554
619,2019-09-02,196,1170,2,0,1368
619,2019-09-03,365,2655,1365,1,4386
619,2019-09-04,744,11565,1407,1,13717
619,2019-09-05,1448,13572,1875,0,16895
619,2019-09-06,786,11601,2432,1,14820
619,2019-09-07,941,41700,2383,0,45024
619,2019-09-08,2798,19116,1318,2,23234
619,2019-09-09,1488,6948,1666,0,10102
619,2019-09-10,801,11807,1635,0,14243
619,2019-09-11,511,16255,2271,5,19042
619,2019-09-12,1219,6989,1330,2,9540
619,2019-09-13,562,15549,2198,40,18349
619,2019-09-14,734,52980,1973,1,55688
619,2019-09-15,617,15053,1877,2,17549
619,2019-09-16,1380,13321,1804,3,16508
619,2019-09-17,519,26977,1436,1,28933
619,2019-09-18,583,28676,1787,1,31047
619,2019-09-19,865,12193,1354,1,14413
619,2019-09-20,634,25362,998,1,26995
619,2019-09-21,425,10987,1733,1,13146
619,2019-09-22,425,9110,2270,0,11805
619,2019-09-23,396,9906,1764,13,12079
619,2019-09-24,1246,15322,1594,6,18168
619,2019-09-25,432,9903,990,2,11327
619,2019-09-26,475,14361,1542,2,16380
619,2019-09-27,439,36460,1762,2,38663
619,2019-09-28,417,22438,1225,3,24083
619,2019-09-29,1027,17936,1082,0,20045
619,2019-09-30,397,27679,1350,0,29426
619,2019-10-01,1111,23118,1104,0,25333
619,2019-10-02,1271,20031,1244,1,22547
619,2019-10-03,2268,23364,1454,2,27088
619,2019-10-04,903,14645,1162,0,16710
619,2019-10-05,602,14724,1361,2,16689
619,2019-10-06,444,12128,1628,1,14201
619,2019-10-07,2760,7434,1888,2,12084
619,2019-10-08,2697,27192,1082,2,30973
619,2019-10-09,267,18505,1098,2,19872
619,2019-10-10,683,12042,1699,1,14425
619,2019-10-11,1477,13280,1510,0,16267
619,2019-10-12,793,8355,1422,0,10570
619,2019-10-13,1175,9596,1605,4,12380
619,2019-10-14,170,6806,957,0,7933
619,2019-10-15,1931,9251,1793,807,13782
619,2019-10-16,312,13344,777,0,14433
619,2019-10-17,229,6150,2108,1,8488
619,2019-10-18,435,9358,1395,2,11190
619,2019-10-19,188,27585,2173,1,29947
619,2019-10-20,1422,3577,1847,1,6847
619,2019-10-21,905,11086,1524,2,13517
619,2019-10-22,1218,7332,2284,1,10835
619,2019-10-23,367,15774,1577,4,17722
619,2019-10-24,506,26036,1418,1,27961
619,2019-10-25,1111,15655,1734,2,18502
619,2019-10-26,313,14272,1346,0,15931
619,2019-10-27,879,16998,1280,0,19157
619,2019-10-28,225,19371,1692,1,21289
619,2019-10-29,251,32137,1011,1,33400
619,2019-10-30,185,21169,922,0,22276
619,2019-10-31,200,12914,1203,0,14317
619,2019-11-01,152,15305,888,0,16345
619,2019-11-02,171,14718,1021,4,15914
619,2019-11-03,1172,22864,1233,1,25270
619,2019-11-04,243,8642,1783,1,10669
619,2019-11-05,1936,3918,1569,1,7424
619,2019-11-06,245,8988,1420,1,10654
619,2019-11-07,409,14268,949,3,15629
619,2019-11-08,477,10420,1244,0,12141
619,2019-11-09,974,9365,1585,0,11924
619,2019-11-10,165,15147,1083,1,16396
619,2019-11-11,207,10608,1324,0,12139
619,2019-11-12,203,11596,2691,3,14493
619,2019-11-13,125,12127,1869,1,14122
619,2019-11-14,125,13344,2162,0,15631
619,2019-11-15,136,5466,3077,1,8680
619,2019-11-16,94,3156,2728,0,5978
619,2019-11-17,196,4225,3799,4,8224
619,2019-11-18,544,2904,2688,1,6137
619,2019-11-19,161,3667,2491,1,6320
619,2019-11-20,1091,2443,1547,0,5081
619,2019-11-21,178,6132,2224,1,8535
619,2019-11-22,195,9298,1798,4,11295
619,2019-11-23,144,7629,1917,0,9690
619,2019-11-24,365,6707,1585,0,8657
619,2019-11-25,100,7294,1890,0,9284
619,2019-11-26,88,5921,1257,0,7266
619,2019-11-27,103,9775,1418,2,11298
619,2019-11-28,152,8097,866,2,9117
619,2019-11-29,11,254,2,0,267
619,2019-08-01,72,32754,127,0,32953
619,2019-08-02,244,34347,341,0,34932
619,2019-08-03,339,9438,188,2,9967
619,2019-08-04,455,1993,374,1,2823
619,2019-08-05,650,1571,282,0,2503
619,2019-08-06,559,9453,157,1,10170
619,2019-08-07,548,6791,566,0,7905
619,2019-08-08,586,1658,373,1,2618
619,2019-08-09,564,1801,351,0,2716
619,2019-08-10,475,1875,115,0,2465
619,2019-08-11,392,2189,99,0,2680
619,2019-08-12,241,2470,193,0,2904
619,2019-08-13,605,6030,120,1,6756
619,2019-08-14,324,5762,66,0,6152
619,2019-08-15,407,1422,69,1,1899
619,2019-08-16,450,2749,102,1,3302
619,2019-08-17,748,5026,1217,0,6991
619,2019-08-18,2156,2201,1073,0,5430
619,2019-08-19,556,55383,391,1,56331
619,2019-08-20,710,73149,1085,1,74945
619,2019-08-21,1271,13417,1105,1,15794
619,2019-08-22,1313,19001,863,0,21177
619,2019-08-23,946,21664,1377,1,23988
619,2019-08-24,584,17337,1750,2,19673
619,2019-08-25,749,48068,1636,3,50456
619,2019-08-26,451,35905,1710,4,38070
619,2019-08-27,719,24069,1984,0,26772
619,2019-08-28,2395,18531,1890,1,22817
619,2019-08-29,702,16341,1767,4,18814
619,2019-08-30,362,8632,836,1,9831
619,2019-08-31,161,855,83,0,1099
619,2019-09-01,211,2062,281,0,2554
619,2019-09-02,196,1170,2,0,1368
619,2019-09-03,365,2655,1365,1,4386
619,2019-09-04,744,11565,1407,1,13717
619,2019-09-05,1448,13572,1875,0,16895
619,2019-09-06,786,11601,2432,1,14820
619,2019-09-07,941,41700,2383,0,45024
619,2019-09-08,2798,19116,1318,2,23234
619,2019-09-09,1488,6948,1666,0,10102
619,2019-09-10,801,11807,1635,0,14243
619,2019-09-11,511,16255,2271,5,19042
619,2019-09-12,1219,6989,1330,2,9540
619,2019-09-13,562,15549,2198,40,18349
619,2019-09-14,734,52980,1973,1,55688
619,2019-09-15,617,15053,1877,2,17549
619,2019-09-16,1380,13321,1804,3,16508
619,2019-09-17,519,26977,1436,1,28933
619,2019-09-18,583,28676,1787,1,31047
619,2019-09-19,865,12193,1354,1,14413
619,2019-09-20,634,25362,998,1,26995
619,2019-09-21,425,10987,1733,1,13146
619,2019-09-22,425,9110,2270,0,11805
619,2019-09-23,396,9906,1764,13,12079
619,2019-09-24,1246,15322,1594,6,18168
619,2019-09-25,432,9903,990,2,11327
619,2019-09-26,475,14361,1542,2,16380
619,2019-09-27,439,36460,1762,2,38663
619,2019-09-28,417,22438,1225,3,24083
619,2019-09-29,1027,17936,1082,0,20045
619,2019-09-30,397,27679,1350,0,29426
619,2019-10-01,1111,23118,1104,0,25333
619,2019-10-02,1271,20031,1244,1,22547
619,2019-10-03,2268,23364,1454,2,27088
619,2019-10-04,903,14645,1162,0,16710
619,2019-10-05,602,14724,1361,2,16689
619,2019-10-06,444,12128,1628,1,14201
619,2019-10-07,2760,7434,1888,2,12084
619,2019-10-08,2697,27192,1082,2,30973
619,2019-10-09,267,18505,1098,2,19872
619,2019-10-10,683,12042,1699,1,14425
619,2019-10-11,1477,13280,1510,0,16267
619,2019-10-12,793,8355,1422,0,10570
619,2019-10-13,1175,9596,1605,4,12380
619,2019-10-14,170,6806,957,0,7933
619,2019-10-15,1931,9251,1793,807,13782
619,2019-10-16,312,13344,777,0,14433
619,2019-10-17,229,6150,2108,1,8488
619,2019-10-18,435,9358,1395,2,11190
619,2019-10-19,188,27585,2173,1,29947
619,2019-10-20,1422,3577,1847,1,6847
619,2019-10-21,905,11086,1524,2,13517
619,2019-10-22,1218,7332,2284,1,10835
619,2019-10-23,367,15774,1577,4,17722
619,2019-10-24,506,26036,1418,1,27961
619,2019-10-25,1111,15655,1734,2,18502
619,2019-10-26,313,14272,1346,0,15931
619,2019-10-27,879,16998,1280,0,19157
619,2019-10-28,225,19371,1692,1,21289
619,2019-10-29,251,32137,1011,1,33400
619,2019-10-30,185,21169,922,0,22276
619,2019-10-31,200,12914,1203,0,14317
619,2019-11-01,152,15305,888,0,16345
619,2019-11-02,171,14718,1021,4,15914
619,2019-11-03,1172,22864,1233,1,25270
619,2019-11-04,243,8642,1783,1,10669
619,2019-11-05,1936,3918,1569,1,7424
619,2019-11-06,245,8988,1420,1,10654
619,2019-11-07,409,14268,949,3,15629
619,2019-11-08,477,10420,1244,0,12141
619,2019-11-09,974,9365,1585,0,11924
619,2019-11-10,165,15147,1083,1,16396
619,2019-11-11,207,10608,1324,0,12139
619,2019-11-12,203,11596,2691,3,14493
619,2019-11-13,125,12127,1869,1,14122
619,2019-11-14,125,13344,2162,0,15631
619,2019-11-15,136,5466,3077,1,8680
619,2019-11-16,94,3156,2728,0,5978
619,2019-11-17,196,4225,3799,4,8224
619,2019-11-18,544,2904,2688,1,6137
619,2019-11-19,161,3667,2491,1,6320
619,2019-11-20,1091,2443,1547,0,5081
619,2019-11-21,178,6132,2224,1,8535
619,2019-11-22,195,9298,1798,4,11295
619,2019-11-23,144,7629,1917,0,9690
619,2019-11-24,365,6707,1585,0,8657
619,2019-11-25,100,7294,1890,0,9284
619,2019-11-26,88,5921,1257,0,7266
619,2019-11-27,103,9775,1418,2,11298
619,2019-11-28,152,8097,866,2,9117
619,2019-11-29,11,254,2,0,267
619,2019-08-03,339,9438,188,2,9967
619,2019-08-04,455,1993,374,1,2823
619,2019-08-05,650,1571,282,0,2503
619,2019-08-06,559,9453,157,1,10170
619,2019-08-07,548,6791,566,0,7905
619,2019-08-08,586,1658,373,1,2618
619,2019-08-09,564,1801,351,0,2716
619,2019-08-10,475,1875,115,0,2465
619,2019-08-11,392,2189,99,0,2680
619,2019-08-12,241,2470,193,0,2904
619,2019-08-13,605,6030,120,1,6756
619,2019-08-14,324,5762,66,0,6152
619,2019-08-15,407,1422,69,1,1899
619,2019-08-16,450,2749,102,1,3302
619,2019-08-17,748,5026,1217,0,6991
619,2019-08-18,2156,2201,1073,0,5430
619,2019-08-19,556,55383,391,1,56331
619,2019-08-20,710,73149,1085,1,74945
619,2019-08-21,1271,13417,1105,1,15794
619,2019-08-22,1313,19001,863,0,21177
619,2019-08-23,946,21664,1377,1,23988
619,2019-08-24,584,17337,1750,2,19673
619,2019-08-25,749,48068,1636,3,50456
619,2019-08-26,451,35905,1710,4,38070
619,2019-08-27,719,24069,1984,0,26772
619,2019-08-28,2395,18531,1890,1,22817
619,2019-08-29,702,16341,1767,4,18814
619,2019-08-30,362,8632,836,1,9831
619,2019-08-31,161,855,83,0,1099
619,2019-09-01,211,2062,281,0,2554
619,2019-09-02,196,1170,2,0,1368
619,2019-09-03,365,2655,1365,1,4386
619,2019-09-04,744,11565,1407,1,13717
619,2019-09-05,1448,13572,1875,0,16895
619,2019-09-06,786,11601,2432,1,14820
619,2019-09-07,941,41700,2383,0,45024
619,2019-09-08,2798,19116,1318,2,23234
619,2019-09-09,1488,6948,1666,0,10102
619,2019-09-10,801,11807,1635,0,14243
619,2019-09-11,511,16255,2271,5,19042
619,2019-09-12,1219,6989,1330,2,9540
619,2019-09-13,562,15549,2198,40,18349
619,2019-09-14,734,52980,1973,1,55688
619,2019-09-15,617,15053,1877,2,17549
619,2019-09-16,1380,13321,1804,3,16508
619,2019-09-17,519,26977,1436,1,28933
619,2019-09-18,583,28676,1787,1,31047
619,2019-09-19,865,12193,1354,1,14413
619,2019-09-20,634,25362,998,1,26995
619,2019-09-21,425,10987,1733,1,13146
619,2019-09-22,425,9110,2270,0,11805
619,2019-09-23,396,9906,1764,13,12079
619,2019-09-24,1246,15322,1594,6,18168
619,2019-09-25,432,9903,990,2,11327
619,2019-09-26,475,14361,1542,2,16380
619,2019-09-27,439,36460,1762,2,38663
619,2019-09-28,417,22438,1225,3,24083
619,2019-09-29,1027,17936,1082,0,20045
619,2019-09-30,397,27679,1350,0,29426
619,2019-10-01,1111,23118,1104,0,25333
619,2019-10-02,1271,20031,1244,1,22547
619,2019-10-03,2268,23364,1454,2,27088
619,2019-10-04,903,14645,1162,0,16710
619,2019-10-05,602,14724,1361,2,16689
619,2019-10-06,444,12128,1628,1,14201
619,2019-10-07,2760,7434,1888,2,12084
619,2019-10-08,2697,27192,1082,2,30973
619,2019-10-09,267,18505,1098,2,19872
619,2019-10-10,683,12042,1699,1,14425
619,2019-10-11,1477,13280,1510,0,16267
619,2019-10-12,793,8355,1422,0,10570
619,2019-10-13,1175,9596,1605,4,12380
619,2019-10-14,170,6806,957,0,7933
619,2019-10-15,1931,9251,1793,807,13782
619,2019-10-16,312,13344,777,0,14433
619,2019-10-17,229,6150,2108,1,8488
619,2019-10-18,435,9358,1395,2,11190
619,2019-10-19,188,27585,2173,1,29947
619,2019-10-20,1422,3577,1847,1,6847
619,2019-10-21,905,11086,1524,2,13517
619,2019-10-22,1218,7332,2284,1,10835
619,2019-10-23,367,15774,1577,4,17722
619,2019-10-24,506,26036,1418,1,27961
619,2019-10-25,1111,15655,1734,2,18502
619,2019-10-26,313,14272,1346,0,15931
619,2019-10-27,879,16998,1280,0,19157
619,2019-10-28,225,19371,1692,1,21289
619,2019-10-29,251,32137,1011,1,33400
619,2019-10-30,185,21169,922,0,22276
619,2019-10-31,200,12914,1203,0,14317
619,2019-11-01,152,15305,888,0,16345
619,2019-11-02,171,14718,1021,4,15914
619,2019-11-03,1172,22864,1233,1,25270
619,2019-11-04,243,8642,1783,1,10669
619,2019-11-05,1936,3918,1569,1,7424
619,2019-11-06,245,8988,1420,1,10654
619,2019-11-07,409,14268,949,3,15629
619,2019-11-08,477,10420,1244,0,12141
619,2019-11-09,974,9365,1585,0,11924
619,2019-11-10,165,15147,1083,1,16396
619,2019-11-11,207,10608,1324,0,12139
619,2019-11-12,203,11596,2691,3,14493
619,2019-11-13,125,12127,1869,1,14122
619,2019-11-14,125,13344,2162,0,15631
619,2019-11-15,136,5466,3077,1,8680
619,2019-11-16,94,3156,2728,0,5978
619,2019-11-17,196,4225,3799,4,8224
619,2019-11-18,544,2904,2688,1,6137
619,2019-11-19,161,3667,2491,1,6320
619,2019-11-20,1091,2443,1547,0,5081
619,2019-11-21,178,6132,2224,1,8535
619,2019-11-22,195,9298,1798,4,11295
619,2019-11-23,144,7629,1917,0,9690
619,2019-11-24,365,6707,1585,0,8657
619,2019-11-25,100,7294,1890,0,9284
619,2019-11-26,88,5921,1257,0,7266
619,2019-11-27,103,9775,1418,2,11298
619,2019-11-28,152,8097,866,2,9117
620,2019-08-01,71,14126,460,0,14657
620,2019-08-02,56,25774,163,0,25993
620,2019-08-03,95,9599,775,0,10469
620,2019-08-04,139,2103,385,0,2627
620,2019-08-05,104,7672,396,1,8173
620,2019-08-06,169,11953,472,1,12595
620,2019-08-07,113,6589,427,0,7129
620,2019-08-08,276,1413,340,0,2029
620,2019-08-09,112,2419,256,0,2787
620,2019-08-10,94,2102,256,0,2452
620,2019-08-11,224,1676,171,0,2071
620,2019-08-12,63,6943,298,1,7305
620,2019-08-13,168,10363,194,2,10727
620,2019-08-14,166,1956,56,0,2178
620,2019-08-15,118,878,81,0,1077
620,2019-08-16,90,3206,136,1,3433
620,2019-08-17,303,3612,952,0,4867
620,2019-08-18,204,3508,1365,1,5078
620,2019-08-19,122,19076,1206,2,20406
620,2019-08-20,111,27811,834,1,28757
620,2019-08-21,144,17143,1777,1,19065
620,2019-08-22,106,18299,1506,2,19913
620,2019-08-23,465,22816,1460,1,24742
620,2019-08-24,913,21143,1920,1,23977
620,2019-08-25,241,37846,2217,2,40306
620,2019-08-26,652,31116,990,2,32760
620,2019-08-27,255,21761,1306,3,23325
620,2019-08-28,243,22360,2071,0,24674
620,2019-08-29,348,14810,1367,0,16525
620,2019-08-30,132,4308,1003,1,5444
620,2019-08-31,41,14191,2,0,14234
620,2019-09-01,94,4499,367,0,4960
620,2019-09-02,141,733,73,1,948
620,2019-09-03,152,1295,1066,0,2513
620,2019-09-04,993,11209,1641,2,13845
620,2019-09-05,224,10715,2075,0,13014
620,2019-09-06,194,18224,2178,0,20596
620,2019-09-07,313,8734,2064,0,11111
620,2019-09-08,277,7504,1858,0,9639
620,2019-09-09,375,8203,2201,2,10781
620,2019-09-10,214,11178,2630,4,14026
620,2019-09-11,206,6734,3593,2,10535
620,2019-09-12,201,7223,2256,3,9683
620,2019-09-13,1043,6098,1365,4,8510
620,2019-09-14,132,5945,1468,22,7567
620,2019-09-15,114,19805,1873,1,21793
620,2019-09-16,155,10487,2225,2,12869
620,2019-09-17,991,7897,2398,2,11288
620,2019-09-18,137,12513,1250,2,13902
620,2019-09-19,376,10970,1687,1,13034
620,2019-09-20,296,13296,1484,0,15076
620,2019-09-21,157,6289,2082,0,8528
620,2019-09-22,163,13451,2205,0,15819
620,2019-09-23,2784,13157,2119,32,18092
620,2019-09-24,1058,12607,2250,2,15917
620,2019-09-25,230,13233,1368,2,14833
620,2019-09-26,1399,12840,1291,0,15530
620,2019-09-27,865,16055,1783,5,18708
620,2019-09-28,314,16384,1744,1,18443
620,2019-09-29,126,18068,1636,4,19834
620,2019-09-30,150,27292,1934,2,29378
620,2019-10-01,197,23089,1905,1,25192
620,2019-10-02,182,13422,1691,0,15295
620,2019-10-03,184,14936,1236,2,16358
620,2019-10-04,254,18330,1519,0,20103
620,2019-10-05,1043,23848,1706,2,26599
620,2019-10-06,267,17505,1982,0,19754
620,2019-10-07,1946,6861,2253,5,11065
620,2019-10-08,1034,19052,1220,1,21307
620,2019-10-09,207,26339,1930,0,28476
620,2019-10-10,1058,18676,1572,2,21308
620,2019-10-11,717,16658,1117,2,18494
620,2019-10-12,124,9972,1734,2,11832
620,2019-10-13,367,12795,1815,0,14977
620,2019-10-14,104,9162,2190,1,11457
620,2019-10-15,106,15527,1677,0,17310
620,2019-10-16,116,24739,920,2,25777
620,2019-10-17,106,8762,1710,2,10580
620,2019-10-18,174,15526,1150,1,16851
620,2019-10-19,123,10019,1418,0,11560
620,2019-10-20,1015,3838,2009,0,6862
620,2019-10-21,385,12892,1887,0,15164
620,2019-10-22,232,7178,2002,1,9413
620,2019-10-23,266,14774,1640,1,16681
620,2019-10-24,310,25805,1311,8,27434
620,2019-10-25,283,20191,1954,1,22429
620,2019-10-26,1765,25830,1343,1,28939
620,2019-10-27,270,31128,1266,1,32665
620,2019-10-28,215,25846,1579,1,27641
620,2019-10-29,177,18438,1261,0,19876
620,2019-10-30,871,16348,1651,1,18871
620,2019-10-31,190,13611,1423,1,15225
620,2019-11-01,683,26025,1922,2,28632
620,2019-11-02,126,17457,1490,1,19074
620,2019-11-03,252,37593,1741,0,39586
620,2019-11-04,1133,11508,835,1,13477
620,2019-11-05,230,3944,1697,1,5872
620,2019-11-06,177,15354,1066,2,16599
620,2019-11-07,218,17507,1170,4,18899
620,2019-11-08,284,10662,1395,0,12341
620,2019-11-09,78,14435,1633,0,16146
620,2019-11-10,118,25427,1053,2,26600
620,2019-11-11,132,17483,859,0,18474
620,2019-11-12,590,19144,2887,0,22621
620,2019-11-13,154,14289,1724,0,16167
620,2019-11-14,213,13550,2478,0,16241
620,2019-11-15,76,5778,3404,0,9258
620,2019-11-16,317,2870,3060,0,6247
620,2019-11-17,282,4219,3666,0,8167
620,2019-11-18,97,3785,2823,0,6705
620,2019-11-19,139,3646,2993,0,6778
620,2019-11-20,887,2061,2277,0,5225
620,2019-11-21,238,4722,1237,0,6197
620,2019-11-22,152,9566,1516,1,11235
620,2019-11-23,264,11681,2701,0,14646
620,2019-11-24,193,11423,1708,0,13324
620,2019-11-25,80,12096,1986,0,14162
620,2019-11-26,125,10233,1361,3,11722
620,2019-11-27,1696,11541,1035,0,14272
620,2019-11-28,334,12832,404,1,13571
620,2019-11-29,5,401,2,0,408
620,2019-08-01,71,14126,460,0,14657
620,2019-08-02,56,25774,163,0,25993
620,2019-08-03,95,9599,775,0,10469
620,2019-08-04,139,2103,385,0,2627
620,2019-08-05,104,7672,396,1,8173
620,2019-08-06,169,11953,472,1,12595
620,2019-08-07,113,6589,427,0,7129
620,2019-08-08,276,1413,340,0,2029
620,2019-08-09,112,2419,256,0,2787
620,2019-08-10,94,2102,256,0,2452
620,2019-08-11,224,1676,171,0,2071
620,2019-08-12,63,6943,298,1,7305
620,2019-08-13,168,10363,194,2,10727
620,2019-08-14,166,1956,56,0,2178
620,2019-08-15,118,878,81,0,1077
620,2019-08-16,90,3206,136,1,3433
620,2019-08-17,303,3612,952,0,4867
620,2019-08-18,204,3508,1365,1,5078
620,2019-08-19,122,19076,1206,2,20406
620,2019-08-20,111,27811,834,1,28757
620,2019-08-21,144,17143,1777,1,19065
620,2019-08-22,106,18299,1506,2,19913
620,2019-08-23,465,22816,1460,1,24742
620,2019-08-24,913,21143,1920,1,23977
620,2019-08-25,241,37846,2217,2,40306
620,2019-08-26,652,31116,990,2,32760
620,2019-08-27,255,21761,1306,3,23325
620,2019-08-28,243,22360,2071,0,24674
620,2019-08-29,348,14810,1367,0,16525
620,2019-08-30,132,4308,1003,1,5444
620,2019-08-31,41,14191,2,0,14234
620,2019-09-01,94,4499,367,0,4960
620,2019-09-02,141,733,73,1,948
620,2019-09-03,152,1295,1066,0,2513
620,2019-09-04,993,11209,1641,2,13845
620,2019-09-05,224,10715,2075,0,13014
620,2019-09-06,194,18224,2178,0,20596
620,2019-09-07,313,8734,2064,0,11111
620,2019-09-08,277,7504,1858,0,9639
620,2019-09-09,375,8203,2201,2,10781
620,2019-09-10,214,11178,2630,4,14026
620,2019-09-11,206,6734,3593,2,10535
620,2019-09-12,201,7223,2256,3,9683
620,2019-09-13,1043,6098,1365,4,8510
620,2019-09-14,132,5945,1468,22,7567
620,2019-09-15,114,19805,1873,1,21793
620,2019-09-16,155,10487,2225,2,12869
620,2019-09-17,991,7897,2398,2,11288
620,2019-09-18,137,12513,1250,2,13902
620,2019-09-19,376,10970,1687,1,13034
620,2019-09-20,296,13296,1484,0,15076
620,2019-09-21,157,6289,2082,0,8528
620,2019-09-22,163,13451,2205,0,15819
620,2019-09-23,2784,13157,2119,32,18092
620,2019-09-24,1058,12607,2250,2,15917
620,2019-09-25,230,13233,1368,2,14833
620,2019-09-26,1399,12840,1291,0,15530
620,2019-09-27,865,16055,1783,5,18708
620,2019-09-28,314,16384,1744,1,18443
620,2019-09-29,126,18068,1636,4,19834
620,2019-09-30,150,27292,1934,2,29378
620,2019-10-01,197,23089,1905,1,25192
620,2019-10-02,182,13422,1691,0,15295
620,2019-10-03,184,14936,1236,2,16358
620,2019-10-04,254,18330,1519,0,20103
620,2019-10-05,1043,23848,1706,2,26599
620,2019-10-06,267,17505,1982,0,19754
620,2019-10-07,1946,6861,2253,5,11065
620,2019-10-08,1034,19052,1220,1,21307
620,2019-10-09,207,26339,1930,0,28476
620,2019-10-10,1058,18676,1572,2,21308
620,2019-10-11,717,16658,1117,2,18494
620,2019-10-12,124,9972,1734,2,11832
620,2019-10-13,367,12795,1815,0,14977
620,2019-10-14,104,9162,2190,1,11457
620,2019-10-15,106,15527,1677,0,17310
620,2019-10-16,116,24739,920,2,25777
620,2019-10-17,106,8762,1710,2,10580
620,2019-10-18,174,15526,1150,1,16851
620,2019-10-19,123,10019,1418,0,11560
620,2019-10-20,1015,3838,2009,0,6862
620,2019-10-21,385,12892,1887,0,15164
620,2019-10-22,232,7178,2002,1,9413
620,2019-10-23,266,14774,1640,1,16681
620,2019-10-24,310,25805,1311,8,27434
620,2019-10-25,283,20191,1954,1,22429
620,2019-10-26,1765,25830,1343,1,28939
620,2019-10-27,270,31128,1266,1,32665
620,2019-10-28,215,25846,1579,1,27641
620,2019-10-29,177,18438,1261,0,19876
620,2019-10-30,871,16348,1651,1,18871
620,2019-10-31,190,13611,1423,1,15225
620,2019-11-01,683,26025,1922,2,28632
620,2019-11-02,126,17457,1490,1,19074
620,2019-11-03,252,37593,1741,0,39586
620,2019-11-04,1133,11508,835,1,13477
620,2019-11-05,230,3944,1697,1,5872
620,2019-11-06,177,15354,1066,2,16599
620,2019-11-07,218,17507,1170,4,18899
620,2019-11-08,284,10662,1395,0,12341
620,2019-11-09,78,14435,1633,0,16146
620,2019-11-10,118,25427,1053,2,26600
620,2019-11-11,132,17483,859,0,18474
620,2019-11-12,590,19144,2887,0,22621
620,2019-11-13,154,14289,1724,0,16167
620,2019-11-14,213,13550,2478,0,16241
620,2019-11-15,76,5778,3404,0,9258
620,2019-11-16,317,2870,3060,0,6247
620,2019-11-17,282,4219,3666,0,8167
620,2019-11-18,97,3785,2823,0,6705
620,2019-11-19,139,3646,2993,0,6778
620,2019-11-20,887,2061,2277,0,5225
620,2019-11-21,238,4722,1237,0,6197
620,2019-11-22,152,9566,1516,1,11235
620,2019-11-23,264,11681,2701,0,14646
620,2019-11-24,193,11423,1708,0,13324
620,2019-11-25,80,12096,1986,0,14162
620,2019-11-26,125,10233,1361,3,11722
620,2019-11-27,1696,11541,1035,0,14272
620,2019-11-28,334,12832,404,1,13571
620,2019-11-29,5,401,2,0,408
620,2019-08-01,71,14126,460,0,14657
620,2019-08-02,56,25774,163,0,25993
620,2019-08-03,95,9599,775,0,10469
620,2019-08-04,139,2103,385,0,2627
620,2019-08-05,104,7672,396,1,8173
620,2019-08-06,169,11953,472,1,12595
620,2019-08-07,113,6589,427,0,7129
620,2019-08-08,276,1413,340,0,2029
620,2019-08-09,112,2419,256,0,2787
620,2019-08-10,94,2102,256,0,2452
620,2019-08-11,224,1676,171,0,2071
620,2019-08-12,63,6943,298,1,7305
620,2019-08-13,168,10363,194,2,10727
620,2019-08-14,166,1956,56,0,2178
620,2019-08-15,118,878,81,0,1077
620,2019-08-16,90,3206,136,1,3433
620,2019-08-17,303,3612,952,0,4867
620,2019-08-18,204,3508,1365,1,5078
620,2019-08-19,122,19076,1206,2,20406
620,2019-08-20,111,27811,834,1,28757
620,2019-08-21,144,17143,1777,1,19065
620,2019-08-22,106,18299,1506,2,19913
620,2019-08-23,465,22816,1460,1,24742
620,2019-08-24,913,21143,1920,1,23977
620,2019-08-25,241,37846,2217,2,40306
620,2019-08-26,652,31116,990,2,32760
620,2019-08-27,255,21761,1306,3,23325
620,2019-08-28,243,22360,2071,0,24674
620,2019-08-29,348,14810,1367,0,16525
620,2019-08-30,132,4308,1003,1,5444
620,2019-08-31,41,14191,2,0,14234
620,2019-09-01,94,4499,367,0,4960
620,2019-09-02,141,733,73,1,948
620,2019-09-03,152,1295,1066,0,2513
620,2019-09-04,993,11209,1641,2,13845
620,2019-09-05,224,10715,2075,0,13014
620,2019-09-06,194,18224,2178,0,20596
620,2019-09-07,313,8734,2064,0,11111
620,2019-09-08,277,7504,1858,0,9639
620,2019-09-09,375,8203,2201,2,10781
620,2019-09-10,214,11178,2630,4,14026
620,2019-09-11,206,6734,3593,2,10535
620,2019-09-12,201,7223,2256,3,9683
620,2019-09-13,1043,6098,1365,4,8510
620,2019-09-14,132,5945,1468,22,7567
620,2019-09-15,114,19805,1873,1,21793
620,2019-09-16,155,10487,2225,2,12869
620,2019-09-17,991,7897,2398,2,11288
620,2019-09-18,137,12513,1250,2,13902
620,2019-09-19,376,10970,1687,1,13034
620,2019-09-20,296,13296,1484,0,15076
620,2019-09-21,157,6289,2082,0,8528
620,2019-09-22,163,13451,2205,0,15819
620,2019-09-23,2784,13157,2119,32,18092
620,2019-09-24,1058,12607,2250,2,15917
620,2019-09-25,230,13233,1368,2,14833
620,2019-09-26,1399,12840,1291,0,15530
620,2019-09-27,865,16055,1783,5,18708
620,2019-09-28,314,16384,1744,1,18443
620,2019-09-29,126,18068,1636,4,19834
620,2019-09-30,150,27292,1934,2,29378
620,2019-10-01,197,23089,1905,1,25192
620,2019-10-02,182,13422,1691,0,15295
620,2019-10-03,184,14936,1236,2,16358
620,2019-10-04,254,18330,1519,0,20103
620,2019-10-05,1043,23848,1706,2,26599
620,2019-10-06,267,17505,1982,0,19754
620,2019-10-07,1946,6861,2253,5,11065
620,2019-10-08,1034,19052,1220,1,21307
620,2019-10-09,207,26339,1930,0,28476
620,2019-10-10,1058,18676,1572,2,21308
620,2019-10-11,717,16658,1117,2,18494
620,2019-10-12,124,9972,1734,2,11832
620,2019-10-13,367,12795,1815,0,14977
620,2019-10-14,104,9162,2190,1,11457
620,2019-10-15,106,15527,1677,0,17310
620,2019-10-16,116,24739,920,2,25777
620,2019-10-17,106,8762,1710,2,10580
620,2019-10-18,174,15526,1150,1,16851
620,2019-10-19,123,10019,1418,0,11560
620,2019-10-20,1015,3838,2009,0,6862
620,2019-10-21,385,12892,1887,0,15164
620,2019-10-22,232,7178,2002,1,9413
620,2019-10-23,266,14774,1640,1,16681
620,2019-10-24,310,25805,1311,8,27434
620,2019-10-25,283,20191,1954,1,22429
620,2019-10-26,1765,25830,1343,1,28939
620,2019-10-27,270,31128,1266,1,32665
620,2019-10-28,215,25846,1579,1,27641
620,2019-10-29,177,18438,1261,0,19876
620,2019-10-30,871,16348,1651,1,18871
620,2019-10-31,190,13611,1423,1,15225
620,2019-11-01,683,26025,1922,2,28632
620,2019-11-02,126,17457,1490,1,19074
620,2019-11-03,252,37593,1741,0,39586
620,2019-11-04,1133,11508,835,1,13477
620,2019-11-05,230,3944,1697,1,5872
620,2019-11-06,177,15354,1066,2,16599
620,2019-11-07,218,17507,1170,4,18899
620,2019-11-08,284,10662,1395,0,12341
620,2019-11-09,78,14435,1633,0,16146
620,2019-11-10,118,25427,1053,2,26600
620,2019-11-11,132,17483,859,0,18474
620,2019-11-12,590,19144,2887,0,22621
620,2019-11-13,154,14289,1724,0,16167
620,2019-11-14,213,13550,2478,0,16241
620,2019-11-15,76,5778,3404,0,9258
620,2019-11-16,317,2870,3060,0,6247
620,2019-11-17,282,4219,3666,0,8167
620,2019-11-18,97,3785,2823,0,6705
620,2019-11-19,139,3646,2993,0,6778
620,2019-11-20,887,2061,2277,0,5225
620,2019-11-21,238,4722,1237,0,6197
620,2019-11-22,152,9566,1516,1,11235
620,2019-11-23,264,11681,2701,0,14646
620,2019-11-24,193,11423,1708,0,13324
620,2019-11-25,80,12096,1986,0,14162
620,2019-11-26,125,10233,1361,3,11722
620,2019-11-27,1696,11541,1035,0,14272
620,2019-11-28,334,12832,404,1,13571
620,2019-11-29,5,401,2,0,408
620,2019-08-05,104,7672,396,1,8173
620,2019-08-06,169,11953,472,1,12595
620,2019-08-07,113,6589,427,0,7129
620,2019-08-08,276,1413,340,0,2029
620,2019-08-09,112,2419,256,0,2787
620,2019-08-10,94,2102,256,0,2452
620,2019-08-11,224,1676,171,0,2071
620,2019-08-12,63,6943,298,1,7305
620,2019-08-13,168,10363,194,2,10727
620,2019-08-14,166,1956,56,0,2178
620,2019-08-15,118,878,81,0,1077
620,2019-08-16,90,3206,136,1,3433
620,2019-08-17,303,3612,952,0,4867
620,2019-08-18,204,3508,1365,1,5078
620,2019-08-19,122,19076,1206,2,20406
620,2019-08-20,111,27811,834,1,28757
620,2019-08-21,144,17143,1777,1,19065
620,2019-08-22,106,18299,1506,2,19913
620,2019-08-23,465,22816,1460,1,24742
620,2019-08-24,913,21143,1920,1,23977
620,2019-08-25,241,37846,2217,2,40306
620,2019-08-26,652,31116,990,2,32760
620,2019-08-27,255,21761,1306,3,23325
620,2019-08-28,243,22360,2071,0,24674
620,2019-08-29,348,14810,1367,0,16525
620,2019-08-30,132,4308,1003,1,5444
620,2019-08-31,41,14191,2,0,14234
620,2019-09-01,94,4499,367,0,4960
620,2019-09-02,141,733,73,1,948
620,2019-09-03,152,1295,1066,0,2513
620,2019-09-04,993,11209,1641,2,13845
620,2019-09-05,224,10715,2075,0,13014
620,2019-09-06,194,18224,2178,0,20596
620,2019-09-07,313,8734,2064,0,11111
620,2019-09-08,277,7504,1858,0,9639
620,2019-09-09,375,8203,2201,2,10781
620,2019-09-10,214,11178,2630,4,14026
620,2019-09-11,206,6734,3593,2,10535
620,2019-09-12,201,7223,2256,3,9683
620,2019-09-13,1043,6098,1365,4,8510
620,2019-09-14,132,5945,1468,22,7567
620,2019-09-15,114,19805,1873,1,21793
620,2019-09-16,155,10487,2225,2,12869
620,2019-09-17,991,7897,2398,2,11288
620,2019-09-18,137,12513,1250,2,13902
620,2019-09-19,376,10970,1687,1,13034
620,2019-09-20,296,13296,1484,0,15076
620,2019-09-21,157,6289,2082,0,8528
620,2019-09-22,163,13451,2205,0,15819
620,2019-09-23,2784,13157,2119,32,18092
620,2019-09-24,1058,12607,2250,2,15917
620,2019-09-25,230,13233,1368,2,14833
620,2019-09-26,1399,12840,1291,0,15530
620,2019-09-27,865,16055,1783,5,18708
620,2019-09-28,314,16384,1744,1,18443
620,2019-09-29,126,18068,1636,4,19834
620,2019-09-30,150,27292,1934,2,29378
620,2019-10-01,197,23089,1905,1,25192
620,2019-10-02,182,13422,1691,0,15295
620,2019-10-03,184,14936,1236,2,16358
620,2019-10-04,254,18330,1519,0,20103
620,2019-10-05,1043,23848,1706,2,26599
620,2019-10-06,267,17505,1982,0,19754
620,2019-10-07,1946,6861,2253,5,11065
620,2019-10-08,1034,19052,1220,1,21307
620,2019-10-09,207,26339,1930,0,28476
620,2019-10-10,1058,18676,1572,2,21308
620,2019-10-11,717,16658,1117,2,18494
620,2019-10-12,124,9972,1734,2,11832
620,2019-10-13,367,12795,1815,0,14977
620,2019-10-14,104,9162,2190,1,11457
620,2019-10-15,106,15527,1677,0,17310
620,2019-10-16,116,24739,920,2,25777
620,2019-10-17,106,8762,1710,2,10580
620,2019-10-18,174,15526,1150,1,16851
620,2019-10-19,123,10019,1418,0,11560
620,2019-10-20,1015,3838,2009,0,6862
620,2019-10-21,385,12892,1887,0,15164
620,2019-10-22,232,7178,2002,1,9413
620,2019-10-23,266,14774,1640,1,16681
620,2019-10-24,310,25805,1311,8,27434
620,2019-10-25,283,20191,1954,1,22429
620,2019-10-26,1765,25830,1343,1,28939
620,2019-10-27,270,31128,1266,1,32665
620,2019-10-28,215,25846,1579,1,27641
620,2019-10-29,177,18438,1261,0,19876
620,2019-10-30,871,16348,1651,1,18871
620,2019-10-31,190,13611,1423,1,15225
620,2019-11-01,683,26025,1922,2,28632
620,2019-11-02,126,17457,1490,1,19074
620,2019-11-03,252,37593,1741,0,39586
620,2019-11-04,1133,11508,835,1,13477
620,2019-11-05,230,3944,1697,1,5872
620,2019-11-06,177,15354,1066,2,16599
620,2019-11-07,218,17507,1170,4,18899
620,2019-11-08,284,10662,1395,0,12341
620,2019-11-09,78,14435,1633,0,16146
620,2019-11-10,118,25427,1053,2,26600
620,2019-11-11,132,17483,859,0,18474
620,2019-11-12,590,19144,2887,0,22621
620,2019-11-13,154,14289,1724,0,16167
620,2019-11-14,213,13550,2478,0,16241
620,2019-11-15,76,5778,3404,0,9258
620,2019-11-16,317,2870,3060,0,6247
620,2019-11-17,282,4219,3666,0,8167
620,2019-11-18,97,3785,2823,0,6705
620,2019-11-19,139,3646,2993,0,6778
620,2019-11-20,887,2061,2277,0,5225
620,2019-11-21,238,4722,1237,0,6197
620,2019-11-22,152,9566,1516,1,11235
620,2019-11-23,264,11681,2701,0,14646
620,2019-11-24,193,11423,1708,0,13324
620,2019-11-25,80,12096,1986,0,14162
620,2019-11-26,125,10233,1361,3,11722
620,2019-11-27,1696,11541,1035,0,14272
620,2019-11-28,334,12832,404,1,13571
621,2019-08-01,313,676,171,0,1160
621,2019-08-02,289,594,244,0,1127
621,2019-08-03,54,1177,173,0,1404
621,2019-08-04,760,1306,79,0,2145
621,2019-08-05,43,1093,148,1,1285
621,2019-08-06,47,1305,417,1,1770
621,2019-08-07,92,1706,447,0,2245
621,2019-08-08,455,1404,583,0,2442
621,2019-08-09,28,2507,261,1,2797
621,2019-08-10,57,17747,342,0,18146
621,2019-08-11,120,9255,44,1,9420
621,2019-08-12,28,2185,199,0,2412
621,2019-08-13,51,17618,75,0,17744
621,2019-08-14,132,16658,103,0,16893
621,2019-08-15,31,1499,13,0,1543
621,2019-08-16,37,1966,213,0,2216
621,2019-08-17,151,3788,832,0,4771
621,2019-08-18,54,3177,1095,1,4327
621,2019-08-19,47,3661,1217,0,4925
621,2019-08-20,63,4025,1273,0,5361
621,2019-08-21,60,4696,1662,0,6418
621,2019-08-22,166,3478,2308,0,5952
621,2019-08-23,50,10987,1066,0,12103
621,2019-08-24,66,6560,1710,0,8336
621,2019-08-25,79,48968,1710,0,50757
621,2019-08-26,86,34306,1440,3,35835
621,2019-08-27,82,6492,1559,3,8136
621,2019-08-28,67,14229,1711,3,16010
621,2019-08-29,65,13573,1004,0,14642
621,2019-08-30,31,3716,903,0,4650
621,2019-08-31,15,8318,0,0,8333
621,2019-09-01,247,3606,211,0,4064
621,2019-09-02,26,523,35,0,584
621,2019-09-03,66,1081,1580,0,2727
621,2019-09-04,96,11406,1674,1,13177
621,2019-09-05,107,7306,1222,2,8637
621,2019-09-06,120,10925,2292,1,13338
621,2019-09-07,222,14012,1600,0,15834
621,2019-09-08,1039,6539,2253,0,9831
621,2019-09-09,219,7938,2154,0,10311
621,2019-09-10,168,8305,2474,2,10949
621,2019-09-11,984,7146,2177,1,10308
621,2019-09-12,66,8876,2399,2,11343
621,2019-09-13,67,7150,2348,1,9566
621,2019-09-14,904,8461,2094,2,11461
621,2019-09-15,922,9116,2903,0,12941
621,2019-09-16,934,7475,2409,0,10818
621,2019-09-17,163,10670,1414,0,12247
621,2019-09-18,914,12601,1034,0,14549
621,2019-09-19,233,13498,2430,0,16161
621,2019-09-20,172,16997,1910,1,19080
621,2019-09-21,87,8198,1801,4,10090
621,2019-09-22,98,7847,2323,0,10268
621,2019-09-23,150,12617,2565,0,15332
621,2019-09-24,88,39064,1533,0,40685
621,2019-09-25,1060,17648,2050,1,20759
621,2019-09-26,137,11929,2303,5,14374
621,2019-09-27,1115,9393,1986,1,12495
621,2019-09-28,155,16108,1892,2,18157
621,2019-09-29,1080,18628,1981,1,21690
621,2019-09-30,1022,16561,1508,1,19092
621,2019-10-01,1981,22402,1558,2,25943
621,2019-10-02,1047,16200,2212,1,19460
621,2019-10-03,84,33693,1321,0,35098
621,2019-10-04,821,17280,1534,2,19637
621,2019-10-05,930,16977,1584,1,19492
621,2019-10-06,1233,12290,1658,3,15184
621,2019-10-07,97,9328,1625,2,11052
621,2019-10-08,101,13271,1245,1,14618
621,2019-10-09,71,34226,1060,3,35360
621,2019-10-10,2640,46358,1722,1,50721
621,2019-10-11,68,18429,995,5,19497
621,2019-10-12,169,5879,2031,0,8079
621,2019-10-13,86,9554,1441,2,11083
621,2019-10-14,70,8572,1730,1,10373
621,2019-10-15,724,9875,2137,17,12753
621,2019-10-16,744,13516,1555,3,15818
621,2019-10-17,1875,6316,1194,1,9386
621,2019-10-18,73,9638,1754,1,11466
621,2019-10-19,88,6574,1292,1,7955
621,2019-10-20,1818,5209,1613,2,8642
621,2019-10-21,188,12054,1804,5,14051
621,2019-10-22,986,8836,1483,0,11305
621,2019-10-23,59,9119,1753,4,10935
621,2019-10-24,201,20309,1110,0,21620
621,2019-10-25,742,19462,1350,4,21558
621,2019-10-26,87,25547,1885,0,27519
621,2019-10-27,105,18789,1861,3,20758
621,2019-10-28,84,20537,2080,1,22702
621,2019-10-29,110,19126,1995,0,21231
621,2019-10-30,557,16000,1285,1,17843
621,2019-10-31,616,20957,1221,2,22796
621,2019-11-01,46,27860,1145,0,29051
621,2019-11-02,1723,26962,1631,0,30316
621,2019-11-03,59,39511,1351,0,40921
621,2019-11-04,100,14270,1498,0,15868
621,2019-11-05,110,4272,2646,0,7028
621,2019-11-06,794,15197,2153,1,18145
621,2019-11-07,1186,16217,1906,2,19311
621,2019-11-08,67,9742,2403,0,12212
621,2019-11-09,69,9835,1928,1,11833
621,2019-11-10,1013,15292,1276,2,17583
621,2019-11-11,86,14534,1849,0,16469
621,2019-11-12,144,17990,3117,0,21251
621,2019-11-13,159,23236,2466,0,25861
621,2019-11-14,66,13409,1741,0,15216
621,2019-11-15,1027,4546,2048,0,7621
621,2019-11-16,1019,2955,2285,0,6259
621,2019-11-17,125,5211,3176,0,8512
621,2019-11-18,237,4482,3214,0,7933
621,2019-11-19,241,5709,2612,0,8562
621,2019-11-20,164,1968,1752,0,3884
621,2019-11-21,127,3925,2751,0,6803
621,2019-11-22,122,5219,1364,0,6705
621,2019-11-23,176,6781,2052,1,9010
621,2019-11-24,1180,7893,1905,1,10979
621,2019-11-25,486,10718,2587,1,13792
621,2019-11-26,146,9429,1451,1,11027
621,2019-11-27,108,7372,1682,1,9163
621,2019-11-28,102,11612,875,0,12589
621,2019-11-29,278,482,1,0,761
621,2019-08-01,313,676,171,0,1160
621,2019-08-02,289,594,244,0,1127
621,2019-08-03,54,1177,173,0,1404
621,2019-08-04,760,1306,79,0,2145
621,2019-08-05,43,1093,148,1,1285
621,2019-08-06,47,1305,417,1,1770
621,2019-08-07,92,1706,447,0,2245
621,2019-08-08,455,1404,583,0,2442
621,2019-08-09,28,2507,261,1,2797
621,2019-08-10,57,17747,342,0,18146
621,2019-08-11,120,9255,44,1,9420
621,2019-08-12,28,2185,199,0,2412
621,2019-08-13,51,17618,75,0,17744
621,2019-08-14,132,16658,103,0,16893
621,2019-08-15,31,1499,13,0,1543
621,2019-08-16,37,1966,213,0,2216
621,2019-08-17,151,3788,832,0,4771
621,2019-08-18,54,3177,1095,1,4327
621,2019-08-19,47,3661,1217,0,4925
621,2019-08-20,63,4025,1273,0,5361
621,2019-08-21,60,4696,1662,0,6418
621,2019-08-22,166,3478,2308,0,5952
621,2019-08-23,50,10987,1066,0,12103
621,2019-08-24,66,6560,1710,0,8336
621,2019-08-25,79,48968,1710,0,50757
621,2019-08-26,86,34306,1440,3,35835
621,2019-08-27,82,6492,1559,3,8136
621,2019-08-28,67,14229,1711,3,16010
621,2019-08-29,65,13573,1004,0,14642
621,2019-08-30,31,3716,903,0,4650
621,2019-08-31,15,8318,0,0,8333
621,2019-09-01,247,3606,211,0,4064
621,2019-09-02,26,523,35,0,584
621,2019-09-03,66,1081,1580,0,2727
621,2019-09-04,96,11406,1674,1,13177
621,2019-09-05,107,7306,1222,2,8637
621,2019-09-06,120,10925,2292,1,13338
621,2019-09-07,222,14012,1600,0,15834
621,2019-09-08,1039,6539,2253,0,9831
621,2019-09-09,219,7938,2154,0,10311
621,2019-09-10,168,8305,2474,2,10949
621,2019-09-11,984,7146,2177,1,10308
621,2019-09-12,66,8876,2399,2,11343
621,2019-09-13,67,7150,2348,1,9566
621,2019-09-14,904,8461,2094,2,11461
621,2019-09-15,922,9116,2903,0,12941
621,2019-09-16,934,7475,2409,0,10818
621,2019-09-17,163,10670,1414,0,12247
621,2019-09-18,914,12601,1034,0,14549
621,2019-09-19,233,13498,2430,0,16161
621,2019-09-20,172,16997,1910,1,19080
621,2019-09-21,87,8198,1801,4,10090
621,2019-09-22,98,7847,2323,0,10268
621,2019-09-23,150,12617,2565,0,15332
621,2019-09-24,88,39064,1533,0,40685
621,2019-09-25,1060,17648,2050,1,20759
621,2019-09-26,137,11929,2303,5,14374
621,2019-09-27,1115,9393,1986,1,12495
621,2019-09-28,155,16108,1892,2,18157
621,2019-09-29,1080,18628,1981,1,21690
621,2019-09-30,1022,16561,1508,1,19092
621,2019-10-01,1981,22402,1558,2,25943
621,2019-10-02,1047,16200,2212,1,19460
621,2019-10-03,84,33693,1321,0,35098
621,2019-10-04,821,17280,1534,2,19637
621,2019-10-05,930,16977,1584,1,19492
621,2019-10-06,1233,12290,1658,3,15184
621,2019-10-07,97,9328,1625,2,11052
621,2019-10-08,101,13271,1245,1,14618
621,2019-10-09,71,34226,1060,3,35360
621,2019-10-10,2640,46358,1722,1,50721
621,2019-10-11,68,18429,995,5,19497
621,2019-10-12,169,5879,2031,0,8079
621,2019-10-13,86,9554,1441,2,11083
621,2019-10-14,70,8572,1730,1,10373
621,2019-10-15,724,9875,2137,17,12753
621,2019-10-16,744,13516,1555,3,15818
621,2019-10-17,1875,6316,1194,1,9386
621,2019-10-18,73,9638,1754,1,11466
621,2019-10-19,88,6574,1292,1,7955
621,2019-10-20,1818,5209,1613,2,8642
621,2019-10-21,188,12054,1804,5,14051
621,2019-10-22,986,8836,1483,0,11305
621,2019-10-23,59,9119,1753,4,10935
621,2019-10-24,201,20309,1110,0,21620
621,2019-10-25,742,19462,1350,4,21558
621,2019-10-26,87,25547,1885,0,27519
621,2019-10-27,105,18789,1861,3,20758
621,2019-10-28,84,20537,2080,1,22702
621,2019-10-29,110,19126,1995,0,21231
621,2019-10-30,557,16000,1285,1,17843
621,2019-10-31,616,20957,1221,2,22796
621,2019-11-01,46,27860,1145,0,29051
621,2019-11-02,1723,26962,1631,0,30316
621,2019-11-03,59,39511,1351,0,40921
621,2019-11-04,100,14270,1498,0,15868
621,2019-11-05,110,4272,2646,0,7028
621,2019-11-06,794,15197,2153,1,18145
621,2019-11-07,1186,16217,1906,2,19311
621,2019-11-08,67,9742,2403,0,12212
621,2019-11-09,69,9835,1928,1,11833
621,2019-11-10,1013,15292,1276,2,17583
621,2019-11-11,86,14534,1849,0,16469
621,2019-11-12,144,17990,3117,0,21251
621,2019-11-13,159,23236,2466,0,25861
621,2019-11-14,66,13409,1741,0,15216
621,2019-11-15,1027,4546,2048,0,7621
621,2019-11-16,1019,2955,2285,0,6259
621,2019-11-17,125,5211,3176,0,8512
621,2019-11-18,237,4482,3214,0,7933
621,2019-11-19,241,5709,2612,0,8562
621,2019-11-20,164,1968,1752,0,3884
621,2019-11-21,127,3925,2751,0,6803
621,2019-11-22,122,5219,1364,0,6705
621,2019-11-23,176,6781,2052,1,9010
621,2019-11-24,1180,7893,1905,1,10979
621,2019-11-25,486,10718,2587,1,13792
621,2019-11-26,146,9429,1451,1,11027
621,2019-11-27,108,7372,1682,1,9163
621,2019-11-28,102,11612,875,0,12589
621,2019-11-29,278,482,1,0,761
621,2019-08-01,313,676,171,0,1160
621,2019-08-02,289,594,244,0,1127
621,2019-08-03,54,1177,173,0,1404
621,2019-08-04,760,1306,79,0,2145
621,2019-08-05,43,1093,148,1,1285
621,2019-08-06,47,1305,417,1,1770
621,2019-08-07,92,1706,447,0,2245
621,2019-08-08,455,1404,583,0,2442
621,2019-08-09,28,2507,261,1,2797
621,2019-08-10,57,17747,342,0,18146
621,2019-08-11,120,9255,44,1,9420
621,2019-08-12,28,2185,199,0,2412
621,2019-08-13,51,17618,75,0,17744
621,2019-08-14,132,16658,103,0,16893
621,2019-08-15,31,1499,13,0,1543
621,2019-08-16,37,1966,213,0,2216
621,2019-08-17,151,3788,832,0,4771
621,2019-08-18,54,3177,1095,1,4327
621,2019-08-19,47,3661,1217,0,4925
621,2019-08-20,63,4025,1273,0,5361
621,2019-08-21,60,4696,1662,0,6418
621,2019-08-22,166,3478,2308,0,5952
621,2019-08-23,50,10987,1066,0,12103
621,2019-08-24,66,6560,1710,0,8336
621,2019-08-25,79,48968,1710,0,50757
621,2019-08-26,86,34306,1440,3,35835
621,2019-08-27,82,6492,1559,3,8136
621,2019-08-28,67,14229,1711,3,16010
621,2019-08-29,65,13573,1004,0,14642
621,2019-08-30,31,3716,903,0,4650
621,2019-08-31,15,8318,0,0,8333
621,2019-09-01,247,3606,211,0,4064
621,2019-09-02,26,523,35,0,584
621,2019-09-03,66,1081,1580,0,2727
621,2019-09-04,96,11406,1674,1,13177
621,2019-09-05,107,7306,1222,2,8637
621,2019-09-06,120,10925,2292,1,13338
621,2019-09-07,222,14012,1600,0,15834
621,2019-09-08,1039,6539,2253,0,9831
621,2019-09-09,219,7938,2154,0,10311
621,2019-09-10,168,8305,2474,2,10949
621,2019-09-11,984,7146,2177,1,10308
621,2019-09-12,66,8876,2399,2,11343
621,2019-09-13,67,7150,2348,1,9566
621,2019-09-14,904,8461,2094,2,11461
621,2019-09-15,922,9116,2903,0,12941
621,2019-09-16,934,7475,2409,0,10818
621,2019-09-17,163,10670,1414,0,12247
621,2019-09-18,914,12601,1034,0,14549
621,2019-09-19,233,13498,2430,0,16161
621,2019-09-20,172,16997,1910,1,19080
621,2019-09-21,87,8198,1801,4,10090
621,2019-09-22,98,7847,2323,0,10268
621,2019-09-23,150,12617,2565,0,15332
621,2019-09-24,88,39064,1533,0,40685
621,2019-09-25,1060,17648,2050,1,20759
621,2019-09-26,137,11929,2303,5,14374
621,2019-09-27,1115,9393,1986,1,12495
621,2019-09-28,155,16108,1892,2,18157
621,2019-09-29,1080,18628,1981,1,21690
621,2019-09-30,1022,16561,1508,1,19092
621,2019-10-01,1981,22402,1558,2,25943
621,2019-10-02,1047,16200,2212,1,19460
621,2019-10-03,84,33693,1321,0,35098
621,2019-10-04,821,17280,1534,2,19637
621,2019-10-05,930,16977,1584,1,19492
621,2019-10-06,1233,12290,1658,3,15184
621,2019-10-07,97,9328,1625,2,11052
621,2019-10-08,101,13271,1245,1,14618
621,2019-10-09,71,34226,1060,3,35360
621,2019-10-10,2640,46358,1722,1,50721
621,2019-10-11,68,18429,995,5,19497
621,2019-10-12,169,5879,2031,0,8079
621,2019-10-13,86,9554,1441,2,11083
621,2019-10-14,70,8572,1730,1,10373
621,2019-10-15,724,9875,2137,17,12753
621,2019-10-16,744,13516,1555,3,15818
621,2019-10-17,1875,6316,1194,1,9386
621,2019-10-18,73,9638,1754,1,11466
621,2019-10-19,88,6574,1292,1,7955
621,2019-10-20,1818,5209,1613,2,8642
621,2019-10-21,188,12054,1804,5,14051
621,2019-10-22,986,8836,1483,0,11305
621,2019-10-23,59,9119,1753,4,10935
621,2019-10-24,201,20309,1110,0,21620
621,2019-10-25,742,19462,1350,4,21558
621,2019-10-26,87,25547,1885,0,27519
621,2019-10-27,105,18789,1861,3,20758
621,2019-10-28,84,20537,2080,1,22702
621,2019-10-29,110,19126,1995,0,21231
621,2019-10-30,557,16000,1285,1,17843
621,2019-10-31,616,20957,1221,2,22796
621,2019-11-01,46,27860,1145,0,29051
621,2019-11-02,1723,26962,1631,0,30316
621,2019-11-03,59,39511,1351,0,40921
621,2019-11-04,100,14270,1498,0,15868
621,2019-11-05,110,4272,2646,0,7028
621,2019-11-06,794,15197,2153,1,18145
621,2019-11-07,1186,16217,1906,2,19311
621,2019-11-08,67,9742,2403,0,12212
621,2019-11-09,69,9835,1928,1,11833
621,2019-11-10,1013,15292,1276,2,17583
621,2019-11-11,86,14534,1849,0,16469
621,2019-11-12,144,17990,3117,0,21251
621,2019-11-13,159,23236,2466,0,25861
621,2019-11-14,66,13409,1741,0,15216
621,2019-11-15,1027,4546,2048,0,7621
621,2019-11-16,1019,2955,2285,0,6259
621,2019-11-17,125,5211,3176,0,8512
621,2019-11-18,237,4482,3214,0,7933
621,2019-11-19,241,5709,2612,0,8562
621,2019-11-20,164,1968,1752,0,3884
621,2019-11-21,127,3925,2751,0,6803
621,2019-11-22,122,5219,1364,0,6705
621,2019-11-23,176,6781,2052,1,9010
621,2019-11-24,1180,7893,1905,1,10979
621,2019-11-25,486,10718,2587,1,13792
621,2019-11-26,146,9429,1451,1,11027
621,2019-11-27,108,7372,1682,1,9163
621,2019-11-28,102,11612,875,0,12589
621,2019-11-29,278,482,1,0,761
621,2019-08-05,43,1093,148,1,1285
621,2019-08-06,47,1305,417,1,1770
621,2019-08-07,92,1706,447,0,2245
621,2019-08-08,455,1404,583,0,2442
621,2019-08-09,28,2507,261,1,2797
621,2019-08-10,57,17747,342,0,18146
621,2019-08-11,120,9255,44,1,9420
621,2019-08-12,28,2185,199,0,2412
621,2019-08-13,51,17618,75,0,17744
621,2019-08-14,132,16658,103,0,16893
621,2019-08-15,31,1499,13,0,1543
621,2019-08-16,37,1966,213,0,2216
621,2019-08-17,151,3788,832,0,4771
621,2019-08-18,54,3177,1095,1,4327
621,2019-08-19,47,3661,1217,0,4925
621,2019-08-20,63,4025,1273,0,5361
621,2019-08-21,60,4696,1662,0,6418
621,2019-08-22,166,3478,2308,0,5952
621,2019-08-23,50,10987,1066,0,12103
621,2019-08-24,66,6560,1710,0,8336
621,2019-08-25,79,48968,1710,0,50757
621,2019-08-26,86,34306,1440,3,35835
621,2019-08-27,82,6492,1559,3,8136
621,2019-08-28,67,14229,1711,3,16010
621,2019-08-29,65,13573,1004,0,14642
621,2019-08-30,31,3716,903,0,4650
621,2019-08-31,15,8318,0,0,8333
621,2019-09-01,247,3606,211,0,4064
621,2019-09-02,26,523,35,0,584
621,2019-09-03,66,1081,1580,0,2727
621,2019-09-04,96,11406,1674,1,13177
621,2019-09-05,107,7306,1222,2,8637
621,2019-09-06,120,10925,2292,1,13338
621,2019-09-07,222,14012,1600,0,15834
621,2019-09-08,1039,6539,2253,0,9831
621,2019-09-09,219,7938,2154,0,10311
621,2019-09-10,168,8305,2474,2,10949
621,2019-09-11,984,7146,2177,1,10308
621,2019-09-12,66,8876,2399,2,11343
621,2019-09-13,67,7150,2348,1,9566
621,2019-09-14,904,8461,2094,2,11461
621,2019-09-15,922,9116,2903,0,12941
621,2019-09-16,934,7475,2409,0,10818
621,2019-09-17,163,10670,1414,0,12247
621,2019-09-18,914,12601,1034,0,14549
621,2019-09-19,233,13498,2430,0,16161
621,2019-09-20,172,16997,1910,1,19080
621,2019-09-21,87,8198,1801,4,10090
621,2019-09-22,98,7847,2323,0,10268
621,2019-09-23,150,12617,2565,0,15332
621,2019-09-24,88,39064,1533,0,40685
621,2019-09-25,1060,17648,2050,1,20759
621,2019-09-26,137,11929,2303,5,14374
621,2019-09-27,1115,9393,1986,1,12495
621,2019-09-28,155,16108,1892,2,18157
621,2019-09-29,1080,18628,1981,1,21690
621,2019-09-30,1022,16561,1508,1,19092
621,2019-10-01,1981,22402,1558,2,25943
621,2019-10-02,1047,16200,2212,1,19460
621,2019-10-03,84,33693,1321,0,35098
621,2019-10-04,821,17280,1534,2,19637
621,2019-10-05,930,16977,1584,1,19492
621,2019-10-06,1233,12290,1658,3,15184
621,2019-10-07,97,9328,1625,2,11052
621,2019-10-08,101,13271,1245,1,14618
621,2019-10-09,71,34226,1060,3,35360
621,2019-10-10,2640,46358,1722,1,50721
621,2019-10-11,68,18429,995,5,19497
621,2019-10-12,169,5879,2031,0,8079
621,2019-10-13,86,9554,1441,2,11083
621,2019-10-14,70,8572,1730,1,10373
621,2019-10-15,724,9875,2137,17,12753
621,2019-10-16,744,13516,1555,3,15818
621,2019-10-17,1875,6316,1194,1,9386
621,2019-10-18,73,9638,1754,1,11466
621,2019-10-19,88,6574,1292,1,7955
621,2019-10-20,1818,5209,1613,2,8642
621,2019-10-21,188,12054,1804,5,14051
621,2019-10-22,986,8836,1483,0,11305
621,2019-10-23,59,9119,1753,4,10935
621,2019-10-24,201,20309,1110,0,21620
621,2019-10-25,742,19462,1350,4,21558
621,2019-10-26,87,25547,1885,0,27519
621,2019-10-27,105,18789,1861,3,20758
621,2019-10-28,84,20537,2080,1,22702
621,2019-10-29,110,19126,1995,0,21231
621,2019-10-30,557,16000,1285,1,17843
621,2019-10-31,616,20957,1221,2,22796
621,2019-11-01,46,27860,1145,0,29051
621,2019-11-02,1723,26962,1631,0,30316
621,2019-11-03,59,39511,1351,0,40921
621,2019-11-04,100,14270,1498,0,15868
621,2019-11-05,110,4272,2646,0,7028
621,2019-11-06,794,15197,2153,1,18145
621,2019-11-07,1186,16217,1906,2,19311
621,2019-11-08,67,9742,2403,0,12212
621,2019-11-09,69,9835,1928,1,11833
621,2019-11-10,1013,15292,1276,2,17583
621,2019-11-11,86,14534,1849,0,16469
621,2019-11-12,144,17990,3117,0,21251
621,2019-11-13,159,23236,2466,0,25861
621,2019-11-14,66,13409,1741,0,15216
621,2019-11-15,1027,4546,2048,0,7621
621,2019-11-16,1019,2955,2285,0,6259
621,2019-11-17,125,5211,3176,0,8512
621,2019-11-18,237,4482,3214,0,7933
621,2019-11-19,241,5709,2612,0,8562
621,2019-11-20,164,1968,1752,0,3884
621,2019-11-21,127,3925,2751,0,6803
621,2019-11-22,122,5219,1364,0,6705
621,2019-11-23,176,6781,2052,1,9010
621,2019-11-24,1180,7893,1905,1,10979
621,2019-11-25,486,10718,2587,1,13792
621,2019-11-26,146,9429,1451,1,11027
621,2019-11-27,108,7372,1682,1,9163
622,2019-08-01,73,14237,453,0,14763
622,2019-08-02,86,19664,515,0,20265
622,2019-08-03,80,6788,439,0,7307
622,2019-08-04,112,1312,276,2,1702
622,2019-08-05,81,1454,371,1,1907
622,2019-08-06,63,1778,730,2,2573
622,2019-08-07,113,2110,704,38,2965
622,2019-08-08,127,1737,235,2,2101
622,2019-08-09,71,1768,460,1,2300
622,2019-08-10,76,2234,551,0,2861
622,2019-08-11,176,1927,58,0,2161
622,2019-08-12,186,1969,28,0,2183
622,2019-08-13,90,4077,380,1,4548
622,2019-08-14,75,6480,144,0,6699
622,2019-08-15,50,1774,12,2,1838
622,2019-08-16,77,3117,212,0,3406
622,2019-08-17,892,3717,470,1,5080
622,2019-08-18,96,2978,1212,3,4289
622,2019-08-19,961,4630,1351,0,6942
622,2019-08-20,119,12663,1738,0,14520
622,2019-08-21,84,4238,1563,1,5886
622,2019-08-22,99,4085,569,0,4753
622,2019-08-23,334,6160,1267,3,7764
622,2019-08-24,936,3325,1560,0,5821
622,2019-08-25,123,16952,2309,0,19384
622,2019-08-26,113,26320,1931,3,28367
622,2019-08-27,114,14130,2324,2,16570
622,2019-08-28,110,13377,1350,1,14838
622,2019-08-29,123,13631,1875,0,15629
622,2019-08-30,62,10960,655,3,11680
622,2019-08-31,28,2061,3,1,2093
622,2019-09-01,384,997,326,1,1708
622,2019-09-02,49,1871,40,1,1961
622,2019-09-03,118,1978,1078,1,3175
622,2019-09-04,95,14355,1348,1,15799
622,2019-09-05,106,10708,1936,0,12750
622,2019-09-06,166,10004,1636,0,11806
622,2019-09-07,215,41209,2230,1,43655
622,2019-09-08,1058,21979,1901,1,24939
622,2019-09-09,966,8278,2034,2,11280
622,2019-09-10,1487,17160,1928,15,20590
622,2019-09-11,145,44027,1844,4,46020
622,2019-09-12,96,34370,2188,2,36656
622,2019-09-13,1072,3949,2344,5,7370
622,2019-09-14,167,7993,2180,2,10342
622,2019-09-15,219,8912,1943,0,11074
622,2019-09-16,167,8255,1377,4,9803
622,2019-09-17,70,37442,2186,7,39705
622,2019-09-18,1023,21040,2041,9,24113
622,2019-09-19,1047,12719,1425,9,15200
622,2019-09-20,196,13584,1984,9,15773
622,2019-09-21,88,5646,1660,9,7403
622,2019-09-22,130,8286,1680,9,10105
622,2019-09-23,193,16973,1980,12,19158
622,2019-09-24,1013,14571,2255,10,17849
622,2019-09-25,235,8648,2031,13,10927
622,2019-09-26,101,10874,1719,12,12706
622,2019-09-27,993,10654,1804,4,13455
622,2019-09-28,165,16980,2244,1,19390
622,2019-09-29,382,17644,2182,1,20209
622,2019-09-30,87,16501,2837,0,19425
622,2019-10-01,680,18864,1922,3,21469
622,2019-10-02,1726,18825,1659,7,22217
622,2019-10-03,697,15803,1495,12,18007
622,2019-10-04,116,14464,1128,20,15728
622,2019-10-05,1364,15107,2335,10,18816
622,2019-10-06,170,12294,1335,10,13809
622,2019-10-07,211,9641,1927,15,11794
622,2019-10-08,118,12271,1848,11,14248
622,2019-10-09,401,27211,969,9,28590
622,2019-10-10,562,43538,2946,10,47056
622,2019-10-11,147,18252,1227,10,19636
622,2019-10-12,605,5600,1413,5,7623
622,2019-10-13,118,9128,1615,14,10875
622,2019-10-14,200,6463,2009,17,8689
622,2019-10-15,274,8864,1570,1,10709
622,2019-10-16,1070,12977,1077,3,15127
622,2019-10-17,89,5856,1960,2,7907
622,2019-10-18,1119,8937,1166,0,11222
622,2019-10-19,2505,30769,1590,0,34864
622,2019-10-20,89,11734,1483,0,13306
622,2019-10-21,2037,12035,1263,1,15336
622,2019-10-22,130,7466,2079,3,9678
622,2019-10-23,1750,15094,1584,2,18430
622,2019-10-24,254,26056,1503,11,27824
622,2019-10-25,142,14557,1509,17,16225
622,2019-10-26,118,23219,1115,0,24452
622,2019-10-27,326,19277,1191,1,20795
622,2019-10-28,68,24143,1786,1,25998
622,2019-10-29,974,23218,1656,0,25848
622,2019-10-30,456,20817,1300,0,22573
622,2019-10-31,473,23379,1154,1,25007
622,2019-11-01,1012,28287,1438,2,30739
622,2019-11-02,82,18051,1992,1,20126
622,2019-11-03,83,23518,1237,0,24838
622,2019-11-04,1855,8758,1703,0,12316
622,2019-11-05,124,4315,1781,0,6220
622,2019-11-06,381,15023,1594,4,17002
622,2019-11-07,172,17159,1095,506,18932
622,2019-11-08,161,10803,1480,1,12445
622,2019-11-09,651,9903,2460,0,13014
622,2019-11-10,232,15411,2176,0,17819
622,2019-11-11,197,10208,1066,11,11482
622,2019-11-12,676,10915,2794,1,14386
622,2019-11-13,123,13113,2038,1,15275
622,2019-11-14,507,14699,1844,1,17051
622,2019-11-15,1043,5665,2182,1,8891
622,2019-11-16,1000,3655,2695,1,7351
622,2019-11-17,201,4122,3896,0,8219
622,2019-11-18,119,2870,3227,0,6216
622,2019-11-19,166,3607,2876,0,6649
622,2019-11-20,150,1885,2046,0,4081
622,2019-11-21,209,3773,1400,0,5382
622,2019-11-22,136,5054,2159,0,7349
622,2019-11-23,111,7427,1745,0,9283
622,2019-11-24,306,6766,2186,0,9258
622,2019-11-25,1042,10950,2381,0,14373
622,2019-11-26,88,11184,1523,0,12795
622,2019-11-27,45,7904,1562,0,9511
622,2019-11-28,39,11263,727,0,12029
622,2019-11-29,11,1387,8,0,1406
622,2019-08-01,73,14237,453,0,14763
622,2019-08-02,86,19664,515,0,20265
622,2019-08-03,80,6788,439,0,7307
622,2019-08-04,112,1312,276,2,1702
622,2019-08-05,81,1454,371,1,1907
622,2019-08-06,63,1778,730,2,2573
622,2019-08-07,113,2110,704,38,2965
622,2019-08-08,127,1737,235,2,2101
622,2019-08-09,71,1768,460,1,2300
622,2019-08-10,76,2234,551,0,2861
622,2019-08-11,176,1927,58,0,2161
622,2019-08-12,186,1969,28,0,2183
622,2019-08-13,90,4077,380,1,4548
622,2019-08-14,75,6480,144,0,6699
622,2019-08-15,50,1774,12,2,1838
622,2019-08-16,77,3117,212,0,3406
622,2019-08-17,892,3717,470,1,5080
622,2019-08-18,96,2978,1212,3,4289
622,2019-08-19,961,4630,1351,0,6942
622,2019-08-20,119,12663,1738,0,14520
622,2019-08-21,84,4238,1563,1,5886
622,2019-08-22,99,4085,569,0,4753
622,2019-08-23,334,6160,1267,3,7764
622,2019-08-24,936,3325,1560,0,5821
622,2019-08-25,123,16952,2309,0,19384
622,2019-08-26,113,26320,1931,3,28367
622,2019-08-27,114,14130,2324,2,16570
622,2019-08-28,110,13377,1350,1,14838
622,2019-08-29,123,13631,1875,0,15629
622,2019-08-30,62,10960,655,3,11680
622,2019-08-31,28,2061,3,1,2093
622,2019-09-01,384,997,326,1,1708
622,2019-09-02,49,1871,40,1,1961
622,2019-09-03,118,1978,1078,1,3175
622,2019-09-04,95,14355,1348,1,15799
622,2019-09-05,106,10708,1936,0,12750
622,2019-09-06,166,10004,1636,0,11806
622,2019-09-07,215,41209,2230,1,43655
622,2019-09-08,1058,21979,1901,1,24939
622,2019-09-09,966,8278,2034,2,11280
622,2019-09-10,1487,17160,1928,15,20590
622,2019-09-11,145,44027,1844,4,46020
622,2019-09-12,96,34370,2188,2,36656
622,2019-09-13,1072,3949,2344,5,7370
622,2019-09-14,167,7993,2180,2,10342
622,2019-09-15,219,8912,1943,0,11074
622,2019-09-16,167,8255,1377,4,9803
622,2019-09-17,70,37442,2186,7,39705
622,2019-09-18,1023,21040,2041,9,24113
622,2019-09-19,1047,12719,1425,9,15200
622,2019-09-20,196,13584,1984,9,15773
622,2019-09-21,88,5646,1660,9,7403
622,2019-09-22,130,8286,1680,9,10105
622,2019-09-23,193,16973,1980,12,19158
622,2019-09-24,1013,14571,2255,10,17849
622,2019-09-25,235,8648,2031,13,10927
622,2019-09-26,101,10874,1719,12,12706
622,2019-09-27,993,10654,1804,4,13455
622,2019-09-28,165,16980,2244,1,19390
622,2019-09-29,382,17644,2182,1,20209
622,2019-09-30,87,16501,2837,0,19425
622,2019-10-01,680,18864,1922,3,21469
622,2019-10-02,1726,18825,1659,7,22217
622,2019-10-03,697,15803,1495,12,18007
622,2019-10-04,116,14464,1128,20,15728
622,2019-10-05,1364,15107,2335,10,18816
622,2019-10-06,170,12294,1335,10,13809
622,2019-10-07,211,9641,1927,15,11794
622,2019-10-08,118,12271,1848,11,14248
622,2019-10-09,401,27211,969,9,28590
622,2019-10-10,562,43538,2946,10,47056
622,2019-10-11,147,18252,1227,10,19636
622,2019-10-12,605,5600,1413,5,7623
622,2019-10-13,118,9128,1615,14,10875
622,2019-10-14,200,6463,2009,17,8689
622,2019-10-15,274,8864,1570,1,10709
622,2019-10-16,1070,12977,1077,3,15127
622,2019-10-17,89,5856,1960,2,7907
622,2019-10-18,1119,8937,1166,0,11222
622,2019-10-19,2505,30769,1590,0,34864
622,2019-10-20,89,11734,1483,0,13306
622,2019-10-21,2037,12035,1263,1,15336
622,2019-10-22,130,7466,2079,3,9678
622,2019-10-23,1750,15094,1584,2,18430
622,2019-10-24,254,26056,1503,11,27824
622,2019-10-25,142,14557,1509,17,16225
622,2019-10-26,118,23219,1115,0,24452
622,2019-10-27,326,19277,1191,1,20795
622,2019-10-28,68,24143,1786,1,25998
622,2019-10-29,974,23218,1656,0,25848
622,2019-10-30,456,20817,1300,0,22573
622,2019-10-31,473,23379,1154,1,25007
622,2019-11-01,1012,28287,1438,2,30739
622,2019-11-02,82,18051,1992,1,20126
622,2019-11-03,83,23518,1237,0,24838
622,2019-11-04,1855,8758,1703,0,12316
622,2019-11-05,124,4315,1781,0,6220
622,2019-11-06,381,15023,1594,4,17002
622,2019-11-07,172,17159,1095,506,18932
622,2019-11-08,161,10803,1480,1,12445
622,2019-11-09,651,9903,2460,0,13014
622,2019-11-10,232,15411,2176,0,17819
622,2019-11-11,197,10208,1066,11,11482
622,2019-11-12,676,10915,2794,1,14386
622,2019-11-13,123,13113,2038,1,15275
622,2019-11-14,507,14699,1844,1,17051
622,2019-11-15,1043,5665,2182,1,8891
622,2019-11-16,1000,3655,2695,1,7351
622,2019-11-17,201,4122,3896,0,8219
622,2019-11-18,119,2870,3227,0,6216
622,2019-11-19,166,3607,2876,0,6649
622,2019-11-20,150,1885,2046,0,4081
622,2019-11-21,209,3773,1400,0,5382
622,2019-11-22,136,5054,2159,0,7349
622,2019-11-23,111,7427,1745,0,9283
622,2019-11-24,306,6766,2186,0,9258
622,2019-11-25,1042,10950,2381,0,14373
622,2019-11-26,88,11184,1523,0,12795
622,2019-11-27,45,7904,1562,0,9511
622,2019-11-28,39,11263,727,0,12029
622,2019-11-29,11,1387,8,0,1406
622,2019-08-01,73,14237,453,0,14763
622,2019-08-02,86,19664,515,0,20265
622,2019-08-03,80,6788,439,0,7307
622,2019-08-04,112,1312,276,2,1702
622,2019-08-05,81,1454,371,1,1907
622,2019-08-06,63,1778,730,2,2573
622,2019-08-07,113,2110,704,38,2965
622,2019-08-08,127,1737,235,2,2101
622,2019-08-09,71,1768,460,1,2300
622,2019-08-10,76,2234,551,0,2861
622,2019-08-11,176,1927,58,0,2161
622,2019-08-12,186,1969,28,0,2183
622,2019-08-13,90,4077,380,1,4548
622,2019-08-14,75,6480,144,0,6699
622,2019-08-15,50,1774,12,2,1838
622,2019-08-16,77,3117,212,0,3406
622,2019-08-17,892,3717,470,1,5080
622,2019-08-18,96,2978,1212,3,4289
622,2019-08-19,961,4630,1351,0,6942
622,2019-08-20,119,12663,1738,0,14520
622,2019-08-21,84,4238,1563,1,5886
622,2019-08-22,99,4085,569,0,4753
622,2019-08-23,334,6160,1267,3,7764
622,2019-08-24,936,3325,1560,0,5821
622,2019-08-25,123,16952,2309,0,19384
622,2019-08-26,113,26320,1931,3,28367
622,2019-08-27,114,14130,2324,2,16570
622,2019-08-28,110,13377,1350,1,14838
622,2019-08-29,123,13631,1875,0,15629
622,2019-08-30,62,10960,655,3,11680
622,2019-08-31,28,2061,3,1,2093
622,2019-09-01,384,997,326,1,1708
622,2019-09-02,49,1871,40,1,1961
622,2019-09-03,118,1978,1078,1,3175
622,2019-09-04,95,14355,1348,1,15799
622,2019-09-05,106,10708,1936,0,12750
622,2019-09-06,166,10004,1636,0,11806
622,2019-09-07,215,41209,2230,1,43655
622,2019-09-08,1058,21979,1901,1,24939
622,2019-09-09,966,8278,2034,2,11280
622,2019-09-10,1487,17160,1928,15,20590
622,2019-09-11,145,44027,1844,4,46020
622,2019-09-12,96,34370,2188,2,36656
622,2019-09-13,1072,3949,2344,5,7370
622,2019-09-14,167,7993,2180,2,10342
622,2019-09-15,219,8912,1943,0,11074
622,2019-09-16,167,8255,1377,4,9803
622,2019-09-17,70,37442,2186,7,39705
622,2019-09-18,1023,21040,2041,9,24113
622,2019-09-19,1047,12719,1425,9,15200
622,2019-09-20,196,13584,1984,9,15773
622,2019-09-21,88,5646,1660,9,7403
622,2019-09-22,130,8286,1680,9,10105
622,2019-09-23,193,16973,1980,12,19158
622,2019-09-24,1013,14571,2255,10,17849
622,2019-09-25,235,8648,2031,13,10927
622,2019-09-26,101,10874,1719,12,12706
622,2019-09-27,993,10654,1804,4,13455
622,2019-09-28,165,16980,2244,1,19390
622,2019-09-29,382,17644,2182,1,20209
622,2019-09-30,87,16501,2837,0,19425
622,2019-10-01,680,18864,1922,3,21469
622,2019-10-02,1726,18825,1659,7,22217
622,2019-10-03,697,15803,1495,12,18007
622,2019-10-04,116,14464,1128,20,15728
622,2019-10-05,1364,15107,2335,10,18816
622,2019-10-06,170,12294,1335,10,13809
622,2019-10-07,211,9641,1927,15,11794
622,2019-10-08,118,12271,1848,11,14248
622,2019-10-09,401,27211,969,9,28590
622,2019-10-10,562,43538,2946,10,47056
622,2019-10-11,147,18252,1227,10,19636
622,2019-10-12,605,5600,1413,5,7623
622,2019-10-13,118,9128,1615,14,10875
622,2019-10-14,200,6463,2009,17,8689
622,2019-10-15,274,8864,1570,1,10709
622,2019-10-16,1070,12977,1077,3,15127
622,2019-10-17,89,5856,1960,2,7907
622,2019-10-18,1119,8937,1166,0,11222
622,2019-10-19,2505,30769,1590,0,34864
622,2019-10-20,89,11734,1483,0,13306
622,2019-10-21,2037,12035,1263,1,15336
622,2019-10-22,130,7466,2079,3,9678
622,2019-10-23,1750,15094,1584,2,18430
622,2019-10-24,254,26056,1503,11,27824
622,2019-10-25,142,14557,1509,17,16225
622,2019-10-26,118,23219,1115,0,24452
622,2019-10-27,326,19277,1191,1,20795
622,2019-10-28,68,24143,1786,1,25998
622,2019-10-29,974,23218,1656,0,25848
622,2019-10-30,456,20817,1300,0,22573
622,2019-10-31,473,23379,1154,1,25007
622,2019-11-01,1012,28287,1438,2,30739
622,2019-11-02,82,18051,1992,1,20126
622,2019-11-03,83,23518,1237,0,24838
622,2019-11-04,1855,8758,1703,0,12316
622,2019-11-05,124,4315,1781,0,6220
622,2019-11-06,381,15023,1594,4,17002
622,2019-11-07,172,17159,1095,506,18932
622,2019-11-08,161,10803,1480,1,12445
622,2019-11-09,651,9903,2460,0,13014
622,2019-11-10,232,15411,2176,0,17819
622,2019-11-11,197,10208,1066,11,11482
622,2019-11-12,676,10915,2794,1,14386
622,2019-11-13,123,13113,2038,1,15275
622,2019-11-14,507,14699,1844,1,17051
622,2019-11-15,1043,5665,2182,1,8891
622,2019-11-16,1000,3655,2695,1,7351
622,2019-11-17,201,4122,3896,0,8219
622,2019-11-18,119,2870,3227,0,6216
622,2019-11-19,166,3607,2876,0,6649
622,2019-11-20,150,1885,2046,0,4081
622,2019-11-21,209,3773,1400,0,5382
622,2019-11-22,136,5054,2159,0,7349
622,2019-11-23,111,7427,1745,0,9283
622,2019-11-24,306,6766,2186,0,9258
622,2019-11-25,1042,10950,2381,0,14373
622,2019-11-26,88,11184,1523,0,12795
622,2019-11-27,45,7904,1562,0,9511
622,2019-11-28,39,11263,727,0,12029
622,2019-11-29,11,1387,8,0,1406
622,2019-08-04,112,1312,276,2,1702
622,2019-08-05,81,1454,371,1,1907
622,2019-08-06,63,1778,730,2,2573
622,2019-08-07,113,2110,704,38,2965
622,2019-08-08,127,1737,235,2,2101
622,2019-08-09,71,1768,460,1,2300
622,2019-08-10,76,2234,551,0,2861
622,2019-08-11,176,1927,58,0,2161
622,2019-08-12,186,1969,28,0,2183
622,2019-08-13,90,4077,380,1,4548
622,2019-08-14,75,6480,144,0,6699
622,2019-08-15,50,1774,12,2,1838
622,2019-08-16,77,3117,212,0,3406
622,2019-08-17,892,3717,470,1,5080
622,2019-08-18,96,2978,1212,3,4289
622,2019-08-19,961,4630,1351,0,6942
622,2019-08-20,119,12663,1738,0,14520
622,2019-08-21,84,4238,1563,1,5886
622,2019-08-22,99,4085,569,0,4753
622,2019-08-23,334,6160,1267,3,7764
622,2019-08-24,936,3325,1560,0,5821
622,2019-08-25,123,16952,2309,0,19384
622,2019-08-26,113,26320,1931,3,28367
622,2019-08-27,114,14130,2324,2,16570
622,2019-08-28,110,13377,1350,1,14838
622,2019-08-29,123,13631,1875,0,15629
622,2019-08-30,62,10960,655,3,11680
622,2019-08-31,28,2061,3,1,2093
622,2019-09-01,384,997,326,1,1708
622,2019-09-02,49,1871,40,1,1961
622,2019-09-03,118,1978,1078,1,3175
622,2019-09-04,95,14355,1348,1,15799
622,2019-09-05,106,10708,1936,0,12750
622,2019-09-06,166,10004,1636,0,11806
622,2019-09-07,215,41209,2230,1,43655
622,2019-09-08,1058,21979,1901,1,24939
622,2019-09-09,966,8278,2034,2,11280
622,2019-09-10,1487,17160,1928,15,20590
622,2019-09-11,145,44027,1844,4,46020
622,2019-09-12,96,34370,2188,2,36656
622,2019-09-13,1072,3949,2344,5,7370
622,2019-09-14,167,7993,2180,2,10342
622,2019-09-15,219,8912,1943,0,11074
622,2019-09-16,167,8255,1377,4,9803
622,2019-09-17,70,37442,2186,7,39705
622,2019-09-18,1023,21040,2041,9,24113
622,2019-09-19,1047,12719,1425,9,15200
622,2019-09-20,196,13584,1984,9,15773
622,2019-09-21,88,5646,1660,9,7403
622,2019-09-22,130,8286,1680,9,10105
622,2019-09-23,193,16973,1980,12,19158
622,2019-09-24,1013,14571,2255,10,17849
622,2019-09-25,235,8648,2031,13,10927
622,2019-09-26,101,10874,1719,12,12706
622,2019-09-27,993,10654,1804,4,13455
622,2019-09-28,165,16980,2244,1,19390
622,2019-09-29,382,17644,2182,1,20209
622,2019-09-30,87,16501,2837,0,19425
622,2019-10-01,680,18864,1922,3,21469
622,2019-10-02,1726,18825,1659,7,22217
622,2019-10-03,697,15803,1495,12,18007
622,2019-10-04,116,14464,1128,20,15728
622,2019-10-05,1364,15107,2335,10,18816
622,2019-10-06,170,12294,1335,10,13809
622,2019-10-07,211,9641,1927,15,11794
622,2019-10-08,118,12271,1848,11,14248
622,2019-10-09,401,27211,969,9,28590
622,2019-10-10,562,43538,2946,10,47056
622,2019-10-11,147,18252,1227,10,19636
622,2019-10-12,605,5600,1413,5,7623
622,2019-10-13,118,9128,1615,14,10875
622,2019-10-14,200,6463,2009,17,8689
622,2019-10-15,274,8864,1570,1,10709
622,2019-10-16,1070,12977,1077,3,15127
622,2019-10-17,89,5856,1960,2,7907
622,2019-10-18,1119,8937,1166,0,11222
622,2019-10-19,2505,30769,1590,0,34864
622,2019-10-20,89,11734,1483,0,13306
622,2019-10-21,2037,12035,1263,1,15336
622,2019-10-22,130,7466,2079,3,9678
622,2019-10-23,1750,15094,1584,2,18430
622,2019-10-24,254,26056,1503,11,27824
622,2019-10-25,142,14557,1509,17,16225
622,2019-10-26,118,23219,1115,0,24452
622,2019-10-27,326,19277,1191,1,20795
622,2019-10-28,68,24143,1786,1,25998
622,2019-10-29,974,23218,1656,0,25848
622,2019-10-30,456,20817,1300,0,22573
622,2019-10-31,473,23379,1154,1,25007
622,2019-11-01,1012,28287,1438,2,30739
622,2019-11-02,82,18051,1992,1,20126
622,2019-11-03,83,23518,1237,0,24838
622,2019-11-04,1855,8758,1703,0,12316
622,2019-11-05,124,4315,1781,0,6220
622,2019-11-06,381,15023,1594,4,17002
622,2019-11-07,172,17159,1095,506,18932
622,2019-11-08,161,10803,1480,1,12445
622,2019-11-09,651,9903,2460,0,13014
622,2019-11-10,232,15411,2176,0,17819
622,2019-11-11,197,10208,1066,11,11482
622,2019-11-12,676,10915,2794,1,14386
622,2019-11-13,123,13113,2038,1,15275
622,2019-11-14,507,14699,1844,1,17051
622,2019-11-15,1043,5665,2182,1,8891
622,2019-11-16,1000,3655,2695,1,7351
623,2019-08-01,2418,32512,103,2,35035
623,2019-08-02,9140,34713,405,0,44258
623,2019-08-03,6731,9275,284,1,16291
623,2019-08-04,351,993,378,1,1723
623,2019-08-05,116,1235,456,1,1808
623,2019-08-06,4198,5072,439,1,9710
623,2019-08-07,7929,3573,769,1,12272
623,2019-08-08,85,1413,456,0,1954
623,2019-08-09,332,2068,350,0,2750
623,2019-08-10,74,1519,124,0,1717
623,2019-08-11,53,1678,35,0,1766
623,2019-08-12,268,1834,216,1,2319
623,2019-08-13,1362,5568,76,0,7006
623,2019-08-14,67,1359,178,0,1604
623,2019-08-15,185,1541,91,0,1817
623,2019-08-16,727,4310,158,0,5195
623,2019-08-17,163,3470,983,0,4616
623,2019-08-18,7427,3303,1564,1,12295
623,2019-08-19,70,2613,1238,0,3921
623,2019-08-20,96,2508,1103,0,3707
623,2019-08-21,296,2146,1441,1,3884
623,2019-08-22,407,13692,1334,1,15434
623,2019-08-23,179,5932,1491,2,7604
623,2019-08-24,937,4319,1688,0,6944
623,2019-08-25,239,7745,1737,1,9722
623,2019-08-26,257,2304,1440,0,4001
623,2019-08-27,102,8650,1619,2,10373
623,2019-08-28,77,5089,1381,3,6550
623,2019-08-29,1529,10688,1599,0,13816
623,2019-08-30,66,5883,819,2,6770
623,2019-08-31,25,410,8,1,444
623,2019-09-01,317,799,292,0,1408
623,2019-09-02,32,576,0,0,608
623,2019-09-03,957,4389,1432,0,6778
623,2019-09-04,929,16699,2131,2,19761
623,2019-09-05,963,12052,2048,0,15063
623,2019-09-06,936,12151,2526,0,15613
623,2019-09-07,207,16283,2585,1,19076
623,2019-09-08,219,5639,2413,33,8304
623,2019-09-09,224,10224,2399,15,12862
623,2019-09-10,153,12768,2151,0,15072
623,2019-09-11,170,9178,1783,3,11134
623,2019-09-12,75,7491,2555,3,10124
623,2019-09-13,939,4907,1820,1,7667
623,2019-09-14,165,8227,1620,1,10013
623,2019-09-15,1302,12428,1502,0,15232
623,2019-09-16,82,13857,2413,1,16353
623,2019-09-17,90,11602,1330,0,13022
623,2019-09-18,70,6589,0,0,6659
623,2019-09-19,175,4807,1852,1,6835
623,2019-09-20,189,13358,1215,0,14762
623,2019-09-21,88,16736,2227,0,19051
623,2019-09-22,80,10129,1397,1,11607
623,2019-09-23,959,10124,1840,1,12924
623,2019-09-24,134,9288,2038,3,11463
623,2019-09-25,281,11592,1771,2,13646
623,2019-09-26,157,11592,1918,2,13669
623,2019-09-27,123,12037,1162,4,13326
623,2019-09-28,115,16030,1652,2,17799
623,2019-09-29,131,17394,1671,6,19202
623,2019-09-30,80,19268,1473,2,20823
623,2019-10-01,2092,18030,1145,0,21267
623,2019-10-02,169,12766,1614,1,14550
623,2019-10-03,673,14458,1281,0,16412
623,2019-10-04,390,15667,633,1,16691
623,2019-10-05,855,16137,1659,2,18653
623,2019-10-06,1674,12003,1453,0,15130
623,2019-10-07,979,8637,1704,2,11322
623,2019-10-08,1347,12502,2012,1,15862
623,2019-10-09,948,15828,1341,2,18119
623,2019-10-10,1038,13045,2179,0,16262
623,2019-10-11,130,9714,1463,3,11310
623,2019-10-12,85,5913,1607,2,7607
623,2019-10-13,719,10361,1583,1,12664
623,2019-10-14,979,9196,1532,1,11708
623,2019-10-15,1066,9047,1200,2,11315
623,2019-10-16,216,18728,1618,1,20563
623,2019-10-17,94,8919,1263,3,10279
623,2019-10-18,977,9254,1262,0,11493
623,2019-10-19,677,6007,2050,10,8744
623,2019-10-20,1060,3640,1879,1,6580
623,2019-10-21,1181,11367,1929,2,14479
623,2019-10-22,91,7051,1710,1,8853
623,2019-10-23,45,9430,1623,0,11098
623,2019-10-24,1509,21658,1436,4,24607
623,2019-10-25,215,21401,1710,2,23328
623,2019-10-26,597,26133,2827,0,29557
623,2019-10-27,113,30642,2582,2,33339
623,2019-10-28,999,26843,2505,20,30367
623,2019-10-29,1707,17800,1987,6,21500
623,2019-10-30,105,16209,1308,1,17623
623,2019-10-31,112,21152,1334,1,22599
623,2019-11-01,1436,27272,1986,2,30696
623,2019-11-02,1406,26446,2061,1,29914
623,2019-11-03,109,24902,1509,0,26520
623,2019-11-04,92,11461,2067,1,13621
623,2019-11-05,147,4020,2812,0,6979
623,2019-11-06,232,9566,1671,1,11470
623,2019-11-07,161,14029,2326,3,16519
623,2019-11-08,503,10868,1473,0,12844
623,2019-11-09,1073,18394,1639,0,21106
623,2019-11-10,714,16798,1182,0,18694
623,2019-11-11,116,14312,1306,4,15738
623,2019-11-12,114,14953,2873,1,17941
623,2019-11-13,183,22842,2026,1,25052
623,2019-11-14,109,15943,1547,0,17599
623,2019-11-15,134,5835,2203,1,8173
623,2019-11-16,223,3060,2845,1,6129
623,2019-11-17,233,3912,3256,0,7401
623,2019-11-18,1024,3858,3907,1,8790
623,2019-11-19,1041,5813,2413,2,9269
623,2019-11-20,410,1609,1767,0,3786
623,2019-11-21,107,6197,1601,5,7910
623,2019-11-22,633,8701,2296,2,11632
623,2019-11-23,103,8757,2311,1,11172
623,2019-11-24,1370,5312,2049,0,8731
623,2019-11-25,820,7134,2250,0,10204
623,2019-11-26,344,10471,1438,2,12255
623,2019-11-27,515,9540,1265,1,11321
623,2019-11-28,42,7788,408,0,8238
623,2019-11-29,5,6,2,0,13
623,2019-08-01,2418,32512,103,2,35035
623,2019-08-02,9140,34713,405,0,44258
623,2019-08-03,6731,9275,284,1,16291
623,2019-08-04,351,993,378,1,1723
623,2019-08-05,116,1235,456,1,1808
623,2019-08-06,4198,5072,439,1,9710
623,2019-08-07,7929,3573,769,1,12272
623,2019-08-08,85,1413,456,0,1954
623,2019-08-09,332,2068,350,0,2750
623,2019-08-10,74,1519,124,0,1717
623,2019-08-11,53,1678,35,0,1766
623,2019-08-12,268,1834,216,1,2319
623,2019-08-13,1362,5568,76,0,7006
623,2019-08-14,67,1359,178,0,1604
623,2019-08-15,185,1541,91,0,1817
623,2019-08-16,727,4310,158,0,5195
623,2019-08-17,163,3470,983,0,4616
623,2019-08-18,7427,3303,1564,1,12295
623,2019-08-19,70,2613,1238,0,3921
623,2019-08-20,96,2508,1103,0,3707
623,2019-08-21,296,2146,1441,1,3884
623,2019-08-22,407,13692,1334,1,15434
623,2019-08-23,179,5932,1491,2,7604
623,2019-08-24,937,4319,1688,0,6944
623,2019-08-25,239,7745,1737,1,9722
623,2019-08-26,257,2304,1440,0,4001
623,2019-08-27,102,8650,1619,2,10373
623,2019-08-28,77,5089,1381,3,6550
623,2019-08-29,1529,10688,1599,0,13816
623,2019-08-30,66,5883,819,2,6770
623,2019-08-31,25,410,8,1,444
623,2019-09-01,317,799,292,0,1408
623,2019-09-02,32,576,0,0,608
623,2019-09-03,957,4389,1432,0,6778
623,2019-09-04,929,16699,2131,2,19761
623,2019-09-05,963,12052,2048,0,15063
623,2019-09-06,936,12151,2526,0,15613
623,2019-09-07,207,16283,2585,1,19076
623,2019-09-08,219,5639,2413,33,8304
623,2019-09-09,224,10224,2399,15,12862
623,2019-09-10,153,12768,2151,0,15072
623,2019-09-11,170,9178,1783,3,11134
623,2019-09-12,75,7491,2555,3,10124
623,2019-09-13,939,4907,1820,1,7667
623,2019-09-14,165,8227,1620,1,10013
623,2019-09-15,1302,12428,1502,0,15232
623,2019-09-16,82,13857,2413,1,16353
623,2019-09-17,90,11602,1330,0,13022
623,2019-09-18,70,6589,0,0,6659
623,2019-09-19,175,4807,1852,1,6835
623,2019-09-20,189,13358,1215,0,14762
623,2019-09-21,88,16736,2227,0,19051
623,2019-09-22,80,10129,1397,1,11607
623,2019-09-23,959,10124,1840,1,12924
623,2019-09-24,134,9288,2038,3,11463
623,2019-09-25,281,11592,1771,2,13646
623,2019-09-26,157,11592,1918,2,13669
623,2019-09-27,123,12037,1162,4,13326
623,2019-09-28,115,16030,1652,2,17799
623,2019-09-29,131,17394,1671,6,19202
623,2019-09-30,80,19268,1473,2,20823
623,2019-10-01,2092,18030,1145,0,21267
623,2019-10-02,169,12766,1614,1,14550
623,2019-10-03,673,14458,1281,0,16412
623,2019-10-04,390,15667,633,1,16691
623,2019-10-05,855,16137,1659,2,18653
623,2019-10-06,1674,12003,1453,0,15130
623,2019-10-07,979,8637,1704,2,11322
623,2019-10-08,1347,12502,2012,1,15862
623,2019-10-09,948,15828,1341,2,18119
623,2019-10-10,1038,13045,2179,0,16262
623,2019-10-11,130,9714,1463,3,11310
623,2019-10-12,85,5913,1607,2,7607
623,2019-10-13,719,10361,1583,1,12664
623,2019-10-14,979,9196,1532,1,11708
623,2019-10-15,1066,9047,1200,2,11315
623,2019-10-16,216,18728,1618,1,20563
623,2019-10-17,94,8919,1263,3,10279
623,2019-10-18,977,9254,1262,0,11493
623,2019-10-19,677,6007,2050,10,8744
623,2019-10-20,1060,3640,1879,1,6580
623,2019-10-21,1181,11367,1929,2,14479
623,2019-10-22,91,7051,1710,1,8853
623,2019-10-23,45,9430,1623,0,11098
623,2019-10-24,1509,21658,1436,4,24607
623,2019-10-25,215,21401,1710,2,23328
623,2019-10-26,597,26133,2827,0,29557
623,2019-10-27,113,30642,2582,2,33339
623,2019-10-28,999,26843,2505,20,30367
623,2019-10-29,1707,17800,1987,6,21500
623,2019-10-30,105,16209,1308,1,17623
623,2019-10-31,112,21152,1334,1,22599
623,2019-11-01,1436,27272,1986,2,30696
623,2019-11-02,1406,26446,2061,1,29914
623,2019-11-03,109,24902,1509,0,26520
623,2019-11-04,92,11461,2067,1,13621
623,2019-11-05,147,4020,2812,0,6979
623,2019-11-06,232,9566,1671,1,11470
623,2019-11-07,161,14029,2326,3,16519
623,2019-11-08,503,10868,1473,0,12844
623,2019-11-09,1073,18394,1639,0,21106
623,2019-11-10,714,16798,1182,0,18694
623,2019-11-11,116,14312,1306,4,15738
623,2019-11-12,114,14953,2873,1,17941
623,2019-11-13,183,22842,2026,1,25052
623,2019-11-14,109,15943,1547,0,17599
623,2019-11-15,134,5835,2203,1,8173
623,2019-11-16,223,3060,2845,1,6129
623,2019-11-17,233,3912,3256,0,7401
623,2019-11-18,1024,3858,3907,1,8790
623,2019-11-19,1041,5813,2413,2,9269
623,2019-11-20,410,1609,1767,0,3786
623,2019-11-21,107,6197,1601,5,7910
623,2019-11-22,633,8701,2296,2,11632
623,2019-11-23,103,8757,2311,1,11172
623,2019-11-24,1370,5312,2049,0,8731
623,2019-11-25,820,7134,2250,0,10204
623,2019-11-26,344,10471,1438,2,12255
623,2019-11-27,515,9540,1265,1,11321
623,2019-11-28,42,7788,408,0,8238
623,2019-11-29,5,6,2,0,13
623,2019-08-01,2418,32512,103,2,35035
623,2019-08-02,9140,34713,405,0,44258
623,2019-08-03,6731,9275,284,1,16291
623,2019-08-04,351,993,378,1,1723
623,2019-08-05,116,1235,456,1,1808
623,2019-08-06,4198,5072,439,1,9710
623,2019-08-07,7929,3573,769,1,12272
623,2019-08-08,85,1413,456,0,1954
623,2019-08-09,332,2068,350,0,2750
623,2019-08-10,74,1519,124,0,1717
623,2019-08-11,53,1678,35,0,1766
623,2019-08-12,268,1834,216,1,2319
623,2019-08-13,1362,5568,76,0,7006
623,2019-08-14,67,1359,178,0,1604
623,2019-08-15,185,1541,91,0,1817
623,2019-08-16,727,4310,158,0,5195
623,2019-08-17,163,3470,983,0,4616
623,2019-08-18,7427,3303,1564,1,12295
623,2019-08-19,70,2613,1238,0,3921
623,2019-08-20,96,2508,1103,0,3707
623,2019-08-21,296,2146,1441,1,3884
623,2019-08-22,407,13692,1334,1,15434
623,2019-08-23,179,5932,1491,2,7604
623,2019-08-24,937,4319,1688,0,6944
623,2019-08-25,239,7745,1737,1,9722
623,2019-08-26,257,2304,1440,0,4001
623,2019-08-27,102,8650,1619,2,10373
623,2019-08-28,77,5089,1381,3,6550
623,2019-08-29,1529,10688,1599,0,13816
623,2019-08-30,66,5883,819,2,6770
623,2019-08-31,25,410,8,1,444
623,2019-09-01,317,799,292,0,1408
623,2019-09-02,32,576,0,0,608
623,2019-09-03,957,4389,1432,0,6778
623,2019-09-04,929,16699,2131,2,19761
623,2019-09-05,963,12052,2048,0,15063
623,2019-09-06,936,12151,2526,0,15613
623,2019-09-07,207,16283,2585,1,19076
623,2019-09-08,219,5639,2413,33,8304
623,2019-09-09,224,10224,2399,15,12862
623,2019-09-10,153,12768,2151,0,15072
623,2019-09-11,170,9178,1783,3,11134
623,2019-09-12,75,7491,2555,3,10124
623,2019-09-13,939,4907,1820,1,7667
623,2019-09-14,165,8227,1620,1,10013
623,2019-09-15,1302,12428,1502,0,15232
623,2019-09-16,82,13857,2413,1,16353
623,2019-09-17,90,11602,1330,0,13022
623,2019-09-18,70,6589,0,0,6659
623,2019-09-19,175,4807,1852,1,6835
623,2019-09-20,189,13358,1215,0,14762
623,2019-09-21,88,16736,2227,0,19051
623,2019-09-22,80,10129,1397,1,11607
623,2019-09-23,959,10124,1840,1,12924
623,2019-09-24,134,9288,2038,3,11463
623,2019-09-25,281,11592,1771,2,13646
623,2019-09-26,157,11592,1918,2,13669
623,2019-09-27,123,12037,1162,4,13326
623,2019-09-28,115,16030,1652,2,17799
623,2019-09-29,131,17394,1671,6,19202
623,2019-09-30,80,19268,1473,2,20823
623,2019-10-01,2092,18030,1145,0,21267
623,2019-10-02,169,12766,1614,1,14550
623,2019-10-03,673,14458,1281,0,16412
623,2019-10-04,390,15667,633,1,16691
623,2019-10-05,855,16137,1659,2,18653
623,2019-10-06,1674,12003,1453,0,15130
623,2019-10-07,979,8637,1704,2,11322
623,2019-10-08,1347,12502,2012,1,15862
623,2019-10-09,948,15828,1341,2,18119
623,2019-10-10,1038,13045,2179,0,16262
623,2019-10-11,130,9714,1463,3,11310
623,2019-10-12,85,5913,1607,2,7607
623,2019-10-13,719,10361,1583,1,12664
623,2019-10-14,979,9196,1532,1,11708
623,2019-10-15,1066,9047,1200,2,11315
623,2019-10-16,216,18728,1618,1,20563
623,2019-10-17,94,8919,1263,3,10279
623,2019-10-18,977,9254,1262,0,11493
623,2019-10-19,677,6007,2050,10,8744
623,2019-10-20,1060,3640,1879,1,6580
623,2019-10-21,1181,11367,1929,2,14479
623,2019-10-22,91,7051,1710,1,8853
623,2019-10-23,45,9430,1623,0,11098
623,2019-10-24,1509,21658,1436,4,24607
623,2019-10-25,215,21401,1710,2,23328
623,2019-10-26,597,26133,2827,0,29557
623,2019-10-27,113,30642,2582,2,33339
623,2019-10-28,999,26843,2505,20,30367
623,2019-10-29,1707,17800,1987,6,21500
623,2019-10-30,105,16209,1308,1,17623
623,2019-10-31,112,21152,1334,1,22599
623,2019-11-01,1436,27272,1986,2,30696
623,2019-11-02,1406,26446,2061,1,29914
623,2019-11-03,109,24902,1509,0,26520
623,2019-11-04,92,11461,2067,1,13621
623,2019-11-05,147,4020,2812,0,6979
623,2019-11-06,232,9566,1671,1,11470
623,2019-11-07,161,14029,2326,3,16519
623,2019-11-08,503,10868,1473,0,12844
623,2019-11-09,1073,18394,1639,0,21106
623,2019-11-10,714,16798,1182,0,18694
623,2019-11-11,116,14312,1306,4,15738
623,2019-11-12,114,14953,2873,1,17941
623,2019-11-13,183,22842,2026,1,25052
623,2019-11-14,109,15943,1547,0,17599
623,2019-11-15,134,5835,2203,1,8173
623,2019-11-16,223,3060,2845,1,6129
623,2019-11-17,233,3912,3256,0,7401
623,2019-11-18,1024,3858,3907,1,8790
623,2019-11-19,1041,5813,2413,2,9269
623,2019-11-20,410,1609,1767,0,3786
623,2019-11-21,107,6197,1601,5,7910
623,2019-11-22,633,8701,2296,2,11632
623,2019-11-23,103,8757,2311,1,11172
623,2019-11-24,1370,5312,2049,0,8731
623,2019-11-25,820,7134,2250,0,10204
623,2019-11-26,344,10471,1438,2,12255
623,2019-11-27,515,9540,1265,1,11321
623,2019-11-28,42,7788,408,0,8238
623,2019-11-29,5,6,2,0,13
623,2019-08-01,2418,32512,103,2,35035
623,2019-08-02,9140,34713,405,0,44258
623,2019-08-03,6731,9275,284,1,16291
623,2019-08-04,351,993,378,1,1723
623,2019-08-05,116,1235,456,1,1808
623,2019-08-06,4198,5072,439,1,9710
623,2019-08-07,7929,3573,769,1,12272
623,2019-08-08,85,1413,456,0,1954
623,2019-08-09,332,2068,350,0,2750
623,2019-08-10,74,1519,124,0,1717
623,2019-08-11,53,1678,35,0,1766
623,2019-08-12,268,1834,216,1,2319
623,2019-08-13,1362,5568,76,0,7006
623,2019-08-14,67,1359,178,0,1604
623,2019-08-15,185,1541,91,0,1817
623,2019-08-16,727,4310,158,0,5195
623,2019-08-17,163,3470,983,0,4616
623,2019-08-18,7427,3303,1564,1,12295
623,2019-08-19,70,2613,1238,0,3921
623,2019-08-20,96,2508,1103,0,3707
623,2019-08-21,296,2146,1441,1,3884
623,2019-08-22,407,13692,1334,1,15434
623,2019-08-23,179,5932,1491,2,7604
623,2019-08-24,937,4319,1688,0,6944
623,2019-08-25,239,7745,1737,1,9722
623,2019-08-26,257,2304,1440,0,4001
623,2019-08-27,102,8650,1619,2,10373
623,2019-08-28,77,5089,1381,3,6550
623,2019-08-29,1529,10688,1599,0,13816
623,2019-08-30,66,5883,819,2,6770
623,2019-08-31,25,410,8,1,444
623,2019-09-01,317,799,292,0,1408
623,2019-09-02,32,576,0,0,608
623,2019-09-03,957,4389,1432,0,6778
623,2019-09-04,929,16699,2131,2,19761
623,2019-09-05,963,12052,2048,0,15063
623,2019-09-06,936,12151,2526,0,15613
623,2019-09-07,207,16283,2585,1,19076
623,2019-09-08,219,5639,2413,33,8304
623,2019-09-09,224,10224,2399,15,12862
623,2019-09-10,153,12768,2151,0,15072
623,2019-09-11,170,9178,1783,3,11134
623,2019-09-12,75,7491,2555,3,10124
623,2019-09-13,939,4907,1820,1,7667
623,2019-09-14,165,8227,1620,1,10013
623,2019-09-15,1302,12428,1502,0,15232
623,2019-09-16,82,13857,2413,1,16353
623,2019-09-17,90,11602,1330,0,13022
623,2019-09-18,70,6589,0,0,6659
623,2019-09-19,175,4807,1852,1,6835
623,2019-09-20,189,13358,1215,0,14762
623,2019-09-21,88,16736,2227,0,19051
623,2019-09-22,80,10129,1397,1,11607
623,2019-09-23,959,10124,1840,1,12924
623,2019-09-24,134,9288,2038,3,11463
623,2019-09-25,281,11592,1771,2,13646
623,2019-09-26,157,11592,1918,2,13669
623,2019-09-27,123,12037,1162,4,13326
623,2019-09-28,115,16030,1652,2,17799
623,2019-09-29,131,17394,1671,6,19202
623,2019-09-30,80,19268,1473,2,20823
623,2019-10-01,2092,18030,1145,0,21267
623,2019-10-02,169,12766,1614,1,14550
623,2019-10-03,673,14458,1281,0,16412
623,2019-10-04,390,15667,633,1,16691
623,2019-10-05,855,16137,1659,2,18653
623,2019-10-06,1674,12003,1453,0,15130
623,2019-10-07,979,8637,1704,2,11322
623,2019-10-08,1347,12502,2012,1,15862
623,2019-10-09,948,15828,1341,2,18119
623,2019-10-10,1038,13045,2179,0,16262
623,2019-10-11,130,9714,1463,3,11310
623,2019-10-12,85,5913,1607,2,7607
623,2019-10-13,719,10361,1583,1,12664
623,2019-10-14,979,9196,1532,1,11708
623,2019-10-15,1066,9047,1200,2,11315
623,2019-10-16,216,18728,1618,1,20563
623,2019-10-17,94,8919,1263,3,10279
623,2019-10-18,977,9254,1262,0,11493
623,2019-10-19,677,6007,2050,10,8744
623,2019-10-20,1060,3640,1879,1,6580
623,2019-10-21,1181,11367,1929,2,14479
623,2019-10-22,91,7051,1710,1,8853
623,2019-10-23,45,9430,1623,0,11098
623,2019-10-24,1509,21658,1436,4,24607
623,2019-10-25,215,21401,1710,2,23328
623,2019-10-26,597,26133,2827,0,29557
623,2019-10-27,113,30642,2582,2,33339
623,2019-10-28,999,26843,2505,20,30367
623,2019-10-29,1707,17800,1987,6,21500
623,2019-10-30,105,16209,1308,1,17623
623,2019-10-31,112,21152,1334,1,22599
623,2019-11-01,1436,27272,1986,2,30696
623,2019-11-02,1406,26446,2061,1,29914
623,2019-11-03,109,24902,1509,0,26520
623,2019-11-04,92,11461,2067,1,13621
623,2019-11-05,147,4020,2812,0,6979
623,2019-11-06,232,9566,1671,1,11470
623,2019-11-07,161,14029,2326,3,16519
623,2019-11-08,503,10868,1473,0,12844
623,2019-11-09,1073,18394,1639,0,21106
623,2019-11-10,714,16798,1182,0,18694
623,2019-11-11,116,14312,1306,4,15738
623,2019-11-12,114,14953,2873,1,17941
623,2019-11-13,183,22842,2026,1,25052
623,2019-11-14,109,15943,1547,0,17599
623,2019-11-15,134,5835,2203,1,8173
623,2019-11-16,223,3060,2845,1,6129
623,2019-11-17,233,3912,3256,0,7401
623,2019-11-18,1024,3858,3907,1,8790
623,2019-11-19,1041,5813,2413,2,9269
623,2019-11-20,410,1609,1767,0,3786
623,2019-11-21,107,6197,1601,5,7910
623,2019-11-22,633,8701,2296,2,11632
623,2019-11-23,103,8757,2311,1,11172
623,2019-11-24,1370,5312,2049,0,8731
623,2019-11-25,820,7134,2250,0,10204
623,2019-11-26,344,10471,1438,2,12255
623,2019-11-27,515,9540,1265,1,11321
624,2019-08-01,71,416,0,0,487
624,2019-08-02,313,588,360,0,1261
624,2019-08-03,172,924,287,0,1383
624,2019-08-04,32,1285,395,0,1712
624,2019-08-05,156,1283,69,0,1508
624,2019-08-06,79,1054,319,0,1452
624,2019-08-07,98,1403,156,2,1659
624,2019-08-08,117,1232,141,0,1490
624,2019-08-09,588,1168,409,1,2166
624,2019-08-10,89,2196,401,2,2688
624,2019-08-11,210,1580,101,0,1891
624,2019-08-12,263,1643,168,0,2074
624,2019-08-13,94,16424,309,0,16827
624,2019-08-14,82,9179,115,0,9376
624,2019-08-15,85,1312,107,1,1505
624,2019-08-16,26,4443,265,0,4734
624,2019-08-17,52,4066,1299,2,5419
624,2019-08-18,63,4860,1398,0,6321
624,2019-08-19,56,4387,1406,0,5849
624,2019-08-20,872,5159,1651,0,7682
624,2019-08-21,115,8862,1260,0,10237
624,2019-08-22,129,16021,1350,2,17502
624,2019-08-23,39,12170,1920,1,14130
624,2019-08-24,56,3798,1258,0,5112
624,2019-08-25,920,15810,2078,2,18810
624,2019-08-26,74,35538,2819,1,38432
624,2019-08-27,95,20226,1530,3,21854
624,2019-08-28,118,2430,1711,0,4259
624,2019-08-29,98,11023,1986,2,13109
624,2019-08-30,56,9106,642,2,9806
624,2019-08-31,22,1623,0,0,1645
624,2019-09-01,45,1796,183,1,2025
624,2019-09-02,106,8262,48,1,8417
624,2019-09-03,112,2420,1294,0,3826
624,2019-09-04,1007,14877,1757,3,17644
624,2019-09-05,205,7836,1883,1,9925
624,2019-09-06,1091,9936,1977,1,13005
624,2019-09-07,1093,16828,1056,1,18978
624,2019-09-08,352,5100,2062,13,7527
624,2019-09-09,409,11398,1711,1,13519
624,2019-09-10,981,14297,1648,0,16926
624,2019-09-11,269,22671,1053,2,23995
624,2019-09-12,972,39932,2160,3,43067
624,2019-09-13,144,32452,1676,2,34274
624,2019-09-14,126,12068,2150,1,14345
624,2019-09-15,951,6244,2134,1,9330
624,2019-09-16,193,12031,2618,4,14846
624,2019-09-17,958,8887,161,0,10006
624,2019-09-18,32,2765,0,0,2797
624,2019-09-19,0,0,0,10,10
624,2019-09-20,269,3006,2240,11,5526
624,2019-09-21,119,5876,1618,11,7624
624,2019-09-22,71,14838,2175,10,17094
624,2019-09-23,1014,10675,1812,10,13511
624,2019-09-24,1069,36456,1677,11,39213
624,2019-09-25,1073,15115,1506,12,17706
624,2019-09-26,206,9064,1458,14,10742
624,2019-09-27,105,7888,1733,5,9731
624,2019-09-28,233,14415,2281,3,16932
624,2019-09-29,124,20782,2229,0,23135
624,2019-09-30,101,26914,1856,0,28871
624,2019-10-01,75,21888,1751,1,23715
624,2019-10-02,101,15101,1758,7,16967
624,2019-10-03,72,29767,1184,10,31033
624,2019-10-04,99,23591,1379,11,25080
624,2019-10-05,140,23111,2459,10,25720
624,2019-10-06,107,16528,1792,11,18438
624,2019-10-07,207,5069,2063,11,7350
624,2019-10-08,185,17410,1379,11,18985
624,2019-10-09,566,24340,2106,9,27021
624,2019-10-10,149,31874,1200,11,33234
624,2019-10-11,134,8084,2179,11,10408
624,2019-10-12,189,3107,1876,3,5175
624,2019-10-13,693,7649,1234,2,9578
624,2019-10-14,182,4336,1940,2,6460
624,2019-10-15,97,14035,1019,1,15152
624,2019-10-16,417,25547,996,3,26963
624,2019-10-17,90,7933,2273,3,10299
624,2019-10-18,1398,7363,1592,1,10354
624,2019-10-19,106,7172,1883,2,9163
624,2019-10-20,60,2486,2346,0,4892
624,2019-10-21,1484,19061,917,740,22202
624,2019-10-22,56,8786,1326,2,10170
624,2019-10-23,920,13414,1680,1,16015
624,2019-10-24,112,19839,1279,0,21230
624,2019-10-25,1011,14516,1778,2,17307
624,2019-10-26,119,16672,2615,0,19406
624,2019-10-27,193,24610,2012,0,26815
624,2019-10-28,98,16485,2067,0,18650
624,2019-10-29,159,26989,1898,0,29046
624,2019-10-30,105,21203,957,1,22266
624,2019-10-31,90,14924,1639,2,16655
624,2019-11-01,61,27543,1131,1,28736
624,2019-11-02,78,26399,1888,1,28366
624,2019-11-03,71,24233,771,0,25075
624,2019-11-04,1163,9353,843,0,11359
624,2019-11-05,530,2131,2180,0,4841
624,2019-11-06,113,13716,2213,0,16042
624,2019-11-07,383,24110,1761,2,26256
624,2019-11-08,1578,17373,1331,0,20282
624,2019-11-09,341,11135,1596,0,13072
624,2019-11-10,103,13059,808,2,13972
624,2019-11-11,393,8849,2038,4,11284
624,2019-11-12,794,9138,2660,0,12592
624,2019-11-13,255,19591,1635,0,21481
624,2019-11-14,229,10799,1703,0,12731
624,2019-11-15,2018,4273,1747,0,8038
624,2019-11-16,92,3988,2627,1,6708
624,2019-11-17,1113,6787,3579,0,11479
624,2019-11-18,101,2884,3191,0,6176
624,2019-11-19,236,4243,3212,0,7691
624,2019-11-20,181,1638,1716,3,3538
624,2019-11-21,148,6097,1921,0,8166
624,2019-11-22,212,5972,1412,1,7597
624,2019-11-23,957,6941,1867,2,9767
624,2019-11-24,187,10828,1129,1,12145
624,2019-11-25,462,12568,1544,1,14575
624,2019-11-26,64,10498,1620,0,12182
624,2019-11-27,51,11425,1698,1,13175
624,2019-11-28,665,8127,667,0,9459
624,2019-11-29,6,624,0,0,630
624,2019-08-01,71,416,0,0,487
624,2019-08-02,313,588,360,0,1261
624,2019-08-03,172,924,287,0,1383
624,2019-08-04,32,1285,395,0,1712
624,2019-08-05,156,1283,69,0,1508
624,2019-08-06,79,1054,319,0,1452
624,2019-08-07,98,1403,156,2,1659
624,2019-08-08,117,1232,141,0,1490
624,2019-08-09,588,1168,409,1,2166
624,2019-08-10,89,2196,401,2,2688
624,2019-08-11,210,1580,101,0,1891
624,2019-08-12,263,1643,168,0,2074
624,2019-08-13,94,16424,309,0,16827
624,2019-08-14,82,9179,115,0,9376
624,2019-08-15,85,1312,107,1,1505
624,2019-08-16,26,4443,265,0,4734
624,2019-08-17,52,4066,1299,2,5419
624,2019-08-18,63,4860,1398,0,6321
624,2019-08-19,56,4387,1406,0,5849
624,2019-08-20,872,5159,1651,0,7682
624,2019-08-21,115,8862,1260,0,10237
624,2019-08-22,129,16021,1350,2,17502
624,2019-08-23,39,12170,1920,1,14130
624,2019-08-24,56,3798,1258,0,5112
624,2019-08-25,920,15810,2078,2,18810
624,2019-08-26,74,35538,2819,1,38432
624,2019-08-27,95,20226,1530,3,21854
624,2019-08-28,118,2430,1711,0,4259
624,2019-08-29,98,11023,1986,2,13109
624,2019-08-30,56,9106,642,2,9806
624,2019-08-31,22,1623,0,0,1645
624,2019-09-01,45,1796,183,1,2025
624,2019-09-02,106,8262,48,1,8417
624,2019-09-03,112,2420,1294,0,3826
624,2019-09-04,1007,14877,1757,3,17644
624,2019-09-05,205,7836,1883,1,9925
624,2019-09-06,1091,9936,1977,1,13005
624,2019-09-07,1093,16828,1056,1,18978
624,2019-09-08,352,5100,2062,13,7527
624,2019-09-09,409,11398,1711,1,13519
624,2019-09-10,981,14297,1648,0,16926
624,2019-09-11,269,22671,1053,2,23995
624,2019-09-12,972,39932,2160,3,43067
624,2019-09-13,144,32452,1676,2,34274
624,2019-09-14,126,12068,2150,1,14345
624,2019-09-15,951,6244,2134,1,9330
624,2019-09-16,193,12031,2618,4,14846
624,2019-09-17,958,8887,161,0,10006
624,2019-09-18,32,2765,0,0,2797
624,2019-09-19,0,0,0,10,10
624,2019-09-20,269,3006,2240,11,5526
624,2019-09-21,119,5876,1618,11,7624
624,2019-09-22,71,14838,2175,10,17094
624,2019-09-23,1014,10675,1812,10,13511
624,2019-09-24,1069,36456,1677,11,39213
624,2019-09-25,1073,15115,1506,12,17706
624,2019-09-26,206,9064,1458,14,10742
624,2019-09-27,105,7888,1733,5,9731
624,2019-09-28,233,14415,2281,3,16932
624,2019-09-29,124,20782,2229,0,23135
624,2019-09-30,101,26914,1856,0,28871
624,2019-10-01,75,21888,1751,1,23715
624,2019-10-02,101,15101,1758,7,16967
624,2019-10-03,72,29767,1184,10,31033
624,2019-10-04,99,23591,1379,11,25080
624,2019-10-05,140,23111,2459,10,25720
624,2019-10-06,107,16528,1792,11,18438
624,2019-10-07,207,5069,2063,11,7350
624,2019-10-08,185,17410,1379,11,18985
624,2019-10-09,566,24340,2106,9,27021
624,2019-10-10,149,31874,1200,11,33234
624,2019-10-11,134,8084,2179,11,10408
624,2019-10-12,189,3107,1876,3,5175
624,2019-10-13,693,7649,1234,2,9578
624,2019-10-14,182,4336,1940,2,6460
624,2019-10-15,97,14035,1019,1,15152
624,2019-10-16,417,25547,996,3,26963
624,2019-10-17,90,7933,2273,3,10299
624,2019-10-18,1398,7363,1592,1,10354
624,2019-10-19,106,7172,1883,2,9163
624,2019-10-20,60,2486,2346,0,4892
624,2019-10-21,1484,19061,917,740,22202
624,2019-10-22,56,8786,1326,2,10170
624,2019-10-23,920,13414,1680,1,16015
624,2019-10-24,112,19839,1279,0,21230
624,2019-10-25,1011,14516,1778,2,17307
624,2019-10-26,119,16672,2615,0,19406
624,2019-10-27,193,24610,2012,0,26815
624,2019-10-28,98,16485,2067,0,18650
624,2019-10-29,159,26989,1898,0,29046
624,2019-10-30,105,21203,957,1,22266
624,2019-10-31,90,14924,1639,2,16655
624,2019-11-01,61,27543,1131,1,28736
624,2019-11-02,78,26399,1888,1,28366
624,2019-11-03,71,24233,771,0,25075
624,2019-11-04,1163,9353,843,0,11359
624,2019-11-05,530,2131,2180,0,4841
624,2019-11-06,113,13716,2213,0,16042
624,2019-11-07,383,24110,1761,2,26256
624,2019-11-08,1578,17373,1331,0,20282
624,2019-11-09,341,11135,1596,0,13072
624,2019-11-10,103,13059,808,2,13972
624,2019-11-11,393,8849,2038,4,11284
624,2019-11-12,794,9138,2660,0,12592
624,2019-11-13,255,19591,1635,0,21481
624,2019-11-14,229,10799,1703,0,12731
624,2019-11-15,2018,4273,1747,0,8038
624,2019-11-16,92,3988,2627,1,6708
624,2019-11-17,1113,6787,3579,0,11479
624,2019-11-18,101,2884,3191,0,6176
624,2019-11-19,236,4243,3212,0,7691
624,2019-11-20,181,1638,1716,3,3538
624,2019-11-21,148,6097,1921,0,8166
624,2019-11-22,212,5972,1412,1,7597
624,2019-11-23,957,6941,1867,2,9767
624,2019-11-24,187,10828,1129,1,12145
624,2019-11-25,462,12568,1544,1,14575
624,2019-11-26,64,10498,1620,0,12182
624,2019-11-27,51,11425,1698,1,13175
624,2019-11-28,665,8127,667,0,9459
624,2019-11-29,6,624,0,0,630
624,2019-08-02,313,588,360,0,1261
624,2019-08-03,172,924,287,0,1383
624,2019-08-04,32,1285,395,0,1712
624,2019-08-05,156,1283,69,0,1508
624,2019-08-06,79,1054,319,0,1452
624,2019-08-07,98,1403,156,2,1659
624,2019-08-08,117,1232,141,0,1490
624,2019-08-09,588,1168,409,1,2166
624,2019-08-10,89,2196,401,2,2688
624,2019-08-11,210,1580,101,0,1891
624,2019-08-12,263,1643,168,0,2074
624,2019-08-13,94,16424,309,0,16827
624,2019-08-14,82,9179,115,0,9376
624,2019-08-15,85,1312,107,1,1505
624,2019-08-16,26,4443,265,0,4734
624,2019-08-17,52,4066,1299,2,5419
624,2019-08-18,63,4860,1398,0,6321
624,2019-08-19,56,4387,1406,0,5849
624,2019-08-20,872,5159,1651,0,7682
624,2019-08-21,115,8862,1260,0,10237
624,2019-08-22,129,16021,1350,2,17502
624,2019-08-23,39,12170,1920,1,14130
624,2019-08-24,56,3798,1258,0,5112
624,2019-08-25,920,15810,2078,2,18810
624,2019-08-26,74,35538,2819,1,38432
624,2019-08-27,95,20226,1530,3,21854
624,2019-08-28,118,2430,1711,0,4259
624,2019-08-29,98,11023,1986,2,13109
624,2019-08-30,56,9106,642,2,9806
624,2019-08-31,22,1623,0,0,1645
624,2019-09-01,45,1796,183,1,2025
624,2019-09-02,106,8262,48,1,8417
624,2019-09-03,112,2420,1294,0,3826
624,2019-09-04,1007,14877,1757,3,17644
624,2019-09-05,205,7836,1883,1,9925
624,2019-09-06,1091,9936,1977,1,13005
624,2019-09-07,1093,16828,1056,1,18978
624,2019-09-08,352,5100,2062,13,7527
624,2019-09-09,409,11398,1711,1,13519
624,2019-09-10,981,14297,1648,0,16926
624,2019-09-11,269,22671,1053,2,23995
624,2019-09-12,972,39932,2160,3,43067
624,2019-09-13,144,32452,1676,2,34274
624,2019-09-14,126,12068,2150,1,14345
624,2019-09-15,951,6244,2134,1,9330
624,2019-09-16,193,12031,2618,4,14846
624,2019-09-17,958,8887,161,0,10006
624,2019-09-18,32,2765,0,0,2797
624,2019-09-19,0,0,0,10,10
624,2019-09-20,269,3006,2240,11,5526
624,2019-09-21,119,5876,1618,11,7624
624,2019-09-22,71,14838,2175,10,17094
624,2019-09-23,1014,10675,1812,10,13511
624,2019-09-24,1069,36456,1677,11,39213
624,2019-09-25,1073,15115,1506,12,17706
624,2019-09-26,206,9064,1458,14,10742
624,2019-09-27,105,7888,1733,5,9731
624,2019-09-28,233,14415,2281,3,16932
624,2019-09-29,124,20782,2229,0,23135
624,2019-09-30,101,26914,1856,0,28871
624,2019-10-01,75,21888,1751,1,23715
624,2019-10-02,101,15101,1758,7,16967
624,2019-10-03,72,29767,1184,10,31033
624,2019-10-04,99,23591,1379,11,25080
624,2019-10-05,140,23111,2459,10,25720
624,2019-10-06,107,16528,1792,11,18438
624,2019-10-07,207,5069,2063,11,7350
624,2019-10-08,185,17410,1379,11,18985
624,2019-10-09,566,24340,2106,9,27021
624,2019-10-10,149,31874,1200,11,33234
624,2019-10-11,134,8084,2179,11,10408
624,2019-10-12,189,3107,1876,3,5175
624,2019-10-13,693,7649,1234,2,9578
624,2019-10-14,182,4336,1940,2,6460
624,2019-10-15,97,14035,1019,1,15152
624,2019-10-16,417,25547,996,3,26963
624,2019-10-17,90,7933,2273,3,10299
624,2019-10-18,1398,7363,1592,1,10354
624,2019-10-19,106,7172,1883,2,9163
624,2019-10-20,60,2486,2346,0,4892
624,2019-10-21,1484,19061,917,740,22202
624,2019-10-22,56,8786,1326,2,10170
624,2019-10-23,920,13414,1680,1,16015
624,2019-10-24,112,19839,1279,0,21230
624,2019-10-25,1011,14516,1778,2,17307
624,2019-10-26,119,16672,2615,0,19406
624,2019-10-27,193,24610,2012,0,26815
624,2019-10-28,98,16485,2067,0,18650
624,2019-10-29,159,26989,1898,0,29046
624,2019-10-30,105,21203,957,1,22266
624,2019-10-31,90,14924,1639,2,16655
624,2019-11-01,61,27543,1131,1,28736
624,2019-11-02,78,26399,1888,1,28366
624,2019-11-03,71,24233,771,0,25075
624,2019-11-04,1163,9353,843,0,11359
624,2019-11-05,530,2131,2180,0,4841
624,2019-11-06,113,13716,2213,0,16042
624,2019-11-07,383,24110,1761,2,26256
624,2019-11-08,1578,17373,1331,0,20282
624,2019-11-09,341,11135,1596,0,13072
624,2019-11-10,103,13059,808,2,13972
624,2019-11-11,393,8849,2038,4,11284
624,2019-11-12,794,9138,2660,0,12592
624,2019-11-13,255,19591,1635,0,21481
624,2019-11-14,229,10799,1703,0,12731
624,2019-11-15,2018,4273,1747,0,8038
624,2019-11-16,92,3988,2627,1,6708
624,2019-11-17,1113,6787,3579,0,11479
624,2019-11-18,101,2884,3191,0,6176
624,2019-11-19,236,4243,3212,0,7691
624,2019-11-20,181,1638,1716,3,3538
624,2019-11-21,148,6097,1921,0,8166
624,2019-11-22,212,5972,1412,1,7597
624,2019-11-23,957,6941,1867,2,9767
624,2019-11-24,187,10828,1129,1,12145
624,2019-11-25,462,12568,1544,1,14575
624,2019-11-26,64,10498,1620,0,12182
624,2019-11-27,51,11425,1698,1,13175
624,2019-11-28,665,8127,667,0,9459
624,2019-08-07,98,1403,156,2,1659
624,2019-08-08,117,1232,141,0,1490
624,2019-08-09,588,1168,409,1,2166
624,2019-08-10,89,2196,401,2,2688
624,2019-08-11,210,1580,101,0,1891
624,2019-08-12,263,1643,168,0,2074
624,2019-08-13,94,16424,309,0,16827
624,2019-08-14,82,9179,115,0,9376
624,2019-08-15,85,1312,107,1,1505
624,2019-08-16,26,4443,265,0,4734
624,2019-08-17,52,4066,1299,2,5419
624,2019-08-18,63,4860,1398,0,6321
624,2019-08-19,56,4387,1406,0,5849
624,2019-08-20,872,5159,1651,0,7682
624,2019-08-21,115,8862,1260,0,10237
624,2019-08-22,129,16021,1350,2,17502
624,2019-08-23,39,12170,1920,1,14130
624,2019-08-24,56,3798,1258,0,5112
624,2019-08-25,920,15810,2078,2,18810
624,2019-08-26,74,35538,2819,1,38432
624,2019-08-27,95,20226,1530,3,21854
624,2019-08-28,118,2430,1711,0,4259
624,2019-08-29,98,11023,1986,2,13109
624,2019-08-30,56,9106,642,2,9806
624,2019-08-31,22,1623,0,0,1645
624,2019-09-01,45,1796,183,1,2025
624,2019-09-02,106,8262,48,1,8417
624,2019-09-03,112,2420,1294,0,3826
624,2019-09-04,1007,14877,1757,3,17644
624,2019-09-05,205,7836,1883,1,9925
624,2019-09-06,1091,9936,1977,1,13005
624,2019-09-07,1093,16828,1056,1,18978
624,2019-09-08,352,5100,2062,13,7527
624,2019-09-09,409,11398,1711,1,13519
624,2019-09-10,981,14297,1648,0,16926
624,2019-09-11,269,22671,1053,2,23995
624,2019-09-12,972,39932,2160,3,43067
624,2019-09-13,144,32452,1676,2,34274
624,2019-09-14,126,12068,2150,1,14345
624,2019-09-15,951,6244,2134,1,9330
624,2019-09-16,193,12031,2618,4,14846
624,2019-09-17,958,8887,161,0,10006
624,2019-09-18,32,2765,0,0,2797
624,2019-09-19,0,0,0,10,10
624,2019-09-20,269,3006,2240,11,5526
624,2019-09-21,119,5876,1618,11,7624
624,2019-09-22,71,14838,2175,10,17094
624,2019-09-23,1014,10675,1812,10,13511
624,2019-09-24,1069,36456,1677,11,39213
624,2019-09-25,1073,15115,1506,12,17706
624,2019-09-26,206,9064,1458,14,10742
624,2019-09-27,105,7888,1733,5,9731
624,2019-09-28,233,14415,2281,3,16932
624,2019-09-29,124,20782,2229,0,23135
624,2019-09-30,101,26914,1856,0,28871
624,2019-10-01,75,21888,1751,1,23715
624,2019-10-02,101,15101,1758,7,16967
624,2019-10-03,72,29767,1184,10,31033
624,2019-10-04,99,23591,1379,11,25080
624,2019-10-05,140,23111,2459,10,25720
624,2019-10-06,107,16528,1792,11,18438
624,2019-10-07,207,5069,2063,11,7350
624,2019-10-08,185,17410,1379,11,18985
624,2019-10-09,566,24340,2106,9,27021
624,2019-10-10,149,31874,1200,11,33234
624,2019-10-11,134,8084,2179,11,10408
624,2019-10-12,189,3107,1876,3,5175
624,2019-10-13,693,7649,1234,2,9578
624,2019-10-14,182,4336,1940,2,6460
624,2019-10-15,97,14035,1019,1,15152
624,2019-10-16,417,25547,996,3,26963
624,2019-10-17,90,7933,2273,3,10299
624,2019-10-18,1398,7363,1592,1,10354
624,2019-10-19,106,7172,1883,2,9163
624,2019-10-20,60,2486,2346,0,4892
624,2019-10-21,1484,19061,917,740,22202
624,2019-10-22,56,8786,1326,2,10170
624,2019-10-23,920,13414,1680,1,16015
624,2019-10-24,112,19839,1279,0,21230
624,2019-10-25,1011,14516,1778,2,17307
624,2019-10-26,119,16672,2615,0,19406
624,2019-10-27,193,24610,2012,0,26815
624,2019-10-28,98,16485,2067,0,18650
624,2019-10-29,159,26989,1898,0,29046
624,2019-10-30,105,21203,957,1,22266
624,2019-10-31,90,14924,1639,2,16655
624,2019-11-01,61,27543,1131,1,28736
624,2019-11-02,78,26399,1888,1,28366
624,2019-11-03,71,24233,771,0,25075
624,2019-11-04,1163,9353,843,0,11359
624,2019-11-05,530,2131,2180,0,4841
624,2019-11-06,113,13716,2213,0,16042
624,2019-11-07,383,24110,1761,2,26256
624,2019-11-08,1578,17373,1331,0,20282
624,2019-11-09,341,11135,1596,0,13072
624,2019-11-10,103,13059,808,2,13972
624,2019-11-11,393,8849,2038,4,11284
624,2019-11-12,794,9138,2660,0,12592
624,2019-11-13,255,19591,1635,0,21481
624,2019-11-14,229,10799,1703,0,12731
624,2019-11-15,2018,4273,1747,0,8038
624,2019-11-16,92,3988,2627,1,6708
624,2019-11-17,1113,6787,3579,0,11479
624,2019-11-18,101,2884,3191,0,6176
624,2019-11-19,236,4243,3212,0,7691
624,2019-11-20,181,1638,1716,3,3538
624,2019-11-21,148,6097,1921,0,8166
624,2019-11-22,212,5972,1412,1,7597
624,2019-11-23,957,6941,1867,2,9767
624,2019-11-24,187,10828,1129,1,12145
624,2019-11-25,462,12568,1544,1,14575
624,2019-11-26,64,10498,1620,0,12182
624,2019-11-27,51,11425,1698,1,13175
625,2019-08-01,308,13719,213,0,14240
625,2019-08-02,410,19767,289,0,20466
625,2019-08-03,420,6896,438,3,7757
625,2019-08-04,462,1251,296,1,2010
625,2019-08-05,431,1169,346,2,1948
625,2019-08-06,530,12745,490,1,13766
625,2019-08-07,521,8762,367,0,9650
625,2019-08-08,401,1992,752,0,3145
625,2019-08-09,405,2279,338,0,3022
625,2019-08-10,512,2102,79,0,2693
625,2019-08-11,514,2049,168,0,2731
625,2019-08-12,436,2216,172,0,2824
625,2019-08-13,413,6174,323,0,6910
625,2019-08-14,316,2258,154,0,2728
625,2019-08-15,263,1637,127,0,2027
625,2019-08-16,366,2857,85,0,3308
625,2019-08-17,457,2948,695,1,4101
625,2019-08-18,757,3585,1060,1,5403
625,2019-08-19,836,5003,1086,0,6925
625,2019-08-20,627,3581,927,0,5135
625,2019-08-21,899,5521,1264,1,7685
625,2019-08-22,388,3907,1288,1,5584
625,2019-08-23,524,3023,2066,2,5615
625,2019-08-24,557,5210,1814,0,7581
625,2019-08-25,547,15708,1213,1,17469
625,2019-08-26,548,23966,1530,0,26044
625,2019-08-27,513,6168,2070,1,8752
625,2019-08-28,618,3335,1530,3,5486
625,2019-08-29,686,11007,1860,2,13555
625,2019-08-30,398,3860,771,2,5031
625,2019-08-31,147,540,17,0,704
625,2019-09-01,108,3846,397,0,4351
625,2019-09-02,184,1051,3,0,1238
625,2019-09-03,152,4016,1034,1,5203
625,2019-09-04,2064,12887,1778,2,16731
625,2019-09-05,345,6339,2605,0,9289
625,2019-09-06,410,10208,1969,0,12587
625,2019-09-07,446,13772,3017,1,17236
625,2019-09-08,556,6878,1969,0,9403
625,2019-09-09,366,8845,1804,0,11015
625,2019-09-10,1617,8653,2152,0,12422
625,2019-09-11,371,7085,1714,5,9175
625,2019-09-12,1591,12472,1323,19,15405
625,2019-09-13,480,7616,1440,18,9554
625,2019-09-14,306,8971,2707,0,11984
625,2019-09-15,628,9659,2206,839,13332
625,2019-09-16,417,6002,2055,5,8479
625,2019-09-17,296,11040,1887,10,13233
625,2019-09-18,2100,12732,1865,8,16705
625,2019-09-19,1376,7541,2527,8,11452
625,2019-09-20,326,9862,2378,10,12576
625,2019-09-21,1161,11272,2258,9,14700
625,2019-09-22,334,15004,1961,10,17309
625,2019-09-23,352,12392,2134,12,14890
625,2019-09-24,441,9865,1483,14,11803
625,2019-09-25,320,8581,2520,12,11433
625,2019-09-26,217,9477,1392,9,11095
625,2019-09-27,157,8826,1316,6,10305
625,2019-09-28,259,15397,1354,3,17013
625,2019-09-29,141,18661,1471,0,20273
625,2019-09-30,204,18957,2164,0,21325
625,2019-10-01,1358,17457,1853,1,20669
625,2019-10-02,182,13374,1431,7,14994
625,2019-10-03,207,15167,1677,12,17063
625,2019-10-04,171,13174,1887,10,15242
625,2019-10-05,1165,22384,1457,9,25015
625,2019-10-06,1045,18075,964,11,20095
625,2019-10-07,1903,9133,2118,14,13168
625,2019-10-08,164,13541,1959,10,15674
625,2019-10-09,578,16428,1056,10,18072
625,2019-10-10,1224,10877,2163,10,14274
625,2019-10-11,1460,9596,1600,10,12666
625,2019-10-12,309,8026,1674,2,10011
625,2019-10-13,219,12750,1634,3,14606
625,2019-10-14,232,7171,2110,1,9514
625,2019-10-15,287,15075,1084,0,16446
625,2019-10-16,277,29415,2039,2,31733
625,2019-10-17,361,11854,2019,3,14237
625,2019-10-18,1297,8756,1456,1,11510
625,2019-10-19,472,6629,2235,1,9337
625,2019-10-20,445,3768,2747,0,6960
625,2019-10-21,404,11797,1855,0,14056
625,2019-10-22,1071,7025,1598,2,9696
625,2019-10-23,663,10589,1864,0,13116
625,2019-10-24,287,14764,1270,1,16322
625,2019-10-25,582,16213,1790,1,18586
625,2019-10-26,390,25140,2707,0,28237
625,2019-10-27,1179,18516,2236,1,21932
625,2019-10-28,537,24869,1567,1,26974
625,2019-10-29,455,18328,1856,818,21457
625,2019-10-30,1066,15660,1708,0,18434
625,2019-10-31,981,21035,1873,1,23890
625,2019-11-01,269,27508,1059,2,28838
625,2019-11-02,279,17344,1888,0,19511
625,2019-11-03,1286,23305,1697,0,26288
625,2019-11-04,1230,8636,1681,0,11547
625,2019-11-05,364,3214,2812,0,6390
625,2019-11-06,363,14872,1303,5,16543
625,2019-11-07,399,17346,686,2,18433
625,2019-11-08,292,10558,1767,3,12620
625,2019-11-09,1333,9275,1476,0,12084
625,2019-11-10,390,25390,1315,0,27095
625,2019-11-11,441,17393,1989,3,19826
625,2019-11-12,1384,17565,1914,0,20863
625,2019-11-13,480,21932,1965,1,24378
625,2019-11-14,365,15307,1796,1,17469
625,2019-11-15,267,5532,2048,0,7847
625,2019-11-16,306,3137,3141,0,6584
625,2019-11-17,431,3823,2789,0,7043
625,2019-11-18,990,3697,3069,0,7756
625,2019-11-19,899,5819,2680,0,9398
625,2019-11-20,1330,2375,2620,0,6325
625,2019-11-21,278,3787,1802,0,5867
625,2019-11-22,325,4944,2012,0,7281
625,2019-11-23,350,6422,2663,0,9435
625,2019-11-24,1235,6333,1878,0,9446
625,2019-11-25,382,10976,1998,0,13356
625,2019-11-26,272,9448,1853,0,11573
625,2019-11-27,242,6886,2286,0,9414
625,2019-11-28,97,12222,455,0,12774
625,2019-11-29,42,479,69,0,590
625,2019-08-01,308,13719,213,0,14240
625,2019-08-02,410,19767,289,0,20466
625,2019-08-03,420,6896,438,3,7757
625,2019-08-04,462,1251,296,1,2010
625,2019-08-05,431,1169,346,2,1948
625,2019-08-06,530,12745,490,1,13766
625,2019-08-07,521,8762,367,0,9650
625,2019-08-08,401,1992,752,0,3145
625,2019-08-09,405,2279,338,0,3022
625,2019-08-10,512,2102,79,0,2693
625,2019-08-11,514,2049,168,0,2731
625,2019-08-12,436,2216,172,0,2824
625,2019-08-13,413,6174,323,0,6910
625,2019-08-14,316,2258,154,0,2728
625,2019-08-15,263,1637,127,0,2027
625,2019-08-16,366,2857,85,0,3308
625,2019-08-17,457,2948,695,1,4101
625,2019-08-18,757,3585,1060,1,5403
625,2019-08-19,836,5003,1086,0,6925
625,2019-08-20,627,3581,927,0,5135
625,2019-08-21,899,5521,1264,1,7685
625,2019-08-22,388,3907,1288,1,5584
625,2019-08-23,524,3023,2066,2,5615
625,2019-08-24,557,5210,1814,0,7581
625,2019-08-25,547,15708,1213,1,17469
625,2019-08-26,548,23966,1530,0,26044
625,2019-08-27,513,6168,2070,1,8752
625,2019-08-28,618,3335,1530,3,5486
625,2019-08-29,686,11007,1860,2,13555
625,2019-08-30,398,3860,771,2,5031
625,2019-08-31,147,540,17,0,704
625,2019-09-01,108,3846,397,0,4351
625,2019-09-02,184,1051,3,0,1238
625,2019-09-03,152,4016,1034,1,5203
625,2019-09-04,2064,12887,1778,2,16731
625,2019-09-05,345,6339,2605,0,9289
625,2019-09-06,410,10208,1969,0,12587
625,2019-09-07,446,13772,3017,1,17236
625,2019-09-08,556,6878,1969,0,9403
625,2019-09-09,366,8845,1804,0,11015
625,2019-09-10,1617,8653,2152,0,12422
625,2019-09-11,371,7085,1714,5,9175
625,2019-09-12,1591,12472,1323,19,15405
625,2019-09-13,480,7616,1440,18,9554
625,2019-09-14,306,8971,2707,0,11984
625,2019-09-15,628,9659,2206,839,13332
625,2019-09-16,417,6002,2055,5,8479
625,2019-09-17,296,11040,1887,10,13233
625,2019-09-18,2100,12732,1865,8,16705
625,2019-09-19,1376,7541,2527,8,11452
625,2019-09-20,326,9862,2378,10,12576
625,2019-09-21,1161,11272,2258,9,14700
625,2019-09-22,334,15004,1961,10,17309
625,2019-09-23,352,12392,2134,12,14890
625,2019-09-24,441,9865,1483,14,11803
625,2019-09-25,320,8581,2520,12,11433
625,2019-09-26,217,9477,1392,9,11095
625,2019-09-27,157,8826,1316,6,10305
625,2019-09-28,259,15397,1354,3,17013
625,2019-09-29,141,18661,1471,0,20273
625,2019-09-30,204,18957,2164,0,21325
625,2019-10-01,1358,17457,1853,1,20669
625,2019-10-02,182,13374,1431,7,14994
625,2019-10-03,207,15167,1677,12,17063
625,2019-10-04,171,13174,1887,10,15242
625,2019-10-05,1165,22384,1457,9,25015
625,2019-10-06,1045,18075,964,11,20095
625,2019-10-07,1903,9133,2118,14,13168
625,2019-10-08,164,13541,1959,10,15674
625,2019-10-09,578,16428,1056,10,18072
625,2019-10-10,1224,10877,2163,10,14274
625,2019-10-11,1460,9596,1600,10,12666
625,2019-10-12,309,8026,1674,2,10011
625,2019-10-13,219,12750,1634,3,14606
625,2019-10-14,232,7171,2110,1,9514
625,2019-10-15,287,15075,1084,0,16446
625,2019-10-16,277,29415,2039,2,31733
625,2019-10-17,361,11854,2019,3,14237
625,2019-10-18,1297,8756,1456,1,11510
625,2019-10-19,472,6629,2235,1,9337
625,2019-10-20,445,3768,2747,0,6960
625,2019-10-21,404,11797,1855,0,14056
625,2019-10-22,1071,7025,1598,2,9696
625,2019-10-23,663,10589,1864,0,13116
625,2019-10-24,287,14764,1270,1,16322
625,2019-10-25,582,16213,1790,1,18586
625,2019-10-26,390,25140,2707,0,28237
625,2019-10-27,1179,18516,2236,1,21932
625,2019-10-28,537,24869,1567,1,26974
625,2019-10-29,455,18328,1856,818,21457
625,2019-10-30,1066,15660,1708,0,18434
625,2019-10-31,981,21035,1873,1,23890
625,2019-11-01,269,27508,1059,2,28838
625,2019-11-02,279,17344,1888,0,19511
625,2019-11-03,1286,23305,1697,0,26288
625,2019-11-04,1230,8636,1681,0,11547
625,2019-11-05,364,3214,2812,0,6390
625,2019-11-06,363,14872,1303,5,16543
625,2019-11-07,399,17346,686,2,18433
625,2019-11-08,292,10558,1767,3,12620
625,2019-11-09,1333,9275,1476,0,12084
625,2019-11-10,390,25390,1315,0,27095
625,2019-11-11,441,17393,1989,3,19826
625,2019-11-12,1384,17565,1914,0,20863
625,2019-11-13,480,21932,1965,1,24378
625,2019-11-14,365,15307,1796,1,17469
625,2019-11-15,267,5532,2048,0,7847
625,2019-11-16,306,3137,3141,0,6584
625,2019-11-17,431,3823,2789,0,7043
625,2019-11-18,990,3697,3069,0,7756
625,2019-11-19,899,5819,2680,0,9398
625,2019-11-20,1330,2375,2620,0,6325
625,2019-11-21,278,3787,1802,0,5867
625,2019-11-22,325,4944,2012,0,7281
625,2019-11-23,350,6422,2663,0,9435
625,2019-11-24,1235,6333,1878,0,9446
625,2019-11-25,382,10976,1998,0,13356
625,2019-11-26,272,9448,1853,0,11573
625,2019-11-27,242,6886,2286,0,9414
625,2019-11-28,97,12222,455,0,12774
625,2019-11-29,42,479,69,0,590
625,2019-08-01,308,13719,213,0,14240
625,2019-08-02,410,19767,289,0,20466
625,2019-08-03,420,6896,438,3,7757
625,2019-08-04,462,1251,296,1,2010
625,2019-08-05,431,1169,346,2,1948
625,2019-08-06,530,12745,490,1,13766
625,2019-08-07,521,8762,367,0,9650
625,2019-08-08,401,1992,752,0,3145
625,2019-08-09,405,2279,338,0,3022
625,2019-08-10,512,2102,79,0,2693
625,2019-08-11,514,2049,168,0,2731
625,2019-08-12,436,2216,172,0,2824
625,2019-08-13,413,6174,323,0,6910
625,2019-08-14,316,2258,154,0,2728
625,2019-08-15,263,1637,127,0,2027
625,2019-08-16,366,2857,85,0,3308
625,2019-08-17,457,2948,695,1,4101
625,2019-08-18,757,3585,1060,1,5403
625,2019-08-19,836,5003,1086,0,6925
625,2019-08-20,627,3581,927,0,5135
625,2019-08-21,899,5521,1264,1,7685
625,2019-08-22,388,3907,1288,1,5584
625,2019-08-23,524,3023,2066,2,5615
625,2019-08-24,557,5210,1814,0,7581
625,2019-08-25,547,15708,1213,1,17469
625,2019-08-26,548,23966,1530,0,26044
625,2019-08-27,513,6168,2070,1,8752
625,2019-08-28,618,3335,1530,3,5486
625,2019-08-29,686,11007,1860,2,13555
625,2019-08-30,398,3860,771,2,5031
625,2019-08-31,147,540,17,0,704
625,2019-09-01,108,3846,397,0,4351
625,2019-09-02,184,1051,3,0,1238
625,2019-09-03,152,4016,1034,1,5203
625,2019-09-04,2064,12887,1778,2,16731
625,2019-09-05,345,6339,2605,0,9289
625,2019-09-06,410,10208,1969,0,12587
625,2019-09-07,446,13772,3017,1,17236
625,2019-09-08,556,6878,1969,0,9403
625,2019-09-09,366,8845,1804,0,11015
625,2019-09-10,1617,8653,2152,0,12422
625,2019-09-11,371,7085,1714,5,9175
625,2019-09-12,1591,12472,1323,19,15405
625,2019-09-13,480,7616,1440,18,9554
625,2019-09-14,306,8971,2707,0,11984
625,2019-09-15,628,9659,2206,839,13332
625,2019-09-16,417,6002,2055,5,8479
625,2019-09-17,296,11040,1887,10,13233
625,2019-09-18,2100,12732,1865,8,16705
625,2019-09-19,1376,7541,2527,8,11452
625,2019-09-20,326,9862,2378,10,12576
625,2019-09-21,1161,11272,2258,9,14700
625,2019-09-22,334,15004,1961,10,17309
625,2019-09-23,352,12392,2134,12,14890
625,2019-09-24,441,9865,1483,14,11803
625,2019-09-25,320,8581,2520,12,11433
625,2019-09-26,217,9477,1392,9,11095
625,2019-09-27,157,8826,1316,6,10305
625,2019-09-28,259,15397,1354,3,17013
625,2019-09-29,141,18661,1471,0,20273
625,2019-09-30,204,18957,2164,0,21325
625,2019-10-01,1358,17457,1853,1,20669
625,2019-10-02,182,13374,1431,7,14994
625,2019-10-03,207,15167,1677,12,17063
625,2019-10-04,171,13174,1887,10,15242
625,2019-10-05,1165,22384,1457,9,25015
625,2019-10-06,1045,18075,964,11,20095
625,2019-10-07,1903,9133,2118,14,13168
625,2019-10-08,164,13541,1959,10,15674
625,2019-10-09,578,16428,1056,10,18072
625,2019-10-10,1224,10877,2163,10,14274
625,2019-10-11,1460,9596,1600,10,12666
625,2019-10-12,309,8026,1674,2,10011
625,2019-10-13,219,12750,1634,3,14606
625,2019-10-14,232,7171,2110,1,9514
625,2019-10-15,287,15075,1084,0,16446
625,2019-10-16,277,29415,2039,2,31733
625,2019-10-17,361,11854,2019,3,14237
625,2019-10-18,1297,8756,1456,1,11510
625,2019-10-19,472,6629,2235,1,9337
625,2019-10-20,445,3768,2747,0,6960
625,2019-10-21,404,11797,1855,0,14056
625,2019-10-22,1071,7025,1598,2,9696
625,2019-10-23,663,10589,1864,0,13116
625,2019-10-24,287,14764,1270,1,16322
625,2019-10-25,582,16213,1790,1,18586
625,2019-10-26,390,25140,2707,0,28237
625,2019-10-27,1179,18516,2236,1,21932
625,2019-10-28,537,24869,1567,1,26974
625,2019-10-29,455,18328,1856,818,21457
625,2019-10-30,1066,15660,1708,0,18434
625,2019-10-31,981,21035,1873,1,23890
625,2019-11-01,269,27508,1059,2,28838
625,2019-11-02,279,17344,1888,0,19511
625,2019-11-03,1286,23305,1697,0,26288
625,2019-11-04,1230,8636,1681,0,11547
625,2019-11-05,364,3214,2812,0,6390
625,2019-11-06,363,14872,1303,5,16543
625,2019-11-07,399,17346,686,2,18433
625,2019-11-08,292,10558,1767,3,12620
625,2019-11-09,1333,9275,1476,0,12084
625,2019-11-10,390,25390,1315,0,27095
625,2019-11-11,441,17393,1989,3,19826
625,2019-11-12,1384,17565,1914,0,20863
625,2019-11-13,480,21932,1965,1,24378
625,2019-11-14,365,15307,1796,1,17469
625,2019-11-15,267,5532,2048,0,7847
625,2019-11-16,306,3137,3141,0,6584
625,2019-11-17,431,3823,2789,0,7043
625,2019-11-18,990,3697,3069,0,7756
625,2019-11-19,899,5819,2680,0,9398
625,2019-11-20,1330,2375,2620,0,6325
625,2019-11-21,278,3787,1802,0,5867
625,2019-11-22,325,4944,2012,0,7281
625,2019-11-23,350,6422,2663,0,9435
625,2019-11-24,1235,6333,1878,0,9446
625,2019-11-25,382,10976,1998,0,13356
625,2019-11-26,272,9448,1853,0,11573
625,2019-11-27,242,6886,2286,0,9414
625,2019-11-28,97,12222,455,0,12774
625,2019-11-29,42,479,69,0,590
625,2019-08-03,420,6896,438,3,7757
625,2019-08-04,462,1251,296,1,2010
625,2019-08-05,431,1169,346,2,1948
625,2019-08-06,530,12745,490,1,13766
625,2019-08-07,521,8762,367,0,9650
625,2019-08-08,401,1992,752,0,3145
625,2019-08-09,405,2279,338,0,3022
625,2019-08-10,512,2102,79,0,2693
625,2019-08-11,514,2049,168,0,2731
625,2019-08-12,436,2216,172,0,2824
625,2019-08-13,413,6174,323,0,6910
625,2019-08-14,316,2258,154,0,2728
625,2019-08-15,263,1637,127,0,2027
625,2019-08-16,366,2857,85,0,3308
625,2019-08-17,457,2948,695,1,4101
625,2019-08-18,757,3585,1060,1,5403
625,2019-08-19,836,5003,1086,0,6925
625,2019-08-20,627,3581,927,0,5135
625,2019-08-21,899,5521,1264,1,7685
625,2019-08-22,388,3907,1288,1,5584
625,2019-08-23,524,3023,2066,2,5615
625,2019-08-24,557,5210,1814,0,7581
625,2019-08-25,547,15708,1213,1,17469
625,2019-08-26,548,23966,1530,0,26044
625,2019-08-27,513,6168,2070,1,8752
625,2019-08-28,618,3335,1530,3,5486
625,2019-08-29,686,11007,1860,2,13555
625,2019-08-30,398,3860,771,2,5031
625,2019-08-31,147,540,17,0,704
625,2019-09-01,108,3846,397,0,4351
625,2019-09-02,184,1051,3,0,1238
625,2019-09-03,152,4016,1034,1,5203
625,2019-09-04,2064,12887,1778,2,16731
625,2019-09-05,345,6339,2605,0,9289
625,2019-09-06,410,10208,1969,0,12587
625,2019-09-07,446,13772,3017,1,17236
625,2019-09-08,556,6878,1969,0,9403
625,2019-09-09,366,8845,1804,0,11015
625,2019-09-10,1617,8653,2152,0,12422
625,2019-09-11,371,7085,1714,5,9175
625,2019-09-12,1591,12472,1323,19,15405
625,2019-09-13,480,7616,1440,18,9554
625,2019-09-14,306,8971,2707,0,11984
625,2019-09-15,628,9659,2206,839,13332
625,2019-09-16,417,6002,2055,5,8479
625,2019-09-17,296,11040,1887,10,13233
625,2019-09-18,2100,12732,1865,8,16705
625,2019-09-19,1376,7541,2527,8,11452
625,2019-09-20,326,9862,2378,10,12576
625,2019-09-21,1161,11272,2258,9,14700
625,2019-09-22,334,15004,1961,10,17309
625,2019-09-23,352,12392,2134,12,14890
625,2019-09-24,441,9865,1483,14,11803
625,2019-09-25,320,8581,2520,12,11433
625,2019-09-26,217,9477,1392,9,11095
625,2019-09-27,157,8826,1316,6,10305
625,2019-09-28,259,15397,1354,3,17013
625,2019-09-29,141,18661,1471,0,20273
625,2019-09-30,204,18957,2164,0,21325
625,2019-10-01,1358,17457,1853,1,20669
625,2019-10-02,182,13374,1431,7,14994
625,2019-10-03,207,15167,1677,12,17063
625,2019-10-04,171,13174,1887,10,15242
625,2019-10-05,1165,22384,1457,9,25015
625,2019-10-06,1045,18075,964,11,20095
625,2019-10-07,1903,9133,2118,14,13168
625,2019-10-08,164,13541,1959,10,15674
625,2019-10-09,578,16428,1056,10,18072
625,2019-10-10,1224,10877,2163,10,14274
625,2019-10-11,1460,9596,1600,10,12666
625,2019-10-12,309,8026,1674,2,10011
625,2019-10-13,219,12750,1634,3,14606
625,2019-10-14,232,7171,2110,1,9514
625,2019-10-15,287,15075,1084,0,16446
625,2019-10-16,277,29415,2039,2,31733
625,2019-10-17,361,11854,2019,3,14237
625,2019-10-18,1297,8756,1456,1,11510
625,2019-10-19,472,6629,2235,1,9337
625,2019-10-20,445,3768,2747,0,6960
625,2019-10-21,404,11797,1855,0,14056
625,2019-10-22,1071,7025,1598,2,9696
625,2019-10-23,663,10589,1864,0,13116
625,2019-10-24,287,14764,1270,1,16322
625,2019-10-25,582,16213,1790,1,18586
625,2019-10-26,390,25140,2707,0,28237
625,2019-10-27,1179,18516,2236,1,21932
625,2019-10-28,537,24869,1567,1,26974
625,2019-10-29,455,18328,1856,818,21457
625,2019-10-30,1066,15660,1708,0,18434
625,2019-10-31,981,21035,1873,1,23890
625,2019-11-01,269,27508,1059,2,28838
625,2019-11-02,279,17344,1888,0,19511
625,2019-11-03,1286,23305,1697,0,26288
625,2019-11-04,1230,8636,1681,0,11547
625,2019-11-05,364,3214,2812,0,6390
625,2019-11-06,363,14872,1303,5,16543
625,2019-11-07,399,17346,686,2,18433
625,2019-11-08,292,10558,1767,3,12620
625,2019-11-09,1333,9275,1476,0,12084
625,2019-11-10,390,25390,1315,0,27095
625,2019-11-11,441,17393,1989,3,19826
625,2019-11-12,1384,17565,1914,0,20863
625,2019-11-13,480,21932,1965,1,24378
625,2019-11-14,365,15307,1796,1,17469
626,2019-08-01,9,13301,140,0,13450
626,2019-08-02,42,25457,221,0,25720
626,2019-08-03,20,9365,468,1,9854
626,2019-08-04,30,1933,477,0,2440
626,2019-08-05,25,1206,325,0,1556
626,2019-08-06,107,1502,458,0,2067
626,2019-08-07,39,1843,926,2,2810
626,2019-08-08,29,1468,396,0,1893
626,2019-08-09,32,1833,315,1,2181
626,2019-08-10,47,1901,184,1,2133
626,2019-08-11,81,1671,211,0,1963
626,2019-08-12,186,2202,123,0,2511
626,2019-08-13,96,6314,11,0,6421
626,2019-08-14,47,6750,265,0,7062
626,2019-08-15,28,1684,110,0,1822
626,2019-08-16,18,7237,18,1,7274
626,2019-08-17,79,4745,323,0,5147
626,2019-08-18,1150,2953,1063,2,5168
626,2019-08-19,81,4585,1575,0,6241
626,2019-08-20,45,3952,1299,3,5299
626,2019-08-21,1510,5326,1095,0,7931
626,2019-08-22,41,4483,964,1,5489
626,2019-08-23,50,4282,1184,4,5520
626,2019-08-24,30,4150,1621,0,5801
626,2019-08-25,917,19406,1353,2,21678
626,2019-08-26,79,14655,1440,1,16175
626,2019-08-27,63,10176,1354,0,11593
626,2019-08-28,58,2878,1347,2,4285
626,2019-08-29,42,10489,1709,0,12240
626,2019-08-30,24,3493,727,3,4247
626,2019-08-31,15,518,2,0,535
626,2019-09-01,25,2576,223,0,2824
626,2019-09-02,32,353,1,0,386
626,2019-09-03,935,4102,1540,1,6578
626,2019-09-04,72,17583,1893,1,19549
626,2019-09-05,81,7627,1464,2,9174
626,2019-09-06,81,14309,2199,0,16589
626,2019-09-07,1002,12720,1396,2,15120
626,2019-09-08,171,7658,6963,2,14794
626,2019-09-09,177,11782,1933,1,13893
626,2019-09-10,45,12508,2030,0,14583
626,2019-09-11,99,7269,1749,2,9119
626,2019-09-12,92,9964,1923,4,11983
626,2019-09-13,69,4611,1628,1,6309
626,2019-09-14,272,11614,1541,21,13448
626,2019-09-15,1680,6309,1985,7,9981
626,2019-09-16,84,9356,2006,3,11449
626,2019-09-17,104,10817,1929,8,12858
626,2019-09-18,884,20616,1325,9,22834
626,2019-09-19,1004,6878,1440,9,9331
626,2019-09-20,1005,14659,2305,9,17978
626,2019-09-21,43,12770,1809,9,14631
626,2019-09-22,73,9205,1769,10,11057
626,2019-09-23,337,12430,1898,13,14678
626,2019-09-24,341,10174,2449,19,12983
626,2019-09-25,137,8590,949,11,9687
626,2019-09-26,102,14193,1752,11,16058
626,2019-09-27,79,8625,1666,8,10378
626,2019-09-28,79,23541,2072,4,25696
626,2019-09-29,79,21604,1863,4,23550
626,2019-09-30,935,19207,1428,0,21570
626,2019-10-01,66,24832,1950,1,26849
626,2019-10-02,92,13417,1706,6,15221
626,2019-10-03,97,24066,1443,10,25616
626,2019-10-04,920,21203,821,15,22959
626,2019-10-05,1195,19773,1235,29,22232
626,2019-10-06,168,14479,1929,11,16587
626,2019-10-07,91,9059,1488,13,10651
626,2019-10-08,981,20792,1064,10,22847
626,2019-10-09,191,19407,983,10,20591
626,2019-10-10,61,14834,1443,13,16351
626,2019-10-11,52,13522,2201,10,15785
626,2019-10-12,968,10264,2546,3,13781
626,2019-10-13,37,11327,1511,2,12877
626,2019-10-14,936,10634,1645,1,13216
626,2019-10-15,72,11076,1287,3,12438
626,2019-10-16,65,14911,1061,2,16039
626,2019-10-17,35,8142,1197,3,9377
626,2019-10-18,153,11446,1580,4,13183
626,2019-10-19,105,8614,3027,2,11748
626,2019-10-20,531,5684,1793,1,8009
626,2019-10-21,1035,13463,1512,2,16012
626,2019-10-22,657,9487,2127,4,12275
626,2019-10-23,950,11062,1375,0,13387
626,2019-10-24,1286,22622,1424,25,25357
626,2019-10-25,70,21729,1652,25,23476
626,2019-10-26,448,19143,2634,0,22225
626,2019-10-27,85,18530,2196,2,20813
626,2019-10-28,515,16795,2059,2,19371
626,2019-10-29,134,20438,2341,0,22913
626,2019-10-30,65,17441,2186,0,19692
626,2019-10-31,935,23169,1504,3,25611
626,2019-11-01,56,29332,1154,3,30545
626,2019-11-02,136,19082,1738,1,20957
626,2019-11-03,1193,24962,1043,1,27199
626,2019-11-04,658,10080,1816,0,12554
626,2019-11-05,111,8374,2012,0,10497
626,2019-11-06,91,16105,1845,2,18043
626,2019-11-07,177,18256,2586,2,21021
626,2019-11-08,66,10988,2605,0,13659
626,2019-11-09,48,10390,2494,0,12932
626,2019-11-10,156,15772,1999,0,17927
626,2019-11-11,89,11942,2236,0,14267
626,2019-11-12,999,12378,3482,0,16859
626,2019-11-13,156,14686,2095,0,16937
626,2019-11-14,73,15283,2230,0,17586
626,2019-11-15,62,6959,1528,0,8549
626,2019-11-16,111,4745,2527,0,7383
626,2019-11-17,164,5266,3147,0,8577
626,2019-11-18,101,4993,2488,0,7582
626,2019-11-19,145,12700,3055,0,15900
626,2019-11-20,110,3570,2056,0,5736
626,2019-11-21,86,7752,1929,1,9768
626,2019-11-22,69,7120,2056,1,9246
626,2019-11-23,203,11711,2463,1,14378
626,2019-11-24,922,10530,1530,1,12983
626,2019-11-25,130,8933,1783,0,10846
626,2019-11-26,58,8471,2237,5,10771
626,2019-11-27,1624,8478,2048,0,12150
626,2019-11-28,51,9179,797,0,10027
626,2019-11-29,20,433,5,0,458
626,2019-08-01,9,13301,140,0,13450
626,2019-08-02,42,25457,221,0,25720
626,2019-08-03,20,9365,468,1,9854
626,2019-08-04,30,1933,477,0,2440
626,2019-08-05,25,1206,325,0,1556
626,2019-08-06,107,1502,458,0,2067
626,2019-08-07,39,1843,926,2,2810
626,2019-08-08,29,1468,396,0,1893
626,2019-08-09,32,1833,315,1,2181
626,2019-08-10,47,1901,184,1,2133
626,2019-08-11,81,1671,211,0,1963
626,2019-08-12,186,2202,123,0,2511
626,2019-08-13,96,6314,11,0,6421
626,2019-08-14,47,6750,265,0,7062
626,2019-08-15,28,1684,110,0,1822
626,2019-08-16,18,7237,18,1,7274
626,2019-08-17,79,4745,323,0,5147
626,2019-08-18,1150,2953,1063,2,5168
626,2019-08-19,81,4585,1575,0,6241
626,2019-08-20,45,3952,1299,3,5299
626,2019-08-21,1510,5326,1095,0,7931
626,2019-08-22,41,4483,964,1,5489
626,2019-08-23,50,4282,1184,4,5520
626,2019-08-24,30,4150,1621,0,5801
626,2019-08-25,917,19406,1353,2,21678
626,2019-08-26,79,14655,1440,1,16175
626,2019-08-27,63,10176,1354,0,11593
626,2019-08-28,58,2878,1347,2,4285
626,2019-08-29,42,10489,1709,0,12240
626,2019-08-30,24,3493,727,3,4247
626,2019-08-31,15,518,2,0,535
626,2019-09-01,25,2576,223,0,2824
626,2019-09-02,32,353,1,0,386
626,2019-09-03,935,4102,1540,1,6578
626,2019-09-04,72,17583,1893,1,19549
626,2019-09-05,81,7627,1464,2,9174
626,2019-09-06,81,14309,2199,0,16589
626,2019-09-07,1002,12720,1396,2,15120
626,2019-09-08,171,7658,6963,2,14794
626,2019-09-09,177,11782,1933,1,13893
626,2019-09-10,45,12508,2030,0,14583
626,2019-09-11,99,7269,1749,2,9119
626,2019-09-12,92,9964,1923,4,11983
626,2019-09-13,69,4611,1628,1,6309
626,2019-09-14,272,11614,1541,21,13448
626,2019-09-15,1680,6309,1985,7,9981
626,2019-09-16,84,9356,2006,3,11449
626,2019-09-17,104,10817,1929,8,12858
626,2019-09-18,884,20616,1325,9,22834
626,2019-09-19,1004,6878,1440,9,9331
626,2019-09-20,1005,14659,2305,9,17978
626,2019-09-21,43,12770,1809,9,14631
626,2019-09-22,73,9205,1769,10,11057
626,2019-09-23,337,12430,1898,13,14678
626,2019-09-24,341,10174,2449,19,12983
626,2019-09-25,137,8590,949,11,9687
626,2019-09-26,102,14193,1752,11,16058
626,2019-09-27,79,8625,1666,8,10378
626,2019-09-28,79,23541,2072,4,25696
626,2019-09-29,79,21604,1863,4,23550
626,2019-09-30,935,19207,1428,0,21570
626,2019-10-01,66,24832,1950,1,26849
626,2019-10-02,92,13417,1706,6,15221
626,2019-10-03,97,24066,1443,10,25616
626,2019-10-04,920,21203,821,15,22959
626,2019-10-05,1195,19773,1235,29,22232
626,2019-10-06,168,14479,1929,11,16587
626,2019-10-07,91,9059,1488,13,10651
626,2019-10-08,981,20792,1064,10,22847
626,2019-10-09,191,19407,983,10,20591
626,2019-10-10,61,14834,1443,13,16351
626,2019-10-11,52,13522,2201,10,15785
626,2019-10-12,968,10264,2546,3,13781
626,2019-10-13,37,11327,1511,2,12877
626,2019-10-14,936,10634,1645,1,13216
626,2019-10-15,72,11076,1287,3,12438
626,2019-10-16,65,14911,1061,2,16039
626,2019-10-17,35,8142,1197,3,9377
626,2019-10-18,153,11446,1580,4,13183
626,2019-10-19,105,8614,3027,2,11748
626,2019-10-20,531,5684,1793,1,8009
626,2019-10-21,1035,13463,1512,2,16012
626,2019-10-22,657,9487,2127,4,12275
626,2019-10-23,950,11062,1375,0,13387
626,2019-10-24,1286,22622,1424,25,25357
626,2019-10-25,70,21729,1652,25,23476
626,2019-10-26,448,19143,2634,0,22225
626,2019-10-27,85,18530,2196,2,20813
626,2019-10-28,515,16795,2059,2,19371
626,2019-10-29,134,20438,2341,0,22913
626,2019-10-30,65,17441,2186,0,19692
626,2019-10-31,935,23169,1504,3,25611
626,2019-11-01,56,29332,1154,3,30545
626,2019-11-02,136,19082,1738,1,20957
626,2019-11-03,1193,24962,1043,1,27199
626,2019-11-04,658,10080,1816,0,12554
626,2019-11-05,111,8374,2012,0,10497
626,2019-11-06,91,16105,1845,2,18043
626,2019-11-07,177,18256,2586,2,21021
626,2019-11-08,66,10988,2605,0,13659
626,2019-11-09,48,10390,2494,0,12932
626,2019-11-10,156,15772,1999,0,17927
626,2019-11-11,89,11942,2236,0,14267
626,2019-11-12,999,12378,3482,0,16859
626,2019-11-13,156,14686,2095,0,16937
626,2019-11-14,73,15283,2230,0,17586
626,2019-11-15,62,6959,1528,0,8549
626,2019-11-16,111,4745,2527,0,7383
626,2019-11-17,164,5266,3147,0,8577
626,2019-11-18,101,4993,2488,0,7582
626,2019-11-19,145,12700,3055,0,15900
626,2019-11-20,110,3570,2056,0,5736
626,2019-11-21,86,7752,1929,1,9768
626,2019-11-22,69,7120,2056,1,9246
626,2019-11-23,203,11711,2463,1,14378
626,2019-11-24,922,10530,1530,1,12983
626,2019-11-25,130,8933,1783,0,10846
626,2019-11-26,58,8471,2237,5,10771
626,2019-11-27,1624,8478,2048,0,12150
626,2019-11-28,51,9179,797,0,10027
626,2019-11-29,20,433,5,0,458
626,2019-08-01,9,13301,140,0,13450
626,2019-08-02,42,25457,221,0,25720
626,2019-08-03,20,9365,468,1,9854
626,2019-08-04,30,1933,477,0,2440
626,2019-08-05,25,1206,325,0,1556
626,2019-08-06,107,1502,458,0,2067
626,2019-08-07,39,1843,926,2,2810
626,2019-08-08,29,1468,396,0,1893
626,2019-08-09,32,1833,315,1,2181
626,2019-08-10,47,1901,184,1,2133
626,2019-08-11,81,1671,211,0,1963
626,2019-08-12,186,2202,123,0,2511
626,2019-08-13,96,6314,11,0,6421
626,2019-08-14,47,6750,265,0,7062
626,2019-08-15,28,1684,110,0,1822
626,2019-08-16,18,7237,18,1,7274
626,2019-08-17,79,4745,323,0,5147
626,2019-08-18,1150,2953,1063,2,5168
626,2019-08-19,81,4585,1575,0,6241
626,2019-08-20,45,3952,1299,3,5299
626,2019-08-21,1510,5326,1095,0,7931
626,2019-08-22,41,4483,964,1,5489
626,2019-08-23,50,4282,1184,4,5520
626,2019-08-24,30,4150,1621,0,5801
626,2019-08-25,917,19406,1353,2,21678
626,2019-08-26,79,14655,1440,1,16175
626,2019-08-27,63,10176,1354,0,11593
626,2019-08-28,58,2878,1347,2,4285
626,2019-08-29,42,10489,1709,0,12240
626,2019-08-30,24,3493,727,3,4247
626,2019-08-31,15,518,2,0,535
626,2019-09-01,25,2576,223,0,2824
626,2019-09-02,32,353,1,0,386
626,2019-09-03,935,4102,1540,1,6578
626,2019-09-04,72,17583,1893,1,19549
626,2019-09-05,81,7627,1464,2,9174
626,2019-09-06,81,14309,2199,0,16589
626,2019-09-07,1002,12720,1396,2,15120
626,2019-09-08,171,7658,6963,2,14794
626,2019-09-09,177,11782,1933,1,13893
626,2019-09-10,45,12508,2030,0,14583
626,2019-09-11,99,7269,1749,2,9119
626,2019-09-12,92,9964,1923,4,11983
626,2019-09-13,69,4611,1628,1,6309
626,2019-09-14,272,11614,1541,21,13448
626,2019-09-15,1680,6309,1985,7,9981
626,2019-09-16,84,9356,2006,3,11449
626,2019-09-17,104,10817,1929,8,12858
626,2019-09-18,884,20616,1325,9,22834
626,2019-09-19,1004,6878,1440,9,9331
626,2019-09-20,1005,14659,2305,9,17978
626,2019-09-21,43,12770,1809,9,14631
626,2019-09-22,73,9205,1769,10,11057
626,2019-09-23,337,12430,1898,13,14678
626,2019-09-24,341,10174,2449,19,12983
626,2019-09-25,137,8590,949,11,9687
626,2019-09-26,102,14193,1752,11,16058
626,2019-09-27,79,8625,1666,8,10378
626,2019-09-28,79,23541,2072,4,25696
626,2019-09-29,79,21604,1863,4,23550
626,2019-09-30,935,19207,1428,0,21570
626,2019-10-01,66,24832,1950,1,26849
626,2019-10-02,92,13417,1706,6,15221
626,2019-10-03,97,24066,1443,10,25616
626,2019-10-04,920,21203,821,15,22959
626,2019-10-05,1195,19773,1235,29,22232
626,2019-10-06,168,14479,1929,11,16587
626,2019-10-07,91,9059,1488,13,10651
626,2019-10-08,981,20792,1064,10,22847
626,2019-10-09,191,19407,983,10,20591
626,2019-10-10,61,14834,1443,13,16351
626,2019-10-11,52,13522,2201,10,15785
626,2019-10-12,968,10264,2546,3,13781
626,2019-10-13,37,11327,1511,2,12877
626,2019-10-14,936,10634,1645,1,13216
626,2019-10-15,72,11076,1287,3,12438
626,2019-10-16,65,14911,1061,2,16039
626,2019-10-17,35,8142,1197,3,9377
626,2019-10-18,153,11446,1580,4,13183
626,2019-10-19,105,8614,3027,2,11748
626,2019-10-20,531,5684,1793,1,8009
626,2019-10-21,1035,13463,1512,2,16012
626,2019-10-22,657,9487,2127,4,12275
626,2019-10-23,950,11062,1375,0,13387
626,2019-10-24,1286,22622,1424,25,25357
626,2019-10-25,70,21729,1652,25,23476
626,2019-10-26,448,19143,2634,0,22225
626,2019-10-27,85,18530,2196,2,20813
626,2019-10-28,515,16795,2059,2,19371
626,2019-10-29,134,20438,2341,0,22913
626,2019-10-30,65,17441,2186,0,19692
626,2019-10-31,935,23169,1504,3,25611
626,2019-11-01,56,29332,1154,3,30545
626,2019-11-02,136,19082,1738,1,20957
626,2019-11-03,1193,24962,1043,1,27199
626,2019-11-04,658,10080,1816,0,12554
626,2019-11-05,111,8374,2012,0,10497
626,2019-11-06,91,16105,1845,2,18043
626,2019-11-07,177,18256,2586,2,21021
626,2019-11-08,66,10988,2605,0,13659
626,2019-11-09,48,10390,2494,0,12932
626,2019-11-10,156,15772,1999,0,17927
626,2019-11-11,89,11942,2236,0,14267
626,2019-11-12,999,12378,3482,0,16859
626,2019-11-13,156,14686,2095,0,16937
626,2019-11-14,73,15283,2230,0,17586
626,2019-11-15,62,6959,1528,0,8549
626,2019-11-16,111,4745,2527,0,7383
626,2019-11-17,164,5266,3147,0,8577
626,2019-11-18,101,4993,2488,0,7582
626,2019-11-19,145,12700,3055,0,15900
626,2019-11-20,110,3570,2056,0,5736
626,2019-11-21,86,7752,1929,1,9768
626,2019-11-22,69,7120,2056,1,9246
626,2019-11-23,203,11711,2463,1,14378
626,2019-11-24,922,10530,1530,1,12983
626,2019-11-25,130,8933,1783,0,10846
626,2019-11-26,58,8471,2237,5,10771
626,2019-11-27,1624,8478,2048,0,12150
626,2019-11-28,51,9179,797,0,10027
626,2019-11-29,20,433,5,0,458
626,2019-08-03,20,9365,468,1,9854
626,2019-08-04,30,1933,477,0,2440
626,2019-08-05,25,1206,325,0,1556
626,2019-08-06,107,1502,458,0,2067
626,2019-08-07,39,1843,926,2,2810
626,2019-08-08,29,1468,396,0,1893
626,2019-08-09,32,1833,315,1,2181
626,2019-08-10,47,1901,184,1,2133
626,2019-08-11,81,1671,211,0,1963
626,2019-08-12,186,2202,123,0,2511
626,2019-08-13,96,6314,11,0,6421
626,2019-08-14,47,6750,265,0,7062
626,2019-08-15,28,1684,110,0,1822
626,2019-08-16,18,7237,18,1,7274
626,2019-08-17,79,4745,323,0,5147
626,2019-08-18,1150,2953,1063,2,5168
626,2019-08-19,81,4585,1575,0,6241
626,2019-08-20,45,3952,1299,3,5299
626,2019-08-21,1510,5326,1095,0,7931
626,2019-08-22,41,4483,964,1,5489
626,2019-08-23,50,4282,1184,4,5520
626,2019-08-24,30,4150,1621,0,5801
626,2019-08-25,917,19406,1353,2,21678
626,2019-08-26,79,14655,1440,1,16175
626,2019-08-27,63,10176,1354,0,11593
626,2019-08-28,58,2878,1347,2,4285
626,2019-08-29,42,10489,1709,0,12240
626,2019-08-30,24,3493,727,3,4247
626,2019-08-31,15,518,2,0,535
626,2019-09-01,25,2576,223,0,2824
626,2019-09-02,32,353,1,0,386
626,2019-09-03,935,4102,1540,1,6578
626,2019-09-04,72,17583,1893,1,19549
626,2019-09-05,81,7627,1464,2,9174
626,2019-09-06,81,14309,2199,0,16589
626,2019-09-07,1002,12720,1396,2,15120
626,2019-09-08,171,7658,6963,2,14794
626,2019-09-09,177,11782,1933,1,13893
626,2019-09-10,45,12508,2030,0,14583
626,2019-09-11,99,7269,1749,2,9119
626,2019-09-12,92,9964,1923,4,11983
626,2019-09-13,69,4611,1628,1,6309
626,2019-09-14,272,11614,1541,21,13448
626,2019-09-15,1680,6309,1985,7,9981
626,2019-09-16,84,9356,2006,3,11449
626,2019-09-17,104,10817,1929,8,12858
626,2019-09-18,884,20616,1325,9,22834
626,2019-09-19,1004,6878,1440,9,9331
626,2019-09-20,1005,14659,2305,9,17978
626,2019-09-21,43,12770,1809,9,14631
626,2019-09-22,73,9205,1769,10,11057
626,2019-09-23,337,12430,1898,13,14678
626,2019-09-24,341,10174,2449,19,12983
626,2019-09-25,137,8590,949,11,9687
626,2019-09-26,102,14193,1752,11,16058
626,2019-09-27,79,8625,1666,8,10378
626,2019-09-28,79,23541,2072,4,25696
626,2019-09-29,79,21604,1863,4,23550
626,2019-09-30,935,19207,1428,0,21570
626,2019-10-01,66,24832,1950,1,26849
626,2019-10-02,92,13417,1706,6,15221
626,2019-10-03,97,24066,1443,10,25616
626,2019-10-04,920,21203,821,15,22959
626,2019-10-05,1195,19773,1235,29,22232
626,2019-10-06,168,14479,1929,11,16587
626,2019-10-07,91,9059,1488,13,10651
626,2019-10-08,981,20792,1064,10,22847
626,2019-10-09,191,19407,983,10,20591
626,2019-10-10,61,14834,1443,13,16351
626,2019-10-11,52,13522,2201,10,15785
626,2019-10-12,968,10264,2546,3,13781
626,2019-10-13,37,11327,1511,2,12877
626,2019-10-14,936,10634,1645,1,13216
626,2019-10-15,72,11076,1287,3,12438
626,2019-10-16,65,14911,1061,2,16039
626,2019-10-17,35,8142,1197,3,9377
626,2019-10-18,153,11446,1580,4,13183
626,2019-10-19,105,8614,3027,2,11748
626,2019-10-20,531,5684,1793,1,8009
626,2019-10-21,1035,13463,1512,2,16012
626,2019-10-22,657,9487,2127,4,12275
626,2019-10-23,950,11062,1375,0,13387
626,2019-10-24,1286,22622,1424,25,25357
626,2019-10-25,70,21729,1652,25,23476
626,2019-10-26,448,19143,2634,0,22225
626,2019-10-27,85,18530,2196,2,20813
626,2019-10-28,515,16795,2059,2,19371
626,2019-10-29,134,20438,2341,0,22913
626,2019-10-30,65,17441,2186,0,19692
626,2019-10-31,935,23169,1504,3,25611
626,2019-11-01,56,29332,1154,3,30545
626,2019-11-02,136,19082,1738,1,20957
626,2019-11-03,1193,24962,1043,1,27199
626,2019-11-04,658,10080,1816,0,12554
626,2019-11-05,111,8374,2012,0,10497
626,2019-11-06,91,16105,1845,2,18043
626,2019-11-07,177,18256,2586,2,21021
626,2019-11-08,66,10988,2605,0,13659
626,2019-11-09,48,10390,2494,0,12932
626,2019-11-10,156,15772,1999,0,17927
626,2019-11-11,89,11942,2236,0,14267
626,2019-11-12,999,12378,3482,0,16859
626,2019-11-13,156,14686,2095,0,16937
626,2019-11-14,73,15283,2230,0,17586
626,2019-11-15,62,6959,1528,0,8549
626,2019-11-16,111,4745,2527,0,7383
626,2019-11-17,164,5266,3147,0,8577
626,2019-11-18,101,4993,2488,0,7582
626,2019-11-19,145,12700,3055,0,15900
626,2019-11-20,110,3570,2056,0,5736
626,2019-11-21,86,7752,1929,1,9768
626,2019-11-22,69,7120,2056,1,9246
626,2019-11-23,203,11711,2463,1,14378
626,2019-11-24,922,10530,1530,1,12983
626,2019-11-25,130,8933,1783,0,10846
626,2019-11-26,58,8471,2237,5,10771
627,2019-08-01,64,32948,217,0,33229
627,2019-08-02,77,28329,228,1,28635
627,2019-08-03,274,6767,484,2,7527
627,2019-08-04,85,1466,55,0,1606
627,2019-08-05,113,1579,413,0,2105
627,2019-08-06,95,1980,382,0,2457
627,2019-08-07,390,4604,312,1,5307
627,2019-08-08,76,1652,380,2,2110
627,2019-08-09,50,1575,317,1,1943
627,2019-08-10,59,32439,253,0,32751
627,2019-08-11,75,16332,109,0,16516
627,2019-08-12,174,1855,43,0,2072
627,2019-08-13,215,16465,256,1,16937
627,2019-08-14,62,10866,243,0,11171
627,2019-08-15,53,1853,57,1,1964
627,2019-08-16,64,3544,293,0,3901
627,2019-08-17,63,4380,839,0,5282
627,2019-08-18,591,3248,1198,1,5038
627,2019-08-19,662,5308,1393,1,7364
627,2019-08-20,115,6321,976,2,7414
627,2019-08-21,113,13561,1427,0,15101
627,2019-08-22,89,3228,925,2,4244
627,2019-08-23,104,2491,1515,2,4112
627,2019-08-24,684,2964,1380,0,5028
627,2019-08-25,121,3893,1260,0,5274
627,2019-08-26,142,3018,1530,2,4692
627,2019-08-27,110,16813,2448,3,19374
627,2019-08-28,105,3312,2272,1,5690
627,2019-08-29,1026,10369,2021,1,13417
627,2019-08-30,70,5567,542,1,6180
627,2019-08-31,42,8528,30,0,8600
627,2019-09-01,55,3131,93,1,3280
627,2019-09-02,46,7614,117,0,7777
627,2019-09-03,113,6099,972,0,7184
627,2019-09-04,121,18737,1710,3,20571
627,2019-09-05,110,16206,1421,4,17741
627,2019-09-06,1013,11812,2062,1,14888
627,2019-09-07,1010,33090,1715,1,35816
627,2019-09-08,1073,7267,2060,1,10401
627,2019-09-09,943,12435,2112,0,15490
627,2019-09-10,128,7963,2238,2,10331
627,2019-09-11,221,7003,2287,1,9512
627,2019-09-12,99,28502,1695,3,30299
627,2019-09-13,1186,3808,1571,4,6569
627,2019-09-14,73,9928,1357,2,11360
627,2019-09-15,1008,4956,1896,2,7862
627,2019-09-16,319,5876,1637,5,7837
627,2019-09-17,87,23546,2320,11,25964
627,2019-09-18,932,20722,874,10,22538
627,2019-09-19,304,4790,1532,10,6636
627,2019-09-20,218,11356,1005,9,12588
627,2019-09-21,938,9354,1532,10,11834
627,2019-09-22,102,15549,2037,8,17696
627,2019-09-23,194,9851,2207,12,12264
627,2019-09-24,170,16018,2519,12,18719
627,2019-09-25,1873,12623,1945,12,16453
627,2019-09-26,129,9317,1958,11,11415
627,2019-09-27,99,8422,2340,11,10872
627,2019-09-28,163,12722,1342,2,14229
627,2019-09-29,82,17746,2642,2,20472
627,2019-09-30,92,26635,1815,0,28542
627,2019-10-01,104,22562,1778,0,24444
627,2019-10-02,853,14407,2327,6,17593
627,2019-10-03,1542,13712,1895,9,17158
627,2019-10-04,912,11562,1636,10,14120
627,2019-10-05,1992,21823,1134,11,24960
627,2019-10-06,78,17686,1717,10,19491
627,2019-10-07,108,6888,1181,15,8192
627,2019-10-08,989,40505,897,12,42403
627,2019-10-09,168,34254,1293,10,35725
627,2019-10-10,196,36266,1214,11,37687
627,2019-10-11,153,10994,1587,10,12744
627,2019-10-12,159,5714,1780,3,7656
627,2019-10-13,164,11121,1624,0,12909
627,2019-10-14,78,3949,1977,1,6005
627,2019-10-15,125,8353,1378,0,9856
627,2019-10-16,1308,22760,1235,0,25303
627,2019-10-17,1910,10017,2697,3,14627
627,2019-10-18,1488,8195,1342,1,11026
627,2019-10-19,143,7994,1720,0,9857
627,2019-10-20,2732,1895,1645,0,6272
627,2019-10-21,131,9961,1814,0,11906
627,2019-10-22,101,4843,1938,2,6884
627,2019-10-23,71,7048,2415,1,9535
627,2019-10-24,212,13537,2155,0,15904
627,2019-10-25,126,9739,1672,2,11539
627,2019-10-26,1087,14277,2173,0,17537
627,2019-10-27,183,15326,2355,3,17867
627,2019-10-28,914,15157,2752,1,18824
627,2019-10-29,301,14942,1548,1,16792
627,2019-10-30,131,16312,1181,0,17624
627,2019-10-31,100,11572,2045,1,13718
627,2019-11-01,99,13728,1094,3,14924
627,2019-11-02,150,14894,846,1,15891
627,2019-11-03,97,22698,1763,1,24559
627,2019-11-04,223,9616,2625,1,12465
627,2019-11-05,144,2293,2419,0,4856
627,2019-11-06,455,7396,1989,3,9843
627,2019-11-07,193,13104,1952,3,15252
627,2019-11-08,345,9792,1842,0,11979
627,2019-11-09,176,7965,1515,0,9656
627,2019-11-10,126,12606,1544,0,14276
627,2019-11-11,179,8631,1026,2,9838
627,2019-11-12,233,9022,2722,0,11977
627,2019-11-13,926,11560,2231,0,14717
627,2019-11-14,903,8414,2173,0,11490
627,2019-11-15,210,5310,2241,0,7761
627,2019-11-16,1649,3188,1479,0,6316
627,2019-11-17,225,3437,3787,0,7449
627,2019-11-18,166,2928,3646,0,6740
627,2019-11-19,368,6504,3417,0,10289
627,2019-11-20,147,1893,1896,0,3936
627,2019-11-21,456,6451,2241,0,9148
627,2019-11-22,153,8414,2295,0,10862
627,2019-11-23,124,7319,2439,1,9883
627,2019-11-24,258,5871,2027,0,8156
627,2019-11-25,537,9245,1748,0,11530
627,2019-11-26,1626,7495,1656,2,10779
627,2019-11-27,1731,7898,1659,0,11288
627,2019-11-28,109,7132,1078,0,8319
627,2019-11-29,47,381,2,0,430
627,2019-08-01,64,32948,217,0,33229
627,2019-08-02,77,28329,228,1,28635
627,2019-08-03,274,6767,484,2,7527
627,2019-08-04,85,1466,55,0,1606
627,2019-08-05,113,1579,413,0,2105
627,2019-08-06,95,1980,382,0,2457
627,2019-08-07,390,4604,312,1,5307
627,2019-08-08,76,1652,380,2,2110
627,2019-08-09,50,1575,317,1,1943
627,2019-08-10,59,32439,253,0,32751
627,2019-08-11,75,16332,109,0,16516
627,2019-08-12,174,1855,43,0,2072
627,2019-08-13,215,16465,256,1,16937
627,2019-08-14,62,10866,243,0,11171
627,2019-08-15,53,1853,57,1,1964
627,2019-08-16,64,3544,293,0,3901
627,2019-08-17,63,4380,839,0,5282
627,2019-08-18,591,3248,1198,1,5038
627,2019-08-19,662,5308,1393,1,7364
627,2019-08-20,115,6321,976,2,7414
627,2019-08-21,113,13561,1427,0,15101
627,2019-08-22,89,3228,925,2,4244
627,2019-08-23,104,2491,1515,2,4112
627,2019-08-24,684,2964,1380,0,5028
627,2019-08-25,121,3893,1260,0,5274
627,2019-08-26,142,3018,1530,2,4692
627,2019-08-27,110,16813,2448,3,19374
627,2019-08-28,105,3312,2272,1,5690
627,2019-08-29,1026,10369,2021,1,13417
627,2019-08-30,70,5567,542,1,6180
627,2019-08-31,42,8528,30,0,8600
627,2019-09-01,55,3131,93,1,3280
627,2019-09-02,46,7614,117,0,7777
627,2019-09-03,113,6099,972,0,7184
627,2019-09-04,121,18737,1710,3,20571
627,2019-09-05,110,16206,1421,4,17741
627,2019-09-06,1013,11812,2062,1,14888
627,2019-09-07,1010,33090,1715,1,35816
627,2019-09-08,1073,7267,2060,1,10401
627,2019-09-09,943,12435,2112,0,15490
627,2019-09-10,128,7963,2238,2,10331
627,2019-09-11,221,7003,2287,1,9512
627,2019-09-12,99,28502,1695,3,30299
627,2019-09-13,1186,3808,1571,4,6569
627,2019-09-14,73,9928,1357,2,11360
627,2019-09-15,1008,4956,1896,2,7862
627,2019-09-16,319,5876,1637,5,7837
627,2019-09-17,87,23546,2320,11,25964
627,2019-09-18,932,20722,874,10,22538
627,2019-09-19,304,4790,1532,10,6636
627,2019-09-20,218,11356,1005,9,12588
627,2019-09-21,938,9354,1532,10,11834
627,2019-09-22,102,15549,2037,8,17696
627,2019-09-23,194,9851,2207,12,12264
627,2019-09-24,170,16018,2519,12,18719
627,2019-09-25,1873,12623,1945,12,16453
627,2019-09-26,129,9317,1958,11,11415
627,2019-09-27,99,8422,2340,11,10872
627,2019-09-28,163,12722,1342,2,14229
627,2019-09-29,82,17746,2642,2,20472
627,2019-09-30,92,26635,1815,0,28542
627,2019-10-01,104,22562,1778,0,24444
627,2019-10-02,853,14407,2327,6,17593
627,2019-10-03,1542,13712,1895,9,17158
627,2019-10-04,912,11562,1636,10,14120
627,2019-10-05,1992,21823,1134,11,24960
627,2019-10-06,78,17686,1717,10,19491
627,2019-10-07,108,6888,1181,15,8192
627,2019-10-08,989,40505,897,12,42403
627,2019-10-09,168,34254,1293,10,35725
627,2019-10-10,196,36266,1214,11,37687
627,2019-10-11,153,10994,1587,10,12744
627,2019-10-12,159,5714,1780,3,7656
627,2019-10-13,164,11121,1624,0,12909
627,2019-10-14,78,3949,1977,1,6005
627,2019-10-15,125,8353,1378,0,9856
627,2019-10-16,1308,22760,1235,0,25303
627,2019-10-17,1910,10017,2697,3,14627
627,2019-10-18,1488,8195,1342,1,11026
627,2019-10-19,143,7994,1720,0,9857
627,2019-10-20,2732,1895,1645,0,6272
627,2019-10-21,131,9961,1814,0,11906
627,2019-10-22,101,4843,1938,2,6884
627,2019-10-23,71,7048,2415,1,9535
627,2019-10-24,212,13537,2155,0,15904
627,2019-10-25,126,9739,1672,2,11539
627,2019-10-26,1087,14277,2173,0,17537
627,2019-10-27,183,15326,2355,3,17867
627,2019-10-28,914,15157,2752,1,18824
627,2019-10-29,301,14942,1548,1,16792
627,2019-10-30,131,16312,1181,0,17624
627,2019-10-31,100,11572,2045,1,13718
627,2019-11-01,99,13728,1094,3,14924
627,2019-11-02,150,14894,846,1,15891
627,2019-11-03,97,22698,1763,1,24559
627,2019-11-04,223,9616,2625,1,12465
627,2019-11-05,144,2293,2419,0,4856
627,2019-11-06,455,7396,1989,3,9843
627,2019-11-07,193,13104,1952,3,15252
627,2019-11-08,345,9792,1842,0,11979
627,2019-11-09,176,7965,1515,0,9656
627,2019-11-10,126,12606,1544,0,14276
627,2019-11-11,179,8631,1026,2,9838
627,2019-11-12,233,9022,2722,0,11977
627,2019-11-13,926,11560,2231,0,14717
627,2019-11-14,903,8414,2173,0,11490
627,2019-11-15,210,5310,2241,0,7761
627,2019-11-16,1649,3188,1479,0,6316
627,2019-11-17,225,3437,3787,0,7449
627,2019-11-18,166,2928,3646,0,6740
627,2019-11-19,368,6504,3417,0,10289
627,2019-11-20,147,1893,1896,0,3936
627,2019-11-21,456,6451,2241,0,9148
627,2019-11-22,153,8414,2295,0,10862
627,2019-11-23,124,7319,2439,1,9883
627,2019-11-24,258,5871,2027,0,8156
627,2019-11-25,537,9245,1748,0,11530
627,2019-11-26,1626,7495,1656,2,10779
627,2019-11-27,1731,7898,1659,0,11288
627,2019-11-28,109,7132,1078,0,8319
627,2019-11-29,47,381,2,0,430
627,2019-08-01,64,32948,217,0,33229
627,2019-08-02,77,28329,228,1,28635
627,2019-08-03,274,6767,484,2,7527
627,2019-08-04,85,1466,55,0,1606
627,2019-08-05,113,1579,413,0,2105
627,2019-08-06,95,1980,382,0,2457
627,2019-08-07,390,4604,312,1,5307
627,2019-08-08,76,1652,380,2,2110
627,2019-08-09,50,1575,317,1,1943
627,2019-08-10,59,32439,253,0,32751
627,2019-08-11,75,16332,109,0,16516
627,2019-08-12,174,1855,43,0,2072
627,2019-08-13,215,16465,256,1,16937
627,2019-08-14,62,10866,243,0,11171
627,2019-08-15,53,1853,57,1,1964
627,2019-08-16,64,3544,293,0,3901
627,2019-08-17,63,4380,839,0,5282
627,2019-08-18,591,3248,1198,1,5038
627,2019-08-19,662,5308,1393,1,7364
627,2019-08-20,115,6321,976,2,7414
627,2019-08-21,113,13561,1427,0,15101
627,2019-08-22,89,3228,925,2,4244
627,2019-08-23,104,2491,1515,2,4112
627,2019-08-24,684,2964,1380,0,5028
627,2019-08-25,121,3893,1260,0,5274
627,2019-08-26,142,3018,1530,2,4692
627,2019-08-27,110,16813,2448,3,19374
627,2019-08-28,105,3312,2272,1,5690
627,2019-08-29,1026,10369,2021,1,13417
627,2019-08-30,70,5567,542,1,6180
627,2019-08-31,42,8528,30,0,8600
627,2019-09-01,55,3131,93,1,3280
627,2019-09-02,46,7614,117,0,7777
627,2019-09-03,113,6099,972,0,7184
627,2019-09-04,121,18737,1710,3,20571
627,2019-09-05,110,16206,1421,4,17741
627,2019-09-06,1013,11812,2062,1,14888
627,2019-09-07,1010,33090,1715,1,35816
627,2019-09-08,1073,7267,2060,1,10401
627,2019-09-09,943,12435,2112,0,15490
627,2019-09-10,128,7963,2238,2,10331
627,2019-09-11,221,7003,2287,1,9512
627,2019-09-12,99,28502,1695,3,30299
627,2019-09-13,1186,3808,1571,4,6569
627,2019-09-14,73,9928,1357,2,11360
627,2019-09-15,1008,4956,1896,2,7862
627,2019-09-16,319,5876,1637,5,7837
627,2019-09-17,87,23546,2320,11,25964
627,2019-09-18,932,20722,874,10,22538
627,2019-09-19,304,4790,1532,10,6636
627,2019-09-20,218,11356,1005,9,12588
627,2019-09-21,938,9354,1532,10,11834
627,2019-09-22,102,15549,2037,8,17696
627,2019-09-23,194,9851,2207,12,12264
627,2019-09-24,170,16018,2519,12,18719
627,2019-09-25,1873,12623,1945,12,16453
627,2019-09-26,129,9317,1958,11,11415
627,2019-09-27,99,8422,2340,11,10872
627,2019-09-28,163,12722,1342,2,14229
627,2019-09-29,82,17746,2642,2,20472
627,2019-09-30,92,26635,1815,0,28542
627,2019-10-01,104,22562,1778,0,24444
627,2019-10-02,853,14407,2327,6,17593
627,2019-10-03,1542,13712,1895,9,17158
627,2019-10-04,912,11562,1636,10,14120
627,2019-10-05,1992,21823,1134,11,24960
627,2019-10-06,78,17686,1717,10,19491
627,2019-10-07,108,6888,1181,15,8192
627,2019-10-08,989,40505,897,12,42403
627,2019-10-09,168,34254,1293,10,35725
627,2019-10-10,196,36266,1214,11,37687
627,2019-10-11,153,10994,1587,10,12744
627,2019-10-12,159,5714,1780,3,7656
627,2019-10-13,164,11121,1624,0,12909
627,2019-10-14,78,3949,1977,1,6005
627,2019-10-15,125,8353,1378,0,9856
627,2019-10-16,1308,22760,1235,0,25303
627,2019-10-17,1910,10017,2697,3,14627
627,2019-10-18,1488,8195,1342,1,11026
627,2019-10-19,143,7994,1720,0,9857
627,2019-10-20,2732,1895,1645,0,6272
627,2019-10-21,131,9961,1814,0,11906
627,2019-10-22,101,4843,1938,2,6884
627,2019-10-23,71,7048,2415,1,9535
627,2019-10-24,212,13537,2155,0,15904
627,2019-10-25,126,9739,1672,2,11539
627,2019-10-26,1087,14277,2173,0,17537
627,2019-10-27,183,15326,2355,3,17867
627,2019-10-28,914,15157,2752,1,18824
627,2019-10-29,301,14942,1548,1,16792
627,2019-10-30,131,16312,1181,0,17624
627,2019-10-31,100,11572,2045,1,13718
627,2019-11-01,99,13728,1094,3,14924
627,2019-11-02,150,14894,846,1,15891
627,2019-11-03,97,22698,1763,1,24559
627,2019-11-04,223,9616,2625,1,12465
627,2019-11-05,144,2293,2419,0,4856
627,2019-11-06,455,7396,1989,3,9843
627,2019-11-07,193,13104,1952,3,15252
627,2019-11-08,345,9792,1842,0,11979
627,2019-11-09,176,7965,1515,0,9656
627,2019-11-10,126,12606,1544,0,14276
627,2019-11-11,179,8631,1026,2,9838
627,2019-11-12,233,9022,2722,0,11977
627,2019-11-13,926,11560,2231,0,14717
627,2019-11-14,903,8414,2173,0,11490
627,2019-11-15,210,5310,2241,0,7761
627,2019-11-16,1649,3188,1479,0,6316
627,2019-11-17,225,3437,3787,0,7449
627,2019-11-18,166,2928,3646,0,6740
627,2019-11-19,368,6504,3417,0,10289
627,2019-11-20,147,1893,1896,0,3936
627,2019-11-21,456,6451,2241,0,9148
627,2019-11-22,153,8414,2295,0,10862
627,2019-11-23,124,7319,2439,1,9883
627,2019-11-24,258,5871,2027,0,8156
627,2019-11-25,537,9245,1748,0,11530
627,2019-11-26,1626,7495,1656,2,10779
627,2019-11-27,1731,7898,1659,0,11288
627,2019-11-28,109,7132,1078,0,8319
627,2019-11-29,47,381,2,0,430
627,2019-08-02,77,28329,228,1,28635
627,2019-08-03,274,6767,484,2,7527
627,2019-08-04,85,1466,55,0,1606
627,2019-08-05,113,1579,413,0,2105
627,2019-08-06,95,1980,382,0,2457
627,2019-08-07,390,4604,312,1,5307
627,2019-08-08,76,1652,380,2,2110
627,2019-08-09,50,1575,317,1,1943
627,2019-08-10,59,32439,253,0,32751
627,2019-08-11,75,16332,109,0,16516
627,2019-08-12,174,1855,43,0,2072
627,2019-08-13,215,16465,256,1,16937
627,2019-08-14,62,10866,243,0,11171
627,2019-08-15,53,1853,57,1,1964
627,2019-08-16,64,3544,293,0,3901
627,2019-08-17,63,4380,839,0,5282
627,2019-08-18,591,3248,1198,1,5038
627,2019-08-19,662,5308,1393,1,7364
627,2019-08-20,115,6321,976,2,7414
627,2019-08-21,113,13561,1427,0,15101
627,2019-08-22,89,3228,925,2,4244
627,2019-08-23,104,2491,1515,2,4112
627,2019-08-24,684,2964,1380,0,5028
627,2019-08-25,121,3893,1260,0,5274
627,2019-08-26,142,3018,1530,2,4692
627,2019-08-27,110,16813,2448,3,19374
627,2019-08-28,105,3312,2272,1,5690
627,2019-08-29,1026,10369,2021,1,13417
627,2019-08-30,70,5567,542,1,6180
627,2019-08-31,42,8528,30,0,8600
627,2019-09-01,55,3131,93,1,3280
627,2019-09-02,46,7614,117,0,7777
627,2019-09-03,113,6099,972,0,7184
627,2019-09-04,121,18737,1710,3,20571
627,2019-09-05,110,16206,1421,4,17741
627,2019-09-06,1013,11812,2062,1,14888
627,2019-09-07,1010,33090,1715,1,35816
627,2019-09-08,1073,7267,2060,1,10401
627,2019-09-09,943,12435,2112,0,15490
627,2019-09-10,128,7963,2238,2,10331
627,2019-09-11,221,7003,2287,1,9512
627,2019-09-12,99,28502,1695,3,30299
627,2019-09-13,1186,3808,1571,4,6569
627,2019-09-14,73,9928,1357,2,11360
627,2019-09-15,1008,4956,1896,2,7862
627,2019-09-16,319,5876,1637,5,7837
627,2019-09-17,87,23546,2320,11,25964
627,2019-09-18,932,20722,874,10,22538
627,2019-09-19,304,4790,1532,10,6636
627,2019-09-20,218,11356,1005,9,12588
627,2019-09-21,938,9354,1532,10,11834
627,2019-09-22,102,15549,2037,8,17696
627,2019-09-23,194,9851,2207,12,12264
627,2019-09-24,170,16018,2519,12,18719
627,2019-09-25,1873,12623,1945,12,16453
627,2019-09-26,129,9317,1958,11,11415
627,2019-09-27,99,8422,2340,11,10872
627,2019-09-28,163,12722,1342,2,14229
627,2019-09-29,82,17746,2642,2,20472
627,2019-09-30,92,26635,1815,0,28542
627,2019-10-01,104,22562,1778,0,24444
627,2019-10-02,853,14407,2327,6,17593
627,2019-10-03,1542,13712,1895,9,17158
627,2019-10-04,912,11562,1636,10,14120
627,2019-10-05,1992,21823,1134,11,24960
627,2019-10-06,78,17686,1717,10,19491
627,2019-10-07,108,6888,1181,15,8192
627,2019-10-08,989,40505,897,12,42403
627,2019-10-09,168,34254,1293,10,35725
627,2019-10-10,196,36266,1214,11,37687
627,2019-10-11,153,10994,1587,10,12744
627,2019-10-12,159,5714,1780,3,7656
627,2019-10-13,164,11121,1624,0,12909
627,2019-10-14,78,3949,1977,1,6005
627,2019-10-15,125,8353,1378,0,9856
627,2019-10-16,1308,22760,1235,0,25303
627,2019-10-17,1910,10017,2697,3,14627
627,2019-10-18,1488,8195,1342,1,11026
627,2019-10-19,143,7994,1720,0,9857
627,2019-10-20,2732,1895,1645,0,6272
627,2019-10-21,131,9961,1814,0,11906
627,2019-10-22,101,4843,1938,2,6884
627,2019-10-23,71,7048,2415,1,9535
627,2019-10-24,212,13537,2155,0,15904
627,2019-10-25,126,9739,1672,2,11539
627,2019-10-26,1087,14277,2173,0,17537
627,2019-10-27,183,15326,2355,3,17867
627,2019-10-28,914,15157,2752,1,18824
627,2019-10-29,301,14942,1548,1,16792
627,2019-10-30,131,16312,1181,0,17624
627,2019-10-31,100,11572,2045,1,13718
627,2019-11-01,99,13728,1094,3,14924
627,2019-11-02,150,14894,846,1,15891
627,2019-11-03,97,22698,1763,1,24559
627,2019-11-04,223,9616,2625,1,12465
627,2019-11-05,144,2293,2419,0,4856
627,2019-11-06,455,7396,1989,3,9843
627,2019-11-07,193,13104,1952,3,15252
627,2019-11-08,345,9792,1842,0,11979
627,2019-11-09,176,7965,1515,0,9656
627,2019-11-10,126,12606,1544,0,14276
627,2019-11-11,179,8631,1026,2,9838
627,2019-11-12,233,9022,2722,0,11977
627,2019-11-13,926,11560,2231,0,14717
627,2019-11-14,903,8414,2173,0,11490
627,2019-11-15,210,5310,2241,0,7761
627,2019-11-16,1649,3188,1479,0,6316
627,2019-11-17,225,3437,3787,0,7449
627,2019-11-18,166,2928,3646,0,6740
627,2019-11-19,368,6504,3417,0,10289
627,2019-11-20,147,1893,1896,0,3936
627,2019-11-21,456,6451,2241,0,9148
627,2019-11-22,153,8414,2295,0,10862
627,2019-11-23,124,7319,2439,1,9883
627,2019-11-24,258,5871,2027,0,8156
627,2019-11-25,537,9245,1748,0,11530
627,2019-11-26,1626,7495,1656,2,10779
628,2019-08-01,640,25337,635,0,26612
628,2019-08-02,481,42552,81,1,43115
628,2019-08-03,497,14627,239,0,15363
628,2019-08-04,533,623,535,1,1692
628,2019-08-05,681,736,257,0,1674
628,2019-08-06,788,4513,658,0,5959
628,2019-08-07,393,3179,115,0,3687
628,2019-08-08,806,584,473,0,1863
628,2019-08-09,523,1238,190,0,1951
628,2019-08-10,384,1671,140,0,2195
628,2019-08-11,693,1396,144,0,2233
628,2019-08-12,462,1105,108,0,1675
628,2019-08-13,403,2550,103,1,3057
628,2019-08-14,465,5362,15,0,5842
628,2019-08-15,407,1072,39,0,1518
628,2019-08-16,387,2295,97,1,2780
628,2019-08-17,371,4067,512,3,4953
628,2019-08-18,499,2992,1417,1,4909
628,2019-08-19,2018,3388,1190,1,6597
628,2019-08-20,615,5664,630,0,6909
628,2019-08-21,412,2678,1689,0,4779
628,2019-08-22,1909,2445,1224,1,5579
628,2019-08-23,675,2669,1797,1,5142
628,2019-08-24,509,5562,2030,1,8102
628,2019-08-25,2203,14546,1170,0,17919
628,2019-08-26,614,15208,1350,2,17174
628,2019-08-27,552,10533,1669,1,12755
628,2019-08-28,531,1872,1230,2,3635
628,2019-08-29,1828,11596,1448,1,14873
628,2019-08-30,329,4232,814,1,5376
628,2019-08-31,178,678,1,0,857
628,2019-09-01,192,769,291,0,1252
628,2019-09-02,234,242,110,0,586
628,2019-09-03,366,1094,1950,1,3411
628,2019-09-04,459,12754,1522,3,14738
628,2019-09-05,2072,8485,1613,1,12171
628,2019-09-06,562,12368,2341,0,15271
628,2019-09-07,451,18509,1947,0,20907
628,2019-09-08,474,5156,2295,0,7925
628,2019-09-09,377,14028,2324,1,16730
628,2019-09-10,313,11917,2426,1,14657
628,2019-09-11,354,6101,2171,2,8628
628,2019-09-12,809,8019,2036,2,10866
628,2019-09-13,1272,4704,1732,2,7710
628,2019-09-14,2015,6941,1884,1,10841
628,2019-09-15,260,8867,1904,1,11032
628,2019-09-16,1183,8965,1968,5,12121
628,2019-09-17,906,10334,1929,7,13176
628,2019-09-18,448,20352,1312,8,22120
628,2019-09-19,672,5626,2611,8,8917
628,2019-09-20,566,16302,1709,9,18586
628,2019-09-21,361,9935,1462,11,11769
628,2019-09-22,465,9398,1587,9,11459
628,2019-09-23,614,10443,1652,10,12719
628,2019-09-24,419,7079,1678,10,9186
628,2019-09-25,671,6240,1416,10,8337
628,2019-09-26,514,12847,1688,13,15062
628,2019-09-27,526,7304,1651,8,9489
628,2019-09-28,1179,21342,1242,4,23767
628,2019-09-29,1257,18391,1098,2,20748
628,2019-09-30,771,25919,1568,1,28259
628,2019-10-01,447,21581,1836,1,23865
628,2019-10-02,1802,14193,2139,8,18142
628,2019-10-03,1360,21059,2023,11,24453
628,2019-10-04,395,20134,2099,9,22637
628,2019-10-05,653,15851,904,12,17420
628,2019-10-06,460,10521,1872,10,12863
628,2019-10-07,379,6155,1590,13,8137
628,2019-10-08,540,10933,858,10,12341
628,2019-10-09,591,13806,2354,10,16761
628,2019-10-10,1655,8593,1338,12,11598
628,2019-10-11,1521,9596,1826,10,12953
628,2019-10-12,354,5469,1966,1,7790
628,2019-10-13,1270,7196,1511,2,9979
628,2019-10-14,359,4020,2065,1,6445
628,2019-10-15,838,7950,2022,0,10810
628,2019-10-16,330,11681,1712,5,13728
628,2019-10-17,334,4178,1491,17,6020
628,2019-10-18,774,7224,1507,0,9505
628,2019-10-19,394,6622,2085,0,9101
628,2019-10-20,1492,865,1477,0,3834
628,2019-10-21,492,10559,1836,5,12892
628,2019-10-22,1211,4574,1621,0,7406
628,2019-10-23,479,13000,1250,2,14731
628,2019-10-24,1446,24516,1697,0,27659
628,2019-10-25,492,13388,1218,3,15101
628,2019-10-26,1826,12248,2735,8,16817
628,2019-10-27,379,14757,2587,1,17724
628,2019-10-28,363,22152,2815,0,25330
628,2019-10-29,468,16754,2313,0,19535
628,2019-10-30,375,23515,1162,1,25053
628,2019-10-31,1359,13410,1606,3,16378
628,2019-11-01,338,13516,1469,0,15323
628,2019-11-02,356,13031,1801,0,15188
628,2019-11-03,357,35826,1258,0,37441
628,2019-11-04,770,12012,1098,0,13880
628,2019-11-05,448,1155,2780,1,4384
628,2019-11-06,1297,6983,1716,2,9998
628,2019-11-07,778,12326,1787,0,14891
628,2019-11-08,568,8401,2380,0,11349
628,2019-11-09,395,11821,1869,0,14085
628,2019-11-10,1276,11686,2028,2,14992
628,2019-11-11,375,7557,1555,4,9491
628,2019-11-12,679,8471,2880,0,12030
628,2019-11-13,403,13086,1675,2,15166
628,2019-11-14,1217,7445,1992,1,10655
628,2019-11-15,457,3285,2320,0,6062
628,2019-11-16,357,896,2124,2,3379
628,2019-11-17,292,2879,2729,0,5900
628,2019-11-18,458,2013,3182,2,5655
628,2019-11-19,449,2961,2402,2,5814
628,2019-11-20,1262,1280,1444,2,3988
628,2019-11-21,365,5104,2262,0,7731
628,2019-11-22,248,4440,1391,2,6081
628,2019-11-23,326,9146,3043,0,12515
628,2019-11-24,1582,8894,1763,0,12239
628,2019-11-25,301,10094,2669,0,13064
628,2019-11-26,202,9544,2588,0,12334
628,2019-11-27,526,5195,1608,0,7329
628,2019-11-28,573,11746,853,0,13172
628,2019-11-29,53,947,4,0,1004
628,2019-08-01,640,25337,635,0,26612
628,2019-08-02,481,42552,81,1,43115
628,2019-08-03,497,14627,239,0,15363
628,2019-08-04,533,623,535,1,1692
628,2019-08-05,681,736,257,0,1674
628,2019-08-06,788,4513,658,0,5959
628,2019-08-07,393,3179,115,0,3687
628,2019-08-08,806,584,473,0,1863
628,2019-08-09,523,1238,190,0,1951
628,2019-08-10,384,1671,140,0,2195
628,2019-08-11,693,1396,144,0,2233
628,2019-08-12,462,1105,108,0,1675
628,2019-08-13,403,2550,103,1,3057
628,2019-08-14,465,5362,15,0,5842
628,2019-08-15,407,1072,39,0,1518
628,2019-08-16,387,2295,97,1,2780
628,2019-08-17,371,4067,512,3,4953
628,2019-08-18,499,2992,1417,1,4909
628,2019-08-19,2018,3388,1190,1,6597
628,2019-08-20,615,5664,630,0,6909
628,2019-08-21,412,2678,1689,0,4779
628,2019-08-22,1909,2445,1224,1,5579
628,2019-08-23,675,2669,1797,1,5142
628,2019-08-24,509,5562,2030,1,8102
628,2019-08-25,2203,14546,1170,0,17919
628,2019-08-26,614,15208,1350,2,17174
628,2019-08-27,552,10533,1669,1,12755
628,2019-08-28,531,1872,1230,2,3635
628,2019-08-29,1828,11596,1448,1,14873
628,2019-08-30,329,4232,814,1,5376
628,2019-08-31,178,678,1,0,857
628,2019-09-01,192,769,291,0,1252
628,2019-09-02,234,242,110,0,586
628,2019-09-03,366,1094,1950,1,3411
628,2019-09-04,459,12754,1522,3,14738
628,2019-09-05,2072,8485,1613,1,12171
628,2019-09-06,562,12368,2341,0,15271
628,2019-09-07,451,18509,1947,0,20907
628,2019-09-08,474,5156,2295,0,7925
628,2019-09-09,377,14028,2324,1,16730
628,2019-09-10,313,11917,2426,1,14657
628,2019-09-11,354,6101,2171,2,8628
628,2019-09-12,809,8019,2036,2,10866
628,2019-09-13,1272,4704,1732,2,7710
628,2019-09-14,2015,6941,1884,1,10841
628,2019-09-15,260,8867,1904,1,11032
628,2019-09-16,1183,8965,1968,5,12121
628,2019-09-17,906,10334,1929,7,13176
628,2019-09-18,448,20352,1312,8,22120
628,2019-09-19,672,5626,2611,8,8917
628,2019-09-20,566,16302,1709,9,18586
628,2019-09-21,361,9935,1462,11,11769
628,2019-09-22,465,9398,1587,9,11459
628,2019-09-23,614,10443,1652,10,12719
628,2019-09-24,419,7079,1678,10,9186
628,2019-09-25,671,6240,1416,10,8337
628,2019-09-26,514,12847,1688,13,15062
628,2019-09-27,526,7304,1651,8,9489
628,2019-09-28,1179,21342,1242,4,23767
628,2019-09-29,1257,18391,1098,2,20748
628,2019-09-30,771,25919,1568,1,28259
628,2019-10-01,447,21581,1836,1,23865
628,2019-10-02,1802,14193,2139,8,18142
628,2019-10-03,1360,21059,2023,11,24453
628,2019-10-04,395,20134,2099,9,22637
628,2019-10-05,653,15851,904,12,17420
628,2019-10-06,460,10521,1872,10,12863
628,2019-10-07,379,6155,1590,13,8137
628,2019-10-08,540,10933,858,10,12341
628,2019-10-09,591,13806,2354,10,16761
628,2019-10-10,1655,8593,1338,12,11598
628,2019-10-11,1521,9596,1826,10,12953
628,2019-10-12,354,5469,1966,1,7790
628,2019-10-13,1270,7196,1511,2,9979
628,2019-10-14,359,4020,2065,1,6445
628,2019-10-15,838,7950,2022,0,10810
628,2019-10-16,330,11681,1712,5,13728
628,2019-10-17,334,4178,1491,17,6020
628,2019-10-18,774,7224,1507,0,9505
628,2019-10-19,394,6622,2085,0,9101
628,2019-10-20,1492,865,1477,0,3834
628,2019-10-21,492,10559,1836,5,12892
628,2019-10-22,1211,4574,1621,0,7406
628,2019-10-23,479,13000,1250,2,14731
628,2019-10-24,1446,24516,1697,0,27659
628,2019-10-25,492,13388,1218,3,15101
628,2019-10-26,1826,12248,2735,8,16817
628,2019-10-27,379,14757,2587,1,17724
628,2019-10-28,363,22152,2815,0,25330
628,2019-10-29,468,16754,2313,0,19535
628,2019-10-30,375,23515,1162,1,25053
628,2019-10-31,1359,13410,1606,3,16378
628,2019-11-01,338,13516,1469,0,15323
628,2019-11-02,356,13031,1801,0,15188
628,2019-11-03,357,35826,1258,0,37441
628,2019-11-04,770,12012,1098,0,13880
628,2019-11-05,448,1155,2780,1,4384
628,2019-11-06,1297,6983,1716,2,9998
628,2019-11-07,778,12326,1787,0,14891
628,2019-11-08,568,8401,2380,0,11349
628,2019-11-09,395,11821,1869,0,14085
628,2019-11-10,1276,11686,2028,2,14992
628,2019-11-11,375,7557,1555,4,9491
628,2019-11-12,679,8471,2880,0,12030
628,2019-11-13,403,13086,1675,2,15166
628,2019-11-14,1217,7445,1992,1,10655
628,2019-11-15,457,3285,2320,0,6062
628,2019-11-16,357,896,2124,2,3379
628,2019-11-17,292,2879,2729,0,5900
628,2019-11-18,458,2013,3182,2,5655
628,2019-11-19,449,2961,2402,2,5814
628,2019-11-20,1262,1280,1444,2,3988
628,2019-11-21,365,5104,2262,0,7731
628,2019-11-22,248,4440,1391,2,6081
628,2019-11-23,326,9146,3043,0,12515
628,2019-11-24,1582,8894,1763,0,12239
628,2019-11-25,301,10094,2669,0,13064
628,2019-11-26,202,9544,2588,0,12334
628,2019-11-27,526,5195,1608,0,7329
628,2019-11-28,573,11746,853,0,13172
628,2019-11-29,53,947,4,0,1004
628,2019-08-01,640,25337,635,0,26612
628,2019-08-02,481,42552,81,1,43115
628,2019-08-03,497,14627,239,0,15363
628,2019-08-04,533,623,535,1,1692
628,2019-08-05,681,736,257,0,1674
628,2019-08-06,788,4513,658,0,5959
628,2019-08-07,393,3179,115,0,3687
628,2019-08-08,806,584,473,0,1863
628,2019-08-09,523,1238,190,0,1951
628,2019-08-10,384,1671,140,0,2195
628,2019-08-11,693,1396,144,0,2233
628,2019-08-12,462,1105,108,0,1675
628,2019-08-13,403,2550,103,1,3057
628,2019-08-14,465,5362,15,0,5842
628,2019-08-15,407,1072,39,0,1518
628,2019-08-16,387,2295,97,1,2780
628,2019-08-17,371,4067,512,3,4953
628,2019-08-18,499,2992,1417,1,4909
628,2019-08-19,2018,3388,1190,1,6597
628,2019-08-20,615,5664,630,0,6909
628,2019-08-21,412,2678,1689,0,4779
628,2019-08-22,1909,2445,1224,1,5579
628,2019-08-23,675,2669,1797,1,5142
628,2019-08-24,509,5562,2030,1,8102
628,2019-08-25,2203,14546,1170,0,17919
628,2019-08-26,614,15208,1350,2,17174
628,2019-08-27,552,10533,1669,1,12755
628,2019-08-28,531,1872,1230,2,3635
628,2019-08-29,1828,11596,1448,1,14873
628,2019-08-30,329,4232,814,1,5376
628,2019-08-31,178,678,1,0,857
628,2019-09-01,192,769,291,0,1252
628,2019-09-02,234,242,110,0,586
628,2019-09-03,366,1094,1950,1,3411
628,2019-09-04,459,12754,1522,3,14738
628,2019-09-05,2072,8485,1613,1,12171
628,2019-09-06,562,12368,2341,0,15271
628,2019-09-07,451,18509,1947,0,20907
628,2019-09-08,474,5156,2295,0,7925
628,2019-09-09,377,14028,2324,1,16730
628,2019-09-10,313,11917,2426,1,14657
628,2019-09-11,354,6101,2171,2,8628
628,2019-09-12,809,8019,2036,2,10866
628,2019-09-13,1272,4704,1732,2,7710
628,2019-09-14,2015,6941,1884,1,10841
628,2019-09-15,260,8867,1904,1,11032
628,2019-09-16,1183,8965,1968,5,12121
628,2019-09-17,906,10334,1929,7,13176
628,2019-09-18,448,20352,1312,8,22120
628,2019-09-19,672,5626,2611,8,8917
628,2019-09-20,566,16302,1709,9,18586
628,2019-09-21,361,9935,1462,11,11769
628,2019-09-22,465,9398,1587,9,11459
628,2019-09-23,614,10443,1652,10,12719
628,2019-09-24,419,7079,1678,10,9186
628,2019-09-25,671,6240,1416,10,8337
628,2019-09-26,514,12847,1688,13,15062
628,2019-09-27,526,7304,1651,8,9489
628,2019-09-28,1179,21342,1242,4,23767
628,2019-09-29,1257,18391,1098,2,20748
628,2019-09-30,771,25919,1568,1,28259
628,2019-10-01,447,21581,1836,1,23865
628,2019-10-02,1802,14193,2139,8,18142
628,2019-10-03,1360,21059,2023,11,24453
628,2019-10-04,395,20134,2099,9,22637
628,2019-10-05,653,15851,904,12,17420
628,2019-10-06,460,10521,1872,10,12863
628,2019-10-07,379,6155,1590,13,8137
628,2019-10-08,540,10933,858,10,12341
628,2019-10-09,591,13806,2354,10,16761
628,2019-10-10,1655,8593,1338,12,11598
628,2019-10-11,1521,9596,1826,10,12953
628,2019-10-12,354,5469,1966,1,7790
628,2019-10-13,1270,7196,1511,2,9979
628,2019-10-14,359,4020,2065,1,6445
628,2019-10-15,838,7950,2022,0,10810
628,2019-10-16,330,11681,1712,5,13728
628,2019-10-17,334,4178,1491,17,6020
628,2019-10-18,774,7224,1507,0,9505
628,2019-10-19,394,6622,2085,0,9101
628,2019-10-20,1492,865,1477,0,3834
628,2019-10-21,492,10559,1836,5,12892
628,2019-10-22,1211,4574,1621,0,7406
628,2019-10-23,479,13000,1250,2,14731
628,2019-10-24,1446,24516,1697,0,27659
628,2019-10-25,492,13388,1218,3,15101
628,2019-10-26,1826,12248,2735,8,16817
628,2019-10-27,379,14757,2587,1,17724
628,2019-10-28,363,22152,2815,0,25330
628,2019-10-29,468,16754,2313,0,19535
628,2019-10-30,375,23515,1162,1,25053
628,2019-10-31,1359,13410,1606,3,16378
628,2019-11-01,338,13516,1469,0,15323
628,2019-11-02,356,13031,1801,0,15188
628,2019-11-03,357,35826,1258,0,37441
628,2019-11-04,770,12012,1098,0,13880
628,2019-11-05,448,1155,2780,1,4384
628,2019-11-06,1297,6983,1716,2,9998
628,2019-11-07,778,12326,1787,0,14891
628,2019-11-08,568,8401,2380,0,11349
628,2019-11-09,395,11821,1869,0,14085
628,2019-11-10,1276,11686,2028,2,14992
628,2019-11-11,375,7557,1555,4,9491
628,2019-11-12,679,8471,2880,0,12030
628,2019-11-13,403,13086,1675,2,15166
628,2019-11-14,1217,7445,1992,1,10655
628,2019-11-15,457,3285,2320,0,6062
628,2019-11-16,357,896,2124,2,3379
628,2019-11-17,292,2879,2729,0,5900
628,2019-11-18,458,2013,3182,2,5655
628,2019-11-19,449,2961,2402,2,5814
628,2019-11-20,1262,1280,1444,2,3988
628,2019-11-21,365,5104,2262,0,7731
628,2019-11-22,248,4440,1391,2,6081
628,2019-11-23,326,9146,3043,0,12515
628,2019-11-24,1582,8894,1763,0,12239
628,2019-11-25,301,10094,2669,0,13064
628,2019-11-26,202,9544,2588,0,12334
628,2019-11-27,526,5195,1608,0,7329
628,2019-11-28,573,11746,853,0,13172
628,2019-11-29,53,947,4,0,1004
628,2019-08-02,481,42552,81,1,43115
628,2019-08-03,497,14627,239,0,15363
628,2019-08-04,533,623,535,1,1692
628,2019-08-05,681,736,257,0,1674
628,2019-08-06,788,4513,658,0,5959
628,2019-08-07,393,3179,115,0,3687
628,2019-08-08,806,584,473,0,1863
628,2019-08-09,523,1238,190,0,1951
628,2019-08-10,384,1671,140,0,2195
628,2019-08-11,693,1396,144,0,2233
628,2019-08-12,462,1105,108,0,1675
628,2019-08-13,403,2550,103,1,3057
628,2019-08-14,465,5362,15,0,5842
628,2019-08-15,407,1072,39,0,1518
628,2019-08-16,387,2295,97,1,2780
628,2019-08-17,371,4067,512,3,4953
628,2019-08-18,499,2992,1417,1,4909
628,2019-08-19,2018,3388,1190,1,6597
628,2019-08-20,615,5664,630,0,6909
628,2019-08-21,412,2678,1689,0,4779
628,2019-08-22,1909,2445,1224,1,5579
628,2019-08-23,675,2669,1797,1,5142
628,2019-08-24,509,5562,2030,1,8102
628,2019-08-25,2203,14546,1170,0,17919
628,2019-08-26,614,15208,1350,2,17174
628,2019-08-27,552,10533,1669,1,12755
628,2019-08-28,531,1872,1230,2,3635
628,2019-08-29,1828,11596,1448,1,14873
628,2019-08-30,329,4232,814,1,5376
628,2019-08-31,178,678,1,0,857
628,2019-09-01,192,769,291,0,1252
628,2019-09-02,234,242,110,0,586
628,2019-09-03,366,1094,1950,1,3411
628,2019-09-04,459,12754,1522,3,14738
628,2019-09-05,2072,8485,1613,1,12171
628,2019-09-06,562,12368,2341,0,15271
628,2019-09-07,451,18509,1947,0,20907
628,2019-09-08,474,5156,2295,0,7925
628,2019-09-09,377,14028,2324,1,16730
628,2019-09-10,313,11917,2426,1,14657
628,2019-09-11,354,6101,2171,2,8628
628,2019-09-12,809,8019,2036,2,10866
628,2019-09-13,1272,4704,1732,2,7710
628,2019-09-14,2015,6941,1884,1,10841
628,2019-09-15,260,8867,1904,1,11032
628,2019-09-16,1183,8965,1968,5,12121
628,2019-09-17,906,10334,1929,7,13176
628,2019-09-18,448,20352,1312,8,22120
628,2019-09-19,672,5626,2611,8,8917
628,2019-09-20,566,16302,1709,9,18586
628,2019-09-21,361,9935,1462,11,11769
628,2019-09-22,465,9398,1587,9,11459
628,2019-09-23,614,10443,1652,10,12719
628,2019-09-24,419,7079,1678,10,9186
628,2019-09-25,671,6240,1416,10,8337
628,2019-09-26,514,12847,1688,13,15062
628,2019-09-27,526,7304,1651,8,9489
628,2019-09-28,1179,21342,1242,4,23767
628,2019-09-29,1257,18391,1098,2,20748
628,2019-09-30,771,25919,1568,1,28259
628,2019-10-01,447,21581,1836,1,23865
628,2019-10-02,1802,14193,2139,8,18142
628,2019-10-03,1360,21059,2023,11,24453
628,2019-10-04,395,20134,2099,9,22637
628,2019-10-05,653,15851,904,12,17420
628,2019-10-06,460,10521,1872,10,12863
628,2019-10-07,379,6155,1590,13,8137
628,2019-10-08,540,10933,858,10,12341
628,2019-10-09,591,13806,2354,10,16761
628,2019-10-10,1655,8593,1338,12,11598
628,2019-10-11,1521,9596,1826,10,12953
628,2019-10-12,354,5469,1966,1,7790
628,2019-10-13,1270,7196,1511,2,9979
628,2019-10-14,359,4020,2065,1,6445
628,2019-10-15,838,7950,2022,0,10810
628,2019-10-16,330,11681,1712,5,13728
628,2019-10-17,334,4178,1491,17,6020
628,2019-10-18,774,7224,1507,0,9505
628,2019-10-19,394,6622,2085,0,9101
628,2019-10-20,1492,865,1477,0,3834
628,2019-10-21,492,10559,1836,5,12892
628,2019-10-22,1211,4574,1621,0,7406
628,2019-10-23,479,13000,1250,2,14731
628,2019-10-24,1446,24516,1697,0,27659
628,2019-10-25,492,13388,1218,3,15101
628,2019-10-26,1826,12248,2735,8,16817
628,2019-10-27,379,14757,2587,1,17724
628,2019-10-28,363,22152,2815,0,25330
628,2019-10-29,468,16754,2313,0,19535
628,2019-10-30,375,23515,1162,1,25053
628,2019-10-31,1359,13410,1606,3,16378
628,2019-11-01,338,13516,1469,0,15323
628,2019-11-02,356,13031,1801,0,15188
628,2019-11-03,357,35826,1258,0,37441
628,2019-11-04,770,12012,1098,0,13880
628,2019-11-05,448,1155,2780,1,4384
628,2019-11-06,1297,6983,1716,2,9998
628,2019-11-07,778,12326,1787,0,14891
628,2019-11-08,568,8401,2380,0,11349
628,2019-11-09,395,11821,1869,0,14085
628,2019-11-10,1276,11686,2028,2,14992
628,2019-11-11,375,7557,1555,4,9491
628,2019-11-12,679,8471,2880,0,12030
628,2019-11-13,403,13086,1675,2,15166
628,2019-11-14,1217,7445,1992,1,10655
628,2019-11-15,457,3285,2320,0,6062
628,2019-11-16,357,896,2124,2,3379
628,2019-11-17,292,2879,2729,0,5900
628,2019-11-18,458,2013,3182,2,5655
628,2019-11-19,449,2961,2402,2,5814
628,2019-11-20,1262,1280,1444,2,3988
628,2019-11-21,365,5104,2262,0,7731
628,2019-11-22,248,4440,1391,2,6081
629,2019-08-01,2642,13733,107,0,16482
629,2019-08-02,2152,19047,517,0,21716
629,2019-08-03,1918,6500,500,0,8918
629,2019-08-04,1372,972,776,2,3122
629,2019-08-05,1291,863,201,0,2355
629,2019-08-06,1326,8669,588,0,10583
629,2019-08-07,2485,5697,777,0,8959
629,2019-08-08,2650,1182,311,1,4144
629,2019-08-09,1656,2007,291,0,3954
629,2019-08-10,1978,2231,21,0,4230
629,2019-08-11,1100,1616,144,0,2860
629,2019-08-12,1609,1651,261,0,3521
629,2019-08-13,1459,5870,127,0,7456
629,2019-08-14,1354,2075,184,1,3614
629,2019-08-15,1129,1192,12,0,2333
629,2019-08-16,1250,2893,155,0,4298
629,2019-08-17,1302,3802,423,1,5528
629,2019-08-18,1825,3482,988,1,6296
629,2019-08-19,1309,4451,779,0,6539
629,2019-08-20,1465,4752,2137,4,8358
629,2019-08-21,1570,5330,1866,0,8766
629,2019-08-22,1586,13660,1234,1,16481
629,2019-08-23,2365,7526,2005,0,11896
629,2019-08-24,1788,3789,1648,2,7227
629,2019-08-25,1390,16063,1641,1,19095
629,2019-08-26,1542,24044,2160,2,27748
629,2019-08-27,1903,12549,2356,1,16809
629,2019-08-28,1916,12859,1890,1,16666
629,2019-08-29,2055,15583,1205,11,18854
629,2019-08-30,1813,3464,637,4,5918
629,2019-08-31,863,538,1,0,1402
629,2019-09-01,1720,966,291,0,2977
629,2019-09-02,1856,369,4,0,2229
629,2019-09-03,2170,1396,1819,1,5386
629,2019-09-04,5126,13409,2394,0,20929
629,2019-09-05,2307,12602,2289,2,17200
629,2019-09-06,3207,17775,1630,0,22612
629,2019-09-07,2806,11053,1892,1,15752
629,2019-09-08,4219,6258,2047,1,12525
629,2019-09-09,4193,14159,1720,2,20074
629,2019-09-10,3759,13051,2277,1,19088
629,2019-09-11,2179,9034,1521,2,12736
629,2019-09-12,3151,8570,1808,4,13533
629,2019-09-13,2586,5419,1541,2,9548
629,2019-09-14,2936,8941,1705,1,13583
629,2019-09-15,2029,6952,2114,0,11095
629,2019-09-16,2393,5807,1556,4,9760
629,2019-09-17,1749,10289,2064,8,14110
629,2019-09-18,2389,20032,1691,8,24120
629,2019-09-19,3021,6133,1264,9,10427
629,2019-09-20,1732,8763,1459,9,11963
629,2019-09-21,1453,6302,2311,10,10076
629,2019-09-22,2387,10296,2308,8,14999
629,2019-09-23,3824,9215,3062,13,16114
629,2019-09-24,2220,8652,2316,11,13199
629,2019-09-25,1894,8536,1758,12,12200
629,2019-09-26,985,10531,1405,11,12932
629,2019-09-27,1465,6849,2072,3,10389
629,2019-09-28,1199,22992,1662,8,25861
629,2019-09-29,2023,19207,1357,1,22588
629,2019-09-30,1023,18054,1493,1,20571
629,2019-10-01,1303,17040,1383,0,19726
629,2019-10-02,1259,12721,1210,6,15196
629,2019-10-03,827,23450,1236,10,25523
629,2019-10-04,2180,14576,1510,10,18276
629,2019-10-05,790,14690,1253,10,16743
629,2019-10-06,1146,12165,1857,11,15179
629,2019-10-07,1044,7581,2869,9,11503
629,2019-10-08,1680,11867,1367,16,14930
629,2019-10-09,829,15483,1746,10,18068
629,2019-10-10,1668,10751,2223,9,14651
629,2019-10-11,900,16166,1848,9,18923
629,2019-10-12,819,9510,2569,1,12899
629,2019-10-13,1284,9126,1881,3,12294
629,2019-10-14,814,9138,1535,0,11487
629,2019-10-15,768,14878,1493,1,17140
629,2019-10-16,782,24126,1588,0,26496
629,2019-10-17,1118,8884,1665,3,11670
629,2019-10-18,1757,8866,1989,4,12616
629,2019-10-19,1232,5800,1849,1,8882
629,2019-10-20,954,3315,1698,0,5967
629,2019-10-21,1252,10390,1541,3,13186
629,2019-10-22,1193,7029,1845,19,10086
629,2019-10-23,1636,14504,1428,4,17572
629,2019-10-24,1488,19139,2308,1,22936
629,2019-10-25,1437,11280,1477,2,14196
629,2019-10-26,2184,13553,2104,1,17842
629,2019-10-27,2566,16376,1663,0,20605
629,2019-10-28,4059,22309,2273,0,28641
629,2019-10-29,2829,17661,1562,0,22052
629,2019-10-30,2512,15309,1455,0,19276
629,2019-10-31,2287,12804,1223,0,16314
629,2019-11-01,3986,14687,1198,1,19872
629,2019-11-02,1959,23195,1738,2,26894
629,2019-11-03,1987,28502,1454,166,32109
629,2019-11-04,1758,8778,1051,0,11587
629,2019-11-05,1592,3102,2106,1,6801
629,2019-11-06,1242,8136,1938,1,11317
629,2019-11-07,1612,21830,1548,2,24992
629,2019-11-08,2074,12088,982,0,15144
629,2019-11-09,1457,9211,1553,2,12223
629,2019-11-10,1810,14144,1337,1,17292
629,2019-11-11,1498,9950,709,1,12158
629,2019-11-12,937,10418,2761,2,14118
629,2019-11-13,938,13465,2015,1,16419
629,2019-11-14,1260,8826,2590,0,12676
629,2019-11-15,1033,4693,2560,1,8287
629,2019-11-16,781,3004,2954,0,6739
629,2019-11-17,897,3200,3747,4,7848
629,2019-11-18,2484,2761,2953,2,8200
629,2019-11-19,1438,3755,2968,0,8161
629,2019-11-20,908,2047,1897,0,4852
629,2019-11-21,911,5893,1966,0,8770
629,2019-11-22,963,8245,1228,4,10440
629,2019-11-23,961,11058,2387,0,14406
629,2019-11-24,1945,7126,1668,0,10739
629,2019-11-25,941,10991,2152,0,14084
629,2019-11-26,737,10979,2004,1,13721
629,2019-11-27,963,7187,1276,1,9427
629,2019-11-28,1174,10867,1056,1,13098
629,2019-11-29,178,227,2,0,407
629,2019-08-01,2642,13733,107,0,16482
629,2019-08-02,2152,19047,517,0,21716
629,2019-08-03,1918,6500,500,0,8918
629,2019-08-04,1372,972,776,2,3122
629,2019-08-05,1291,863,201,0,2355
629,2019-08-06,1326,8669,588,0,10583
629,2019-08-07,2485,5697,777,0,8959
629,2019-08-08,2650,1182,311,1,4144
629,2019-08-09,1656,2007,291,0,3954
629,2019-08-10,1978,2231,21,0,4230
629,2019-08-11,1100,1616,144,0,2860
629,2019-08-12,1609,1651,261,0,3521
629,2019-08-13,1459,5870,127,0,7456
629,2019-08-14,1354,2075,184,1,3614
629,2019-08-15,1129,1192,12,0,2333
629,2019-08-16,1250,2893,155,0,4298
629,2019-08-17,1302,3802,423,1,5528
629,2019-08-18,1825,3482,988,1,6296
629,2019-08-19,1309,4451,779,0,6539
629,2019-08-20,1465,4752,2137,4,8358
629,2019-08-21,1570,5330,1866,0,8766
629,2019-08-22,1586,13660,1234,1,16481
629,2019-08-23,2365,7526,2005,0,11896
629,2019-08-24,1788,3789,1648,2,7227
629,2019-08-25,1390,16063,1641,1,19095
629,2019-08-26,1542,24044,2160,2,27748
629,2019-08-27,1903,12549,2356,1,16809
629,2019-08-28,1916,12859,1890,1,16666
629,2019-08-29,2055,15583,1205,11,18854
629,2019-08-30,1813,3464,637,4,5918
629,2019-08-31,863,538,1,0,1402
629,2019-09-01,1720,966,291,0,2977
629,2019-09-02,1856,369,4,0,2229
629,2019-09-03,2170,1396,1819,1,5386
629,2019-09-04,5126,13409,2394,0,20929
629,2019-09-05,2307,12602,2289,2,17200
629,2019-09-06,3207,17775,1630,0,22612
629,2019-09-07,2806,11053,1892,1,15752
629,2019-09-08,4219,6258,2047,1,12525
629,2019-09-09,4193,14159,1720,2,20074
629,2019-09-10,3759,13051,2277,1,19088
629,2019-09-11,2179,9034,1521,2,12736
629,2019-09-12,3151,8570,1808,4,13533
629,2019-09-13,2586,5419,1541,2,9548
629,2019-09-14,2936,8941,1705,1,13583
629,2019-09-15,2029,6952,2114,0,11095
629,2019-09-16,2393,5807,1556,4,9760
629,2019-09-17,1749,10289,2064,8,14110
629,2019-09-18,2389,20032,1691,8,24120
629,2019-09-19,3021,6133,1264,9,10427
629,2019-09-20,1732,8763,1459,9,11963
629,2019-09-21,1453,6302,2311,10,10076
629,2019-09-22,2387,10296,2308,8,14999
629,2019-09-23,3824,9215,3062,13,16114
629,2019-09-24,2220,8652,2316,11,13199
629,2019-09-25,1894,8536,1758,12,12200
629,2019-09-26,985,10531,1405,11,12932
629,2019-09-27,1465,6849,2072,3,10389
629,2019-09-28,1199,22992,1662,8,25861
629,2019-09-29,2023,19207,1357,1,22588
629,2019-09-30,1023,18054,1493,1,20571
629,2019-10-01,1303,17040,1383,0,19726
629,2019-10-02,1259,12721,1210,6,15196
629,2019-10-03,827,23450,1236,10,25523
629,2019-10-04,2180,14576,1510,10,18276
629,2019-10-05,790,14690,1253,10,16743
629,2019-10-06,1146,12165,1857,11,15179
629,2019-10-07,1044,7581,2869,9,11503
629,2019-10-08,1680,11867,1367,16,14930
629,2019-10-09,829,15483,1746,10,18068
629,2019-10-10,1668,10751,2223,9,14651
629,2019-10-11,900,16166,1848,9,18923
629,2019-10-12,819,9510,2569,1,12899
629,2019-10-13,1284,9126,1881,3,12294
629,2019-10-14,814,9138,1535,0,11487
629,2019-10-15,768,14878,1493,1,17140
629,2019-10-16,782,24126,1588,0,26496
629,2019-10-17,1118,8884,1665,3,11670
629,2019-10-18,1757,8866,1989,4,12616
629,2019-10-19,1232,5800,1849,1,8882
629,2019-10-20,954,3315,1698,0,5967
629,2019-10-21,1252,10390,1541,3,13186
629,2019-10-22,1193,7029,1845,19,10086
629,2019-10-23,1636,14504,1428,4,17572
629,2019-10-24,1488,19139,2308,1,22936
629,2019-10-25,1437,11280,1477,2,14196
629,2019-10-26,2184,13553,2104,1,17842
629,2019-10-27,2566,16376,1663,0,20605
629,2019-10-28,4059,22309,2273,0,28641
629,2019-10-29,2829,17661,1562,0,22052
629,2019-10-30,2512,15309,1455,0,19276
629,2019-10-31,2287,12804,1223,0,16314
629,2019-11-01,3986,14687,1198,1,19872
629,2019-11-02,1959,23195,1738,2,26894
629,2019-11-03,1987,28502,1454,166,32109
629,2019-11-04,1758,8778,1051,0,11587
629,2019-11-05,1592,3102,2106,1,6801
629,2019-11-06,1242,8136,1938,1,11317
629,2019-11-07,1612,21830,1548,2,24992
629,2019-11-08,2074,12088,982,0,15144
629,2019-11-09,1457,9211,1553,2,12223
629,2019-11-10,1810,14144,1337,1,17292
629,2019-11-11,1498,9950,709,1,12158
629,2019-11-12,937,10418,2761,2,14118
629,2019-11-13,938,13465,2015,1,16419
629,2019-11-14,1260,8826,2590,0,12676
629,2019-11-15,1033,4693,2560,1,8287
629,2019-11-16,781,3004,2954,0,6739
629,2019-11-17,897,3200,3747,4,7848
629,2019-11-18,2484,2761,2953,2,8200
629,2019-11-19,1438,3755,2968,0,8161
629,2019-11-20,908,2047,1897,0,4852
629,2019-11-21,911,5893,1966,0,8770
629,2019-11-22,963,8245,1228,4,10440
629,2019-11-23,961,11058,2387,0,14406
629,2019-11-24,1945,7126,1668,0,10739
629,2019-11-25,941,10991,2152,0,14084
629,2019-11-26,737,10979,2004,1,13721
629,2019-11-27,963,7187,1276,1,9427
629,2019-11-28,1174,10867,1056,1,13098
629,2019-11-29,178,227,2,0,407
629,2019-08-01,2642,13733,107,0,16482
629,2019-08-02,2152,19047,517,0,21716
629,2019-08-03,1918,6500,500,0,8918
629,2019-08-04,1372,972,776,2,3122
629,2019-08-05,1291,863,201,0,2355
629,2019-08-06,1326,8669,588,0,10583
629,2019-08-07,2485,5697,777,0,8959
629,2019-08-08,2650,1182,311,1,4144
629,2019-08-09,1656,2007,291,0,3954
629,2019-08-10,1978,2231,21,0,4230
629,2019-08-11,1100,1616,144,0,2860
629,2019-08-12,1609,1651,261,0,3521
629,2019-08-13,1459,5870,127,0,7456
629,2019-08-14,1354,2075,184,1,3614
629,2019-08-15,1129,1192,12,0,2333
629,2019-08-16,1250,2893,155,0,4298
629,2019-08-17,1302,3802,423,1,5528
629,2019-08-18,1825,3482,988,1,6296
629,2019-08-19,1309,4451,779,0,6539
629,2019-08-20,1465,4752,2137,4,8358
629,2019-08-21,1570,5330,1866,0,8766
629,2019-08-22,1586,13660,1234,1,16481
629,2019-08-23,2365,7526,2005,0,11896
629,2019-08-24,1788,3789,1648,2,7227
629,2019-08-25,1390,16063,1641,1,19095
629,2019-08-26,1542,24044,2160,2,27748
629,2019-08-27,1903,12549,2356,1,16809
629,2019-08-28,1916,12859,1890,1,16666
629,2019-08-29,2055,15583,1205,11,18854
629,2019-08-30,1813,3464,637,4,5918
629,2019-08-31,863,538,1,0,1402
629,2019-09-01,1720,966,291,0,2977
629,2019-09-02,1856,369,4,0,2229
629,2019-09-03,2170,1396,1819,1,5386
629,2019-09-04,5126,13409,2394,0,20929
629,2019-09-05,2307,12602,2289,2,17200
629,2019-09-06,3207,17775,1630,0,22612
629,2019-09-07,2806,11053,1892,1,15752
629,2019-09-08,4219,6258,2047,1,12525
629,2019-09-09,4193,14159,1720,2,20074
629,2019-09-10,3759,13051,2277,1,19088
629,2019-09-11,2179,9034,1521,2,12736
629,2019-09-12,3151,8570,1808,4,13533
629,2019-09-13,2586,5419,1541,2,9548
629,2019-09-14,2936,8941,1705,1,13583
629,2019-09-15,2029,6952,2114,0,11095
629,2019-09-16,2393,5807,1556,4,9760
629,2019-09-17,1749,10289,2064,8,14110
629,2019-09-18,2389,20032,1691,8,24120
629,2019-09-19,3021,6133,1264,9,10427
629,2019-09-20,1732,8763,1459,9,11963
629,2019-09-21,1453,6302,2311,10,10076
629,2019-09-22,2387,10296,2308,8,14999
629,2019-09-23,3824,9215,3062,13,16114
629,2019-09-24,2220,8652,2316,11,13199
629,2019-09-25,1894,8536,1758,12,12200
629,2019-09-26,985,10531,1405,11,12932
629,2019-09-27,1465,6849,2072,3,10389
629,2019-09-28,1199,22992,1662,8,25861
629,2019-09-29,2023,19207,1357,1,22588
629,2019-09-30,1023,18054,1493,1,20571
629,2019-10-01,1303,17040,1383,0,19726
629,2019-10-02,1259,12721,1210,6,15196
629,2019-10-03,827,23450,1236,10,25523
629,2019-10-04,2180,14576,1510,10,18276
629,2019-10-05,790,14690,1253,10,16743
629,2019-10-06,1146,12165,1857,11,15179
629,2019-10-07,1044,7581,2869,9,11503
629,2019-10-08,1680,11867,1367,16,14930
629,2019-10-09,829,15483,1746,10,18068
629,2019-10-10,1668,10751,2223,9,14651
629,2019-10-11,900,16166,1848,9,18923
629,2019-10-12,819,9510,2569,1,12899
629,2019-10-13,1284,9126,1881,3,12294
629,2019-10-14,814,9138,1535,0,11487
629,2019-10-15,768,14878,1493,1,17140
629,2019-10-16,782,24126,1588,0,26496
629,2019-10-17,1118,8884,1665,3,11670
629,2019-10-18,1757,8866,1989,4,12616
629,2019-10-19,1232,5800,1849,1,8882
629,2019-10-20,954,3315,1698,0,5967
629,2019-10-21,1252,10390,1541,3,13186
629,2019-10-22,1193,7029,1845,19,10086
629,2019-10-23,1636,14504,1428,4,17572
629,2019-10-24,1488,19139,2308,1,22936
629,2019-10-25,1437,11280,1477,2,14196
629,2019-10-26,2184,13553,2104,1,17842
629,2019-10-27,2566,16376,1663,0,20605
629,2019-10-28,4059,22309,2273,0,28641
629,2019-10-29,2829,17661,1562,0,22052
629,2019-10-30,2512,15309,1455,0,19276
629,2019-10-31,2287,12804,1223,0,16314
629,2019-11-01,3986,14687,1198,1,19872
629,2019-11-02,1959,23195,1738,2,26894
629,2019-11-03,1987,28502,1454,166,32109
629,2019-11-04,1758,8778,1051,0,11587
629,2019-11-05,1592,3102,2106,1,6801
629,2019-11-06,1242,8136,1938,1,11317
629,2019-11-07,1612,21830,1548,2,24992
629,2019-11-08,2074,12088,982,0,15144
629,2019-11-09,1457,9211,1553,2,12223
629,2019-11-10,1810,14144,1337,1,17292
629,2019-11-11,1498,9950,709,1,12158
629,2019-11-12,937,10418,2761,2,14118
629,2019-11-13,938,13465,2015,1,16419
629,2019-11-14,1260,8826,2590,0,12676
629,2019-11-15,1033,4693,2560,1,8287
629,2019-11-16,781,3004,2954,0,6739
629,2019-11-17,897,3200,3747,4,7848
629,2019-11-18,2484,2761,2953,2,8200
629,2019-11-19,1438,3755,2968,0,8161
629,2019-11-20,908,2047,1897,0,4852
629,2019-11-21,911,5893,1966,0,8770
629,2019-11-22,963,8245,1228,4,10440
629,2019-11-23,961,11058,2387,0,14406
629,2019-11-24,1945,7126,1668,0,10739
629,2019-11-25,941,10991,2152,0,14084
629,2019-11-26,737,10979,2004,1,13721
629,2019-11-27,963,7187,1276,1,9427
629,2019-11-28,1174,10867,1056,1,13098
629,2019-11-29,178,227,2,0,407
629,2019-08-04,1372,972,776,2,3122
629,2019-08-05,1291,863,201,0,2355
629,2019-08-06,1326,8669,588,0,10583
629,2019-08-07,2485,5697,777,0,8959
629,2019-08-08,2650,1182,311,1,4144
629,2019-08-09,1656,2007,291,0,3954
629,2019-08-10,1978,2231,21,0,4230
629,2019-08-11,1100,1616,144,0,2860
629,2019-08-12,1609,1651,261,0,3521
629,2019-08-13,1459,5870,127,0,7456
629,2019-08-14,1354,2075,184,1,3614
629,2019-08-15,1129,1192,12,0,2333
629,2019-08-16,1250,2893,155,0,4298
629,2019-08-17,1302,3802,423,1,5528
629,2019-08-18,1825,3482,988,1,6296
629,2019-08-19,1309,4451,779,0,6539
629,2019-08-20,1465,4752,2137,4,8358
629,2019-08-21,1570,5330,1866,0,8766
629,2019-08-22,1586,13660,1234,1,16481
629,2019-08-23,2365,7526,2005,0,11896
629,2019-08-24,1788,3789,1648,2,7227
629,2019-08-25,1390,16063,1641,1,19095
629,2019-08-26,1542,24044,2160,2,27748
629,2019-08-27,1903,12549,2356,1,16809
629,2019-08-28,1916,12859,1890,1,16666
629,2019-08-29,2055,15583,1205,11,18854
629,2019-08-30,1813,3464,637,4,5918
629,2019-08-31,863,538,1,0,1402
629,2019-09-01,1720,966,291,0,2977
629,2019-09-02,1856,369,4,0,2229
629,2019-09-03,2170,1396,1819,1,5386
629,2019-09-04,5126,13409,2394,0,20929
629,2019-09-05,2307,12602,2289,2,17200
629,2019-09-06,3207,17775,1630,0,22612
629,2019-09-07,2806,11053,1892,1,15752
629,2019-09-08,4219,6258,2047,1,12525
629,2019-09-09,4193,14159,1720,2,20074
629,2019-09-10,3759,13051,2277,1,19088
629,2019-09-11,2179,9034,1521,2,12736
629,2019-09-12,3151,8570,1808,4,13533
629,2019-09-13,2586,5419,1541,2,9548
629,2019-09-14,2936,8941,1705,1,13583
629,2019-09-15,2029,6952,2114,0,11095
629,2019-09-16,2393,5807,1556,4,9760
629,2019-09-17,1749,10289,2064,8,14110
629,2019-09-18,2389,20032,1691,8,24120
629,2019-09-19,3021,6133,1264,9,10427
629,2019-09-20,1732,8763,1459,9,11963
629,2019-09-21,1453,6302,2311,10,10076
629,2019-09-22,2387,10296,2308,8,14999
629,2019-09-23,3824,9215,3062,13,16114
629,2019-09-24,2220,8652,2316,11,13199
629,2019-09-25,1894,8536,1758,12,12200
629,2019-09-26,985,10531,1405,11,12932
629,2019-09-27,1465,6849,2072,3,10389
629,2019-09-28,1199,22992,1662,8,25861
629,2019-09-29,2023,19207,1357,1,22588
629,2019-09-30,1023,18054,1493,1,20571
629,2019-10-01,1303,17040,1383,0,19726
629,2019-10-02,1259,12721,1210,6,15196
629,2019-10-03,827,23450,1236,10,25523
629,2019-10-04,2180,14576,1510,10,18276
629,2019-10-05,790,14690,1253,10,16743
629,2019-10-06,1146,12165,1857,11,15179
629,2019-10-07,1044,7581,2869,9,11503
629,2019-10-08,1680,11867,1367,16,14930
629,2019-10-09,829,15483,1746,10,18068
629,2019-10-10,1668,10751,2223,9,14651
629,2019-10-11,900,16166,1848,9,18923
629,2019-10-12,819,9510,2569,1,12899
629,2019-10-13,1284,9126,1881,3,12294
629,2019-10-14,814,9138,1535,0,11487
629,2019-10-15,768,14878,1493,1,17140
629,2019-10-16,782,24126,1588,0,26496
629,2019-10-17,1118,8884,1665,3,11670
629,2019-10-18,1757,8866,1989,4,12616
629,2019-10-19,1232,5800,1849,1,8882
629,2019-10-20,954,3315,1698,0,5967
629,2019-10-21,1252,10390,1541,3,13186
629,2019-10-22,1193,7029,1845,19,10086
629,2019-10-23,1636,14504,1428,4,17572
629,2019-10-24,1488,19139,2308,1,22936
629,2019-10-25,1437,11280,1477,2,14196
629,2019-10-26,2184,13553,2104,1,17842
629,2019-10-27,2566,16376,1663,0,20605
629,2019-10-28,4059,22309,2273,0,28641
629,2019-10-29,2829,17661,1562,0,22052
629,2019-10-30,2512,15309,1455,0,19276
629,2019-10-31,2287,12804,1223,0,16314
629,2019-11-01,3986,14687,1198,1,19872
629,2019-11-02,1959,23195,1738,2,26894
629,2019-11-03,1987,28502,1454,166,32109
629,2019-11-04,1758,8778,1051,0,11587
629,2019-11-05,1592,3102,2106,1,6801
629,2019-11-06,1242,8136,1938,1,11317
629,2019-11-07,1612,21830,1548,2,24992
629,2019-11-08,2074,12088,982,0,15144
629,2019-11-09,1457,9211,1553,2,12223
629,2019-11-10,1810,14144,1337,1,17292
629,2019-11-11,1498,9950,709,1,12158
629,2019-11-12,937,10418,2761,2,14118
629,2019-11-13,938,13465,2015,1,16419
629,2019-11-14,1260,8826,2590,0,12676
629,2019-11-15,1033,4693,2560,1,8287
629,2019-11-16,781,3004,2954,0,6739
629,2019-11-17,897,3200,3747,4,7848
629,2019-11-18,2484,2761,2953,2,8200
629,2019-11-19,1438,3755,2968,0,8161
629,2019-11-20,908,2047,1897,0,4852
629,2019-11-21,911,5893,1966,0,8770
629,2019-11-22,963,8245,1228,4,10440
629,2019-11-23,961,11058,2387,0,14406
629,2019-11-24,1945,7126,1668,0,10739
629,2019-11-25,941,10991,2152,0,14084
629,2019-11-26,737,10979,2004,1,13721
629,2019-11-27,963,7187,1276,1,9427
629,2019-11-28,1174,10867,1056,1,13098
630,2019-08-01,407,35603,186,0,36196
630,2019-08-02,607,32426,117,0,33150
630,2019-08-03,295,7675,225,2,8197
630,2019-08-04,300,2294,428,1,3023
630,2019-08-05,545,40553,289,2,41389
630,2019-08-06,357,18059,435,1,18852
630,2019-08-07,642,2614,300,0,3556
630,2019-08-08,391,1442,672,2,2507
630,2019-08-09,938,2634,219,2,3793
630,2019-08-10,507,1606,118,1,2232
630,2019-08-11,282,1605,136,0,2023
630,2019-08-12,426,15551,79,0,16056
630,2019-08-13,357,14319,54,0,14730
630,2019-08-14,289,5807,211,0,6307
630,2019-08-15,296,1602,25,0,1923
630,2019-08-16,287,3681,86,0,4054
630,2019-08-17,465,4137,282,0,4884
630,2019-08-18,176,1607,0,0,1783
630,2019-08-19,0,0,0,0,0
630,2019-08-20,0,0,0,0,0
630,2019-08-21,0,0,0,0,0
630,2019-08-22,0,0,0,0,0
630,2019-08-23,0,0,0,0,0
630,2019-08-24,87,151,271,0,509
630,2019-08-25,1158,856,1349,3,3366
630,2019-08-26,373,769,1449,1,2592
630,2019-08-27,1290,632,1756,2,3680
630,2019-08-28,405,828,1620,2,2855
630,2019-08-29,513,931,2560,12,4016
630,2019-08-30,331,785,650,1,1767
630,2019-08-31,186,391,1,0,578
630,2019-09-01,1070,358,363,0,1791
630,2019-09-02,218,185,148,0,551
630,2019-09-03,644,239,1128,0,2011
630,2019-09-04,488,420,1635,4,2547
630,2019-09-05,865,428,1516,4,2813
630,2019-09-06,1326,236,1700,1,3263
630,2019-09-07,1107,327,1868,0,3302
630,2019-09-08,954,472,1530,0,2956
630,2019-09-09,1334,5813,1524,2,8673
630,2019-09-10,814,679,2146,0,3639
630,2019-09-11,1373,574,1864,3,3814
630,2019-09-12,1304,425,2428,15,4172
630,2019-09-13,2138,507,1724,1,4370
630,2019-09-14,1156,488,1760,1,3405
630,2019-09-15,339,5469,2351,1,8160
630,2019-09-16,477,312,2754,4,3547
630,2019-09-17,1309,304,1250,8,2871
630,2019-09-18,837,452,1430,9,2728
630,2019-09-19,386,7812,1532,11,9741
630,2019-09-20,484,20106,2239,9,22838
630,2019-09-21,293,7603,1892,9,9797
630,2019-09-22,1781,22190,1321,11,25303
630,2019-09-23,388,12946,2098,16,15448
630,2019-09-24,519,7702,1170,15,9406
630,2019-09-25,642,7809,2083,13,10547
630,2019-09-26,343,11904,2382,27,14656
630,2019-09-27,1269,8385,1812,2,11468
630,2019-09-28,433,15492,1337,4,17266
630,2019-09-29,1181,17138,1928,3,20250
630,2019-09-30,328,24522,1679,1,26530
630,2019-10-01,742,22320,1567,4,24633
630,2019-10-02,417,22847,1515,7,24786
630,2019-10-03,585,27954,1810,10,30359
630,2019-10-04,938,13509,882,13,15342
630,2019-10-05,396,21396,1507,12,23311
630,2019-10-06,253,16110,2483,11,18857
630,2019-10-07,288,5040,1736,11,7075
630,2019-10-08,434,17329,1501,9,19273
630,2019-10-09,769,34055,1416,13,36253
630,2019-10-10,402,40377,2505,12,43296
630,2019-10-11,290,16248,1976,8,18522
630,2019-10-12,1222,6260,2058,0,9540
630,2019-10-13,794,7250,2317,1,10362
630,2019-10-14,2023,5575,1656,1,9255
630,2019-10-15,1392,7894,2023,0,11309
630,2019-10-16,330,17647,2005,1,19983
630,2019-10-17,759,25062,1211,4,27036
630,2019-10-18,2984,7684,1325,0,11993
630,2019-10-19,327,5126,2053,0,7506
630,2019-10-20,531,1162,2365,0,4058
630,2019-10-21,1699,9829,1391,1,12920
630,2019-10-22,443,5255,1960,3,7661
630,2019-10-23,1356,12775,1058,2,15191
630,2019-10-24,1238,18949,1547,3,21737
630,2019-10-25,1179,12817,2373,2,16371
630,2019-10-26,264,14598,1328,0,16190
630,2019-10-27,643,16352,1643,0,18638
630,2019-10-28,300,24302,1818,1,26421
630,2019-10-29,453,18404,1362,3,20222
630,2019-10-30,589,34646,1725,0,36960
630,2019-10-31,258,16251,1446,3,17958
630,2019-11-01,637,25679,2346,0,28662
630,2019-11-02,960,15831,1313,0,18104
630,2019-11-03,680,35855,1623,4,38162
630,2019-11-04,1115,13524,2121,0,16760
630,2019-11-05,428,2745,1955,1,5129
630,2019-11-06,413,7845,1296,2,9556
630,2019-11-07,1048,13632,894,1,15575
630,2019-11-08,717,10045,823,2,11587
630,2019-11-09,275,15652,1535,0,17462
630,2019-11-10,404,12753,995,1,14153
630,2019-11-11,492,12741,1700,0,14933
630,2019-11-12,958,17218,2439,0,20615
630,2019-11-13,319,13143,1856,0,15318
630,2019-11-14,550,12800,2338,0,15688
630,2019-11-15,297,6939,1923,0,9159
630,2019-11-16,314,3002,1801,0,5117
630,2019-11-17,384,5199,3666,0,9249
630,2019-11-18,390,2708,3479,0,6577
630,2019-11-19,413,5191,2308,0,7912
630,2019-11-20,394,1957,2513,0,4864
630,2019-11-21,316,3921,1761,0,5998
630,2019-11-22,1184,9369,1235,0,11788
630,2019-11-23,1829,11292,2022,0,15143
630,2019-11-24,438,10255,2113,0,12806
630,2019-11-25,602,11896,2381,0,14879
630,2019-11-26,416,10930,1498,0,12844
630,2019-11-27,1240,8294,1941,0,11475
630,2019-11-28,494,13723,339,0,14556
630,2019-11-29,36,894,0,0,930
630,2019-08-01,407,35603,186,0,36196
630,2019-08-02,607,32426,117,0,33150
630,2019-08-03,295,7675,225,2,8197
630,2019-08-04,300,2294,428,1,3023
630,2019-08-05,545,40553,289,2,41389
630,2019-08-06,357,18059,435,1,18852
630,2019-08-07,642,2614,300,0,3556
630,2019-08-08,391,1442,672,2,2507
630,2019-08-09,938,2634,219,2,3793
630,2019-08-10,507,1606,118,1,2232
630,2019-08-11,282,1605,136,0,2023
630,2019-08-12,426,15551,79,0,16056
630,2019-08-13,357,14319,54,0,14730
630,2019-08-14,289,5807,211,0,6307
630,2019-08-15,296,1602,25,0,1923
630,2019-08-16,287,3681,86,0,4054
630,2019-08-17,465,4137,282,0,4884
630,2019-08-18,176,1607,0,0,1783
630,2019-08-19,0,0,0,0,0
630,2019-08-20,0,0,0,0,0
630,2019-08-21,0,0,0,0,0
630,2019-08-22,0,0,0,0,0
630,2019-08-23,0,0,0,0,0
630,2019-08-24,87,151,271,0,509
630,2019-08-25,1158,856,1349,3,3366
630,2019-08-26,373,769,1449,1,2592
630,2019-08-27,1290,632,1756,2,3680
630,2019-08-28,405,828,1620,2,2855
630,2019-08-29,513,931,2560,12,4016
630,2019-08-30,331,785,650,1,1767
630,2019-08-31,186,391,1,0,578
630,2019-09-01,1070,358,363,0,1791
630,2019-09-02,218,185,148,0,551
630,2019-09-03,644,239,1128,0,2011
630,2019-09-04,488,420,1635,4,2547
630,2019-09-05,865,428,1516,4,2813
630,2019-09-06,1326,236,1700,1,3263
630,2019-09-07,1107,327,1868,0,3302
630,2019-09-08,954,472,1530,0,2956
630,2019-09-09,1334,5813,1524,2,8673
630,2019-09-10,814,679,2146,0,3639
630,2019-09-11,1373,574,1864,3,3814
630,2019-09-12,1304,425,2428,15,4172
630,2019-09-13,2138,507,1724,1,4370
630,2019-09-14,1156,488,1760,1,3405
630,2019-09-15,339,5469,2351,1,8160
630,2019-09-16,477,312,2754,4,3547
630,2019-09-17,1309,304,1250,8,2871
630,2019-09-18,837,452,1430,9,2728
630,2019-09-19,386,7812,1532,11,9741
630,2019-09-20,484,20106,2239,9,22838
630,2019-09-21,293,7603,1892,9,9797
630,2019-09-22,1781,22190,1321,11,25303
630,2019-09-23,388,12946,2098,16,15448
630,2019-09-24,519,7702,1170,15,9406
630,2019-09-25,642,7809,2083,13,10547
630,2019-09-26,343,11904,2382,27,14656
630,2019-09-27,1269,8385,1812,2,11468
630,2019-09-28,433,15492,1337,4,17266
630,2019-09-29,1181,17138,1928,3,20250
630,2019-09-30,328,24522,1679,1,26530
630,2019-10-01,742,22320,1567,4,24633
630,2019-10-02,417,22847,1515,7,24786
630,2019-10-03,585,27954,1810,10,30359
630,2019-10-04,938,13509,882,13,15342
630,2019-10-05,396,21396,1507,12,23311
630,2019-10-06,253,16110,2483,11,18857
630,2019-10-07,288,5040,1736,11,7075
630,2019-10-08,434,17329,1501,9,19273
630,2019-10-09,769,34055,1416,13,36253
630,2019-10-10,402,40377,2505,12,43296
630,2019-10-11,290,16248,1976,8,18522
630,2019-10-12,1222,6260,2058,0,9540
630,2019-10-13,794,7250,2317,1,10362
630,2019-10-14,2023,5575,1656,1,9255
630,2019-10-15,1392,7894,2023,0,11309
630,2019-10-16,330,17647,2005,1,19983
630,2019-10-17,759,25062,1211,4,27036
630,2019-10-18,2984,7684,1325,0,11993
630,2019-10-19,327,5126,2053,0,7506
630,2019-10-20,531,1162,2365,0,4058
630,2019-10-21,1699,9829,1391,1,12920
630,2019-10-22,443,5255,1960,3,7661
630,2019-10-23,1356,12775,1058,2,15191
630,2019-10-24,1238,18949,1547,3,21737
630,2019-10-25,1179,12817,2373,2,16371
630,2019-10-26,264,14598,1328,0,16190
630,2019-10-27,643,16352,1643,0,18638
630,2019-10-28,300,24302,1818,1,26421
630,2019-10-29,453,18404,1362,3,20222
630,2019-10-30,589,34646,1725,0,36960
630,2019-10-31,258,16251,1446,3,17958
630,2019-11-01,637,25679,2346,0,28662
630,2019-11-02,960,15831,1313,0,18104
630,2019-11-03,680,35855,1623,4,38162
630,2019-11-04,1115,13524,2121,0,16760
630,2019-11-05,428,2745,1955,1,5129
630,2019-11-06,413,7845,1296,2,9556
630,2019-11-07,1048,13632,894,1,15575
630,2019-11-08,717,10045,823,2,11587
630,2019-11-09,275,15652,1535,0,17462
630,2019-11-10,404,12753,995,1,14153
630,2019-11-11,492,12741,1700,0,14933
630,2019-11-12,958,17218,2439,0,20615
630,2019-11-13,319,13143,1856,0,15318
630,2019-11-14,550,12800,2338,0,15688
630,2019-11-15,297,6939,1923,0,9159
630,2019-11-16,314,3002,1801,0,5117
630,2019-11-17,384,5199,3666,0,9249
630,2019-11-18,390,2708,3479,0,6577
630,2019-11-19,413,5191,2308,0,7912
630,2019-11-20,394,1957,2513,0,4864
630,2019-11-21,316,3921,1761,0,5998
630,2019-11-22,1184,9369,1235,0,11788
630,2019-11-23,1829,11292,2022,0,15143
630,2019-11-24,438,10255,2113,0,12806
630,2019-11-25,602,11896,2381,0,14879
630,2019-11-26,416,10930,1498,0,12844
630,2019-11-27,1240,8294,1941,0,11475
630,2019-11-28,494,13723,339,0,14556
630,2019-11-29,36,894,0,0,930
630,2019-08-01,407,35603,186,0,36196
630,2019-08-02,607,32426,117,0,33150
630,2019-08-03,295,7675,225,2,8197
630,2019-08-04,300,2294,428,1,3023
630,2019-08-05,545,40553,289,2,41389
630,2019-08-06,357,18059,435,1,18852
630,2019-08-07,642,2614,300,0,3556
630,2019-08-08,391,1442,672,2,2507
630,2019-08-09,938,2634,219,2,3793
630,2019-08-10,507,1606,118,1,2232
630,2019-08-11,282,1605,136,0,2023
630,2019-08-12,426,15551,79,0,16056
630,2019-08-13,357,14319,54,0,14730
630,2019-08-14,289,5807,211,0,6307
630,2019-08-15,296,1602,25,0,1923
630,2019-08-16,287,3681,86,0,4054
630,2019-08-17,465,4137,282,0,4884
630,2019-08-18,176,1607,0,0,1783
630,2019-08-19,0,0,0,0,0
630,2019-08-20,0,0,0,0,0
630,2019-08-21,0,0,0,0,0
630,2019-08-22,0,0,0,0,0
630,2019-08-23,0,0,0,0,0
630,2019-08-24,87,151,271,0,509
630,2019-08-25,1158,856,1349,3,3366
630,2019-08-26,373,769,1449,1,2592
630,2019-08-27,1290,632,1756,2,3680
630,2019-08-28,405,828,1620,2,2855
630,2019-08-29,513,931,2560,12,4016
630,2019-08-30,331,785,650,1,1767
630,2019-08-31,186,391,1,0,578
630,2019-09-01,1070,358,363,0,1791
630,2019-09-02,218,185,148,0,551
630,2019-09-03,644,239,1128,0,2011
630,2019-09-04,488,420,1635,4,2547
630,2019-09-05,865,428,1516,4,2813
630,2019-09-06,1326,236,1700,1,3263
630,2019-09-07,1107,327,1868,0,3302
630,2019-09-08,954,472,1530,0,2956
630,2019-09-09,1334,5813,1524,2,8673
630,2019-09-10,814,679,2146,0,3639
630,2019-09-11,1373,574,1864,3,3814
630,2019-09-12,1304,425,2428,15,4172
630,2019-09-13,2138,507,1724,1,4370
630,2019-09-14,1156,488,1760,1,3405
630,2019-09-15,339,5469,2351,1,8160
630,2019-09-16,477,312,2754,4,3547
630,2019-09-17,1309,304,1250,8,2871
630,2019-09-18,837,452,1430,9,2728
630,2019-09-19,386,7812,1532,11,9741
630,2019-09-20,484,20106,2239,9,22838
630,2019-09-21,293,7603,1892,9,9797
630,2019-09-22,1781,22190,1321,11,25303
630,2019-09-23,388,12946,2098,16,15448
630,2019-09-24,519,7702,1170,15,9406
630,2019-09-25,642,7809,2083,13,10547
630,2019-09-26,343,11904,2382,27,14656
630,2019-09-27,1269,8385,1812,2,11468
630,2019-09-28,433,15492,1337,4,17266
630,2019-09-29,1181,17138,1928,3,20250
630,2019-09-30,328,24522,1679,1,26530
630,2019-10-01,742,22320,1567,4,24633
630,2019-10-02,417,22847,1515,7,24786
630,2019-10-03,585,27954,1810,10,30359
630,2019-10-04,938,13509,882,13,15342
630,2019-10-05,396,21396,1507,12,23311
630,2019-10-06,253,16110,2483,11,18857
630,2019-10-07,288,5040,1736,11,7075
630,2019-10-08,434,17329,1501,9,19273
630,2019-10-09,769,34055,1416,13,36253
630,2019-10-10,402,40377,2505,12,43296
630,2019-10-11,290,16248,1976,8,18522
630,2019-10-12,1222,6260,2058,0,9540
630,2019-10-13,794,7250,2317,1,10362
630,2019-10-14,2023,5575,1656,1,9255
630,2019-10-15,1392,7894,2023,0,11309
630,2019-10-16,330,17647,2005,1,19983
630,2019-10-17,759,25062,1211,4,27036
630,2019-10-18,2984,7684,1325,0,11993
630,2019-10-19,327,5126,2053,0,7506
630,2019-10-20,531,1162,2365,0,4058
630,2019-10-21,1699,9829,1391,1,12920
630,2019-10-22,443,5255,1960,3,7661
630,2019-10-23,1356,12775,1058,2,15191
630,2019-10-24,1238,18949,1547,3,21737
630,2019-10-25,1179,12817,2373,2,16371
630,2019-10-26,264,14598,1328,0,16190
630,2019-10-27,643,16352,1643,0,18638
630,2019-10-28,300,24302,1818,1,26421
630,2019-10-29,453,18404,1362,3,20222
630,2019-10-30,589,34646,1725,0,36960
630,2019-10-31,258,16251,1446,3,17958
630,2019-11-01,637,25679,2346,0,28662
630,2019-11-02,960,15831,1313,0,18104
630,2019-11-03,680,35855,1623,4,38162
630,2019-11-04,1115,13524,2121,0,16760
630,2019-11-05,428,2745,1955,1,5129
630,2019-11-06,413,7845,1296,2,9556
630,2019-11-07,1048,13632,894,1,15575
630,2019-11-08,717,10045,823,2,11587
630,2019-11-09,275,15652,1535,0,17462
630,2019-11-10,404,12753,995,1,14153
630,2019-11-11,492,12741,1700,0,14933
630,2019-11-12,958,17218,2439,0,20615
630,2019-11-13,319,13143,1856,0,15318
630,2019-11-14,550,12800,2338,0,15688
630,2019-11-15,297,6939,1923,0,9159
630,2019-11-16,314,3002,1801,0,5117
630,2019-11-17,384,5199,3666,0,9249
630,2019-11-18,390,2708,3479,0,6577
630,2019-11-19,413,5191,2308,0,7912
630,2019-11-20,394,1957,2513,0,4864
630,2019-11-21,316,3921,1761,0,5998
630,2019-11-22,1184,9369,1235,0,11788
630,2019-11-23,1829,11292,2022,0,15143
630,2019-11-24,438,10255,2113,0,12806
630,2019-11-25,602,11896,2381,0,14879
630,2019-11-26,416,10930,1498,0,12844
630,2019-11-27,1240,8294,1941,0,11475
630,2019-11-28,494,13723,339,0,14556
630,2019-08-03,295,7675,225,2,8197
630,2019-08-04,300,2294,428,1,3023
630,2019-08-05,545,40553,289,2,41389
630,2019-08-06,357,18059,435,1,18852
630,2019-08-07,642,2614,300,0,3556
630,2019-08-08,391,1442,672,2,2507
630,2019-08-09,938,2634,219,2,3793
630,2019-08-10,507,1606,118,1,2232
630,2019-08-11,282,1605,136,0,2023
630,2019-08-12,426,15551,79,0,16056
630,2019-08-13,357,14319,54,0,14730
630,2019-08-14,289,5807,211,0,6307
630,2019-08-15,296,1602,25,0,1923
630,2019-08-16,287,3681,86,0,4054
630,2019-08-17,465,4137,282,0,4884
630,2019-08-18,176,1607,0,0,1783
630,2019-08-19,0,0,0,0,0
630,2019-08-20,0,0,0,0,0
630,2019-08-21,0,0,0,0,0
630,2019-08-22,0,0,0,0,0
630,2019-08-23,0,0,0,0,0
630,2019-08-24,87,151,271,0,509
630,2019-08-25,1158,856,1349,3,3366
630,2019-08-26,373,769,1449,1,2592
630,2019-08-27,1290,632,1756,2,3680
630,2019-08-28,405,828,1620,2,2855
630,2019-08-29,513,931,2560,12,4016
630,2019-08-30,331,785,650,1,1767
630,2019-08-31,186,391,1,0,578
630,2019-09-01,1070,358,363,0,1791
630,2019-09-02,218,185,148,0,551
630,2019-09-03,644,239,1128,0,2011
630,2019-09-04,488,420,1635,4,2547
630,2019-09-05,865,428,1516,4,2813
630,2019-09-06,1326,236,1700,1,3263
630,2019-09-07,1107,327,1868,0,3302
630,2019-09-08,954,472,1530,0,2956
630,2019-09-09,1334,5813,1524,2,8673
630,2019-09-10,814,679,2146,0,3639
630,2019-09-11,1373,574,1864,3,3814
630,2019-09-12,1304,425,2428,15,4172
630,2019-09-13,2138,507,1724,1,4370
630,2019-09-14,1156,488,1760,1,3405
630,2019-09-15,339,5469,2351,1,8160
630,2019-09-16,477,312,2754,4,3547
630,2019-09-17,1309,304,1250,8,2871
630,2019-09-18,837,452,1430,9,2728
630,2019-09-19,386,7812,1532,11,9741
630,2019-09-20,484,20106,2239,9,22838
630,2019-09-21,293,7603,1892,9,9797
630,2019-09-22,1781,22190,1321,11,25303
630,2019-09-23,388,12946,2098,16,15448
630,2019-09-24,519,7702,1170,15,9406
630,2019-09-25,642,7809,2083,13,10547
630,2019-09-26,343,11904,2382,27,14656
630,2019-09-27,1269,8385,1812,2,11468
630,2019-09-28,433,15492,1337,4,17266
630,2019-09-29,1181,17138,1928,3,20250
630,2019-09-30,328,24522,1679,1,26530
630,2019-10-01,742,22320,1567,4,24633
630,2019-10-02,417,22847,1515,7,24786
630,2019-10-03,585,27954,1810,10,30359
630,2019-10-04,938,13509,882,13,15342
630,2019-10-05,396,21396,1507,12,23311
630,2019-10-06,253,16110,2483,11,18857
630,2019-10-07,288,5040,1736,11,7075
630,2019-10-08,434,17329,1501,9,19273
630,2019-10-09,769,34055,1416,13,36253
630,2019-10-10,402,40377,2505,12,43296
630,2019-10-11,290,16248,1976,8,18522
630,2019-10-12,1222,6260,2058,0,9540
630,2019-10-13,794,7250,2317,1,10362
630,2019-10-14,2023,5575,1656,1,9255
630,2019-10-15,1392,7894,2023,0,11309
630,2019-10-16,330,17647,2005,1,19983
630,2019-10-17,759,25062,1211,4,27036
630,2019-10-18,2984,7684,1325,0,11993
630,2019-10-19,327,5126,2053,0,7506
630,2019-10-20,531,1162,2365,0,4058
630,2019-10-21,1699,9829,1391,1,12920
630,2019-10-22,443,5255,1960,3,7661
630,2019-10-23,1356,12775,1058,2,15191
630,2019-10-24,1238,18949,1547,3,21737
630,2019-10-25,1179,12817,2373,2,16371
630,2019-10-26,264,14598,1328,0,16190
630,2019-10-27,643,16352,1643,0,18638
630,2019-10-28,300,24302,1818,1,26421
630,2019-10-29,453,18404,1362,3,20222
630,2019-10-30,589,34646,1725,0,36960
630,2019-10-31,258,16251,1446,3,17958
630,2019-11-01,637,25679,2346,0,28662
630,2019-11-02,960,15831,1313,0,18104
630,2019-11-03,680,35855,1623,4,38162
630,2019-11-04,1115,13524,2121,0,16760
630,2019-11-05,428,2745,1955,1,5129
630,2019-11-06,413,7845,1296,2,9556
630,2019-11-07,1048,13632,894,1,15575
630,2019-11-08,717,10045,823,2,11587
630,2019-11-09,275,15652,1535,0,17462
630,2019-11-10,404,12753,995,1,14153
631,2019-08-01,47,14619,215,0,14881
631,2019-08-02,44,20307,431,1,20783
631,2019-08-03,118,7709,293,0,8120
631,2019-08-04,51,2054,241,1,2347
631,2019-08-05,60,8623,218,0,8901
631,2019-08-06,52,5154,428,0,5634
631,2019-08-07,66,2005,393,0,2464
631,2019-08-08,40,1194,489,2,1725
631,2019-08-09,124,1203,297,1,1625
631,2019-08-10,40,1354,475,0,1869
631,2019-08-11,106,2217,94,2,2419
631,2019-08-12,51,6609,156,1,6817
631,2019-08-13,45,9679,54,0,9778
631,2019-08-14,54,6129,124,0,6307
631,2019-08-15,180,1492,37,0,1709
631,2019-08-16,53,2442,95,0,2590
631,2019-08-17,166,4196,680,0,5042
631,2019-08-18,75,3565,1079,0,4719
631,2019-08-19,886,4380,1306,2,6574
631,2019-08-20,57,5145,791,0,5993
631,2019-08-21,86,3990,730,0,4806
631,2019-08-22,45,14732,1381,2,16160
631,2019-08-23,60,10884,1505,0,12449
631,2019-08-24,68,16437,1890,1,18396
631,2019-08-25,75,21457,1735,2,23269
631,2019-08-26,62,25516,1530,1,27109
631,2019-08-27,67,22713,1783,2,24565
631,2019-08-28,63,22317,1995,2,24377
631,2019-08-29,186,15019,2075,0,17280
631,2019-08-30,42,4195,1061,1,5299
631,2019-08-31,40,7538,13,0,7591
631,2019-09-01,405,3254,186,0,3845
631,2019-09-02,21,441,104,0,566
631,2019-09-03,79,2360,1615,0,4054
631,2019-09-04,923,11612,2286,1,14822
631,2019-09-05,88,12272,1833,3,14196
631,2019-09-06,1591,15433,2626,2,19652
631,2019-09-07,183,7743,1893,0,9819
631,2019-09-08,1863,8424,1749,0,12036
631,2019-09-09,1120,6147,2321,1,9589
631,2019-09-10,101,12984,1930,1,15016
631,2019-09-11,950,10659,2087,4,13700
631,2019-09-12,65,8767,2397,19,11248
631,2019-09-13,95,7806,1435,18,9354
631,2019-09-14,108,9647,1980,1,11736
631,2019-09-15,51,9625,2189,3,11868
631,2019-09-16,87,9651,3323,0,13061
631,2019-09-17,97,9683,1547,2,11329
631,2019-09-18,89,11812,1466,1,13368
631,2019-09-19,200,5813,1972,1,7986
631,2019-09-20,1032,11934,2294,2,15262
631,2019-09-21,178,6351,2499,2,9030
631,2019-09-22,957,14573,2148,2,17680
631,2019-09-23,1077,10342,1982,5,13406
631,2019-09-24,122,7336,2342,4,9804
631,2019-09-25,160,10985,1778,1,12924
631,2019-09-26,126,12212,1984,4,14326
631,2019-09-27,71,8218,1704,2,9995
631,2019-09-28,105,15522,1613,2,17242
631,2019-09-29,67,16842,1832,0,18741
631,2019-09-30,89,26322,1509,0,27920
631,2019-10-01,76,27699,1870,2,29647
631,2019-10-02,90,14424,1196,2,15712
631,2019-10-03,51,22203,1735,1,23990
631,2019-10-04,52,19982,1617,0,21651
631,2019-10-05,1072,22768,2020,1,25861
631,2019-10-06,957,16159,1344,2,18462
631,2019-10-07,381,5002,2163,0,7546
631,2019-10-08,778,17188,2129,0,20095
631,2019-10-09,1091,16286,1626,0,19003
631,2019-10-10,83,9490,2087,1,11661
631,2019-10-11,925,11908,1513,57,14403
631,2019-10-12,99,6837,1432,1,8369
631,2019-10-13,387,7775,1948,1,10111
631,2019-10-14,126,5194,1278,2,6600
631,2019-10-15,471,13169,1672,2,15314
631,2019-10-16,95,23834,1075,3,25007
631,2019-10-17,975,7761,2493,1,11230
631,2019-10-18,607,8040,1685,1,10333
631,2019-10-19,71,4434,1565,0,6070
631,2019-10-20,61,1538,2226,0,3825
631,2019-10-21,70,18333,2375,65,20843
631,2019-10-22,1696,8604,2623,0,12923
631,2019-10-23,63,7595,1424,2,9084
631,2019-10-24,1052,13806,1915,1,16774
631,2019-10-25,79,16638,1670,1,18388
631,2019-10-26,63,24524,1788,0,26375
631,2019-10-27,84,30414,1324,1,31823
631,2019-10-28,212,24316,1074,0,25602
631,2019-10-29,551,28771,1198,413,30933
631,2019-10-30,439,20442,1701,1,22583
631,2019-10-31,1230,20070,1708,2,23010
631,2019-11-01,539,27031,1084,1,28655
631,2019-11-02,351,35671,1858,2,37882
631,2019-11-03,184,26399,1634,1,28218
631,2019-11-04,1665,9684,1623,1,12973
631,2019-11-05,113,2239,1899,1,4252
631,2019-11-06,86,13900,1410,1,15397
631,2019-11-07,1396,25311,1618,2,28327
631,2019-11-08,87,17071,925,0,18083
631,2019-11-09,95,15493,1482,1,17071
631,2019-11-10,84,13224,737,2,14047
631,2019-11-11,500,13017,1770,4,15291
631,2019-11-12,80,17349,2893,0,20322
631,2019-11-13,184,13700,2111,3,15998
631,2019-11-14,128,8360,2024,2310,12822
631,2019-11-15,81,4084,2459,0,6624
631,2019-11-16,85,3422,3481,0,6988
631,2019-11-17,260,3921,3448,0,7629
631,2019-11-18,1030,3627,3872,0,8529
631,2019-11-19,136,3739,3936,0,7811
631,2019-11-20,95,2226,2084,0,4405
631,2019-11-21,587,6345,1783,0,8715
631,2019-11-22,80,6049,1626,0,7755
631,2019-11-23,92,10148,2886,0,13126
631,2019-11-24,196,7868,1395,0,9459
631,2019-11-25,96,11592,1614,0,13302
631,2019-11-26,341,10869,1482,0,12692
631,2019-11-27,62,6881,1831,0,8774
631,2019-11-28,60,13263,393,1,13717
631,2019-11-29,28,847,2,0,877
631,2019-08-01,47,14619,215,0,14881
631,2019-08-02,44,20307,431,1,20783
631,2019-08-03,118,7709,293,0,8120
631,2019-08-04,51,2054,241,1,2347
631,2019-08-05,60,8623,218,0,8901
631,2019-08-06,52,5154,428,0,5634
631,2019-08-07,66,2005,393,0,2464
631,2019-08-08,40,1194,489,2,1725
631,2019-08-09,124,1203,297,1,1625
631,2019-08-10,40,1354,475,0,1869
631,2019-08-11,106,2217,94,2,2419
631,2019-08-12,51,6609,156,1,6817
631,2019-08-13,45,9679,54,0,9778
631,2019-08-14,54,6129,124,0,6307
631,2019-08-15,180,1492,37,0,1709
631,2019-08-16,53,2442,95,0,2590
631,2019-08-17,166,4196,680,0,5042
631,2019-08-18,75,3565,1079,0,4719
631,2019-08-19,886,4380,1306,2,6574
631,2019-08-20,57,5145,791,0,5993
631,2019-08-21,86,3990,730,0,4806
631,2019-08-22,45,14732,1381,2,16160
631,2019-08-23,60,10884,1505,0,12449
631,2019-08-24,68,16437,1890,1,18396
631,2019-08-25,75,21457,1735,2,23269
631,2019-08-26,62,25516,1530,1,27109
631,2019-08-27,67,22713,1783,2,24565
631,2019-08-28,63,22317,1995,2,24377
631,2019-08-29,186,15019,2075,0,17280
631,2019-08-30,42,4195,1061,1,5299
631,2019-08-31,40,7538,13,0,7591
631,2019-09-01,405,3254,186,0,3845
631,2019-09-02,21,441,104,0,566
631,2019-09-03,79,2360,1615,0,4054
631,2019-09-04,923,11612,2286,1,14822
631,2019-09-05,88,12272,1833,3,14196
631,2019-09-06,1591,15433,2626,2,19652
631,2019-09-07,183,7743,1893,0,9819
631,2019-09-08,1863,8424,1749,0,12036
631,2019-09-09,1120,6147,2321,1,9589
631,2019-09-10,101,12984,1930,1,15016
631,2019-09-11,950,10659,2087,4,13700
631,2019-09-12,65,8767,2397,19,11248
631,2019-09-13,95,7806,1435,18,9354
631,2019-09-14,108,9647,1980,1,11736
631,2019-09-15,51,9625,2189,3,11868
631,2019-09-16,87,9651,3323,0,13061
631,2019-09-17,97,9683,1547,2,11329
631,2019-09-18,89,11812,1466,1,13368
631,2019-09-19,200,5813,1972,1,7986
631,2019-09-20,1032,11934,2294,2,15262
631,2019-09-21,178,6351,2499,2,9030
631,2019-09-22,957,14573,2148,2,17680
631,2019-09-23,1077,10342,1982,5,13406
631,2019-09-24,122,7336,2342,4,9804
631,2019-09-25,160,10985,1778,1,12924
631,2019-09-26,126,12212,1984,4,14326
631,2019-09-27,71,8218,1704,2,9995
631,2019-09-28,105,15522,1613,2,17242
631,2019-09-29,67,16842,1832,0,18741
631,2019-09-30,89,26322,1509,0,27920
631,2019-10-01,76,27699,1870,2,29647
631,2019-10-02,90,14424,1196,2,15712
631,2019-10-03,51,22203,1735,1,23990
631,2019-10-04,52,19982,1617,0,21651
631,2019-10-05,1072,22768,2020,1,25861
631,2019-10-06,957,16159,1344,2,18462
631,2019-10-07,381,5002,2163,0,7546
631,2019-10-08,778,17188,2129,0,20095
631,2019-10-09,1091,16286,1626,0,19003
631,2019-10-10,83,9490,2087,1,11661
631,2019-10-11,925,11908,1513,57,14403
631,2019-10-12,99,6837,1432,1,8369
631,2019-10-13,387,7775,1948,1,10111
631,2019-10-14,126,5194,1278,2,6600
631,2019-10-15,471,13169,1672,2,15314
631,2019-10-16,95,23834,1075,3,25007
631,2019-10-17,975,7761,2493,1,11230
631,2019-10-18,607,8040,1685,1,10333
631,2019-10-19,71,4434,1565,0,6070
631,2019-10-20,61,1538,2226,0,3825
631,2019-10-21,70,18333,2375,65,20843
631,2019-10-22,1696,8604,2623,0,12923
631,2019-10-23,63,7595,1424,2,9084
631,2019-10-24,1052,13806,1915,1,16774
631,2019-10-25,79,16638,1670,1,18388
631,2019-10-26,63,24524,1788,0,26375
631,2019-10-27,84,30414,1324,1,31823
631,2019-10-28,212,24316,1074,0,25602
631,2019-10-29,551,28771,1198,413,30933
631,2019-10-30,439,20442,1701,1,22583
631,2019-10-31,1230,20070,1708,2,23010
631,2019-11-01,539,27031,1084,1,28655
631,2019-11-02,351,35671,1858,2,37882
631,2019-11-03,184,26399,1634,1,28218
631,2019-11-04,1665,9684,1623,1,12973
631,2019-11-05,113,2239,1899,1,4252
631,2019-11-06,86,13900,1410,1,15397
631,2019-11-07,1396,25311,1618,2,28327
631,2019-11-08,87,17071,925,0,18083
631,2019-11-09,95,15493,1482,1,17071
631,2019-11-10,84,13224,737,2,14047
631,2019-11-11,500,13017,1770,4,15291
631,2019-11-12,80,17349,2893,0,20322
631,2019-11-13,184,13700,2111,3,15998
631,2019-11-14,128,8360,2024,2310,12822
631,2019-11-15,81,4084,2459,0,6624
631,2019-11-16,85,3422,3481,0,6988
631,2019-11-17,260,3921,3448,0,7629
631,2019-11-18,1030,3627,3872,0,8529
631,2019-11-19,136,3739,3936,0,7811
631,2019-11-20,95,2226,2084,0,4405
631,2019-11-21,587,6345,1783,0,8715
631,2019-11-22,80,6049,1626,0,7755
631,2019-11-23,92,10148,2886,0,13126
631,2019-11-24,196,7868,1395,0,9459
631,2019-11-25,96,11592,1614,0,13302
631,2019-11-26,341,10869,1482,0,12692
631,2019-11-27,62,6881,1831,0,8774
631,2019-11-28,60,13263,393,1,13717
631,2019-11-29,28,847,2,0,877
631,2019-08-01,47,14619,215,0,14881
631,2019-08-02,44,20307,431,1,20783
631,2019-08-03,118,7709,293,0,8120
631,2019-08-04,51,2054,241,1,2347
631,2019-08-05,60,8623,218,0,8901
631,2019-08-06,52,5154,428,0,5634
631,2019-08-07,66,2005,393,0,2464
631,2019-08-08,40,1194,489,2,1725
631,2019-08-09,124,1203,297,1,1625
631,2019-08-10,40,1354,475,0,1869
631,2019-08-11,106,2217,94,2,2419
631,2019-08-12,51,6609,156,1,6817
631,2019-08-13,45,9679,54,0,9778
631,2019-08-14,54,6129,124,0,6307
631,2019-08-15,180,1492,37,0,1709
631,2019-08-16,53,2442,95,0,2590
631,2019-08-17,166,4196,680,0,5042
631,2019-08-18,75,3565,1079,0,4719
631,2019-08-19,886,4380,1306,2,6574
631,2019-08-20,57,5145,791,0,5993
631,2019-08-21,86,3990,730,0,4806
631,2019-08-22,45,14732,1381,2,16160
631,2019-08-23,60,10884,1505,0,12449
631,2019-08-24,68,16437,1890,1,18396
631,2019-08-25,75,21457,1735,2,23269
631,2019-08-26,62,25516,1530,1,27109
631,2019-08-27,67,22713,1783,2,24565
631,2019-08-28,63,22317,1995,2,24377
631,2019-08-29,186,15019,2075,0,17280
631,2019-08-30,42,4195,1061,1,5299
631,2019-08-31,40,7538,13,0,7591
631,2019-09-01,405,3254,186,0,3845
631,2019-09-02,21,441,104,0,566
631,2019-09-03,79,2360,1615,0,4054
631,2019-09-04,923,11612,2286,1,14822
631,2019-09-05,88,12272,1833,3,14196
631,2019-09-06,1591,15433,2626,2,19652
631,2019-09-07,183,7743,1893,0,9819
631,2019-09-08,1863,8424,1749,0,12036
631,2019-09-09,1120,6147,2321,1,9589
631,2019-09-10,101,12984,1930,1,15016
631,2019-09-11,950,10659,2087,4,13700
631,2019-09-12,65,8767,2397,19,11248
631,2019-09-13,95,7806,1435,18,9354
631,2019-09-14,108,9647,1980,1,11736
631,2019-09-15,51,9625,2189,3,11868
631,2019-09-16,87,9651,3323,0,13061
631,2019-09-17,97,9683,1547,2,11329
631,2019-09-18,89,11812,1466,1,13368
631,2019-09-19,200,5813,1972,1,7986
631,2019-09-20,1032,11934,2294,2,15262
631,2019-09-21,178,6351,2499,2,9030
631,2019-09-22,957,14573,2148,2,17680
631,2019-09-23,1077,10342,1982,5,13406
631,2019-09-24,122,7336,2342,4,9804
631,2019-09-25,160,10985,1778,1,12924
631,2019-09-26,126,12212,1984,4,14326
631,2019-09-27,71,8218,1704,2,9995
631,2019-09-28,105,15522,1613,2,17242
631,2019-09-29,67,16842,1832,0,18741
631,2019-09-30,89,26322,1509,0,27920
631,2019-10-01,76,27699,1870,2,29647
631,2019-10-02,90,14424,1196,2,15712
631,2019-10-03,51,22203,1735,1,23990
631,2019-10-04,52,19982,1617,0,21651
631,2019-10-05,1072,22768,2020,1,25861
631,2019-10-06,957,16159,1344,2,18462
631,2019-10-07,381,5002,2163,0,7546
631,2019-10-08,778,17188,2129,0,20095
631,2019-10-09,1091,16286,1626,0,19003
631,2019-10-10,83,9490,2087,1,11661
631,2019-10-11,925,11908,1513,57,14403
631,2019-10-12,99,6837,1432,1,8369
631,2019-10-13,387,7775,1948,1,10111
631,2019-10-14,126,5194,1278,2,6600
631,2019-10-15,471,13169,1672,2,15314
631,2019-10-16,95,23834,1075,3,25007
631,2019-10-17,975,7761,2493,1,11230
631,2019-10-18,607,8040,1685,1,10333
631,2019-10-19,71,4434,1565,0,6070
631,2019-10-20,61,1538,2226,0,3825
631,2019-10-21,70,18333,2375,65,20843
631,2019-10-22,1696,8604,2623,0,12923
631,2019-10-23,63,7595,1424,2,9084
631,2019-10-24,1052,13806,1915,1,16774
631,2019-10-25,79,16638,1670,1,18388
631,2019-10-26,63,24524,1788,0,26375
631,2019-10-27,84,30414,1324,1,31823
631,2019-10-28,212,24316,1074,0,25602
631,2019-10-29,551,28771,1198,413,30933
631,2019-10-30,439,20442,1701,1,22583
631,2019-10-31,1230,20070,1708,2,23010
631,2019-11-01,539,27031,1084,1,28655
631,2019-11-02,351,35671,1858,2,37882
631,2019-11-03,184,26399,1634,1,28218
631,2019-11-04,1665,9684,1623,1,12973
631,2019-11-05,113,2239,1899,1,4252
631,2019-11-06,86,13900,1410,1,15397
631,2019-11-07,1396,25311,1618,2,28327
631,2019-11-08,87,17071,925,0,18083
631,2019-11-09,95,15493,1482,1,17071
631,2019-11-10,84,13224,737,2,14047
631,2019-11-11,500,13017,1770,4,15291
631,2019-11-12,80,17349,2893,0,20322
631,2019-11-13,184,13700,2111,3,15998
631,2019-11-14,128,8360,2024,2310,12822
631,2019-11-15,81,4084,2459,0,6624
631,2019-11-16,85,3422,3481,0,6988
631,2019-11-17,260,3921,3448,0,7629
631,2019-11-18,1030,3627,3872,0,8529
631,2019-11-19,136,3739,3936,0,7811
631,2019-11-20,95,2226,2084,0,4405
631,2019-11-21,587,6345,1783,0,8715
631,2019-11-22,80,6049,1626,0,7755
631,2019-11-23,92,10148,2886,0,13126
631,2019-11-24,196,7868,1395,0,9459
631,2019-11-25,96,11592,1614,0,13302
631,2019-11-26,341,10869,1482,0,12692
631,2019-11-27,62,6881,1831,0,8774
631,2019-11-28,60,13263,393,1,13717
631,2019-11-29,28,847,2,0,877
631,2019-08-02,44,20307,431,1,20783
631,2019-08-03,118,7709,293,0,8120
631,2019-08-04,51,2054,241,1,2347
631,2019-08-05,60,8623,218,0,8901
631,2019-08-06,52,5154,428,0,5634
631,2019-08-07,66,2005,393,0,2464
631,2019-08-08,40,1194,489,2,1725
631,2019-08-09,124,1203,297,1,1625
631,2019-08-10,40,1354,475,0,1869
631,2019-08-11,106,2217,94,2,2419
631,2019-08-12,51,6609,156,1,6817
631,2019-08-13,45,9679,54,0,9778
631,2019-08-14,54,6129,124,0,6307
631,2019-08-15,180,1492,37,0,1709
631,2019-08-16,53,2442,95,0,2590
631,2019-08-17,166,4196,680,0,5042
631,2019-08-18,75,3565,1079,0,4719
631,2019-08-19,886,4380,1306,2,6574
631,2019-08-20,57,5145,791,0,5993
631,2019-08-21,86,3990,730,0,4806
631,2019-08-22,45,14732,1381,2,16160
631,2019-08-23,60,10884,1505,0,12449
631,2019-08-24,68,16437,1890,1,18396
631,2019-08-25,75,21457,1735,2,23269
631,2019-08-26,62,25516,1530,1,27109
631,2019-08-27,67,22713,1783,2,24565
631,2019-08-28,63,22317,1995,2,24377
631,2019-08-29,186,15019,2075,0,17280
631,2019-08-30,42,4195,1061,1,5299
631,2019-08-31,40,7538,13,0,7591
631,2019-09-01,405,3254,186,0,3845
631,2019-09-02,21,441,104,0,566
631,2019-09-03,79,2360,1615,0,4054
631,2019-09-04,923,11612,2286,1,14822
631,2019-09-05,88,12272,1833,3,14196
631,2019-09-06,1591,15433,2626,2,19652
631,2019-09-07,183,7743,1893,0,9819
631,2019-09-08,1863,8424,1749,0,12036
631,2019-09-09,1120,6147,2321,1,9589
631,2019-09-10,101,12984,1930,1,15016
631,2019-09-11,950,10659,2087,4,13700
631,2019-09-12,65,8767,2397,19,11248
631,2019-09-13,95,7806,1435,18,9354
631,2019-09-14,108,9647,1980,1,11736
631,2019-09-15,51,9625,2189,3,11868
631,2019-09-16,87,9651,3323,0,13061
631,2019-09-17,97,9683,1547,2,11329
631,2019-09-18,89,11812,1466,1,13368
631,2019-09-19,200,5813,1972,1,7986
631,2019-09-20,1032,11934,2294,2,15262
631,2019-09-21,178,6351,2499,2,9030
631,2019-09-22,957,14573,2148,2,17680
631,2019-09-23,1077,10342,1982,5,13406
631,2019-09-24,122,7336,2342,4,9804
631,2019-09-25,160,10985,1778,1,12924
631,2019-09-26,126,12212,1984,4,14326
631,2019-09-27,71,8218,1704,2,9995
631,2019-09-28,105,15522,1613,2,17242
631,2019-09-29,67,16842,1832,0,18741
631,2019-09-30,89,26322,1509,0,27920
631,2019-10-01,76,27699,1870,2,29647
631,2019-10-02,90,14424,1196,2,15712
631,2019-10-03,51,22203,1735,1,23990
631,2019-10-04,52,19982,1617,0,21651
631,2019-10-05,1072,22768,2020,1,25861
631,2019-10-06,957,16159,1344,2,18462
631,2019-10-07,381,5002,2163,0,7546
631,2019-10-08,778,17188,2129,0,20095
631,2019-10-09,1091,16286,1626,0,19003
631,2019-10-10,83,9490,2087,1,11661
631,2019-10-11,925,11908,1513,57,14403
631,2019-10-12,99,6837,1432,1,8369
631,2019-10-13,387,7775,1948,1,10111
631,2019-10-14,126,5194,1278,2,6600
631,2019-10-15,471,13169,1672,2,15314
631,2019-10-16,95,23834,1075,3,25007
631,2019-10-17,975,7761,2493,1,11230
631,2019-10-18,607,8040,1685,1,10333
631,2019-10-19,71,4434,1565,0,6070
631,2019-10-20,61,1538,2226,0,3825
631,2019-10-21,70,18333,2375,65,20843
631,2019-10-22,1696,8604,2623,0,12923
631,2019-10-23,63,7595,1424,2,9084
631,2019-10-24,1052,13806,1915,1,16774
631,2019-10-25,79,16638,1670,1,18388
631,2019-10-26,63,24524,1788,0,26375
631,2019-10-27,84,30414,1324,1,31823
631,2019-10-28,212,24316,1074,0,25602
631,2019-10-29,551,28771,1198,413,30933
631,2019-10-30,439,20442,1701,1,22583
631,2019-10-31,1230,20070,1708,2,23010
631,2019-11-01,539,27031,1084,1,28655
631,2019-11-02,351,35671,1858,2,37882
631,2019-11-03,184,26399,1634,1,28218
631,2019-11-04,1665,9684,1623,1,12973
631,2019-11-05,113,2239,1899,1,4252
631,2019-11-06,86,13900,1410,1,15397
631,2019-11-07,1396,25311,1618,2,28327
631,2019-11-08,87,17071,925,0,18083
631,2019-11-09,95,15493,1482,1,17071
631,2019-11-10,84,13224,737,2,14047
631,2019-11-11,500,13017,1770,4,15291
631,2019-11-12,80,17349,2893,0,20322
631,2019-11-13,184,13700,2111,3,15998
631,2019-11-14,128,8360,2024,2310,12822
631,2019-11-15,81,4084,2459,0,6624
631,2019-11-16,85,3422,3481,0,6988
631,2019-11-17,260,3921,3448,0,7629
631,2019-11-18,1030,3627,3872,0,8529
631,2019-11-19,136,3739,3936,0,7811
631,2019-11-20,95,2226,2084,0,4405
631,2019-11-21,587,6345,1783,0,8715
631,2019-11-22,80,6049,1626,0,7755
631,2019-11-23,92,10148,2886,0,13126
631,2019-11-24,196,7868,1395,0,9459
631,2019-11-25,96,11592,1614,0,13302
631,2019-11-26,341,10869,1482,0,12692
631,2019-11-27,62,6881,1831,0,8774
631,2019-11-28,60,13263,393,1,13717
632,2019-08-01,506,32919,379,2,33806
632,2019-08-02,518,29091,416,0,30025
632,2019-08-03,266,6906,296,1,7469
632,2019-08-04,128,1215,586,2,1931
632,2019-08-05,74,13840,234,0,14148
632,2019-08-06,89,6092,471,3,6655
632,2019-08-07,53,7051,577,1,7682
632,2019-08-08,45,3176,751,1,3973
632,2019-08-09,59,1551,275,1,1886
632,2019-08-10,59,1456,180,0,1695
632,2019-08-11,85,1358,55,0,1498
632,2019-08-12,53,15944,214,1,16212
632,2019-08-13,129,18376,134,1,18640
632,2019-08-14,169,6659,16,0,6844
632,2019-08-15,372,1326,59,0,1757
632,2019-08-16,109,2351,72,2,2534
632,2019-08-17,84,3255,650,0,3989
632,2019-08-18,273,2439,1099,1,3812
632,2019-08-19,180,21988,1608,0,23776
632,2019-08-20,1209,22037,767,2,24015
632,2019-08-21,253,13667,1477,2,15399
632,2019-08-22,251,19382,1583,1,21217
632,2019-08-23,258,24779,1716,1,26754
632,2019-08-24,405,16744,1565,0,18714
632,2019-08-25,334,78710,1789,3,80836
632,2019-08-26,460,36576,1779,4,38819
632,2019-08-27,393,23140,2612,3,26148
632,2019-08-28,674,30694,1710,0,33078
632,2019-08-29,1874,18262,1361,0,21497
632,2019-08-30,579,3912,1091,1,5583
632,2019-08-31,141,779,6,0,926
632,2019-09-01,103,1251,90,0,1444
632,2019-09-02,95,8027,0,0,8122
632,2019-09-03,1000,3396,1262,0,5658
632,2019-09-04,209,11941,1970,2,14122
632,2019-09-05,469,12470,2592,4,15535
632,2019-09-06,247,17547,1913,0,19707
632,2019-09-07,1154,16891,1968,0,20013
632,2019-09-08,1304,6993,1379,0,9676
632,2019-09-09,2069,6082,1439,11,9601
632,2019-09-10,256,9201,2244,0,11701
632,2019-09-11,1430,28227,1725,2,31384
632,2019-09-12,167,47493,3012,1,50673
632,2019-09-13,943,6522,2229,2,9696
632,2019-09-14,112,7938,2530,1,10581
632,2019-09-15,128,10646,2579,1,13354
632,2019-09-16,227,47879,1799,3,49908
632,2019-09-17,979,26664,3034,7,30684
632,2019-09-18,159,13273,1931,11,15374
632,2019-09-19,279,11946,1440,8,13673
632,2019-09-20,406,18557,1951,9,20923
632,2019-09-21,702,5973,2440,9,9124
632,2019-09-22,218,9426,2366,6,12016
632,2019-09-23,1128,10347,1942,1,13418
632,2019-09-24,154,8476,2069,5,10704
632,2019-09-25,248,8271,2497,6,11022
632,2019-09-26,228,10199,1659,0,12086
632,2019-09-27,978,8395,1724,2,11099
632,2019-09-28,762,15785,2484,1,19032
632,2019-09-29,1078,16636,1897,1,19612
632,2019-09-30,166,16179,1797,3,18145
632,2019-10-01,101,16171,1844,0,18116
632,2019-10-02,167,12167,1047,1,13382
632,2019-10-03,100,21262,1328,0,22690
632,2019-10-04,725,29297,910,0,30932
632,2019-10-05,632,32274,1178,1,34085
632,2019-10-06,1027,14132,1786,1,16946
632,2019-10-07,89,5290,1870,2,7251
632,2019-10-08,148,11473,1939,1,13561
632,2019-10-09,858,13896,1423,0,16177
632,2019-10-10,989,39378,1977,3,42347
632,2019-10-11,150,16635,1828,0,18613
632,2019-10-12,156,6989,1787,2,8934
632,2019-10-13,632,7864,1447,1,9944
632,2019-10-14,1019,5539,2126,4,8688
632,2019-10-15,1422,13114,1270,4,15810
632,2019-10-16,644,18202,1580,1,20427
632,2019-10-17,160,4396,1576,0,6132
632,2019-10-18,240,10664,1483,3,12390
632,2019-10-19,103,38076,1962,0,40141
632,2019-10-20,147,9230,1719,3,11099
632,2019-10-21,81,9896,1535,0,11512
632,2019-10-22,115,4994,1948,1,7058
632,2019-10-23,1028,13571,1807,1,16407
632,2019-10-24,207,25118,1385,0,26710
632,2019-10-25,1330,22065,1580,3,24978
632,2019-10-26,158,24784,1257,0,26199
632,2019-10-27,543,29963,1434,2,31942
632,2019-10-28,860,28747,1731,1,31339
632,2019-10-29,618,47273,1196,1,49088
632,2019-10-30,238,33019,1238,2,34497
632,2019-10-31,129,22377,1624,0,24130
632,2019-11-01,117,26759,1834,0,28710
632,2019-11-02,139,16070,1678,1,17888
632,2019-11-03,1407,21891,1497,0,24795
632,2019-11-04,168,10398,1142,3,11711
632,2019-11-05,566,2152,1565,1,4284
632,2019-11-06,223,13829,1133,0,15185
632,2019-11-07,229,16576,1177,3,17985
632,2019-11-08,1205,9095,1615,0,11915
632,2019-11-09,568,17802,1438,2,19810
632,2019-11-10,239,13615,1565,1,15420
632,2019-11-11,492,12905,912,1,14310
632,2019-11-12,143,12361,2803,1,15308
632,2019-11-13,190,14012,2167,1,16370
632,2019-11-14,103,7877,1855,0,9835
632,2019-11-15,110,2697,3645,0,6452
632,2019-11-16,67,1240,2693,0,4000
632,2019-11-17,93,2545,3525,0,6163
632,2019-11-18,886,2300,3673,0,6859
632,2019-11-19,122,5205,2591,0,7918
632,2019-11-20,106,1349,2545,0,4000
632,2019-11-21,208,3524,1324,0,5056
632,2019-11-22,112,5413,1515,0,7040
632,2019-11-23,279,6020,2737,0,9036
632,2019-11-24,241,6637,2430,0,9308
632,2019-11-25,152,5888,1800,2,7842
632,2019-11-26,158,5278,2047,1,7484
632,2019-11-27,105,5374,2074,0,7553
632,2019-11-28,89,8100,910,0,9099
632,2019-11-29,15,687,1,0,703
632,2019-08-01,506,32919,379,2,33806
632,2019-08-02,518,29091,416,0,30025
632,2019-08-03,266,6906,296,1,7469
632,2019-08-04,128,1215,586,2,1931
632,2019-08-05,74,13840,234,0,14148
632,2019-08-06,89,6092,471,3,6655
632,2019-08-07,53,7051,577,1,7682
632,2019-08-08,45,3176,751,1,3973
632,2019-08-09,59,1551,275,1,1886
632,2019-08-10,59,1456,180,0,1695
632,2019-08-11,85,1358,55,0,1498
632,2019-08-12,53,15944,214,1,16212
632,2019-08-13,129,18376,134,1,18640
632,2019-08-14,169,6659,16,0,6844
632,2019-08-15,372,1326,59,0,1757
632,2019-08-16,109,2351,72,2,2534
632,2019-08-17,84,3255,650,0,3989
632,2019-08-18,273,2439,1099,1,3812
632,2019-08-19,180,21988,1608,0,23776
632,2019-08-20,1209,22037,767,2,24015
632,2019-08-21,253,13667,1477,2,15399
632,2019-08-22,251,19382,1583,1,21217
632,2019-08-23,258,24779,1716,1,26754
632,2019-08-24,405,16744,1565,0,18714
632,2019-08-25,334,78710,1789,3,80836
632,2019-08-26,460,36576,1779,4,38819
632,2019-08-27,393,23140,2612,3,26148
632,2019-08-28,674,30694,1710,0,33078
632,2019-08-29,1874,18262,1361,0,21497
632,2019-08-30,579,3912,1091,1,5583
632,2019-08-31,141,779,6,0,926
632,2019-09-01,103,1251,90,0,1444
632,2019-09-02,95,8027,0,0,8122
632,2019-09-03,1000,3396,1262,0,5658
632,2019-09-04,209,11941,1970,2,14122
632,2019-09-05,469,12470,2592,4,15535
632,2019-09-06,247,17547,1913,0,19707
632,2019-09-07,1154,16891,1968,0,20013
632,2019-09-08,1304,6993,1379,0,9676
632,2019-09-09,2069,6082,1439,11,9601
632,2019-09-10,256,9201,2244,0,11701
632,2019-09-11,1430,28227,1725,2,31384
632,2019-09-12,167,47493,3012,1,50673
632,2019-09-13,943,6522,2229,2,9696
632,2019-09-14,112,7938,2530,1,10581
632,2019-09-15,128,10646,2579,1,13354
632,2019-09-16,227,47879,1799,3,49908
632,2019-09-17,979,26664,3034,7,30684
632,2019-09-18,159,13273,1931,11,15374
632,2019-09-19,279,11946,1440,8,13673
632,2019-09-20,406,18557,1951,9,20923
632,2019-09-21,702,5973,2440,9,9124
632,2019-09-22,218,9426,2366,6,12016
632,2019-09-23,1128,10347,1942,1,13418
632,2019-09-24,154,8476,2069,5,10704
632,2019-09-25,248,8271,2497,6,11022
632,2019-09-26,228,10199,1659,0,12086
632,2019-09-27,978,8395,1724,2,11099
632,2019-09-28,762,15785,2484,1,19032
632,2019-09-29,1078,16636,1897,1,19612
632,2019-09-30,166,16179,1797,3,18145
632,2019-10-01,101,16171,1844,0,18116
632,2019-10-02,167,12167,1047,1,13382
632,2019-10-03,100,21262,1328,0,22690
632,2019-10-04,725,29297,910,0,30932
632,2019-10-05,632,32274,1178,1,34085
632,2019-10-06,1027,14132,1786,1,16946
632,2019-10-07,89,5290,1870,2,7251
632,2019-10-08,148,11473,1939,1,13561
632,2019-10-09,858,13896,1423,0,16177
632,2019-10-10,989,39378,1977,3,42347
632,2019-10-11,150,16635,1828,0,18613
632,2019-10-12,156,6989,1787,2,8934
632,2019-10-13,632,7864,1447,1,9944
632,2019-10-14,1019,5539,2126,4,8688
632,2019-10-15,1422,13114,1270,4,15810
632,2019-10-16,644,18202,1580,1,20427
632,2019-10-17,160,4396,1576,0,6132
632,2019-10-18,240,10664,1483,3,12390
632,2019-10-19,103,38076,1962,0,40141
632,2019-10-20,147,9230,1719,3,11099
632,2019-10-21,81,9896,1535,0,11512
632,2019-10-22,115,4994,1948,1,7058
632,2019-10-23,1028,13571,1807,1,16407
632,2019-10-24,207,25118,1385,0,26710
632,2019-10-25,1330,22065,1580,3,24978
632,2019-10-26,158,24784,1257,0,26199
632,2019-10-27,543,29963,1434,2,31942
632,2019-10-28,860,28747,1731,1,31339
632,2019-10-29,618,47273,1196,1,49088
632,2019-10-30,238,33019,1238,2,34497
632,2019-10-31,129,22377,1624,0,24130
632,2019-11-01,117,26759,1834,0,28710
632,2019-11-02,139,16070,1678,1,17888
632,2019-11-03,1407,21891,1497,0,24795
632,2019-11-04,168,10398,1142,3,11711
632,2019-11-05,566,2152,1565,1,4284
632,2019-11-06,223,13829,1133,0,15185
632,2019-11-07,229,16576,1177,3,17985
632,2019-11-08,1205,9095,1615,0,11915
632,2019-11-09,568,17802,1438,2,19810
632,2019-11-10,239,13615,1565,1,15420
632,2019-11-11,492,12905,912,1,14310
632,2019-11-12,143,12361,2803,1,15308
632,2019-11-13,190,14012,2167,1,16370
632,2019-11-14,103,7877,1855,0,9835
632,2019-11-15,110,2697,3645,0,6452
632,2019-11-16,67,1240,2693,0,4000
632,2019-11-17,93,2545,3525,0,6163
632,2019-11-18,886,2300,3673,0,6859
632,2019-11-19,122,5205,2591,0,7918
632,2019-11-20,106,1349,2545,0,4000
632,2019-11-21,208,3524,1324,0,5056
632,2019-11-22,112,5413,1515,0,7040
632,2019-11-23,279,6020,2737,0,9036
632,2019-11-24,241,6637,2430,0,9308
632,2019-11-25,152,5888,1800,2,7842
632,2019-11-26,158,5278,2047,1,7484
632,2019-11-27,105,5374,2074,0,7553
632,2019-11-28,89,8100,910,0,9099
632,2019-11-29,15,687,1,0,703
632,2019-08-01,506,32919,379,2,33806
632,2019-08-02,518,29091,416,0,30025
632,2019-08-03,266,6906,296,1,7469
632,2019-08-04,128,1215,586,2,1931
632,2019-08-05,74,13840,234,0,14148
632,2019-08-06,89,6092,471,3,6655
632,2019-08-07,53,7051,577,1,7682
632,2019-08-08,45,3176,751,1,3973
632,2019-08-09,59,1551,275,1,1886
632,2019-08-10,59,1456,180,0,1695
632,2019-08-11,85,1358,55,0,1498
632,2019-08-12,53,15944,214,1,16212
632,2019-08-13,129,18376,134,1,18640
632,2019-08-14,169,6659,16,0,6844
632,2019-08-15,372,1326,59,0,1757
632,2019-08-16,109,2351,72,2,2534
632,2019-08-17,84,3255,650,0,3989
632,2019-08-18,273,2439,1099,1,3812
632,2019-08-19,180,21988,1608,0,23776
632,2019-08-20,1209,22037,767,2,24015
632,2019-08-21,253,13667,1477,2,15399
632,2019-08-22,251,19382,1583,1,21217
632,2019-08-23,258,24779,1716,1,26754
632,2019-08-24,405,16744,1565,0,18714
632,2019-08-25,334,78710,1789,3,80836
632,2019-08-26,460,36576,1779,4,38819
632,2019-08-27,393,23140,2612,3,26148
632,2019-08-28,674,30694,1710,0,33078
632,2019-08-29,1874,18262,1361,0,21497
632,2019-08-30,579,3912,1091,1,5583
632,2019-08-31,141,779,6,0,926
632,2019-09-01,103,1251,90,0,1444
632,2019-09-02,95,8027,0,0,8122
632,2019-09-03,1000,3396,1262,0,5658
632,2019-09-04,209,11941,1970,2,14122
632,2019-09-05,469,12470,2592,4,15535
632,2019-09-06,247,17547,1913,0,19707
632,2019-09-07,1154,16891,1968,0,20013
632,2019-09-08,1304,6993,1379,0,9676
632,2019-09-09,2069,6082,1439,11,9601
632,2019-09-10,256,9201,2244,0,11701
632,2019-09-11,1430,28227,1725,2,31384
632,2019-09-12,167,47493,3012,1,50673
632,2019-09-13,943,6522,2229,2,9696
632,2019-09-14,112,7938,2530,1,10581
632,2019-09-15,128,10646,2579,1,13354
632,2019-09-16,227,47879,1799,3,49908
632,2019-09-17,979,26664,3034,7,30684
632,2019-09-18,159,13273,1931,11,15374
632,2019-09-19,279,11946,1440,8,13673
632,2019-09-20,406,18557,1951,9,20923
632,2019-09-21,702,5973,2440,9,9124
632,2019-09-22,218,9426,2366,6,12016
632,2019-09-23,1128,10347,1942,1,13418
632,2019-09-24,154,8476,2069,5,10704
632,2019-09-25,248,8271,2497,6,11022
632,2019-09-26,228,10199,1659,0,12086
632,2019-09-27,978,8395,1724,2,11099
632,2019-09-28,762,15785,2484,1,19032
632,2019-09-29,1078,16636,1897,1,19612
632,2019-09-30,166,16179,1797,3,18145
632,2019-10-01,101,16171,1844,0,18116
632,2019-10-02,167,12167,1047,1,13382
632,2019-10-03,100,21262,1328,0,22690
632,2019-10-04,725,29297,910,0,30932
632,2019-10-05,632,32274,1178,1,34085
632,2019-10-06,1027,14132,1786,1,16946
632,2019-10-07,89,5290,1870,2,7251
632,2019-10-08,148,11473,1939,1,13561
632,2019-10-09,858,13896,1423,0,16177
632,2019-10-10,989,39378,1977,3,42347
632,2019-10-11,150,16635,1828,0,18613
632,2019-10-12,156,6989,1787,2,8934
632,2019-10-13,632,7864,1447,1,9944
632,2019-10-14,1019,5539,2126,4,8688
632,2019-10-15,1422,13114,1270,4,15810
632,2019-10-16,644,18202,1580,1,20427
632,2019-10-17,160,4396,1576,0,6132
632,2019-10-18,240,10664,1483,3,12390
632,2019-10-19,103,38076,1962,0,40141
632,2019-10-20,147,9230,1719,3,11099
632,2019-10-21,81,9896,1535,0,11512
632,2019-10-22,115,4994,1948,1,7058
632,2019-10-23,1028,13571,1807,1,16407
632,2019-10-24,207,25118,1385,0,26710
632,2019-10-25,1330,22065,1580,3,24978
632,2019-10-26,158,24784,1257,0,26199
632,2019-10-27,543,29963,1434,2,31942
632,2019-10-28,860,28747,1731,1,31339
632,2019-10-29,618,47273,1196,1,49088
632,2019-10-30,238,33019,1238,2,34497
632,2019-10-31,129,22377,1624,0,24130
632,2019-11-01,117,26759,1834,0,28710
632,2019-11-02,139,16070,1678,1,17888
632,2019-11-03,1407,21891,1497,0,24795
632,2019-11-04,168,10398,1142,3,11711
632,2019-11-05,566,2152,1565,1,4284
632,2019-11-06,223,13829,1133,0,15185
632,2019-11-07,229,16576,1177,3,17985
632,2019-11-08,1205,9095,1615,0,11915
632,2019-11-09,568,17802,1438,2,19810
632,2019-11-10,239,13615,1565,1,15420
632,2019-11-11,492,12905,912,1,14310
632,2019-11-12,143,12361,2803,1,15308
632,2019-11-13,190,14012,2167,1,16370
632,2019-11-14,103,7877,1855,0,9835
632,2019-11-15,110,2697,3645,0,6452
632,2019-11-16,67,1240,2693,0,4000
632,2019-11-17,93,2545,3525,0,6163
632,2019-11-18,886,2300,3673,0,6859
632,2019-11-19,122,5205,2591,0,7918
632,2019-11-20,106,1349,2545,0,4000
632,2019-11-21,208,3524,1324,0,5056
632,2019-11-22,112,5413,1515,0,7040
632,2019-11-23,279,6020,2737,0,9036
632,2019-11-24,241,6637,2430,0,9308
632,2019-11-25,152,5888,1800,2,7842
632,2019-11-26,158,5278,2047,1,7484
632,2019-11-27,105,5374,2074,0,7553
632,2019-11-28,89,8100,910,0,9099
632,2019-11-29,15,687,1,0,703
632,2019-08-01,506,32919,379,2,33806
632,2019-08-02,518,29091,416,0,30025
632,2019-08-03,266,6906,296,1,7469
632,2019-08-04,128,1215,586,2,1931
632,2019-08-05,74,13840,234,0,14148
632,2019-08-06,89,6092,471,3,6655
632,2019-08-07,53,7051,577,1,7682
632,2019-08-08,45,3176,751,1,3973
632,2019-08-09,59,1551,275,1,1886
632,2019-08-10,59,1456,180,0,1695
632,2019-08-11,85,1358,55,0,1498
632,2019-08-12,53,15944,214,1,16212
632,2019-08-13,129,18376,134,1,18640
632,2019-08-14,169,6659,16,0,6844
632,2019-08-15,372,1326,59,0,1757
632,2019-08-16,109,2351,72,2,2534
632,2019-08-17,84,3255,650,0,3989
632,2019-08-18,273,2439,1099,1,3812
632,2019-08-19,180,21988,1608,0,23776
632,2019-08-20,1209,22037,767,2,24015
632,2019-08-21,253,13667,1477,2,15399
632,2019-08-22,251,19382,1583,1,21217
632,2019-08-23,258,24779,1716,1,26754
632,2019-08-24,405,16744,1565,0,18714
632,2019-08-25,334,78710,1789,3,80836
632,2019-08-26,460,36576,1779,4,38819
632,2019-08-27,393,23140,2612,3,26148
632,2019-08-28,674,30694,1710,0,33078
632,2019-08-29,1874,18262,1361,0,21497
632,2019-08-30,579,3912,1091,1,5583
632,2019-08-31,141,779,6,0,926
632,2019-09-01,103,1251,90,0,1444
632,2019-09-02,95,8027,0,0,8122
632,2019-09-03,1000,3396,1262,0,5658
632,2019-09-04,209,11941,1970,2,14122
632,2019-09-05,469,12470,2592,4,15535
632,2019-09-06,247,17547,1913,0,19707
632,2019-09-07,1154,16891,1968,0,20013
632,2019-09-08,1304,6993,1379,0,9676
632,2019-09-09,2069,6082,1439,11,9601
632,2019-09-10,256,9201,2244,0,11701
632,2019-09-11,1430,28227,1725,2,31384
632,2019-09-12,167,47493,3012,1,50673
632,2019-09-13,943,6522,2229,2,9696
632,2019-09-14,112,7938,2530,1,10581
632,2019-09-15,128,10646,2579,1,13354
632,2019-09-16,227,47879,1799,3,49908
632,2019-09-17,979,26664,3034,7,30684
632,2019-09-18,159,13273,1931,11,15374
632,2019-09-19,279,11946,1440,8,13673
632,2019-09-20,406,18557,1951,9,20923
632,2019-09-21,702,5973,2440,9,9124
632,2019-09-22,218,9426,2366,6,12016
632,2019-09-23,1128,10347,1942,1,13418
632,2019-09-24,154,8476,2069,5,10704
632,2019-09-25,248,8271,2497,6,11022
632,2019-09-26,228,10199,1659,0,12086
632,2019-09-27,978,8395,1724,2,11099
632,2019-09-28,762,15785,2484,1,19032
632,2019-09-29,1078,16636,1897,1,19612
632,2019-09-30,166,16179,1797,3,18145
632,2019-10-01,101,16171,1844,0,18116
632,2019-10-02,167,12167,1047,1,13382
632,2019-10-03,100,21262,1328,0,22690
632,2019-10-04,725,29297,910,0,30932
632,2019-10-05,632,32274,1178,1,34085
632,2019-10-06,1027,14132,1786,1,16946
632,2019-10-07,89,5290,1870,2,7251
632,2019-10-08,148,11473,1939,1,13561
632,2019-10-09,858,13896,1423,0,16177
632,2019-10-10,989,39378,1977,3,42347
632,2019-10-11,150,16635,1828,0,18613
632,2019-10-12,156,6989,1787,2,8934
632,2019-10-13,632,7864,1447,1,9944
632,2019-10-14,1019,5539,2126,4,8688
632,2019-10-15,1422,13114,1270,4,15810
632,2019-10-16,644,18202,1580,1,20427
632,2019-10-17,160,4396,1576,0,6132
632,2019-10-18,240,10664,1483,3,12390
632,2019-10-19,103,38076,1962,0,40141
632,2019-10-20,147,9230,1719,3,11099
632,2019-10-21,81,9896,1535,0,11512
632,2019-10-22,115,4994,1948,1,7058
632,2019-10-23,1028,13571,1807,1,16407
632,2019-10-24,207,25118,1385,0,26710
632,2019-10-25,1330,22065,1580,3,24978
632,2019-10-26,158,24784,1257,0,26199
632,2019-10-27,543,29963,1434,2,31942
632,2019-10-28,860,28747,1731,1,31339
632,2019-10-29,618,47273,1196,1,49088
632,2019-10-30,238,33019,1238,2,34497
632,2019-10-31,129,22377,1624,0,24130
632,2019-11-01,117,26759,1834,0,28710
632,2019-11-02,139,16070,1678,1,17888
632,2019-11-03,1407,21891,1497,0,24795
632,2019-11-04,168,10398,1142,3,11711
632,2019-11-05,566,2152,1565,1,4284
632,2019-11-06,223,13829,1133,0,15185
632,2019-11-07,229,16576,1177,3,17985
632,2019-11-08,1205,9095,1615,0,11915
632,2019-11-09,568,17802,1438,2,19810
632,2019-11-10,239,13615,1565,1,15420
632,2019-11-11,492,12905,912,1,14310
632,2019-11-12,143,12361,2803,1,15308
632,2019-11-13,190,14012,2167,1,16370
632,2019-11-14,103,7877,1855,0,9835
632,2019-11-15,110,2697,3645,0,6452
632,2019-11-16,67,1240,2693,0,4000
632,2019-11-17,93,2545,3525,0,6163
632,2019-11-18,886,2300,3673,0,6859
632,2019-11-19,122,5205,2591,0,7918
632,2019-11-20,106,1349,2545,0,4000
632,2019-11-21,208,3524,1324,0,5056
632,2019-11-22,112,5413,1515,0,7040
632,2019-11-23,279,6020,2737,0,9036
632,2019-11-24,241,6637,2430,0,9308
632,2019-11-25,152,5888,1800,2,7842
632,2019-11-26,158,5278,2047,1,7484
633,2019-08-01,26,39555,255,1,39837
633,2019-08-02,35,32593,311,1,32940
633,2019-08-03,35,7121,298,1,7455
633,2019-08-04,20,1240,620,3,1883
633,2019-08-05,64,13725,484,1,14274
633,2019-08-06,64,6838,602,0,7504
633,2019-08-07,53,1810,583,0,2446
633,2019-08-08,45,1401,182,1,1629
633,2019-08-09,15,1566,213,0,1794
633,2019-08-10,29,1720,98,0,1847
633,2019-08-11,114,5478,89,0,5681
633,2019-08-12,156,15472,254,1,15883
633,2019-08-13,56,14459,413,0,14928
633,2019-08-14,45,2194,12,0,2251
633,2019-08-15,14,1187,53,0,1254
633,2019-08-16,18,2294,8,1,2321
633,2019-08-17,73,3260,826,0,4159
633,2019-08-18,155,4104,873,0,5132
633,2019-08-19,723,9974,1147,2,11846
633,2019-08-20,43,15366,1057,0,16466
633,2019-08-21,35,15185,1012,0,16232
633,2019-08-22,401,16972,995,3,18371
633,2019-08-23,33,39332,1808,2,41175
633,2019-08-24,35,24505,1274,3,25817
633,2019-08-25,891,49191,2160,0,52242
633,2019-08-26,154,33212,2452,0,35818
633,2019-08-27,900,16630,2711,0,20241
633,2019-08-28,68,21451,2363,0,23882
633,2019-08-29,71,13822,2171,2,16066
633,2019-08-30,33,3594,540,1,4168
633,2019-08-31,21,620,1,0,642
633,2019-09-01,756,1016,193,0,1965
633,2019-09-02,11,487,9,0,507
633,2019-09-03,57,2143,1364,3,3567
633,2019-09-04,62,13853,2282,0,16197
633,2019-09-05,76,8399,2182,1,10658
633,2019-09-06,103,16092,3094,0,19289
633,2019-09-07,190,18283,3541,0,22014
633,2019-09-08,1021,5706,2265,0,8992
633,2019-09-09,84,7882,1747,4,9717
633,2019-09-10,50,9045,1458,1,10554
633,2019-09-11,175,10408,1464,2,12049
633,2019-09-12,892,6145,3033,1,10071
633,2019-09-13,71,7196,2459,2,9728
633,2019-09-14,143,6547,2325,1,9016
633,2019-09-15,62,13099,1428,3,14592
633,2019-09-16,72,7304,1909,3,9288
633,2019-09-17,850,9636,2092,7,12585
633,2019-09-18,171,20252,1927,9,22359
633,2019-09-19,184,11602,1824,9,13619
633,2019-09-20,96,19266,1802,9,21173
633,2019-09-21,913,7372,1170,10,9465
633,2019-09-22,43,8935,2376,9,11363
633,2019-09-23,1016,29791,1977,12,32796
633,2019-09-24,296,10460,1530,11,12297
633,2019-09-25,1036,8799,1968,13,11816
633,2019-09-26,78,12286,2365,13,14742
633,2019-09-27,72,10198,1388,7,11665
633,2019-09-28,115,16562,2197,5,18879
633,2019-09-29,95,18633,2124,1,20853
633,2019-09-30,52,16797,1766,1,18616
633,2019-10-01,110,18597,1023,3,19733
633,2019-10-02,1161,13881,2876,6,17924
633,2019-10-03,943,15352,1526,10,17831
633,2019-10-04,64,35051,1498,10,36623
633,2019-10-05,896,21262,1623,10,23791
633,2019-10-06,61,11936,1664,11,13672
633,2019-10-07,239,7937,1753,14,9943
633,2019-10-08,208,13312,1743,14,15277
633,2019-10-09,1322,15901,1434,10,18667
633,2019-10-10,644,11508,1544,11,13707
633,2019-10-11,933,10693,1448,9,13083
633,2019-10-12,939,7730,1937,2,10608
633,2019-10-13,936,9245,1550,4,11735
633,2019-10-14,81,9155,1630,1,10867
633,2019-10-15,482,9556,1073,1,11112
633,2019-10-16,95,18998,2110,0,21203
633,2019-10-17,46,8888,2260,4,11198
633,2019-10-18,67,10243,1829,1,12140
633,2019-10-19,160,8612,1454,1,10227
633,2019-10-20,2453,3381,2258,1,8093
633,2019-10-21,80,11115,1271,4,12470
633,2019-10-22,51,7062,2117,0,9230
633,2019-10-23,42,15073,1728,5,16848
633,2019-10-24,170,18987,1711,1,20869
633,2019-10-25,647,11732,1889,1,14269
633,2019-10-26,89,14195,1568,1,15853
633,2019-10-27,757,17091,994,2,18844
633,2019-10-28,35,24260,1446,1,25742
633,2019-10-29,114,29949,2148,1,32212
633,2019-10-30,172,31950,1060,1,33183
633,2019-10-31,42,15443,1913,1,17399
633,2019-11-01,45,15527,1141,0,16713
633,2019-11-02,39,15088,1558,4,16689
633,2019-11-03,1727,37701,1501,0,40929
633,2019-11-04,78,11548,1776,0,13402
633,2019-11-05,977,3770,1811,0,6558
633,2019-11-06,66,15443,994,0,16503
633,2019-11-07,170,17260,1178,3,18611
633,2019-11-08,134,10202,1066,0,11402
633,2019-11-09,62,10086,1786,1,11935
633,2019-11-10,1086,15573,1144,2,17805
633,2019-11-11,70,10482,1628,0,12180
633,2019-11-12,260,11437,2788,5,14490
633,2019-11-13,1116,14914,1862,1,17893
633,2019-11-14,72,9027,2400,2,11501
633,2019-11-15,55,4604,2454,1,7114
633,2019-11-16,995,3053,2548,1,6597
633,2019-11-17,265,3733,3503,3,7504
633,2019-11-18,188,2781,3112,0,6081
633,2019-11-19,141,3649,2602,1,6393
633,2019-11-20,95,2259,1243,1,3598
633,2019-11-21,1012,5447,1438,1,7898
633,2019-11-22,76,5895,1606,0,7577
633,2019-11-23,67,6279,2121,0,8467
633,2019-11-24,83,8481,1851,0,10415
633,2019-11-25,965,12063,2398,0,15426
633,2019-11-26,46,10685,1886,0,12617
633,2019-11-27,47,10891,2036,0,12974
633,2019-11-28,51,13800,1172,0,15023
633,2019-11-29,20,475,1,0,496
633,2019-08-01,26,39555,255,1,39837
633,2019-08-02,35,32593,311,1,32940
633,2019-08-03,35,7121,298,1,7455
633,2019-08-04,20,1240,620,3,1883
633,2019-08-05,64,13725,484,1,14274
633,2019-08-06,64,6838,602,0,7504
633,2019-08-07,53,1810,583,0,2446
633,2019-08-08,45,1401,182,1,1629
633,2019-08-09,15,1566,213,0,1794
633,2019-08-10,29,1720,98,0,1847
633,2019-08-11,114,5478,89,0,5681
633,2019-08-12,156,15472,254,1,15883
633,2019-08-13,56,14459,413,0,14928
633,2019-08-14,45,2194,12,0,2251
633,2019-08-15,14,1187,53,0,1254
633,2019-08-16,18,2294,8,1,2321
633,2019-08-17,73,3260,826,0,4159
633,2019-08-18,155,4104,873,0,5132
633,2019-08-19,723,9974,1147,2,11846
633,2019-08-20,43,15366,1057,0,16466
633,2019-08-21,35,15185,1012,0,16232
633,2019-08-22,401,16972,995,3,18371
633,2019-08-23,33,39332,1808,2,41175
633,2019-08-24,35,24505,1274,3,25817
633,2019-08-25,891,49191,2160,0,52242
633,2019-08-26,154,33212,2452,0,35818
633,2019-08-27,900,16630,2711,0,20241
633,2019-08-28,68,21451,2363,0,23882
633,2019-08-29,71,13822,2171,2,16066
633,2019-08-30,33,3594,540,1,4168
633,2019-08-31,21,620,1,0,642
633,2019-09-01,756,1016,193,0,1965
633,2019-09-02,11,487,9,0,507
633,2019-09-03,57,2143,1364,3,3567
633,2019-09-04,62,13853,2282,0,16197
633,2019-09-05,76,8399,2182,1,10658
633,2019-09-06,103,16092,3094,0,19289
633,2019-09-07,190,18283,3541,0,22014
633,2019-09-08,1021,5706,2265,0,8992
633,2019-09-09,84,7882,1747,4,9717
633,2019-09-10,50,9045,1458,1,10554
633,2019-09-11,175,10408,1464,2,12049
633,2019-09-12,892,6145,3033,1,10071
633,2019-09-13,71,7196,2459,2,9728
633,2019-09-14,143,6547,2325,1,9016
633,2019-09-15,62,13099,1428,3,14592
633,2019-09-16,72,7304,1909,3,9288
633,2019-09-17,850,9636,2092,7,12585
633,2019-09-18,171,20252,1927,9,22359
633,2019-09-19,184,11602,1824,9,13619
633,2019-09-20,96,19266,1802,9,21173
633,2019-09-21,913,7372,1170,10,9465
633,2019-09-22,43,8935,2376,9,11363
633,2019-09-23,1016,29791,1977,12,32796
633,2019-09-24,296,10460,1530,11,12297
633,2019-09-25,1036,8799,1968,13,11816
633,2019-09-26,78,12286,2365,13,14742
633,2019-09-27,72,10198,1388,7,11665
633,2019-09-28,115,16562,2197,5,18879
633,2019-09-29,95,18633,2124,1,20853
633,2019-09-30,52,16797,1766,1,18616
633,2019-10-01,110,18597,1023,3,19733
633,2019-10-02,1161,13881,2876,6,17924
633,2019-10-03,943,15352,1526,10,17831
633,2019-10-04,64,35051,1498,10,36623
633,2019-10-05,896,21262,1623,10,23791
633,2019-10-06,61,11936,1664,11,13672
633,2019-10-07,239,7937,1753,14,9943
633,2019-10-08,208,13312,1743,14,15277
633,2019-10-09,1322,15901,1434,10,18667
633,2019-10-10,644,11508,1544,11,13707
633,2019-10-11,933,10693,1448,9,13083
633,2019-10-12,939,7730,1937,2,10608
633,2019-10-13,936,9245,1550,4,11735
633,2019-10-14,81,9155,1630,1,10867
633,2019-10-15,482,9556,1073,1,11112
633,2019-10-16,95,18998,2110,0,21203
633,2019-10-17,46,8888,2260,4,11198
633,2019-10-18,67,10243,1829,1,12140
633,2019-10-19,160,8612,1454,1,10227
633,2019-10-20,2453,3381,2258,1,8093
633,2019-10-21,80,11115,1271,4,12470
633,2019-10-22,51,7062,2117,0,9230
633,2019-10-23,42,15073,1728,5,16848
633,2019-10-24,170,18987,1711,1,20869
633,2019-10-25,647,11732,1889,1,14269
633,2019-10-26,89,14195,1568,1,15853
633,2019-10-27,757,17091,994,2,18844
633,2019-10-28,35,24260,1446,1,25742
633,2019-10-29,114,29949,2148,1,32212
633,2019-10-30,172,31950,1060,1,33183
633,2019-10-31,42,15443,1913,1,17399
633,2019-11-01,45,15527,1141,0,16713
633,2019-11-02,39,15088,1558,4,16689
633,2019-11-03,1727,37701,1501,0,40929
633,2019-11-04,78,11548,1776,0,13402
633,2019-11-05,977,3770,1811,0,6558
633,2019-11-06,66,15443,994,0,16503
633,2019-11-07,170,17260,1178,3,18611
633,2019-11-08,134,10202,1066,0,11402
633,2019-11-09,62,10086,1786,1,11935
633,2019-11-10,1086,15573,1144,2,17805
633,2019-11-11,70,10482,1628,0,12180
633,2019-11-12,260,11437,2788,5,14490
633,2019-11-13,1116,14914,1862,1,17893
633,2019-11-14,72,9027,2400,2,11501
633,2019-11-15,55,4604,2454,1,7114
633,2019-11-16,995,3053,2548,1,6597
633,2019-11-17,265,3733,3503,3,7504
633,2019-11-18,188,2781,3112,0,6081
633,2019-11-19,141,3649,2602,1,6393
633,2019-11-20,95,2259,1243,1,3598
633,2019-11-21,1012,5447,1438,1,7898
633,2019-11-22,76,5895,1606,0,7577
633,2019-11-23,67,6279,2121,0,8467
633,2019-11-24,83,8481,1851,0,10415
633,2019-11-25,965,12063,2398,0,15426
633,2019-11-26,46,10685,1886,0,12617
633,2019-11-27,47,10891,2036,0,12974
633,2019-11-28,51,13800,1172,0,15023
633,2019-11-29,20,475,1,0,496
633,2019-08-01,26,39555,255,1,39837
633,2019-08-02,35,32593,311,1,32940
633,2019-08-03,35,7121,298,1,7455
633,2019-08-04,20,1240,620,3,1883
633,2019-08-05,64,13725,484,1,14274
633,2019-08-06,64,6838,602,0,7504
633,2019-08-07,53,1810,583,0,2446
633,2019-08-08,45,1401,182,1,1629
633,2019-08-09,15,1566,213,0,1794
633,2019-08-10,29,1720,98,0,1847
633,2019-08-11,114,5478,89,0,5681
633,2019-08-12,156,15472,254,1,15883
633,2019-08-13,56,14459,413,0,14928
633,2019-08-14,45,2194,12,0,2251
633,2019-08-15,14,1187,53,0,1254
633,2019-08-16,18,2294,8,1,2321
633,2019-08-17,73,3260,826,0,4159
633,2019-08-18,155,4104,873,0,5132
633,2019-08-19,723,9974,1147,2,11846
633,2019-08-20,43,15366,1057,0,16466
633,2019-08-21,35,15185,1012,0,16232
633,2019-08-22,401,16972,995,3,18371
633,2019-08-23,33,39332,1808,2,41175
633,2019-08-24,35,24505,1274,3,25817
633,2019-08-25,891,49191,2160,0,52242
633,2019-08-26,154,33212,2452,0,35818
633,2019-08-27,900,16630,2711,0,20241
633,2019-08-28,68,21451,2363,0,23882
633,2019-08-29,71,13822,2171,2,16066
633,2019-08-30,33,3594,540,1,4168
633,2019-08-31,21,620,1,0,642
633,2019-09-01,756,1016,193,0,1965
633,2019-09-02,11,487,9,0,507
633,2019-09-03,57,2143,1364,3,3567
633,2019-09-04,62,13853,2282,0,16197
633,2019-09-05,76,8399,2182,1,10658
633,2019-09-06,103,16092,3094,0,19289
633,2019-09-07,190,18283,3541,0,22014
633,2019-09-08,1021,5706,2265,0,8992
633,2019-09-09,84,7882,1747,4,9717
633,2019-09-10,50,9045,1458,1,10554
633,2019-09-11,175,10408,1464,2,12049
633,2019-09-12,892,6145,3033,1,10071
633,2019-09-13,71,7196,2459,2,9728
633,2019-09-14,143,6547,2325,1,9016
633,2019-09-15,62,13099,1428,3,14592
633,2019-09-16,72,7304,1909,3,9288
633,2019-09-17,850,9636,2092,7,12585
633,2019-09-18,171,20252,1927,9,22359
633,2019-09-19,184,11602,1824,9,13619
633,2019-09-20,96,19266,1802,9,21173
633,2019-09-21,913,7372,1170,10,9465
633,2019-09-22,43,8935,2376,9,11363
633,2019-09-23,1016,29791,1977,12,32796
633,2019-09-24,296,10460,1530,11,12297
633,2019-09-25,1036,8799,1968,13,11816
633,2019-09-26,78,12286,2365,13,14742
633,2019-09-27,72,10198,1388,7,11665
633,2019-09-28,115,16562,2197,5,18879
633,2019-09-29,95,18633,2124,1,20853
633,2019-09-30,52,16797,1766,1,18616
633,2019-10-01,110,18597,1023,3,19733
633,2019-10-02,1161,13881,2876,6,17924
633,2019-10-03,943,15352,1526,10,17831
633,2019-10-04,64,35051,1498,10,36623
633,2019-10-05,896,21262,1623,10,23791
633,2019-10-06,61,11936,1664,11,13672
633,2019-10-07,239,7937,1753,14,9943
633,2019-10-08,208,13312,1743,14,15277
633,2019-10-09,1322,15901,1434,10,18667
633,2019-10-10,644,11508,1544,11,13707
633,2019-10-11,933,10693,1448,9,13083
633,2019-10-12,939,7730,1937,2,10608
633,2019-10-13,936,9245,1550,4,11735
633,2019-10-14,81,9155,1630,1,10867
633,2019-10-15,482,9556,1073,1,11112
633,2019-10-16,95,18998,2110,0,21203
633,2019-10-17,46,8888,2260,4,11198
633,2019-10-18,67,10243,1829,1,12140
633,2019-10-19,160,8612,1454,1,10227
633,2019-10-20,2453,3381,2258,1,8093
633,2019-10-21,80,11115,1271,4,12470
633,2019-10-22,51,7062,2117,0,9230
633,2019-10-23,42,15073,1728,5,16848
633,2019-10-24,170,18987,1711,1,20869
633,2019-10-25,647,11732,1889,1,14269
633,2019-10-26,89,14195,1568,1,15853
633,2019-10-27,757,17091,994,2,18844
633,2019-10-28,35,24260,1446,1,25742
633,2019-10-29,114,29949,2148,1,32212
633,2019-10-30,172,31950,1060,1,33183
633,2019-10-31,42,15443,1913,1,17399
633,2019-11-01,45,15527,1141,0,16713
633,2019-11-02,39,15088,1558,4,16689
633,2019-11-03,1727,37701,1501,0,40929
633,2019-11-04,78,11548,1776,0,13402
633,2019-11-05,977,3770,1811,0,6558
633,2019-11-06,66,15443,994,0,16503
633,2019-11-07,170,17260,1178,3,18611
633,2019-11-08,134,10202,1066,0,11402
633,2019-11-09,62,10086,1786,1,11935
633,2019-11-10,1086,15573,1144,2,17805
633,2019-11-11,70,10482,1628,0,12180
633,2019-11-12,260,11437,2788,5,14490
633,2019-11-13,1116,14914,1862,1,17893
633,2019-11-14,72,9027,2400,2,11501
633,2019-11-15,55,4604,2454,1,7114
633,2019-11-16,995,3053,2548,1,6597
633,2019-11-17,265,3733,3503,3,7504
633,2019-11-18,188,2781,3112,0,6081
633,2019-11-19,141,3649,2602,1,6393
633,2019-11-20,95,2259,1243,1,3598
633,2019-11-21,1012,5447,1438,1,7898
633,2019-11-22,76,5895,1606,0,7577
633,2019-11-23,67,6279,2121,0,8467
633,2019-11-24,83,8481,1851,0,10415
633,2019-11-25,965,12063,2398,0,15426
633,2019-11-26,46,10685,1886,0,12617
633,2019-11-27,47,10891,2036,0,12974
633,2019-11-28,51,13800,1172,0,15023
633,2019-11-29,20,475,1,0,496
633,2019-08-01,26,39555,255,1,39837
633,2019-08-02,35,32593,311,1,32940
633,2019-08-03,35,7121,298,1,7455
633,2019-08-04,20,1240,620,3,1883
633,2019-08-05,64,13725,484,1,14274
633,2019-08-06,64,6838,602,0,7504
633,2019-08-07,53,1810,583,0,2446
633,2019-08-08,45,1401,182,1,1629
633,2019-08-09,15,1566,213,0,1794
633,2019-08-10,29,1720,98,0,1847
633,2019-08-11,114,5478,89,0,5681
633,2019-08-12,156,15472,254,1,15883
633,2019-08-13,56,14459,413,0,14928
633,2019-08-14,45,2194,12,0,2251
633,2019-08-15,14,1187,53,0,1254
633,2019-08-16,18,2294,8,1,2321
633,2019-08-17,73,3260,826,0,4159
633,2019-08-18,155,4104,873,0,5132
633,2019-08-19,723,9974,1147,2,11846
633,2019-08-20,43,15366,1057,0,16466
633,2019-08-21,35,15185,1012,0,16232
633,2019-08-22,401,16972,995,3,18371
633,2019-08-23,33,39332,1808,2,41175
633,2019-08-24,35,24505,1274,3,25817
633,2019-08-25,891,49191,2160,0,52242
633,2019-08-26,154,33212,2452,0,35818
633,2019-08-27,900,16630,2711,0,20241
633,2019-08-28,68,21451,2363,0,23882
633,2019-08-29,71,13822,2171,2,16066
633,2019-08-30,33,3594,540,1,4168
633,2019-08-31,21,620,1,0,642
633,2019-09-01,756,1016,193,0,1965
633,2019-09-02,11,487,9,0,507
633,2019-09-03,57,2143,1364,3,3567
633,2019-09-04,62,13853,2282,0,16197
633,2019-09-05,76,8399,2182,1,10658
633,2019-09-06,103,16092,3094,0,19289
633,2019-09-07,190,18283,3541,0,22014
633,2019-09-08,1021,5706,2265,0,8992
633,2019-09-09,84,7882,1747,4,9717
633,2019-09-10,50,9045,1458,1,10554
633,2019-09-11,175,10408,1464,2,12049
633,2019-09-12,892,6145,3033,1,10071
633,2019-09-13,71,7196,2459,2,9728
633,2019-09-14,143,6547,2325,1,9016
633,2019-09-15,62,13099,1428,3,14592
633,2019-09-16,72,7304,1909,3,9288
633,2019-09-17,850,9636,2092,7,12585
633,2019-09-18,171,20252,1927,9,22359
633,2019-09-19,184,11602,1824,9,13619
633,2019-09-20,96,19266,1802,9,21173
633,2019-09-21,913,7372,1170,10,9465
633,2019-09-22,43,8935,2376,9,11363
633,2019-09-23,1016,29791,1977,12,32796
633,2019-09-24,296,10460,1530,11,12297
633,2019-09-25,1036,8799,1968,13,11816
633,2019-09-26,78,12286,2365,13,14742
633,2019-09-27,72,10198,1388,7,11665
633,2019-09-28,115,16562,2197,5,18879
633,2019-09-29,95,18633,2124,1,20853
633,2019-09-30,52,16797,1766,1,18616
633,2019-10-01,110,18597,1023,3,19733
633,2019-10-02,1161,13881,2876,6,17924
633,2019-10-03,943,15352,1526,10,17831
633,2019-10-04,64,35051,1498,10,36623
633,2019-10-05,896,21262,1623,10,23791
633,2019-10-06,61,11936,1664,11,13672
633,2019-10-07,239,7937,1753,14,9943
633,2019-10-08,208,13312,1743,14,15277
633,2019-10-09,1322,15901,1434,10,18667
633,2019-10-10,644,11508,1544,11,13707
633,2019-10-11,933,10693,1448,9,13083
633,2019-10-12,939,7730,1937,2,10608
633,2019-10-13,936,9245,1550,4,11735
633,2019-10-14,81,9155,1630,1,10867
633,2019-10-15,482,9556,1073,1,11112
633,2019-10-16,95,18998,2110,0,21203
633,2019-10-17,46,8888,2260,4,11198
633,2019-10-18,67,10243,1829,1,12140
633,2019-10-19,160,8612,1454,1,10227
633,2019-10-20,2453,3381,2258,1,8093
633,2019-10-21,80,11115,1271,4,12470
633,2019-10-22,51,7062,2117,0,9230
633,2019-10-23,42,15073,1728,5,16848
633,2019-10-24,170,18987,1711,1,20869
633,2019-10-25,647,11732,1889,1,14269
633,2019-10-26,89,14195,1568,1,15853
633,2019-10-27,757,17091,994,2,18844
633,2019-10-28,35,24260,1446,1,25742
633,2019-10-29,114,29949,2148,1,32212
633,2019-10-30,172,31950,1060,1,33183
633,2019-10-31,42,15443,1913,1,17399
633,2019-11-01,45,15527,1141,0,16713
633,2019-11-02,39,15088,1558,4,16689
633,2019-11-03,1727,37701,1501,0,40929
633,2019-11-04,78,11548,1776,0,13402
633,2019-11-05,977,3770,1811,0,6558
633,2019-11-06,66,15443,994,0,16503
633,2019-11-07,170,17260,1178,3,18611
633,2019-11-08,134,10202,1066,0,11402
633,2019-11-09,62,10086,1786,1,11935
633,2019-11-10,1086,15573,1144,2,17805
633,2019-11-11,70,10482,1628,0,12180
633,2019-11-12,260,11437,2788,5,14490
633,2019-11-13,1116,14914,1862,1,17893
633,2019-11-14,72,9027,2400,2,11501
633,2019-11-15,55,4604,2454,1,7114
633,2019-11-16,995,3053,2548,1,6597
633,2019-11-17,265,3733,3503,3,7504
633,2019-11-18,188,2781,3112,0,6081
633,2019-11-19,141,3649,2602,1,6393
633,2019-11-20,95,2259,1243,1,3598
633,2019-11-21,1012,5447,1438,1,7898
634,2019-08-01,22,38443,241,0,38706
634,2019-08-02,44,33012,61,0,33117
634,2019-08-03,28,7417,317,0,7762
634,2019-08-04,66,2320,284,2,2672
634,2019-08-05,23,1890,151,1,2065
634,2019-08-06,256,6088,445,1,6790
634,2019-08-07,27,4609,419,2,5057
634,2019-08-08,39,2865,361,1,3266
634,2019-08-09,266,1271,462,0,1999
634,2019-08-10,26,1192,268,2,1488
634,2019-08-11,108,5420,310,0,5838
634,2019-08-12,172,1750,324,0,2246
634,2019-08-13,28,2291,107,0,2426
634,2019-08-14,209,1764,255,1,2229
634,2019-08-15,23,889,129,0,1041
634,2019-08-16,15,2530,257,3,2805
634,2019-08-17,355,4538,591,0,5484
634,2019-08-18,729,4425,1272,1,6427
634,2019-08-19,33,3916,1769,1,5719
634,2019-08-20,864,5948,1543,1,8356
634,2019-08-21,24,47726,1381,0,49131
634,2019-08-22,28,23852,2170,1,26051
634,2019-08-23,1051,9667,2022,1,12741
634,2019-08-24,148,4819,2547,0,7514
634,2019-08-25,89,16461,1166,3,17719
634,2019-08-26,56,35953,2070,1,38080
634,2019-08-27,907,17095,788,0,18790
634,2019-08-28,42,18387,1189,0,19618
634,2019-08-29,1493,14240,1850,2,17585
634,2019-08-30,227,12078,540,0,12845
634,2019-08-31,16,1545,1,1,1563
634,2019-09-01,36,1341,165,0,1542
634,2019-09-02,13,8811,29,0,8853
634,2019-09-03,63,8094,1442,2,9601
634,2019-09-04,67,16645,2124,4,18840
634,2019-09-05,100,11538,1545,0,13183
634,2019-09-06,959,13097,1875,2,15933
634,2019-09-07,126,18980,1492,0,20598
634,2019-09-08,172,15585,2197,0,17954
634,2019-09-09,939,7154,1589,2,9684
634,2019-09-10,163,15063,2068,1,17295
634,2019-09-11,76,11866,2079,1,14022
634,2019-09-12,53,11488,2342,1,13884
634,2019-09-13,59,10746,1621,0,12426
634,2019-09-14,66,7779,1956,2,9803
634,2019-09-15,60,13489,2059,1,15609
634,2019-09-16,133,33999,1637,5,35774
634,2019-09-17,909,45215,1338,18,47480
634,2019-09-18,315,13492,1337,1,15145
634,2019-09-19,174,12314,1245,1,13734
634,2019-09-20,163,24127,2054,0,26344
634,2019-09-21,60,11958,2740,0,14758
634,2019-09-22,47,14782,1773,0,16602
634,2019-09-23,971,12004,1802,0,14777
634,2019-09-24,103,13662,1351,4,15120
634,2019-09-25,170,11713,1833,1,13717
634,2019-09-26,87,11016,1422,2,12527
634,2019-09-27,57,12109,1617,5,13788
634,2019-09-28,113,26024,1579,2,27718
634,2019-09-29,962,29242,1250,2,31456
634,2019-09-30,48,29398,1535,2,30983
634,2019-10-01,77,28332,1136,0,29545
634,2019-10-02,136,15557,1645,1,17339
634,2019-10-03,1296,22984,1335,0,25615
634,2019-10-04,54,20830,2325,2,23211
634,2019-10-05,74,24089,1219,0,25382
634,2019-10-06,492,19029,1297,1,20819
634,2019-10-07,113,7620,1817,6,9556
634,2019-10-08,1035,41096,1117,0,43248
634,2019-10-09,189,30571,1510,2,32272
634,2019-10-10,1661,12564,2098,0,16323
634,2019-10-11,1183,15839,1323,0,18345
634,2019-10-12,734,9774,1189,0,11697
634,2019-10-13,746,13101,2210,2,16059
634,2019-10-14,968,10962,2779,0,14709
634,2019-10-15,1241,8603,1110,0,10954
634,2019-10-16,93,19199,1519,0,20811
634,2019-10-17,377,9031,1790,21,11219
634,2019-10-18,93,15758,1446,0,17297
634,2019-10-19,53,24292,1658,2,26005
634,2019-10-20,946,43443,1325,0,45714
634,2019-10-21,75,16201,1089,0,17365
634,2019-10-22,66,9258,1910,2,11236
634,2019-10-23,48,15007,1900,3,16958
634,2019-10-24,124,26636,1961,3,28724
634,2019-10-25,67,15709,2486,0,18262
634,2019-10-26,1247,14711,1515,0,17473
634,2019-10-27,2136,16749,1410,2,20297
634,2019-10-28,251,14525,817,0,15593
634,2019-10-29,2441,27409,1625,5,31480
634,2019-10-30,62,31322,1222,0,32606
634,2019-10-31,42,15740,2588,0,18370
634,2019-11-01,42,15401,1246,1,16690
634,2019-11-02,55,15512,894,2,16463
634,2019-11-03,635,23409,1279,3,25326
634,2019-11-04,115,11478,1628,0,13221
634,2019-11-05,143,3549,1929,1,5622
634,2019-11-06,76,15271,1113,1,16461
634,2019-11-07,164,17454,608,2,18228
634,2019-11-08,71,10474,1295,1,11841
634,2019-11-09,111,9276,1190,0,10577
634,2019-11-10,47,15941,748,1,16737
634,2019-11-11,653,10702,999,0,12354
634,2019-11-12,150,11060,3074,2,14286
634,2019-11-13,55,20555,1469,2,22081
634,2019-11-14,168,10876,2402,0,13446
634,2019-11-15,75,4232,2855,1,7163
634,2019-11-16,183,2493,3334,0,6010
634,2019-11-17,79,3776,2924,0,6779
634,2019-11-18,96,4040,3570,5,7711
634,2019-11-19,109,5846,4103,2,10060
634,2019-11-20,538,2188,1965,1,4692
634,2019-11-21,999,5885,2333,0,9217
634,2019-11-22,83,6042,2113,293,8531
634,2019-11-23,79,6731,2254,0,9064
634,2019-11-24,62,7068,1339,0,8469
634,2019-11-25,725,11380,1806,0,13911
634,2019-11-26,954,6437,1936,0,9327
634,2019-11-27,44,6895,1731,0,8670
634,2019-11-28,47,8825,231,0,9103
634,2019-08-01,22,38443,241,0,38706
634,2019-08-02,44,33012,61,0,33117
634,2019-08-03,28,7417,317,0,7762
634,2019-08-04,66,2320,284,2,2672
634,2019-08-05,23,1890,151,1,2065
634,2019-08-06,256,6088,445,1,6790
634,2019-08-07,27,4609,419,2,5057
634,2019-08-08,39,2865,361,1,3266
634,2019-08-09,266,1271,462,0,1999
634,2019-08-10,26,1192,268,2,1488
634,2019-08-11,108,5420,310,0,5838
634,2019-08-12,172,1750,324,0,2246
634,2019-08-13,28,2291,107,0,2426
634,2019-08-14,209,1764,255,1,2229
634,2019-08-15,23,889,129,0,1041
634,2019-08-16,15,2530,257,3,2805
634,2019-08-17,355,4538,591,0,5484
634,2019-08-18,729,4425,1272,1,6427
634,2019-08-19,33,3916,1769,1,5719
634,2019-08-20,864,5948,1543,1,8356
634,2019-08-21,24,47726,1381,0,49131
634,2019-08-22,28,23852,2170,1,26051
634,2019-08-23,1051,9667,2022,1,12741
634,2019-08-24,148,4819,2547,0,7514
634,2019-08-25,89,16461,1166,3,17719
634,2019-08-26,56,35953,2070,1,38080
634,2019-08-27,907,17095,788,0,18790
634,2019-08-28,42,18387,1189,0,19618
634,2019-08-29,1493,14240,1850,2,17585
634,2019-08-30,227,12078,540,0,12845
634,2019-08-31,16,1545,1,1,1563
634,2019-09-01,36,1341,165,0,1542
634,2019-09-02,13,8811,29,0,8853
634,2019-09-03,63,8094,1442,2,9601
634,2019-09-04,67,16645,2124,4,18840
634,2019-09-05,100,11538,1545,0,13183
634,2019-09-06,959,13097,1875,2,15933
634,2019-09-07,126,18980,1492,0,20598
634,2019-09-08,172,15585,2197,0,17954
634,2019-09-09,939,7154,1589,2,9684
634,2019-09-10,163,15063,2068,1,17295
634,2019-09-11,76,11866,2079,1,14022
634,2019-09-12,53,11488,2342,1,13884
634,2019-09-13,59,10746,1621,0,12426
634,2019-09-14,66,7779,1956,2,9803
634,2019-09-15,60,13489,2059,1,15609
634,2019-09-16,133,33999,1637,5,35774
634,2019-09-17,909,45215,1338,18,47480
634,2019-09-18,315,13492,1337,1,15145
634,2019-09-19,174,12314,1245,1,13734
634,2019-09-20,163,24127,2054,0,26344
634,2019-09-21,60,11958,2740,0,14758
634,2019-09-22,47,14782,1773,0,16602
634,2019-09-23,971,12004,1802,0,14777
634,2019-09-24,103,13662,1351,4,15120
634,2019-09-25,170,11713,1833,1,13717
634,2019-09-26,87,11016,1422,2,12527
634,2019-09-27,57,12109,1617,5,13788
634,2019-09-28,113,26024,1579,2,27718
634,2019-09-29,962,29242,1250,2,31456
634,2019-09-30,48,29398,1535,2,30983
634,2019-10-01,77,28332,1136,0,29545
634,2019-10-02,136,15557,1645,1,17339
634,2019-10-03,1296,22984,1335,0,25615
634,2019-10-04,54,20830,2325,2,23211
634,2019-10-05,74,24089,1219,0,25382
634,2019-10-06,492,19029,1297,1,20819
634,2019-10-07,113,7620,1817,6,9556
634,2019-10-08,1035,41096,1117,0,43248
634,2019-10-09,189,30571,1510,2,32272
634,2019-10-10,1661,12564,2098,0,16323
634,2019-10-11,1183,15839,1323,0,18345
634,2019-10-12,734,9774,1189,0,11697
634,2019-10-13,746,13101,2210,2,16059
634,2019-10-14,968,10962,2779,0,14709
634,2019-10-15,1241,8603,1110,0,10954
634,2019-10-16,93,19199,1519,0,20811
634,2019-10-17,377,9031,1790,21,11219
634,2019-10-18,93,15758,1446,0,17297
634,2019-10-19,53,24292,1658,2,26005
634,2019-10-20,946,43443,1325,0,45714
634,2019-10-21,75,16201,1089,0,17365
634,2019-10-22,66,9258,1910,2,11236
634,2019-10-23,48,15007,1900,3,16958
634,2019-10-24,124,26636,1961,3,28724
634,2019-10-25,67,15709,2486,0,18262
634,2019-10-26,1247,14711,1515,0,17473
634,2019-10-27,2136,16749,1410,2,20297
634,2019-10-28,251,14525,817,0,15593
634,2019-10-29,2441,27409,1625,5,31480
634,2019-10-30,62,31322,1222,0,32606
634,2019-10-31,42,15740,2588,0,18370
634,2019-11-01,42,15401,1246,1,16690
634,2019-11-02,55,15512,894,2,16463
634,2019-11-03,635,23409,1279,3,25326
634,2019-11-04,115,11478,1628,0,13221
634,2019-11-05,143,3549,1929,1,5622
634,2019-11-06,76,15271,1113,1,16461
634,2019-11-07,164,17454,608,2,18228
634,2019-11-08,71,10474,1295,1,11841
634,2019-11-09,111,9276,1190,0,10577
634,2019-11-10,47,15941,748,1,16737
634,2019-11-11,653,10702,999,0,12354
634,2019-11-12,150,11060,3074,2,14286
634,2019-11-13,55,20555,1469,2,22081
634,2019-11-14,168,10876,2402,0,13446
634,2019-11-15,75,4232,2855,1,7163
634,2019-11-16,183,2493,3334,0,6010
634,2019-11-17,79,3776,2924,0,6779
634,2019-11-18,96,4040,3570,5,7711
634,2019-11-19,109,5846,4103,2,10060
634,2019-11-20,538,2188,1965,1,4692
634,2019-11-21,999,5885,2333,0,9217
634,2019-11-22,83,6042,2113,293,8531
634,2019-11-23,79,6731,2254,0,9064
634,2019-11-24,62,7068,1339,0,8469
634,2019-11-25,725,11380,1806,0,13911
634,2019-11-26,954,6437,1936,0,9327
634,2019-11-27,44,6895,1731,0,8670
634,2019-11-28,47,8825,231,0,9103
634,2019-11-29,0,431,0,0,431
634,2019-08-01,22,38443,241,0,38706
634,2019-08-02,44,33012,61,0,33117
634,2019-08-03,28,7417,317,0,7762
634,2019-08-04,66,2320,284,2,2672
634,2019-08-05,23,1890,151,1,2065
634,2019-08-06,256,6088,445,1,6790
634,2019-08-07,27,4609,419,2,5057
634,2019-08-08,39,2865,361,1,3266
634,2019-08-09,266,1271,462,0,1999
634,2019-08-10,26,1192,268,2,1488
634,2019-08-11,108,5420,310,0,5838
634,2019-08-12,172,1750,324,0,2246
634,2019-08-13,28,2291,107,0,2426
634,2019-08-14,209,1764,255,1,2229
634,2019-08-15,23,889,129,0,1041
634,2019-08-16,15,2530,257,3,2805
634,2019-08-17,355,4538,591,0,5484
634,2019-08-18,729,4425,1272,1,6427
634,2019-08-19,33,3916,1769,1,5719
634,2019-08-20,864,5948,1543,1,8356
634,2019-08-21,24,47726,1381,0,49131
634,2019-08-22,28,23852,2170,1,26051
634,2019-08-23,1051,9667,2022,1,12741
634,2019-08-24,148,4819,2547,0,7514
634,2019-08-25,89,16461,1166,3,17719
634,2019-08-26,56,35953,2070,1,38080
634,2019-08-27,907,17095,788,0,18790
634,2019-08-28,42,18387,1189,0,19618
634,2019-08-29,1493,14240,1850,2,17585
634,2019-08-30,227,12078,540,0,12845
634,2019-08-31,16,1545,1,1,1563
634,2019-09-01,36,1341,165,0,1542
634,2019-09-02,13,8811,29,0,8853
634,2019-09-03,63,8094,1442,2,9601
634,2019-09-04,67,16645,2124,4,18840
634,2019-09-05,100,11538,1545,0,13183
634,2019-09-06,959,13097,1875,2,15933
634,2019-09-07,126,18980,1492,0,20598
634,2019-09-08,172,15585,2197,0,17954
634,2019-09-09,939,7154,1589,2,9684
634,2019-09-10,163,15063,2068,1,17295
634,2019-09-11,76,11866,2079,1,14022
634,2019-09-12,53,11488,2342,1,13884
634,2019-09-13,59,10746,1621,0,12426
634,2019-09-14,66,7779,1956,2,9803
634,2019-09-15,60,13489,2059,1,15609
634,2019-09-16,133,33999,1637,5,35774
634,2019-09-17,909,45215,1338,18,47480
634,2019-09-18,315,13492,1337,1,15145
634,2019-09-19,174,12314,1245,1,13734
634,2019-09-20,163,24127,2054,0,26344
634,2019-09-21,60,11958,2740,0,14758
634,2019-09-22,47,14782,1773,0,16602
634,2019-09-23,971,12004,1802,0,14777
634,2019-09-24,103,13662,1351,4,15120
634,2019-09-25,170,11713,1833,1,13717
634,2019-09-26,87,11016,1422,2,12527
634,2019-09-27,57,12109,1617,5,13788
634,2019-09-28,113,26024,1579,2,27718
634,2019-09-29,962,29242,1250,2,31456
634,2019-09-30,48,29398,1535,2,30983
634,2019-10-01,77,28332,1136,0,29545
634,2019-10-02,136,15557,1645,1,17339
634,2019-10-03,1296,22984,1335,0,25615
634,2019-10-04,54,20830,2325,2,23211
634,2019-10-05,74,24089,1219,0,25382
634,2019-10-06,492,19029,1297,1,20819
634,2019-10-07,113,7620,1817,6,9556
634,2019-10-08,1035,41096,1117,0,43248
634,2019-10-09,189,30571,1510,2,32272
634,2019-10-10,1661,12564,2098,0,16323
634,2019-10-11,1183,15839,1323,0,18345
634,2019-10-12,734,9774,1189,0,11697
634,2019-10-13,746,13101,2210,2,16059
634,2019-10-14,968,10962,2779,0,14709
634,2019-10-15,1241,8603,1110,0,10954
634,2019-10-16,93,19199,1519,0,20811
634,2019-10-17,377,9031,1790,21,11219
634,2019-10-18,93,15758,1446,0,17297
634,2019-10-19,53,24292,1658,2,26005
634,2019-10-20,946,43443,1325,0,45714
634,2019-10-21,75,16201,1089,0,17365
634,2019-10-22,66,9258,1910,2,11236
634,2019-10-23,48,15007,1900,3,16958
634,2019-10-24,124,26636,1961,3,28724
634,2019-10-25,67,15709,2486,0,18262
634,2019-10-26,1247,14711,1515,0,17473
634,2019-10-27,2136,16749,1410,2,20297
634,2019-10-28,251,14525,817,0,15593
634,2019-10-29,2441,27409,1625,5,31480
634,2019-10-30,62,31322,1222,0,32606
634,2019-10-31,42,15740,2588,0,18370
634,2019-11-01,42,15401,1246,1,16690
634,2019-11-02,55,15512,894,2,16463
634,2019-11-03,635,23409,1279,3,25326
634,2019-11-04,115,11478,1628,0,13221
634,2019-11-05,143,3549,1929,1,5622
634,2019-11-06,76,15271,1113,1,16461
634,2019-11-07,164,17454,608,2,18228
634,2019-11-08,71,10474,1295,1,11841
634,2019-11-09,111,9276,1190,0,10577
634,2019-11-10,47,15941,748,1,16737
634,2019-11-11,653,10702,999,0,12354
634,2019-11-12,150,11060,3074,2,14286
634,2019-11-13,55,20555,1469,2,22081
634,2019-11-14,168,10876,2402,0,13446
634,2019-11-15,75,4232,2855,1,7163
634,2019-11-16,183,2493,3334,0,6010
634,2019-11-17,79,3776,2924,0,6779
634,2019-11-18,96,4040,3570,5,7711
634,2019-11-19,109,5846,4103,2,10060
634,2019-11-20,538,2188,1965,1,4692
634,2019-11-21,999,5885,2333,0,9217
634,2019-11-22,83,6042,2113,293,8531
634,2019-11-23,79,6731,2254,0,9064
634,2019-11-24,62,7068,1339,0,8469
634,2019-11-25,725,11380,1806,0,13911
634,2019-11-26,954,6437,1936,0,9327
634,2019-11-27,44,6895,1731,0,8670
634,2019-11-28,47,8825,231,0,9103
634,2019-08-04,66,2320,284,2,2672
634,2019-08-05,23,1890,151,1,2065
634,2019-08-06,256,6088,445,1,6790
634,2019-08-07,27,4609,419,2,5057
634,2019-08-08,39,2865,361,1,3266
634,2019-08-09,266,1271,462,0,1999
634,2019-08-10,26,1192,268,2,1488
634,2019-08-11,108,5420,310,0,5838
634,2019-08-12,172,1750,324,0,2246
634,2019-08-13,28,2291,107,0,2426
634,2019-08-14,209,1764,255,1,2229
634,2019-08-15,23,889,129,0,1041
634,2019-08-16,15,2530,257,3,2805
634,2019-08-17,355,4538,591,0,5484
634,2019-08-18,729,4425,1272,1,6427
634,2019-08-19,33,3916,1769,1,5719
634,2019-08-20,864,5948,1543,1,8356
634,2019-08-21,24,47726,1381,0,49131
634,2019-08-22,28,23852,2170,1,26051
634,2019-08-23,1051,9667,2022,1,12741
634,2019-08-24,148,4819,2547,0,7514
634,2019-08-25,89,16461,1166,3,17719
634,2019-08-26,56,35953,2070,1,38080
634,2019-08-27,907,17095,788,0,18790
634,2019-08-28,42,18387,1189,0,19618
634,2019-08-29,1493,14240,1850,2,17585
634,2019-08-30,227,12078,540,0,12845
634,2019-08-31,16,1545,1,1,1563
634,2019-09-01,36,1341,165,0,1542
634,2019-09-02,13,8811,29,0,8853
634,2019-09-03,63,8094,1442,2,9601
634,2019-09-04,67,16645,2124,4,18840
634,2019-09-05,100,11538,1545,0,13183
634,2019-09-06,959,13097,1875,2,15933
634,2019-09-07,126,18980,1492,0,20598
634,2019-09-08,172,15585,2197,0,17954
634,2019-09-09,939,7154,1589,2,9684
634,2019-09-10,163,15063,2068,1,17295
634,2019-09-11,76,11866,2079,1,14022
634,2019-09-12,53,11488,2342,1,13884
634,2019-09-13,59,10746,1621,0,12426
634,2019-09-14,66,7779,1956,2,9803
634,2019-09-15,60,13489,2059,1,15609
634,2019-09-16,133,33999,1637,5,35774
634,2019-09-17,909,45215,1338,18,47480
634,2019-09-18,315,13492,1337,1,15145
634,2019-09-19,174,12314,1245,1,13734
634,2019-09-20,163,24127,2054,0,26344
634,2019-09-21,60,11958,2740,0,14758
634,2019-09-22,47,14782,1773,0,16602
634,2019-09-23,971,12004,1802,0,14777
634,2019-09-24,103,13662,1351,4,15120
634,2019-09-25,170,11713,1833,1,13717
634,2019-09-26,87,11016,1422,2,12527
634,2019-09-27,57,12109,1617,5,13788
634,2019-09-28,113,26024,1579,2,27718
634,2019-09-29,962,29242,1250,2,31456
634,2019-09-30,48,29398,1535,2,30983
634,2019-10-01,77,28332,1136,0,29545
634,2019-10-02,136,15557,1645,1,17339
634,2019-10-03,1296,22984,1335,0,25615
634,2019-10-04,54,20830,2325,2,23211
634,2019-10-05,74,24089,1219,0,25382
634,2019-10-06,492,19029,1297,1,20819
634,2019-10-07,113,7620,1817,6,9556
634,2019-10-08,1035,41096,1117,0,43248
634,2019-10-09,189,30571,1510,2,32272
634,2019-10-10,1661,12564,2098,0,16323
634,2019-10-11,1183,15839,1323,0,18345
634,2019-10-12,734,9774,1189,0,11697
634,2019-10-13,746,13101,2210,2,16059
634,2019-10-14,968,10962,2779,0,14709
634,2019-10-15,1241,8603,1110,0,10954
634,2019-10-16,93,19199,1519,0,20811
634,2019-10-17,377,9031,1790,21,11219
634,2019-10-18,93,15758,1446,0,17297
634,2019-10-19,53,24292,1658,2,26005
634,2019-10-20,946,43443,1325,0,45714
634,2019-10-21,75,16201,1089,0,17365
634,2019-10-22,66,9258,1910,2,11236
634,2019-10-23,48,15007,1900,3,16958
634,2019-10-24,124,26636,1961,3,28724
634,2019-10-25,67,15709,2486,0,18262
634,2019-10-26,1247,14711,1515,0,17473
634,2019-10-27,2136,16749,1410,2,20297
634,2019-10-28,251,14525,817,0,15593
634,2019-10-29,2441,27409,1625,5,31480
634,2019-10-30,62,31322,1222,0,32606
634,2019-10-31,42,15740,2588,0,18370
634,2019-11-01,42,15401,1246,1,16690
634,2019-11-02,55,15512,894,2,16463
634,2019-11-03,635,23409,1279,3,25326
634,2019-11-04,115,11478,1628,0,13221
634,2019-11-05,143,3549,1929,1,5622
634,2019-11-06,76,15271,1113,1,16461
634,2019-11-07,164,17454,608,2,18228
634,2019-11-08,71,10474,1295,1,11841
634,2019-11-09,111,9276,1190,0,10577
634,2019-11-10,47,15941,748,1,16737
634,2019-11-11,653,10702,999,0,12354
634,2019-11-12,150,11060,3074,2,14286
634,2019-11-13,55,20555,1469,2,22081
634,2019-11-14,168,10876,2402,0,13446
634,2019-11-15,75,4232,2855,1,7163
634,2019-11-16,183,2493,3334,0,6010
634,2019-11-17,79,3776,2924,0,6779
634,2019-11-18,96,4040,3570,5,7711
634,2019-11-19,109,5846,4103,2,10060
634,2019-11-20,538,2188,1965,1,4692
634,2019-11-21,999,5885,2333,0,9217
634,2019-11-22,83,6042,2113,293,8531
635,2019-08-01,31,38698,312,0,39041
635,2019-08-02,68,37906,316,2,38292
635,2019-08-03,186,9811,152,0,10149
635,2019-08-04,17,1345,240,3,1605
635,2019-08-05,108,7883,283,0,8274
635,2019-08-06,72,4143,736,0,4951
635,2019-08-07,104,1658,296,1,2059
635,2019-08-08,79,1460,104,0,1643
635,2019-08-09,32,1694,317,0,2043
635,2019-08-10,63,1742,422,0,2227
635,2019-08-11,62,5687,472,0,6221
635,2019-08-12,104,6989,13,1,7107
635,2019-08-13,85,6408,272,0,6765
635,2019-08-14,306,6056,283,0,6645
635,2019-08-15,27,1286,37,0,1350
635,2019-08-16,360,3249,35,0,3644
635,2019-08-17,142,3915,442,0,4499
635,2019-08-18,35,3164,552,0,3751
635,2019-08-19,578,6149,1149,1,7877
635,2019-08-20,190,3991,1504,0,5685
635,2019-08-21,47,3905,1817,2,5771
635,2019-08-22,48,13953,1232,1,15234
635,2019-08-23,60,6757,1259,1,8077
635,2019-08-24,49,4706,2139,5,6899
635,2019-08-25,164,28075,1890,1,30130
635,2019-08-26,67,29496,1714,0,31277
635,2019-08-27,56,7577,1351,2,8986
635,2019-08-28,638,16819,1980,1,19438
635,2019-08-29,127,14232,1441,4,15804
635,2019-08-30,34,3730,906,1,4671
635,2019-08-31,17,12017,23,0,12057
635,2019-09-01,29,4637,183,2,4851
635,2019-09-02,18,619,50,0,687
635,2019-09-03,63,4796,1261,2,6122
635,2019-09-04,1758,9165,1901,1,12825
635,2019-09-05,84,7880,1436,2,9402
635,2019-09-06,107,16377,1714,1,18199
635,2019-09-07,105,14176,1009,0,15290
635,2019-09-08,2715,9008,1694,2,13419
635,2019-09-09,1763,10469,2364,1,14597
635,2019-09-10,151,14442,1537,1,16131
635,2019-09-11,1020,10049,1725,3,12797
635,2019-09-12,47,7786,1930,1,9764
635,2019-09-13,87,6904,1351,1,8343
635,2019-09-14,59,6931,1288,2,8280
635,2019-09-15,73,9425,2585,11,12094
635,2019-09-16,84,11089,2976,19,14168
635,2019-09-17,79,8046,2246,7,10378
635,2019-09-18,99,13324,1655,9,15087
635,2019-09-19,169,12278,1772,9,14228
635,2019-09-20,74,10643,1550,10,12277
635,2019-09-21,66,6317,2056,9,8448
635,2019-09-22,54,10084,1841,5,11984
635,2019-09-23,149,9381,2359,4,11893
635,2019-09-24,951,9829,1478,1,12259
635,2019-09-25,184,11287,2088,6,13565
635,2019-09-26,1780,10644,1854,8,14286
635,2019-09-27,80,10282,2571,4,12937
635,2019-09-28,932,15982,1824,2,18740
635,2019-09-29,1188,18000,1655,2,20845
635,2019-09-30,958,18543,1664,0,21165
635,2019-10-01,1931,16858,1825,1,20615
635,2019-10-02,1647,13508,1281,1,16437
635,2019-10-03,68,14584,2026,0,16678
635,2019-10-04,683,14135,1792,1,16611
635,2019-10-05,151,15081,1311,3,16546
635,2019-10-06,293,11828,1560,5,13686
635,2019-10-07,896,6930,2191,1,10018
635,2019-10-08,753,13094,2152,3,16002
635,2019-10-09,106,15616,1882,0,17604
635,2019-10-10,99,11649,2344,17,14109
635,2019-10-11,473,12867,1475,1,14816
635,2019-10-12,1418,7745,1592,1,10756
635,2019-10-13,70,9828,2441,3,12342
635,2019-10-14,102,7699,1550,1,9352
635,2019-10-15,101,8788,1801,7,10697
635,2019-10-16,160,18888,1278,9,20335
635,2019-10-17,60,9045,1496,3,10604
635,2019-10-18,85,9454,2193,2,11734
635,2019-10-19,964,6059,1081,0,8104
635,2019-10-20,150,3261,2078,0,5489
635,2019-10-21,506,11402,1768,0,13676
635,2019-10-22,567,7095,2163,1,9826
635,2019-10-23,57,9521,1229,3,10810
635,2019-10-24,82,14206,1382,2,15672
635,2019-10-25,1031,11734,1641,11,14417
635,2019-10-26,415,13856,1855,10,16136
635,2019-10-27,1259,17403,1643,0,20305
635,2019-10-28,37,13866,1547,0,15450
635,2019-10-29,241,27623,1960,0,29824
635,2019-10-30,62,23863,1649,0,25574
635,2019-10-31,38,13187,1255,0,14480
635,2019-11-01,765,26467,2139,0,29371
635,2019-11-02,39,17945,1196,4,19184
635,2019-11-03,97,23195,1245,0,24537
635,2019-11-04,93,8831,1731,0,10655
635,2019-11-05,129,4068,2107,2,6306
635,2019-11-06,882,14793,1051,0,16726
635,2019-11-07,585,17754,1580,2,19921
635,2019-11-08,173,9945,2956,1,13075
635,2019-11-09,413,8905,3183,0,12501
635,2019-11-10,68,14764,2008,2,16842
635,2019-11-11,434,10166,1405,1,12006
635,2019-11-12,113,11068,2205,3,13389
635,2019-11-13,62,11613,1988,2,13665
635,2019-11-14,618,13520,2067,0,16205
635,2019-11-15,49,6980,2129,1,9159
635,2019-11-16,96,2803,2633,1,5533
635,2019-11-17,155,4646,3676,2,8479
635,2019-11-18,917,2913,3583,3,7416
635,2019-11-19,82,3767,2138,1,5988
635,2019-11-20,106,2034,1917,2,4059
635,2019-11-21,966,4125,1224,0,6315
635,2019-11-22,86,9609,1654,5,11354
635,2019-11-23,70,7219,2460,1,9750
635,2019-11-24,160,6540,2152,0,8852
635,2019-11-25,122,7527,2044,1,9694
635,2019-11-26,81,7131,1826,0,9038
635,2019-11-27,72,7004,2366,4,9446
635,2019-11-28,77,8466,349,0,8892
635,2019-11-29,9,152,2,0,163
635,2019-08-01,31,38698,312,0,39041
635,2019-08-02,68,37906,316,2,38292
635,2019-08-03,186,9811,152,0,10149
635,2019-08-04,17,1345,240,3,1605
635,2019-08-05,108,7883,283,0,8274
635,2019-08-06,72,4143,736,0,4951
635,2019-08-07,104,1658,296,1,2059
635,2019-08-08,79,1460,104,0,1643
635,2019-08-09,32,1694,317,0,2043
635,2019-08-10,63,1742,422,0,2227
635,2019-08-11,62,5687,472,0,6221
635,2019-08-12,104,6989,13,1,7107
635,2019-08-13,85,6408,272,0,6765
635,2019-08-14,306,6056,283,0,6645
635,2019-08-15,27,1286,37,0,1350
635,2019-08-16,360,3249,35,0,3644
635,2019-08-17,142,3915,442,0,4499
635,2019-08-18,35,3164,552,0,3751
635,2019-08-19,578,6149,1149,1,7877
635,2019-08-20,190,3991,1504,0,5685
635,2019-08-21,47,3905,1817,2,5771
635,2019-08-22,48,13953,1232,1,15234
635,2019-08-23,60,6757,1259,1,8077
635,2019-08-24,49,4706,2139,5,6899
635,2019-08-25,164,28075,1890,1,30130
635,2019-08-26,67,29496,1714,0,31277
635,2019-08-27,56,7577,1351,2,8986
635,2019-08-28,638,16819,1980,1,19438
635,2019-08-29,127,14232,1441,4,15804
635,2019-08-30,34,3730,906,1,4671
635,2019-08-31,17,12017,23,0,12057
635,2019-09-01,29,4637,183,2,4851
635,2019-09-02,18,619,50,0,687
635,2019-09-03,63,4796,1261,2,6122
635,2019-09-04,1758,9165,1901,1,12825
635,2019-09-05,84,7880,1436,2,9402
635,2019-09-06,107,16377,1714,1,18199
635,2019-09-07,105,14176,1009,0,15290
635,2019-09-08,2715,9008,1694,2,13419
635,2019-09-09,1763,10469,2364,1,14597
635,2019-09-10,151,14442,1537,1,16131
635,2019-09-11,1020,10049,1725,3,12797
635,2019-09-12,47,7786,1930,1,9764
635,2019-09-13,87,6904,1351,1,8343
635,2019-09-14,59,6931,1288,2,8280
635,2019-09-15,73,9425,2585,11,12094
635,2019-09-16,84,11089,2976,19,14168
635,2019-09-17,79,8046,2246,7,10378
635,2019-09-18,99,13324,1655,9,15087
635,2019-09-19,169,12278,1772,9,14228
635,2019-09-20,74,10643,1550,10,12277
635,2019-09-21,66,6317,2056,9,8448
635,2019-09-22,54,10084,1841,5,11984
635,2019-09-23,149,9381,2359,4,11893
635,2019-09-24,951,9829,1478,1,12259
635,2019-09-25,184,11287,2088,6,13565
635,2019-09-26,1780,10644,1854,8,14286
635,2019-09-27,80,10282,2571,4,12937
635,2019-09-28,932,15982,1824,2,18740
635,2019-09-29,1188,18000,1655,2,20845
635,2019-09-30,958,18543,1664,0,21165
635,2019-10-01,1931,16858,1825,1,20615
635,2019-10-02,1647,13508,1281,1,16437
635,2019-10-03,68,14584,2026,0,16678
635,2019-10-04,683,14135,1792,1,16611
635,2019-10-05,151,15081,1311,3,16546
635,2019-10-06,293,11828,1560,5,13686
635,2019-10-07,896,6930,2191,1,10018
635,2019-10-08,753,13094,2152,3,16002
635,2019-10-09,106,15616,1882,0,17604
635,2019-10-10,99,11649,2344,17,14109
635,2019-10-11,473,12867,1475,1,14816
635,2019-10-12,1418,7745,1592,1,10756
635,2019-10-13,70,9828,2441,3,12342
635,2019-10-14,102,7699,1550,1,9352
635,2019-10-15,101,8788,1801,7,10697
635,2019-10-16,160,18888,1278,9,20335
635,2019-10-17,60,9045,1496,3,10604
635,2019-10-18,85,9454,2193,2,11734
635,2019-10-19,964,6059,1081,0,8104
635,2019-10-20,150,3261,2078,0,5489
635,2019-10-21,506,11402,1768,0,13676
635,2019-10-22,567,7095,2163,1,9826
635,2019-10-23,57,9521,1229,3,10810
635,2019-10-24,82,14206,1382,2,15672
635,2019-10-25,1031,11734,1641,11,14417
635,2019-10-26,415,13856,1855,10,16136
635,2019-10-27,1259,17403,1643,0,20305
635,2019-10-28,37,13866,1547,0,15450
635,2019-10-29,241,27623,1960,0,29824
635,2019-10-30,62,23863,1649,0,25574
635,2019-10-31,38,13187,1255,0,14480
635,2019-11-01,765,26467,2139,0,29371
635,2019-11-02,39,17945,1196,4,19184
635,2019-11-03,97,23195,1245,0,24537
635,2019-11-04,93,8831,1731,0,10655
635,2019-11-05,129,4068,2107,2,6306
635,2019-11-06,882,14793,1051,0,16726
635,2019-11-07,585,17754,1580,2,19921
635,2019-11-08,173,9945,2956,1,13075
635,2019-11-09,413,8905,3183,0,12501
635,2019-11-10,68,14764,2008,2,16842
635,2019-11-11,434,10166,1405,1,12006
635,2019-11-12,113,11068,2205,3,13389
635,2019-11-13,62,11613,1988,2,13665
635,2019-11-14,618,13520,2067,0,16205
635,2019-11-15,49,6980,2129,1,9159
635,2019-11-16,96,2803,2633,1,5533
635,2019-11-17,155,4646,3676,2,8479
635,2019-11-18,917,2913,3583,3,7416
635,2019-11-19,82,3767,2138,1,5988
635,2019-11-20,106,2034,1917,2,4059
635,2019-11-21,966,4125,1224,0,6315
635,2019-11-22,86,9609,1654,5,11354
635,2019-11-23,70,7219,2460,1,9750
635,2019-11-24,160,6540,2152,0,8852
635,2019-11-25,122,7527,2044,1,9694
635,2019-11-26,81,7131,1826,0,9038
635,2019-11-27,72,7004,2366,4,9446
635,2019-11-28,77,8466,349,0,8892
635,2019-11-29,9,152,2,0,163
635,2019-08-01,31,38698,312,0,39041
635,2019-08-02,68,37906,316,2,38292
635,2019-08-03,186,9811,152,0,10149
635,2019-08-04,17,1345,240,3,1605
635,2019-08-05,108,7883,283,0,8274
635,2019-08-06,72,4143,736,0,4951
635,2019-08-07,104,1658,296,1,2059
635,2019-08-08,79,1460,104,0,1643
635,2019-08-09,32,1694,317,0,2043
635,2019-08-10,63,1742,422,0,2227
635,2019-08-11,62,5687,472,0,6221
635,2019-08-12,104,6989,13,1,7107
635,2019-08-13,85,6408,272,0,6765
635,2019-08-14,306,6056,283,0,6645
635,2019-08-15,27,1286,37,0,1350
635,2019-08-16,360,3249,35,0,3644
635,2019-08-17,142,3915,442,0,4499
635,2019-08-18,35,3164,552,0,3751
635,2019-08-19,578,6149,1149,1,7877
635,2019-08-20,190,3991,1504,0,5685
635,2019-08-21,47,3905,1817,2,5771
635,2019-08-22,48,13953,1232,1,15234
635,2019-08-23,60,6757,1259,1,8077
635,2019-08-24,49,4706,2139,5,6899
635,2019-08-25,164,28075,1890,1,30130
635,2019-08-26,67,29496,1714,0,31277
635,2019-08-27,56,7577,1351,2,8986
635,2019-08-28,638,16819,1980,1,19438
635,2019-08-29,127,14232,1441,4,15804
635,2019-08-30,34,3730,906,1,4671
635,2019-08-31,17,12017,23,0,12057
635,2019-09-01,29,4637,183,2,4851
635,2019-09-02,18,619,50,0,687
635,2019-09-03,63,4796,1261,2,6122
635,2019-09-04,1758,9165,1901,1,12825
635,2019-09-05,84,7880,1436,2,9402
635,2019-09-06,107,16377,1714,1,18199
635,2019-09-07,105,14176,1009,0,15290
635,2019-09-08,2715,9008,1694,2,13419
635,2019-09-09,1763,10469,2364,1,14597
635,2019-09-10,151,14442,1537,1,16131
635,2019-09-11,1020,10049,1725,3,12797
635,2019-09-12,47,7786,1930,1,9764
635,2019-09-13,87,6904,1351,1,8343
635,2019-09-14,59,6931,1288,2,8280
635,2019-09-15,73,9425,2585,11,12094
635,2019-09-16,84,11089,2976,19,14168
635,2019-09-17,79,8046,2246,7,10378
635,2019-09-18,99,13324,1655,9,15087
635,2019-09-19,169,12278,1772,9,14228
635,2019-09-20,74,10643,1550,10,12277
635,2019-09-21,66,6317,2056,9,8448
635,2019-09-22,54,10084,1841,5,11984
635,2019-09-23,149,9381,2359,4,11893
635,2019-09-24,951,9829,1478,1,12259
635,2019-09-25,184,11287,2088,6,13565
635,2019-09-26,1780,10644,1854,8,14286
635,2019-09-27,80,10282,2571,4,12937
635,2019-09-28,932,15982,1824,2,18740
635,2019-09-29,1188,18000,1655,2,20845
635,2019-09-30,958,18543,1664,0,21165
635,2019-10-01,1931,16858,1825,1,20615
635,2019-10-02,1647,13508,1281,1,16437
635,2019-10-03,68,14584,2026,0,16678
635,2019-10-04,683,14135,1792,1,16611
635,2019-10-05,151,15081,1311,3,16546
635,2019-10-06,293,11828,1560,5,13686
635,2019-10-07,896,6930,2191,1,10018
635,2019-10-08,753,13094,2152,3,16002
635,2019-10-09,106,15616,1882,0,17604
635,2019-10-10,99,11649,2344,17,14109
635,2019-10-11,473,12867,1475,1,14816
635,2019-10-12,1418,7745,1592,1,10756
635,2019-10-13,70,9828,2441,3,12342
635,2019-10-14,102,7699,1550,1,9352
635,2019-10-15,101,8788,1801,7,10697
635,2019-10-16,160,18888,1278,9,20335
635,2019-10-17,60,9045,1496,3,10604
635,2019-10-18,85,9454,2193,2,11734
635,2019-10-19,964,6059,1081,0,8104
635,2019-10-20,150,3261,2078,0,5489
635,2019-10-21,506,11402,1768,0,13676
635,2019-10-22,567,7095,2163,1,9826
635,2019-10-23,57,9521,1229,3,10810
635,2019-10-24,82,14206,1382,2,15672
635,2019-10-25,1031,11734,1641,11,14417
635,2019-10-26,415,13856,1855,10,16136
635,2019-10-27,1259,17403,1643,0,20305
635,2019-10-28,37,13866,1547,0,15450
635,2019-10-29,241,27623,1960,0,29824
635,2019-10-30,62,23863,1649,0,25574
635,2019-10-31,38,13187,1255,0,14480
635,2019-11-01,765,26467,2139,0,29371
635,2019-11-02,39,17945,1196,4,19184
635,2019-11-03,97,23195,1245,0,24537
635,2019-11-04,93,8831,1731,0,10655
635,2019-11-05,129,4068,2107,2,6306
635,2019-11-06,882,14793,1051,0,16726
635,2019-11-07,585,17754,1580,2,19921
635,2019-11-08,173,9945,2956,1,13075
635,2019-11-09,413,8905,3183,0,12501
635,2019-11-10,68,14764,2008,2,16842
635,2019-11-11,434,10166,1405,1,12006
635,2019-11-12,113,11068,2205,3,13389
635,2019-11-13,62,11613,1988,2,13665
635,2019-11-14,618,13520,2067,0,16205
635,2019-11-15,49,6980,2129,1,9159
635,2019-11-16,96,2803,2633,1,5533
635,2019-11-17,155,4646,3676,2,8479
635,2019-11-18,917,2913,3583,3,7416
635,2019-11-19,82,3767,2138,1,5988
635,2019-11-20,106,2034,1917,2,4059
635,2019-11-21,966,4125,1224,0,6315
635,2019-11-22,86,9609,1654,5,11354
635,2019-11-23,70,7219,2460,1,9750
635,2019-11-24,160,6540,2152,0,8852
635,2019-11-25,122,7527,2044,1,9694
635,2019-11-26,81,7131,1826,0,9038
635,2019-11-27,72,7004,2366,4,9446
635,2019-11-28,77,8466,349,0,8892
635,2019-11-29,9,152,2,0,163
635,2019-08-02,68,37906,316,2,38292
635,2019-08-03,186,9811,152,0,10149
635,2019-08-04,17,1345,240,3,1605
635,2019-08-05,108,7883,283,0,8274
635,2019-08-06,72,4143,736,0,4951
635,2019-08-07,104,1658,296,1,2059
635,2019-08-08,79,1460,104,0,1643
635,2019-08-09,32,1694,317,0,2043
635,2019-08-10,63,1742,422,0,2227
635,2019-08-11,62,5687,472,0,6221
635,2019-08-12,104,6989,13,1,7107
635,2019-08-13,85,6408,272,0,6765
635,2019-08-14,306,6056,283,0,6645
635,2019-08-15,27,1286,37,0,1350
635,2019-08-16,360,3249,35,0,3644
635,2019-08-17,142,3915,442,0,4499
635,2019-08-18,35,3164,552,0,3751
635,2019-08-19,578,6149,1149,1,7877
635,2019-08-20,190,3991,1504,0,5685
635,2019-08-21,47,3905,1817,2,5771
635,2019-08-22,48,13953,1232,1,15234
635,2019-08-23,60,6757,1259,1,8077
635,2019-08-24,49,4706,2139,5,6899
635,2019-08-25,164,28075,1890,1,30130
635,2019-08-26,67,29496,1714,0,31277
635,2019-08-27,56,7577,1351,2,8986
635,2019-08-28,638,16819,1980,1,19438
635,2019-08-29,127,14232,1441,4,15804
635,2019-08-30,34,3730,906,1,4671
635,2019-08-31,17,12017,23,0,12057
635,2019-09-01,29,4637,183,2,4851
635,2019-09-02,18,619,50,0,687
635,2019-09-03,63,4796,1261,2,6122
635,2019-09-04,1758,9165,1901,1,12825
635,2019-09-05,84,7880,1436,2,9402
635,2019-09-06,107,16377,1714,1,18199
635,2019-09-07,105,14176,1009,0,15290
635,2019-09-08,2715,9008,1694,2,13419
635,2019-09-09,1763,10469,2364,1,14597
635,2019-09-10,151,14442,1537,1,16131
635,2019-09-11,1020,10049,1725,3,12797
635,2019-09-12,47,7786,1930,1,9764
635,2019-09-13,87,6904,1351,1,8343
635,2019-09-14,59,6931,1288,2,8280
635,2019-09-15,73,9425,2585,11,12094
635,2019-09-16,84,11089,2976,19,14168
635,2019-09-17,79,8046,2246,7,10378
635,2019-09-18,99,13324,1655,9,15087
635,2019-09-19,169,12278,1772,9,14228
635,2019-09-20,74,10643,1550,10,12277
635,2019-09-21,66,6317,2056,9,8448
635,2019-09-22,54,10084,1841,5,11984
635,2019-09-23,149,9381,2359,4,11893
635,2019-09-24,951,9829,1478,1,12259
635,2019-09-25,184,11287,2088,6,13565
635,2019-09-26,1780,10644,1854,8,14286
635,2019-09-27,80,10282,2571,4,12937
635,2019-09-28,932,15982,1824,2,18740
635,2019-09-29,1188,18000,1655,2,20845
635,2019-09-30,958,18543,1664,0,21165
635,2019-10-01,1931,16858,1825,1,20615
635,2019-10-02,1647,13508,1281,1,16437
635,2019-10-03,68,14584,2026,0,16678
635,2019-10-04,683,14135,1792,1,16611
635,2019-10-05,151,15081,1311,3,16546
635,2019-10-06,293,11828,1560,5,13686
635,2019-10-07,896,6930,2191,1,10018
635,2019-10-08,753,13094,2152,3,16002
635,2019-10-09,106,15616,1882,0,17604
635,2019-10-10,99,11649,2344,17,14109
635,2019-10-11,473,12867,1475,1,14816
635,2019-10-12,1418,7745,1592,1,10756
635,2019-10-13,70,9828,2441,3,12342
635,2019-10-14,102,7699,1550,1,9352
635,2019-10-15,101,8788,1801,7,10697
635,2019-10-16,160,18888,1278,9,20335
635,2019-10-17,60,9045,1496,3,10604
635,2019-10-18,85,9454,2193,2,11734
635,2019-10-19,964,6059,1081,0,8104
635,2019-10-20,150,3261,2078,0,5489
635,2019-10-21,506,11402,1768,0,13676
635,2019-10-22,567,7095,2163,1,9826
635,2019-10-23,57,9521,1229,3,10810
635,2019-10-24,82,14206,1382,2,15672
635,2019-10-25,1031,11734,1641,11,14417
635,2019-10-26,415,13856,1855,10,16136
635,2019-10-27,1259,17403,1643,0,20305
635,2019-10-28,37,13866,1547,0,15450
635,2019-10-29,241,27623,1960,0,29824
635,2019-10-30,62,23863,1649,0,25574
635,2019-10-31,38,13187,1255,0,14480
635,2019-11-01,765,26467,2139,0,29371
635,2019-11-02,39,17945,1196,4,19184
635,2019-11-03,97,23195,1245,0,24537
635,2019-11-04,93,8831,1731,0,10655
635,2019-11-05,129,4068,2107,2,6306
635,2019-11-06,882,14793,1051,0,16726
635,2019-11-07,585,17754,1580,2,19921
635,2019-11-08,173,9945,2956,1,13075
635,2019-11-09,413,8905,3183,0,12501
635,2019-11-10,68,14764,2008,2,16842
635,2019-11-11,434,10166,1405,1,12006
635,2019-11-12,113,11068,2205,3,13389
635,2019-11-13,62,11613,1988,2,13665
635,2019-11-14,618,13520,2067,0,16205
635,2019-11-15,49,6980,2129,1,9159
635,2019-11-16,96,2803,2633,1,5533
635,2019-11-17,155,4646,3676,2,8479
635,2019-11-18,917,2913,3583,3,7416
635,2019-11-19,82,3767,2138,1,5988
635,2019-11-20,106,2034,1917,2,4059
635,2019-11-21,966,4125,1224,0,6315
635,2019-11-22,86,9609,1654,5,11354
635,2019-11-23,70,7219,2460,1,9750
635,2019-11-24,160,6540,2152,0,8852
635,2019-11-25,122,7527,2044,1,9694
635,2019-11-26,81,7131,1826,0,9038
635,2019-11-27,72,7004,2366,4,9446
636,2019-08-01,746,39091,164,0,40001
636,2019-08-02,681,37491,218,0,38390
636,2019-08-03,557,9691,612,0,10860
636,2019-08-04,526,1004,208,0,1738
636,2019-08-05,535,350,322,0,1207
636,2019-08-06,566,0,346,2,914
636,2019-08-07,637,0,365,1,1003
636,2019-08-08,514,0,280,2,796
636,2019-08-09,531,0,89,1,621
636,2019-08-10,539,0,260,2,801
636,2019-08-11,513,0,88,1,602
636,2019-08-12,353,0,306,1,660
636,2019-08-13,456,0,218,0,674
636,2019-08-14,409,0,114,1,524
636,2019-08-15,319,0,37,0,356
636,2019-08-16,399,0,159,3,561
636,2019-08-17,570,0,632,1,1203
636,2019-08-18,1417,0,1106,1,2524
636,2019-08-19,815,0,974,1,1790
636,2019-08-20,724,0,1335,0,2059
636,2019-08-21,762,0,1006,2,1770
636,2019-08-22,762,0,1418,1,2181
636,2019-08-23,761,3735,1820,0,6316
636,2019-08-24,737,2535,1387,2,4661
636,2019-08-25,901,3925,1621,4,6451
636,2019-08-26,718,1207,2160,4,4089
636,2019-08-27,653,0,1620,0,2273
636,2019-08-28,670,0,1260,0,1930
636,2019-08-29,822,0,2274,0,3096
636,2019-08-30,1391,0,375,1,1767
636,2019-08-31,110,0,16,0,126
636,2019-09-01,175,2371,270,0,2816
636,2019-09-02,170,72,0,0,242
636,2019-09-03,491,19031,1890,0,21412
636,2019-09-04,1573,2488,1858,2,5921
636,2019-09-05,1469,0,2654,2,4125
636,2019-09-06,906,0,1375,1,2282
636,2019-09-07,1696,0,1875,0,3571
636,2019-09-08,849,0,1340,0,2189
636,2019-09-09,973,0,2262,2,3237
636,2019-09-10,405,0,2776,15,3196
636,2019-09-11,604,0,2319,6,2929
636,2019-09-12,664,0,1595,1,2260
636,2019-09-13,2011,0,2284,2,4297
636,2019-09-14,1570,0,2062,3,3635
636,2019-09-15,665,0,826,1,1492
636,2019-09-16,1482,0,2276,6,3764
636,2019-09-17,580,0,2070,7,2657
636,2019-09-18,962,0,1962,9,2933
636,2019-09-19,951,0,2342,8,3301
636,2019-09-20,1716,0,1161,31,2908
636,2019-09-21,785,0,1980,21,2786
636,2019-09-22,1482,0,1776,9,3267
636,2019-09-23,969,0,1985,10,2964
636,2019-09-24,999,0,1498,14,2511
636,2019-09-25,461,0,1868,15,2344
636,2019-09-26,1156,0,2549,10,3715
636,2019-09-27,1101,0,2048,1,3150
636,2019-09-28,1116,0,1333,4,2453
636,2019-09-29,1120,0,1256,1,2377
636,2019-09-30,274,0,1379,13,1666
636,2019-10-01,279,0,1909,9,2197
636,2019-10-02,257,0,2608,6,2871
636,2019-10-03,711,0,1889,10,2610
636,2019-10-04,265,0,1086,10,1361
636,2019-10-05,1123,0,1371,10,2504
636,2019-10-06,696,0,1446,11,2153
636,2019-10-07,295,0,1948,13,2256
636,2019-10-08,1882,0,1437,11,3330
636,2019-10-09,360,0,2107,11,2478
636,2019-10-10,1621,0,1856,12,3489
636,2019-10-11,877,0,1241,10,2128
636,2019-10-12,639,0,2594,2,3235
636,2019-10-13,547,0,2796,1,3344
636,2019-10-14,614,0,1596,1,2211
636,2019-10-15,612,0,1406,3,2021
636,2019-10-16,1003,0,1514,3,2520
636,2019-10-17,691,0,1907,1,2599
636,2019-10-18,704,0,1468,1,2173
636,2019-10-19,1569,0,1859,1,3429
636,2019-10-20,741,0,1290,8,2039
636,2019-10-21,689,0,1218,16,1923
636,2019-10-22,1571,0,2489,0,4060
636,2019-10-23,906,0,1102,1,2009
636,2019-10-24,638,0,1586,1,2225
636,2019-10-25,758,0,2220,4,2982
636,2019-10-26,1202,0,1809,1,3012
636,2019-10-27,625,0,1181,0,1806
636,2019-10-28,721,0,1138,0,1859
636,2019-10-29,717,0,1307,0,2024
636,2019-10-30,1119,0,1454,17,2590
636,2019-10-31,2784,0,2643,0,5427
636,2019-11-01,662,0,894,0,1556
636,2019-11-02,1691,0,1370,1,3062
636,2019-11-03,608,0,873,0,1481
636,2019-11-04,674,0,2067,4,2745
636,2019-11-05,642,0,1989,0,2631
636,2019-11-06,1519,0,1586,1,3106
636,2019-11-07,909,0,1354,2,2265
636,2019-11-08,700,0,1189,0,1889
636,2019-11-09,692,0,2302,2,2996
636,2019-11-10,1552,0,1839,0,3391
636,2019-11-11,740,0,2602,0,3342
636,2019-11-12,596,0,3228,1,3825
636,2019-11-13,667,0,1628,3,2298
636,2019-11-14,666,0,1944,0,2610
636,2019-11-15,718,0,1748,0,2466
636,2019-11-16,1244,0,2670,0,3914
636,2019-11-17,727,0,3733,0,4460
636,2019-11-18,778,0,2334,0,3112
636,2019-11-19,1339,0,3932,0,5271
636,2019-11-20,1587,0,2441,0,4028
636,2019-11-21,711,0,1517,0,2228
636,2019-11-22,773,0,1434,0,2207
636,2019-11-23,623,0,2979,0,3602
636,2019-11-24,779,0,1701,0,2480
636,2019-11-25,1584,0,1946,0,3530
636,2019-11-26,664,0,1581,0,2245
636,2019-11-27,670,0,1234,0,1904
636,2019-11-28,325,22864,507,0,23696
636,2019-11-29,128,1312,5,0,1445
636,2019-08-01,746,39091,164,0,40001
636,2019-08-02,681,37491,218,0,38390
636,2019-08-03,557,9691,612,0,10860
636,2019-08-04,526,1004,208,0,1738
636,2019-08-05,535,350,322,0,1207
636,2019-08-06,566,0,346,2,914
636,2019-08-07,637,0,365,1,1003
636,2019-08-08,514,0,280,2,796
636,2019-08-09,531,0,89,1,621
636,2019-08-10,539,0,260,2,801
636,2019-08-11,513,0,88,1,602
636,2019-08-12,353,0,306,1,660
636,2019-08-13,456,0,218,0,674
636,2019-08-14,409,0,114,1,524
636,2019-08-15,319,0,37,0,356
636,2019-08-16,399,0,159,3,561
636,2019-08-17,570,0,632,1,1203
636,2019-08-18,1417,0,1106,1,2524
636,2019-08-19,815,0,974,1,1790
636,2019-08-20,724,0,1335,0,2059
636,2019-08-21,762,0,1006,2,1770
636,2019-08-22,762,0,1418,1,2181
636,2019-08-23,761,3735,1820,0,6316
636,2019-08-24,737,2535,1387,2,4661
636,2019-08-25,901,3925,1621,4,6451
636,2019-08-26,718,1207,2160,4,4089
636,2019-08-27,653,0,1620,0,2273
636,2019-08-28,670,0,1260,0,1930
636,2019-08-29,822,0,2274,0,3096
636,2019-08-30,1391,0,375,1,1767
636,2019-08-31,110,0,16,0,126
636,2019-09-01,175,2371,270,0,2816
636,2019-09-02,170,72,0,0,242
636,2019-09-03,491,19031,1890,0,21412
636,2019-09-04,1573,2488,1858,2,5921
636,2019-09-05,1469,0,2654,2,4125
636,2019-09-06,906,0,1375,1,2282
636,2019-09-07,1696,0,1875,0,3571
636,2019-09-08,849,0,1340,0,2189
636,2019-09-09,973,0,2262,2,3237
636,2019-09-10,405,0,2776,15,3196
636,2019-09-11,604,0,2319,6,2929
636,2019-09-12,664,0,1595,1,2260
636,2019-09-13,2011,0,2284,2,4297
636,2019-09-14,1570,0,2062,3,3635
636,2019-09-15,665,0,826,1,1492
636,2019-09-16,1482,0,2276,6,3764
636,2019-09-17,580,0,2070,7,2657
636,2019-09-18,962,0,1962,9,2933
636,2019-09-19,951,0,2342,8,3301
636,2019-09-20,1716,0,1161,31,2908
636,2019-09-21,785,0,1980,21,2786
636,2019-09-22,1482,0,1776,9,3267
636,2019-09-23,969,0,1985,10,2964
636,2019-09-24,999,0,1498,14,2511
636,2019-09-25,461,0,1868,15,2344
636,2019-09-26,1156,0,2549,10,3715
636,2019-09-27,1101,0,2048,1,3150
636,2019-09-28,1116,0,1333,4,2453
636,2019-09-29,1120,0,1256,1,2377
636,2019-09-30,274,0,1379,13,1666
636,2019-10-01,279,0,1909,9,2197
636,2019-10-02,257,0,2608,6,2871
636,2019-10-03,711,0,1889,10,2610
636,2019-10-04,265,0,1086,10,1361
636,2019-10-05,1123,0,1371,10,2504
636,2019-10-06,696,0,1446,11,2153
636,2019-10-07,295,0,1948,13,2256
636,2019-10-08,1882,0,1437,11,3330
636,2019-10-09,360,0,2107,11,2478
636,2019-10-10,1621,0,1856,12,3489
636,2019-10-11,877,0,1241,10,2128
636,2019-10-12,639,0,2594,2,3235
636,2019-10-13,547,0,2796,1,3344
636,2019-10-14,614,0,1596,1,2211
636,2019-10-15,612,0,1406,3,2021
636,2019-10-16,1003,0,1514,3,2520
636,2019-10-17,691,0,1907,1,2599
636,2019-10-18,704,0,1468,1,2173
636,2019-10-19,1569,0,1859,1,3429
636,2019-10-20,741,0,1290,8,2039
636,2019-10-21,689,0,1218,16,1923
636,2019-10-22,1571,0,2489,0,4060
636,2019-10-23,906,0,1102,1,2009
636,2019-10-24,638,0,1586,1,2225
636,2019-10-25,758,0,2220,4,2982
636,2019-10-26,1202,0,1809,1,3012
636,2019-10-27,625,0,1181,0,1806
636,2019-10-28,721,0,1138,0,1859
636,2019-10-29,717,0,1307,0,2024
636,2019-10-30,1119,0,1454,17,2590
636,2019-10-31,2784,0,2643,0,5427
636,2019-11-01,662,0,894,0,1556
636,2019-11-02,1691,0,1370,1,3062
636,2019-11-03,608,0,873,0,1481
636,2019-11-04,674,0,2067,4,2745
636,2019-11-05,642,0,1989,0,2631
636,2019-11-06,1519,0,1586,1,3106
636,2019-11-07,909,0,1354,2,2265
636,2019-11-08,700,0,1189,0,1889
636,2019-11-09,692,0,2302,2,2996
636,2019-11-10,1552,0,1839,0,3391
636,2019-11-11,740,0,2602,0,3342
636,2019-11-12,596,0,3228,1,3825
636,2019-11-13,667,0,1628,3,2298
636,2019-11-14,666,0,1944,0,2610
636,2019-11-15,718,0,1748,0,2466
636,2019-11-16,1244,0,2670,0,3914
636,2019-11-17,727,0,3733,0,4460
636,2019-11-18,778,0,2334,0,3112
636,2019-11-19,1339,0,3932,0,5271
636,2019-11-20,1587,0,2441,0,4028
636,2019-11-21,711,0,1517,0,2228
636,2019-11-22,773,0,1434,0,2207
636,2019-11-23,623,0,2979,0,3602
636,2019-11-24,779,0,1701,0,2480
636,2019-11-25,1584,0,1946,0,3530
636,2019-11-26,664,0,1581,0,2245
636,2019-11-27,670,0,1234,0,1904
636,2019-11-28,325,22864,507,0,23696
636,2019-11-29,128,1312,5,0,1445
636,2019-08-01,746,39091,164,0,40001
636,2019-08-02,681,37491,218,0,38390
636,2019-08-03,557,9691,612,0,10860
636,2019-08-04,526,1004,208,0,1738
636,2019-08-05,535,350,322,0,1207
636,2019-08-06,566,0,346,2,914
636,2019-08-07,637,0,365,1,1003
636,2019-08-08,514,0,280,2,796
636,2019-08-09,531,0,89,1,621
636,2019-08-10,539,0,260,2,801
636,2019-08-11,513,0,88,1,602
636,2019-08-12,353,0,306,1,660
636,2019-08-13,456,0,218,0,674
636,2019-08-14,409,0,114,1,524
636,2019-08-15,319,0,37,0,356
636,2019-08-16,399,0,159,3,561
636,2019-08-17,570,0,632,1,1203
636,2019-08-18,1417,0,1106,1,2524
636,2019-08-19,815,0,974,1,1790
636,2019-08-20,724,0,1335,0,2059
636,2019-08-21,762,0,1006,2,1770
636,2019-08-22,762,0,1418,1,2181
636,2019-08-23,761,3735,1820,0,6316
636,2019-08-24,737,2535,1387,2,4661
636,2019-08-25,901,3925,1621,4,6451
636,2019-08-26,718,1207,2160,4,4089
636,2019-08-27,653,0,1620,0,2273
636,2019-08-28,670,0,1260,0,1930
636,2019-08-29,822,0,2274,0,3096
636,2019-08-30,1391,0,375,1,1767
636,2019-08-31,110,0,16,0,126
636,2019-09-01,175,2371,270,0,2816
636,2019-09-02,170,72,0,0,242
636,2019-09-03,491,19031,1890,0,21412
636,2019-09-04,1573,2488,1858,2,5921
636,2019-09-05,1469,0,2654,2,4125
636,2019-09-06,906,0,1375,1,2282
636,2019-09-07,1696,0,1875,0,3571
636,2019-09-08,849,0,1340,0,2189
636,2019-09-09,973,0,2262,2,3237
636,2019-09-10,405,0,2776,15,3196
636,2019-09-11,604,0,2319,6,2929
636,2019-09-12,664,0,1595,1,2260
636,2019-09-13,2011,0,2284,2,4297
636,2019-09-14,1570,0,2062,3,3635
636,2019-09-15,665,0,826,1,1492
636,2019-09-16,1482,0,2276,6,3764
636,2019-09-17,580,0,2070,7,2657
636,2019-09-18,962,0,1962,9,2933
636,2019-09-19,951,0,2342,8,3301
636,2019-09-20,1716,0,1161,31,2908
636,2019-09-21,785,0,1980,21,2786
636,2019-09-22,1482,0,1776,9,3267
636,2019-09-23,969,0,1985,10,2964
636,2019-09-24,999,0,1498,14,2511
636,2019-09-25,461,0,1868,15,2344
636,2019-09-26,1156,0,2549,10,3715
636,2019-09-27,1101,0,2048,1,3150
636,2019-09-28,1116,0,1333,4,2453
636,2019-09-29,1120,0,1256,1,2377
636,2019-09-30,274,0,1379,13,1666
636,2019-10-01,279,0,1909,9,2197
636,2019-10-02,257,0,2608,6,2871
636,2019-10-03,711,0,1889,10,2610
636,2019-10-04,265,0,1086,10,1361
636,2019-10-05,1123,0,1371,10,2504
636,2019-10-06,696,0,1446,11,2153
636,2019-10-07,295,0,1948,13,2256
636,2019-10-08,1882,0,1437,11,3330
636,2019-10-09,360,0,2107,11,2478
636,2019-10-10,1621,0,1856,12,3489
636,2019-10-11,877,0,1241,10,2128
636,2019-10-12,639,0,2594,2,3235
636,2019-10-13,547,0,2796,1,3344
636,2019-10-14,614,0,1596,1,2211
636,2019-10-15,612,0,1406,3,2021
636,2019-10-16,1003,0,1514,3,2520
636,2019-10-17,691,0,1907,1,2599
636,2019-10-18,704,0,1468,1,2173
636,2019-10-19,1569,0,1859,1,3429
636,2019-10-20,741,0,1290,8,2039
636,2019-10-21,689,0,1218,16,1923
636,2019-10-22,1571,0,2489,0,4060
636,2019-10-23,906,0,1102,1,2009
636,2019-10-24,638,0,1586,1,2225
636,2019-10-25,758,0,2220,4,2982
636,2019-10-26,1202,0,1809,1,3012
636,2019-10-27,625,0,1181,0,1806
636,2019-10-28,721,0,1138,0,1859
636,2019-10-29,717,0,1307,0,2024
636,2019-10-30,1119,0,1454,17,2590
636,2019-10-31,2784,0,2643,0,5427
636,2019-11-01,662,0,894,0,1556
636,2019-11-02,1691,0,1370,1,3062
636,2019-11-03,608,0,873,0,1481
636,2019-11-04,674,0,2067,4,2745
636,2019-11-05,642,0,1989,0,2631
636,2019-11-06,1519,0,1586,1,3106
636,2019-11-07,909,0,1354,2,2265
636,2019-11-08,700,0,1189,0,1889
636,2019-11-09,692,0,2302,2,2996
636,2019-11-10,1552,0,1839,0,3391
636,2019-11-11,740,0,2602,0,3342
636,2019-11-12,596,0,3228,1,3825
636,2019-11-13,667,0,1628,3,2298
636,2019-11-14,666,0,1944,0,2610
636,2019-11-15,718,0,1748,0,2466
636,2019-11-16,1244,0,2670,0,3914
636,2019-11-17,727,0,3733,0,4460
636,2019-11-18,778,0,2334,0,3112
636,2019-11-19,1339,0,3932,0,5271
636,2019-11-20,1587,0,2441,0,4028
636,2019-11-21,711,0,1517,0,2228
636,2019-11-22,773,0,1434,0,2207
636,2019-11-23,623,0,2979,0,3602
636,2019-11-24,779,0,1701,0,2480
636,2019-11-25,1584,0,1946,0,3530
636,2019-11-26,664,0,1581,0,2245
636,2019-11-27,670,0,1234,0,1904
636,2019-11-28,325,22864,507,0,23696
636,2019-11-29,128,1312,5,0,1445
636,2019-08-06,566,0,346,2,914
636,2019-08-07,637,0,365,1,1003
636,2019-08-08,514,0,280,2,796
636,2019-08-09,531,0,89,1,621
636,2019-08-10,539,0,260,2,801
636,2019-08-11,513,0,88,1,602
636,2019-08-12,353,0,306,1,660
636,2019-08-13,456,0,218,0,674
636,2019-08-14,409,0,114,1,524
636,2019-08-15,319,0,37,0,356
636,2019-08-16,399,0,159,3,561
636,2019-08-17,570,0,632,1,1203
636,2019-08-18,1417,0,1106,1,2524
636,2019-08-19,815,0,974,1,1790
636,2019-08-20,724,0,1335,0,2059
636,2019-08-21,762,0,1006,2,1770
636,2019-08-22,762,0,1418,1,2181
636,2019-08-23,761,3735,1820,0,6316
636,2019-08-24,737,2535,1387,2,4661
636,2019-08-25,901,3925,1621,4,6451
636,2019-08-26,718,1207,2160,4,4089
636,2019-08-27,653,0,1620,0,2273
636,2019-08-28,670,0,1260,0,1930
636,2019-08-29,822,0,2274,0,3096
636,2019-08-30,1391,0,375,1,1767
636,2019-08-31,110,0,16,0,126
636,2019-09-01,175,2371,270,0,2816
636,2019-09-02,170,72,0,0,242
636,2019-09-03,491,19031,1890,0,21412
636,2019-09-04,1573,2488,1858,2,5921
636,2019-09-05,1469,0,2654,2,4125
636,2019-09-06,906,0,1375,1,2282
636,2019-09-07,1696,0,1875,0,3571
636,2019-09-08,849,0,1340,0,2189
636,2019-09-09,973,0,2262,2,3237
636,2019-09-10,405,0,2776,15,3196
636,2019-09-11,604,0,2319,6,2929
636,2019-09-12,664,0,1595,1,2260
636,2019-09-13,2011,0,2284,2,4297
636,2019-09-14,1570,0,2062,3,3635
636,2019-09-15,665,0,826,1,1492
636,2019-09-16,1482,0,2276,6,3764
636,2019-09-17,580,0,2070,7,2657
636,2019-09-18,962,0,1962,9,2933
636,2019-09-19,951,0,2342,8,3301
636,2019-09-20,1716,0,1161,31,2908
636,2019-09-21,785,0,1980,21,2786
636,2019-09-22,1482,0,1776,9,3267
636,2019-09-23,969,0,1985,10,2964
636,2019-09-24,999,0,1498,14,2511
636,2019-09-25,461,0,1868,15,2344
636,2019-09-26,1156,0,2549,10,3715
636,2019-09-27,1101,0,2048,1,3150
636,2019-09-28,1116,0,1333,4,2453
636,2019-09-29,1120,0,1256,1,2377
636,2019-09-30,274,0,1379,13,1666
636,2019-10-01,279,0,1909,9,2197
636,2019-10-02,257,0,2608,6,2871
636,2019-10-03,711,0,1889,10,2610
636,2019-10-04,265,0,1086,10,1361
636,2019-10-05,1123,0,1371,10,2504
636,2019-10-06,696,0,1446,11,2153
636,2019-10-07,295,0,1948,13,2256
636,2019-10-08,1882,0,1437,11,3330
636,2019-10-09,360,0,2107,11,2478
636,2019-10-10,1621,0,1856,12,3489
636,2019-10-11,877,0,1241,10,2128
636,2019-10-12,639,0,2594,2,3235
636,2019-10-13,547,0,2796,1,3344
636,2019-10-14,614,0,1596,1,2211
636,2019-10-15,612,0,1406,3,2021
636,2019-10-16,1003,0,1514,3,2520
636,2019-10-17,691,0,1907,1,2599
636,2019-10-18,704,0,1468,1,2173
636,2019-10-19,1569,0,1859,1,3429
636,2019-10-20,741,0,1290,8,2039
636,2019-10-21,689,0,1218,16,1923
636,2019-10-22,1571,0,2489,0,4060
636,2019-10-23,906,0,1102,1,2009
636,2019-10-24,638,0,1586,1,2225
636,2019-10-25,758,0,2220,4,2982
636,2019-10-26,1202,0,1809,1,3012
636,2019-10-27,625,0,1181,0,1806
636,2019-10-28,721,0,1138,0,1859
636,2019-10-29,717,0,1307,0,2024
636,2019-10-30,1119,0,1454,17,2590
636,2019-10-31,2784,0,2643,0,5427
636,2019-11-01,662,0,894,0,1556
636,2019-11-02,1691,0,1370,1,3062
636,2019-11-03,608,0,873,0,1481
636,2019-11-04,674,0,2067,4,2745
636,2019-11-05,642,0,1989,0,2631
636,2019-11-06,1519,0,1586,1,3106
636,2019-11-07,909,0,1354,2,2265
636,2019-11-08,700,0,1189,0,1889
636,2019-11-09,692,0,2302,2,2996
636,2019-11-10,1552,0,1839,0,3391
636,2019-11-11,740,0,2602,0,3342
636,2019-11-12,596,0,3228,1,3825
636,2019-11-13,667,0,1628,3,2298
637,2019-08-01,926,33207,322,0,34455
637,2019-08-02,106,35371,17,1,35495
637,2019-08-03,90,9424,318,1,9833
637,2019-08-04,973,1117,240,2,2332
637,2019-08-05,253,886,419,0,1558
637,2019-08-06,43,1119,318,1,1481
637,2019-08-07,947,1547,488,1,2983
637,2019-08-08,19,1018,220,1,1258
637,2019-08-09,32,1956,254,0,2242
637,2019-08-10,1110,1194,203,2,2509
637,2019-08-11,42,1061,222,2,1327
637,2019-08-12,37,1742,239,0,2018
637,2019-08-13,787,1960,222,1,2970
637,2019-08-14,55,1183,159,2,1399
637,2019-08-15,53,915,0,0,968
637,2019-08-16,902,1592,23,0,2517
637,2019-08-17,167,2891,1558,0,4616
637,2019-08-18,47,2874,1179,0,4100
637,2019-08-19,1163,22769,1393,1,25326
637,2019-08-20,76,30130,475,1,30682
637,2019-08-21,42,3460,1178,1,4681
637,2019-08-22,969,7705,2160,2,10836
637,2019-08-23,37,11192,1621,0,12850
637,2019-08-24,69,8850,1171,0,10090
637,2019-08-25,1802,7414,1629,3,10848
637,2019-08-26,117,5033,2075,1,7226
637,2019-08-27,73,5376,1228,2,6679
637,2019-08-28,172,11958,1908,0,14038
637,2019-08-29,947,18076,1114,1,20138
637,2019-08-30,154,5555,668,2,6379
637,2019-08-31,14,12543,5,0,12562
637,2019-09-01,104,3543,273,0,3920
637,2019-09-02,31,1226,4,0,1261
637,2019-09-03,67,6047,843,2,6959
637,2019-09-04,2676,16220,1975,3,20874
637,2019-09-05,78,12510,2207,0,14795
637,2019-09-06,141,18002,1841,0,19984
637,2019-09-07,1024,34666,2515,0,38205
637,2019-09-08,205,9119,2198,0,11522
637,2019-09-09,1464,13925,1544,2,16935
637,2019-09-10,1021,15513,2138,1,18673
637,2019-09-11,120,7980,1510,1,9611
637,2019-09-12,173,8399,1761,3,10336
637,2019-09-13,1988,55978,2507,1,60474
637,2019-09-14,67,19167,1835,1,21070
637,2019-09-15,59,14039,1933,12,16043
637,2019-09-16,1024,44245,2075,6,47350
637,2019-09-17,70,9069,1822,7,10968
637,2019-09-18,179,20676,1710,8,22573
637,2019-09-19,1196,6484,1710,11,9401
637,2019-09-20,185,13091,1425,10,14711
637,2019-09-21,56,14008,2594,9,16667
637,2019-09-22,987,14315,1416,9,16727
637,2019-09-23,159,18699,1634,10,20502
637,2019-09-24,120,11164,1596,15,12895
637,2019-09-25,1160,11377,2439,11,14987
637,2019-09-26,83,12387,2053,10,14533
637,2019-09-27,79,9131,2353,2,11565
637,2019-09-28,1944,37207,1807,3,40961
637,2019-09-29,108,47005,2048,4,49165
637,2019-09-30,88,39034,1304,1,40427
637,2019-10-01,1103,19522,2340,3,22968
637,2019-10-02,170,16695,2292,7,19164
637,2019-10-03,107,12017,1987,10,14121
637,2019-10-04,988,31768,1257,26,34039
637,2019-10-05,509,21549,1872,11,23941
637,2019-10-06,64,10422,1872,13,12371
637,2019-10-07,1087,6333,2182,11,9613
637,2019-10-08,1032,21731,2153,9,24925
637,2019-10-09,96,16227,1278,13,17614
637,2019-10-10,998,15758,1833,10,18599
637,2019-10-11,397,9783,2340,8,12528
637,2019-10-12,113,6231,2357,2,8703
637,2019-10-13,1254,5899,2019,3,9175
637,2019-10-14,132,7541,1565,1,9239
637,2019-10-15,60,14111,1295,11,15477
637,2019-10-16,642,24498,1308,0,26448
637,2019-10-17,966,8800,2072,1,11839
637,2019-10-18,169,7863,1936,0,9968
637,2019-10-19,1436,4282,2128,0,7846
637,2019-10-20,129,1189,2429,1,3748
637,2019-10-21,147,9934,1555,1,11637
637,2019-10-22,2210,5281,1913,1,9405
637,2019-10-23,744,13802,1427,3,15976
637,2019-10-24,97,23963,1550,3,25613
637,2019-10-25,699,13738,1349,0,15786
637,2019-10-26,1149,21099,2358,0,24606
637,2019-10-27,113,30824,1655,0,32592
637,2019-10-28,501,18576,1767,0,20844
637,2019-10-29,241,19283,2267,3,21794
637,2019-10-30,217,15594,1232,1,17044
637,2019-10-31,646,19763,2125,0,22534
637,2019-11-01,30,26796,1178,0,28004
637,2019-11-02,60,16687,1059,1,17807
637,2019-11-03,2003,51119,1197,5,54324
637,2019-11-04,123,18915,2046,0,21084
637,2019-11-05,147,1988,1679,1,3815
637,2019-11-06,1129,13788,950,2,15869
637,2019-11-07,168,25545,865,3,26581
637,2019-11-08,77,11456,2271,0,13804
637,2019-11-09,653,12188,3107,0,15948
637,2019-11-10,404,12473,1907,2,14786
637,2019-11-11,75,14682,1419,0,16176
637,2019-11-12,696,12654,2951,3,16304
637,2019-11-13,395,19616,1695,4,21710
637,2019-11-14,79,14866,1786,0,16731
637,2019-11-15,67,3550,2104,1,5722
637,2019-11-16,1888,1178,1882,1,4949
637,2019-11-17,76,2647,3673,0,6396
637,2019-11-18,101,1488,3322,3,4914
637,2019-11-19,1268,3110,2792,0,7170
637,2019-11-20,202,1235,1273,0,2710
637,2019-11-21,110,5935,2016,1,8062
637,2019-11-22,550,5320,1689,2,7561
637,2019-11-23,102,6042,2044,3,8191
637,2019-11-24,1501,8055,2668,0,12224
637,2019-11-25,920,5913,1602,0,8435
637,2019-11-26,389,6250,2387,0,9026
637,2019-11-27,1171,5648,1071,2,7892
637,2019-11-28,256,8910,502,1,9669
637,2019-11-29,15,835,3,0,853
637,2019-08-01,926,33207,322,0,34455
637,2019-08-02,106,35371,17,1,35495
637,2019-08-03,90,9424,318,1,9833
637,2019-08-04,973,1117,240,2,2332
637,2019-08-05,253,886,419,0,1558
637,2019-08-06,43,1119,318,1,1481
637,2019-08-07,947,1547,488,1,2983
637,2019-08-08,19,1018,220,1,1258
637,2019-08-09,32,1956,254,0,2242
637,2019-08-10,1110,1194,203,2,2509
637,2019-08-11,42,1061,222,2,1327
637,2019-08-12,37,1742,239,0,2018
637,2019-08-13,787,1960,222,1,2970
637,2019-08-14,55,1183,159,2,1399
637,2019-08-15,53,915,0,0,968
637,2019-08-16,902,1592,23,0,2517
637,2019-08-17,167,2891,1558,0,4616
637,2019-08-18,47,2874,1179,0,4100
637,2019-08-19,1163,22769,1393,1,25326
637,2019-08-20,76,30130,475,1,30682
637,2019-08-21,42,3460,1178,1,4681
637,2019-08-22,969,7705,2160,2,10836
637,2019-08-23,37,11192,1621,0,12850
637,2019-08-24,69,8850,1171,0,10090
637,2019-08-25,1802,7414,1629,3,10848
637,2019-08-26,117,5033,2075,1,7226
637,2019-08-27,73,5376,1228,2,6679
637,2019-08-28,172,11958,1908,0,14038
637,2019-08-29,947,18076,1114,1,20138
637,2019-08-30,154,5555,668,2,6379
637,2019-08-31,14,12543,5,0,12562
637,2019-09-01,104,3543,273,0,3920
637,2019-09-02,31,1226,4,0,1261
637,2019-09-03,67,6047,843,2,6959
637,2019-09-04,2676,16220,1975,3,20874
637,2019-09-05,78,12510,2207,0,14795
637,2019-09-06,141,18002,1841,0,19984
637,2019-09-07,1024,34666,2515,0,38205
637,2019-09-08,205,9119,2198,0,11522
637,2019-09-09,1464,13925,1544,2,16935
637,2019-09-10,1021,15513,2138,1,18673
637,2019-09-11,120,7980,1510,1,9611
637,2019-09-12,173,8399,1761,3,10336
637,2019-09-13,1988,55978,2507,1,60474
637,2019-09-14,67,19167,1835,1,21070
637,2019-09-15,59,14039,1933,12,16043
637,2019-09-16,1024,44245,2075,6,47350
637,2019-09-17,70,9069,1822,7,10968
637,2019-09-18,179,20676,1710,8,22573
637,2019-09-19,1196,6484,1710,11,9401
637,2019-09-20,185,13091,1425,10,14711
637,2019-09-21,56,14008,2594,9,16667
637,2019-09-22,987,14315,1416,9,16727
637,2019-09-23,159,18699,1634,10,20502
637,2019-09-24,120,11164,1596,15,12895
637,2019-09-25,1160,11377,2439,11,14987
637,2019-09-26,83,12387,2053,10,14533
637,2019-09-27,79,9131,2353,2,11565
637,2019-09-28,1944,37207,1807,3,40961
637,2019-09-29,108,47005,2048,4,49165
637,2019-09-30,88,39034,1304,1,40427
637,2019-10-01,1103,19522,2340,3,22968
637,2019-10-02,170,16695,2292,7,19164
637,2019-10-03,107,12017,1987,10,14121
637,2019-10-04,988,31768,1257,26,34039
637,2019-10-05,509,21549,1872,11,23941
637,2019-10-06,64,10422,1872,13,12371
637,2019-10-07,1087,6333,2182,11,9613
637,2019-10-08,1032,21731,2153,9,24925
637,2019-10-09,96,16227,1278,13,17614
637,2019-10-10,998,15758,1833,10,18599
637,2019-10-11,397,9783,2340,8,12528
637,2019-10-12,113,6231,2357,2,8703
637,2019-10-13,1254,5899,2019,3,9175
637,2019-10-14,132,7541,1565,1,9239
637,2019-10-15,60,14111,1295,11,15477
637,2019-10-16,642,24498,1308,0,26448
637,2019-10-17,966,8800,2072,1,11839
637,2019-10-18,169,7863,1936,0,9968
637,2019-10-19,1436,4282,2128,0,7846
637,2019-10-20,129,1189,2429,1,3748
637,2019-10-21,147,9934,1555,1,11637
637,2019-10-22,2210,5281,1913,1,9405
637,2019-10-23,744,13802,1427,3,15976
637,2019-10-24,97,23963,1550,3,25613
637,2019-10-25,699,13738,1349,0,15786
637,2019-10-26,1149,21099,2358,0,24606
637,2019-10-27,113,30824,1655,0,32592
637,2019-10-28,501,18576,1767,0,20844
637,2019-10-29,241,19283,2267,3,21794
637,2019-10-30,217,15594,1232,1,17044
637,2019-10-31,646,19763,2125,0,22534
637,2019-11-01,30,26796,1178,0,28004
637,2019-11-02,60,16687,1059,1,17807
637,2019-11-03,2003,51119,1197,5,54324
637,2019-11-04,123,18915,2046,0,21084
637,2019-11-05,147,1988,1679,1,3815
637,2019-11-06,1129,13788,950,2,15869
637,2019-11-07,168,25545,865,3,26581
637,2019-11-08,77,11456,2271,0,13804
637,2019-11-09,653,12188,3107,0,15948
637,2019-11-10,404,12473,1907,2,14786
637,2019-11-11,75,14682,1419,0,16176
637,2019-11-12,696,12654,2951,3,16304
637,2019-11-13,395,19616,1695,4,21710
637,2019-11-14,79,14866,1786,0,16731
637,2019-11-15,67,3550,2104,1,5722
637,2019-11-16,1888,1178,1882,1,4949
637,2019-11-17,76,2647,3673,0,6396
637,2019-11-18,101,1488,3322,3,4914
637,2019-11-19,1268,3110,2792,0,7170
637,2019-11-20,202,1235,1273,0,2710
637,2019-11-21,110,5935,2016,1,8062
637,2019-11-22,550,5320,1689,2,7561
637,2019-11-23,102,6042,2044,3,8191
637,2019-11-24,1501,8055,2668,0,12224
637,2019-11-25,920,5913,1602,0,8435
637,2019-11-26,389,6250,2387,0,9026
637,2019-11-27,1171,5648,1071,2,7892
637,2019-11-28,256,8910,502,1,9669
637,2019-11-29,15,835,3,0,853
637,2019-08-01,926,33207,322,0,34455
637,2019-08-02,106,35371,17,1,35495
637,2019-08-03,90,9424,318,1,9833
637,2019-08-04,973,1117,240,2,2332
637,2019-08-05,253,886,419,0,1558
637,2019-08-06,43,1119,318,1,1481
637,2019-08-07,947,1547,488,1,2983
637,2019-08-08,19,1018,220,1,1258
637,2019-08-09,32,1956,254,0,2242
637,2019-08-10,1110,1194,203,2,2509
637,2019-08-11,42,1061,222,2,1327
637,2019-08-12,37,1742,239,0,2018
637,2019-08-13,787,1960,222,1,2970
637,2019-08-14,55,1183,159,2,1399
637,2019-08-15,53,915,0,0,968
637,2019-08-16,902,1592,23,0,2517
637,2019-08-17,167,2891,1558,0,4616
637,2019-08-18,47,2874,1179,0,4100
637,2019-08-19,1163,22769,1393,1,25326
637,2019-08-20,76,30130,475,1,30682
637,2019-08-21,42,3460,1178,1,4681
637,2019-08-22,969,7705,2160,2,10836
637,2019-08-23,37,11192,1621,0,12850
637,2019-08-24,69,8850,1171,0,10090
637,2019-08-25,1802,7414,1629,3,10848
637,2019-08-26,117,5033,2075,1,7226
637,2019-08-27,73,5376,1228,2,6679
637,2019-08-28,172,11958,1908,0,14038
637,2019-08-29,947,18076,1114,1,20138
637,2019-08-30,154,5555,668,2,6379
637,2019-08-31,14,12543,5,0,12562
637,2019-09-01,104,3543,273,0,3920
637,2019-09-02,31,1226,4,0,1261
637,2019-09-03,67,6047,843,2,6959
637,2019-09-04,2676,16220,1975,3,20874
637,2019-09-05,78,12510,2207,0,14795
637,2019-09-06,141,18002,1841,0,19984
637,2019-09-07,1024,34666,2515,0,38205
637,2019-09-08,205,9119,2198,0,11522
637,2019-09-09,1464,13925,1544,2,16935
637,2019-09-10,1021,15513,2138,1,18673
637,2019-09-11,120,7980,1510,1,9611
637,2019-09-12,173,8399,1761,3,10336
637,2019-09-13,1988,55978,2507,1,60474
637,2019-09-14,67,19167,1835,1,21070
637,2019-09-15,59,14039,1933,12,16043
637,2019-09-16,1024,44245,2075,6,47350
637,2019-09-17,70,9069,1822,7,10968
637,2019-09-18,179,20676,1710,8,22573
637,2019-09-19,1196,6484,1710,11,9401
637,2019-09-20,185,13091,1425,10,14711
637,2019-09-21,56,14008,2594,9,16667
637,2019-09-22,987,14315,1416,9,16727
637,2019-09-23,159,18699,1634,10,20502
637,2019-09-24,120,11164,1596,15,12895
637,2019-09-25,1160,11377,2439,11,14987
637,2019-09-26,83,12387,2053,10,14533
637,2019-09-27,79,9131,2353,2,11565
637,2019-09-28,1944,37207,1807,3,40961
637,2019-09-29,108,47005,2048,4,49165
637,2019-09-30,88,39034,1304,1,40427
637,2019-10-01,1103,19522,2340,3,22968
637,2019-10-02,170,16695,2292,7,19164
637,2019-10-03,107,12017,1987,10,14121
637,2019-10-04,988,31768,1257,26,34039
637,2019-10-05,509,21549,1872,11,23941
637,2019-10-06,64,10422,1872,13,12371
637,2019-10-07,1087,6333,2182,11,9613
637,2019-10-08,1032,21731,2153,9,24925
637,2019-10-09,96,16227,1278,13,17614
637,2019-10-10,998,15758,1833,10,18599
637,2019-10-11,397,9783,2340,8,12528
637,2019-10-12,113,6231,2357,2,8703
637,2019-10-13,1254,5899,2019,3,9175
637,2019-10-14,132,7541,1565,1,9239
637,2019-10-15,60,14111,1295,11,15477
637,2019-10-16,642,24498,1308,0,26448
637,2019-10-17,966,8800,2072,1,11839
637,2019-10-18,169,7863,1936,0,9968
637,2019-10-19,1436,4282,2128,0,7846
637,2019-10-20,129,1189,2429,1,3748
637,2019-10-21,147,9934,1555,1,11637
637,2019-10-22,2210,5281,1913,1,9405
637,2019-10-23,744,13802,1427,3,15976
637,2019-10-24,97,23963,1550,3,25613
637,2019-10-25,699,13738,1349,0,15786
637,2019-10-26,1149,21099,2358,0,24606
637,2019-10-27,113,30824,1655,0,32592
637,2019-10-28,501,18576,1767,0,20844
637,2019-10-29,241,19283,2267,3,21794
637,2019-10-30,217,15594,1232,1,17044
637,2019-10-31,646,19763,2125,0,22534
637,2019-11-01,30,26796,1178,0,28004
637,2019-11-02,60,16687,1059,1,17807
637,2019-11-03,2003,51119,1197,5,54324
637,2019-11-04,123,18915,2046,0,21084
637,2019-11-05,147,1988,1679,1,3815
637,2019-11-06,1129,13788,950,2,15869
637,2019-11-07,168,25545,865,3,26581
637,2019-11-08,77,11456,2271,0,13804
637,2019-11-09,653,12188,3107,0,15948
637,2019-11-10,404,12473,1907,2,14786
637,2019-11-11,75,14682,1419,0,16176
637,2019-11-12,696,12654,2951,3,16304
637,2019-11-13,395,19616,1695,4,21710
637,2019-11-14,79,14866,1786,0,16731
637,2019-11-15,67,3550,2104,1,5722
637,2019-11-16,1888,1178,1882,1,4949
637,2019-11-17,76,2647,3673,0,6396
637,2019-11-18,101,1488,3322,3,4914
637,2019-11-19,1268,3110,2792,0,7170
637,2019-11-20,202,1235,1273,0,2710
637,2019-11-21,110,5935,2016,1,8062
637,2019-11-22,550,5320,1689,2,7561
637,2019-11-23,102,6042,2044,3,8191
637,2019-11-24,1501,8055,2668,0,12224
637,2019-11-25,920,5913,1602,0,8435
637,2019-11-26,389,6250,2387,0,9026
637,2019-11-27,1171,5648,1071,2,7892
637,2019-11-28,256,8910,502,1,9669
637,2019-11-29,15,835,3,0,853
637,2019-08-02,106,35371,17,1,35495
637,2019-08-03,90,9424,318,1,9833
637,2019-08-04,973,1117,240,2,2332
637,2019-08-05,253,886,419,0,1558
637,2019-08-06,43,1119,318,1,1481
637,2019-08-07,947,1547,488,1,2983
637,2019-08-08,19,1018,220,1,1258
637,2019-08-09,32,1956,254,0,2242
637,2019-08-10,1110,1194,203,2,2509
637,2019-08-11,42,1061,222,2,1327
637,2019-08-12,37,1742,239,0,2018
637,2019-08-13,787,1960,222,1,2970
637,2019-08-14,55,1183,159,2,1399
637,2019-08-15,53,915,0,0,968
637,2019-08-16,902,1592,23,0,2517
637,2019-08-17,167,2891,1558,0,4616
637,2019-08-18,47,2874,1179,0,4100
637,2019-08-19,1163,22769,1393,1,25326
637,2019-08-20,76,30130,475,1,30682
637,2019-08-21,42,3460,1178,1,4681
637,2019-08-22,969,7705,2160,2,10836
637,2019-08-23,37,11192,1621,0,12850
637,2019-08-24,69,8850,1171,0,10090
637,2019-08-25,1802,7414,1629,3,10848
637,2019-08-26,117,5033,2075,1,7226
637,2019-08-27,73,5376,1228,2,6679
637,2019-08-28,172,11958,1908,0,14038
637,2019-08-29,947,18076,1114,1,20138
637,2019-08-30,154,5555,668,2,6379
637,2019-08-31,14,12543,5,0,12562
637,2019-09-01,104,3543,273,0,3920
637,2019-09-02,31,1226,4,0,1261
637,2019-09-03,67,6047,843,2,6959
637,2019-09-04,2676,16220,1975,3,20874
637,2019-09-05,78,12510,2207,0,14795
637,2019-09-06,141,18002,1841,0,19984
637,2019-09-07,1024,34666,2515,0,38205
637,2019-09-08,205,9119,2198,0,11522
637,2019-09-09,1464,13925,1544,2,16935
637,2019-09-10,1021,15513,2138,1,18673
637,2019-09-11,120,7980,1510,1,9611
637,2019-09-12,173,8399,1761,3,10336
637,2019-09-13,1988,55978,2507,1,60474
637,2019-09-14,67,19167,1835,1,21070
637,2019-09-15,59,14039,1933,12,16043
637,2019-09-16,1024,44245,2075,6,47350
637,2019-09-17,70,9069,1822,7,10968
637,2019-09-18,179,20676,1710,8,22573
637,2019-09-19,1196,6484,1710,11,9401
637,2019-09-20,185,13091,1425,10,14711
637,2019-09-21,56,14008,2594,9,16667
637,2019-09-22,987,14315,1416,9,16727
637,2019-09-23,159,18699,1634,10,20502
637,2019-09-24,120,11164,1596,15,12895
637,2019-09-25,1160,11377,2439,11,14987
637,2019-09-26,83,12387,2053,10,14533
637,2019-09-27,79,9131,2353,2,11565
637,2019-09-28,1944,37207,1807,3,40961
637,2019-09-29,108,47005,2048,4,49165
637,2019-09-30,88,39034,1304,1,40427
637,2019-10-01,1103,19522,2340,3,22968
637,2019-10-02,170,16695,2292,7,19164
637,2019-10-03,107,12017,1987,10,14121
637,2019-10-04,988,31768,1257,26,34039
637,2019-10-05,509,21549,1872,11,23941
637,2019-10-06,64,10422,1872,13,12371
637,2019-10-07,1087,6333,2182,11,9613
637,2019-10-08,1032,21731,2153,9,24925
637,2019-10-09,96,16227,1278,13,17614
637,2019-10-10,998,15758,1833,10,18599
637,2019-10-11,397,9783,2340,8,12528
637,2019-10-12,113,6231,2357,2,8703
637,2019-10-13,1254,5899,2019,3,9175
637,2019-10-14,132,7541,1565,1,9239
637,2019-10-15,60,14111,1295,11,15477
637,2019-10-16,642,24498,1308,0,26448
637,2019-10-17,966,8800,2072,1,11839
637,2019-10-18,169,7863,1936,0,9968
637,2019-10-19,1436,4282,2128,0,7846
637,2019-10-20,129,1189,2429,1,3748
637,2019-10-21,147,9934,1555,1,11637
637,2019-10-22,2210,5281,1913,1,9405
637,2019-10-23,744,13802,1427,3,15976
637,2019-10-24,97,23963,1550,3,25613
637,2019-10-25,699,13738,1349,0,15786
637,2019-10-26,1149,21099,2358,0,24606
637,2019-10-27,113,30824,1655,0,32592
637,2019-10-28,501,18576,1767,0,20844
637,2019-10-29,241,19283,2267,3,21794
637,2019-10-30,217,15594,1232,1,17044
637,2019-10-31,646,19763,2125,0,22534
637,2019-11-01,30,26796,1178,0,28004
637,2019-11-02,60,16687,1059,1,17807
637,2019-11-03,2003,51119,1197,5,54324
637,2019-11-04,123,18915,2046,0,21084
637,2019-11-05,147,1988,1679,1,3815
637,2019-11-06,1129,13788,950,2,15869
637,2019-11-07,168,25545,865,3,26581
637,2019-11-08,77,11456,2271,0,13804
637,2019-11-09,653,12188,3107,0,15948
637,2019-11-10,404,12473,1907,2,14786
637,2019-11-11,75,14682,1419,0,16176
637,2019-11-12,696,12654,2951,3,16304
637,2019-11-13,395,19616,1695,4,21710
637,2019-11-14,79,14866,1786,0,16731
637,2019-11-15,67,3550,2104,1,5722
637,2019-11-16,1888,1178,1882,1,4949
637,2019-11-17,76,2647,3673,0,6396
637,2019-11-18,101,1488,3322,3,4914
637,2019-11-19,1268,3110,2792,0,7170
637,2019-11-20,202,1235,1273,0,2710
637,2019-11-21,110,5935,2016,1,8062
637,2019-11-22,550,5320,1689,2,7561
637,2019-11-23,102,6042,2044,3,8191
637,2019-11-24,1501,8055,2668,0,12224
637,2019-11-25,920,5913,1602,0,8435
637,2019-11-26,389,6250,2387,0,9026
637,2019-11-27,1171,5648,1071,2,7892
637,2019-11-28,256,8910,502,1,9669
638,2019-08-01,52,14313,77,0,14442
638,2019-08-02,114,20757,134,0,21005
638,2019-08-03,186,5868,319,0,6373
638,2019-08-04,75,2058,291,1,2425
638,2019-08-05,267,2066,120,2,2455
638,2019-08-06,90,2036,197,0,2323
638,2019-08-07,63,2160,373,1,2597
638,2019-08-08,247,1066,350,0,1663
638,2019-08-09,216,4111,211,1,4539
638,2019-08-10,87,1433,321,0,1841
638,2019-08-11,282,5348,448,1,6079
638,2019-08-12,64,1699,21,0,1784
638,2019-08-13,222,2410,125,0,2757
638,2019-08-14,221,1843,38,1,2103
638,2019-08-15,64,1839,13,0,1916
638,2019-08-16,72,5814,178,2,6066
638,2019-08-17,189,3657,706,2,4554
638,2019-08-18,76,3199,1600,0,4875
638,2019-08-19,54,6728,0,0,6782
638,2019-08-20,0,0,0,0,0
638,2019-08-21,0,0,0,0,0
638,2019-08-22,0,0,0,0,0
638,2019-08-23,0,0,0,0,0
638,2019-08-24,3,143,1170,0,1316
638,2019-08-25,136,962,2351,2,3451
638,2019-08-26,94,750,1375,1,2220
638,2019-08-27,86,666,1741,3,2496
638,2019-08-28,922,756,1720,1,3399
638,2019-08-29,196,1207,1003,0,2406
638,2019-08-30,70,735,790,1,1596
638,2019-08-31,62,391,4,0,457
638,2019-09-01,56,298,530,2,886
638,2019-09-02,69,187,74,0,330
638,2019-09-03,101,12425,1212,1,13739
638,2019-09-04,957,47359,2649,2,50967
638,2019-09-05,88,229,2160,3,2480
638,2019-09-06,134,4510,1914,4,6562
638,2019-09-07,112,382,1598,1,2093
638,2019-09-08,1083,2385,1422,2,4892
638,2019-09-09,965,390,1935,1,3291
638,2019-09-10,131,388,2009,37,2565
638,2019-09-11,118,429,2637,31,3215
638,2019-09-12,79,413,1365,2,1859
638,2019-09-13,199,354,2437,1,2991
638,2019-09-14,161,494,2430,2,3087
638,2019-09-15,86,766,2639,1,3492
638,2019-09-16,911,445,208621,5,209982
638,2019-09-17,262,314,1724,7,2307
638,2019-09-18,75,585,1673,9,2342
638,2019-09-19,261,2036,1272,8,3577
638,2019-09-20,195,7919,1834,33,9981
638,2019-09-21,82,8035,2434,50,10601
638,2019-09-22,78,9739,1489,10,11316
638,2019-09-23,152,18124,1896,10,20182
638,2019-09-24,131,35826,2252,14,38223
638,2019-09-25,1140,13352,2291,8,16791
638,2019-09-26,121,9497,1528,12,11158
638,2019-09-27,106,9481,1895,3,11485
638,2019-09-28,123,14734,2031,3,16891
638,2019-09-29,362,17840,1270,1,19473
638,2019-09-30,177,16394,1887,12,18470
638,2019-10-01,494,20340,1582,7,22423
638,2019-10-02,953,13292,1379,6,15630
638,2019-10-03,98,22455,1908,11,24472
638,2019-10-04,96,14430,1584,9,16119
638,2019-10-05,115,13846,1696,11,15668
638,2019-10-06,798,8418,1814,12,11042
638,2019-10-07,118,4919,1854,11,6902
638,2019-10-08,133,17361,2198,10,19702
638,2019-10-09,117,33948,1713,11,35789
638,2019-10-10,119,40010,1297,12,41438
638,2019-10-11,84,14425,1831,10,16350
638,2019-10-12,1009,5980,1978,2,8969
638,2019-10-13,1967,5693,1404,2,9066
638,2019-10-14,3844,7049,2118,0,13011
638,2019-10-15,500,7203,2226,0,9929
638,2019-10-16,125,12723,969,2,13819
638,2019-10-17,161,16724,1562,1,18448
638,2019-10-18,170,36330,1938,0,38438
638,2019-10-19,102,7690,1765,0,9557
638,2019-10-20,1885,1176,2180,4,5245
638,2019-10-21,107,9786,2119,9,12021
638,2019-10-22,103,6252,1866,1,8222
638,2019-10-23,89,7349,1441,2,8881
638,2019-10-24,107,12752,1610,1,14470
638,2019-10-25,265,10262,1567,2,12096
638,2019-10-26,857,21350,1035,2,23244
638,2019-10-27,126,20510,737,0,21373
638,2019-10-28,98,13498,2769,0,16365
638,2019-10-29,1080,26119,1734,2,28935
638,2019-10-30,559,23276,1674,11,25520
638,2019-10-31,166,19892,1932,15,22005
638,2019-11-01,483,26948,1242,0,28673
638,2019-11-02,109,16167,1330,3,17609
638,2019-11-03,1747,36531,1380,1,39659
638,2019-11-04,913,10191,1823,0,12927
638,2019-11-05,166,1945,1833,1,3945
638,2019-11-06,737,10234,1105,0,12076
638,2019-11-07,318,13291,1304,0,14913
638,2019-11-08,146,9590,1404,0,11140
638,2019-11-09,120,8595,1272,0,9987
638,2019-11-10,120,13626,1276,0,15022
638,2019-11-11,156,12776,1060,0,13992
638,2019-11-12,148,12584,3435,0,16167
638,2019-11-13,639,11609,1610,0,13858
638,2019-11-14,533,8577,1840,0,10950
638,2019-11-15,165,5507,3671,0,9343
638,2019-11-16,128,2972,3005,0,6105
638,2019-11-17,184,3952,4352,0,8488
638,2019-11-18,154,3911,3904,0,7969
638,2019-11-19,212,10716,2769,1,13698
638,2019-11-20,140,1806,2487,2,4435
638,2019-11-21,126,4286,2086,1,6499
638,2019-11-22,627,5866,1412,1,7906
638,2019-11-23,123,6439,2275,2,8839
638,2019-11-24,147,7059,2067,1,9274
638,2019-11-25,139,7502,2476,0,10117
638,2019-11-26,137,7206,2148,1,9492
638,2019-11-27,91,6800,1458,0,8349
638,2019-11-28,107,13066,654,2,13829
638,2019-11-29,19,943,21,0,983
638,2019-08-01,52,14313,77,0,14442
638,2019-08-02,114,20757,134,0,21005
638,2019-08-03,186,5868,319,0,6373
638,2019-08-04,75,2058,291,1,2425
638,2019-08-05,267,2066,120,2,2455
638,2019-08-06,90,2036,197,0,2323
638,2019-08-07,63,2160,373,1,2597
638,2019-08-08,247,1066,350,0,1663
638,2019-08-09,216,4111,211,1,4539
638,2019-08-10,87,1433,321,0,1841
638,2019-08-11,282,5348,448,1,6079
638,2019-08-12,64,1699,21,0,1784
638,2019-08-13,222,2410,125,0,2757
638,2019-08-14,221,1843,38,1,2103
638,2019-08-15,64,1839,13,0,1916
638,2019-08-16,72,5814,178,2,6066
638,2019-08-17,189,3657,706,2,4554
638,2019-08-18,76,3199,1600,0,4875
638,2019-08-19,54,6728,0,0,6782
638,2019-08-20,0,0,0,0,0
638,2019-08-21,0,0,0,0,0
638,2019-08-22,0,0,0,0,0
638,2019-08-23,0,0,0,0,0
638,2019-08-24,3,143,1170,0,1316
638,2019-08-25,136,962,2351,2,3451
638,2019-08-26,94,750,1375,1,2220
638,2019-08-27,86,666,1741,3,2496
638,2019-08-28,922,756,1720,1,3399
638,2019-08-29,196,1207,1003,0,2406
638,2019-08-30,70,735,790,1,1596
638,2019-08-31,62,391,4,0,457
638,2019-09-01,56,298,530,2,886
638,2019-09-02,69,187,74,0,330
638,2019-09-03,101,12425,1212,1,13739
638,2019-09-04,957,47359,2649,2,50967
638,2019-09-05,88,229,2160,3,2480
638,2019-09-06,134,4510,1914,4,6562
638,2019-09-07,112,382,1598,1,2093
638,2019-09-08,1083,2385,1422,2,4892
638,2019-09-09,965,390,1935,1,3291
638,2019-09-10,131,388,2009,37,2565
638,2019-09-11,118,429,2637,31,3215
638,2019-09-12,79,413,1365,2,1859
638,2019-09-13,199,354,2437,1,2991
638,2019-09-14,161,494,2430,2,3087
638,2019-09-15,86,766,2639,1,3492
638,2019-09-16,911,445,208621,5,209982
638,2019-09-17,262,314,1724,7,2307
638,2019-09-18,75,585,1673,9,2342
638,2019-09-19,261,2036,1272,8,3577
638,2019-09-20,195,7919,1834,33,9981
638,2019-09-21,82,8035,2434,50,10601
638,2019-09-22,78,9739,1489,10,11316
638,2019-09-23,152,18124,1896,10,20182
638,2019-09-24,131,35826,2252,14,38223
638,2019-09-25,1140,13352,2291,8,16791
638,2019-09-26,121,9497,1528,12,11158
638,2019-09-27,106,9481,1895,3,11485
638,2019-09-28,123,14734,2031,3,16891
638,2019-09-29,362,17840,1270,1,19473
638,2019-09-30,177,16394,1887,12,18470
638,2019-10-01,494,20340,1582,7,22423
638,2019-10-02,953,13292,1379,6,15630
638,2019-10-03,98,22455,1908,11,24472
638,2019-10-04,96,14430,1584,9,16119
638,2019-10-05,115,13846,1696,11,15668
638,2019-10-06,798,8418,1814,12,11042
638,2019-10-07,118,4919,1854,11,6902
638,2019-10-08,133,17361,2198,10,19702
638,2019-10-09,117,33948,1713,11,35789
638,2019-10-10,119,40010,1297,12,41438
638,2019-10-11,84,14425,1831,10,16350
638,2019-10-12,1009,5980,1978,2,8969
638,2019-10-13,1967,5693,1404,2,9066
638,2019-10-14,3844,7049,2118,0,13011
638,2019-10-15,500,7203,2226,0,9929
638,2019-10-16,125,12723,969,2,13819
638,2019-10-17,161,16724,1562,1,18448
638,2019-10-18,170,36330,1938,0,38438
638,2019-10-19,102,7690,1765,0,9557
638,2019-10-20,1885,1176,2180,4,5245
638,2019-10-21,107,9786,2119,9,12021
638,2019-10-22,103,6252,1866,1,8222
638,2019-10-23,89,7349,1441,2,8881
638,2019-10-24,107,12752,1610,1,14470
638,2019-10-25,265,10262,1567,2,12096
638,2019-10-26,857,21350,1035,2,23244
638,2019-10-27,126,20510,737,0,21373
638,2019-10-28,98,13498,2769,0,16365
638,2019-10-29,1080,26119,1734,2,28935
638,2019-10-30,559,23276,1674,11,25520
638,2019-10-31,166,19892,1932,15,22005
638,2019-11-01,483,26948,1242,0,28673
638,2019-11-02,109,16167,1330,3,17609
638,2019-11-03,1747,36531,1380,1,39659
638,2019-11-04,913,10191,1823,0,12927
638,2019-11-05,166,1945,1833,1,3945
638,2019-11-06,737,10234,1105,0,12076
638,2019-11-07,318,13291,1304,0,14913
638,2019-11-08,146,9590,1404,0,11140
638,2019-11-09,120,8595,1272,0,9987
638,2019-11-10,120,13626,1276,0,15022
638,2019-11-11,156,12776,1060,0,13992
638,2019-11-12,148,12584,3435,0,16167
638,2019-11-13,639,11609,1610,0,13858
638,2019-11-14,533,8577,1840,0,10950
638,2019-11-15,165,5507,3671,0,9343
638,2019-11-16,128,2972,3005,0,6105
638,2019-11-17,184,3952,4352,0,8488
638,2019-11-18,154,3911,3904,0,7969
638,2019-11-19,212,10716,2769,1,13698
638,2019-11-20,140,1806,2487,2,4435
638,2019-11-21,126,4286,2086,1,6499
638,2019-11-22,627,5866,1412,1,7906
638,2019-11-23,123,6439,2275,2,8839
638,2019-11-24,147,7059,2067,1,9274
638,2019-11-25,139,7502,2476,0,10117
638,2019-11-26,137,7206,2148,1,9492
638,2019-11-27,91,6800,1458,0,8349
638,2019-11-28,107,13066,654,2,13829
638,2019-11-29,19,943,21,0,983
638,2019-08-01,52,14313,77,0,14442
638,2019-08-02,114,20757,134,0,21005
638,2019-08-03,186,5868,319,0,6373
638,2019-08-04,75,2058,291,1,2425
638,2019-08-05,267,2066,120,2,2455
638,2019-08-06,90,2036,197,0,2323
638,2019-08-07,63,2160,373,1,2597
638,2019-08-08,247,1066,350,0,1663
638,2019-08-09,216,4111,211,1,4539
638,2019-08-10,87,1433,321,0,1841
638,2019-08-11,282,5348,448,1,6079
638,2019-08-12,64,1699,21,0,1784
638,2019-08-13,222,2410,125,0,2757
638,2019-08-14,221,1843,38,1,2103
638,2019-08-15,64,1839,13,0,1916
638,2019-08-16,72,5814,178,2,6066
638,2019-08-17,189,3657,706,2,4554
638,2019-08-18,76,3199,1600,0,4875
638,2019-08-19,54,6728,0,0,6782
638,2019-08-20,0,0,0,0,0
638,2019-08-21,0,0,0,0,0
638,2019-08-22,0,0,0,0,0
638,2019-08-23,0,0,0,0,0
638,2019-08-24,3,143,1170,0,1316
638,2019-08-25,136,962,2351,2,3451
638,2019-08-26,94,750,1375,1,2220
638,2019-08-27,86,666,1741,3,2496
638,2019-08-28,922,756,1720,1,3399
638,2019-08-29,196,1207,1003,0,2406
638,2019-08-30,70,735,790,1,1596
638,2019-08-31,62,391,4,0,457
638,2019-09-01,56,298,530,2,886
638,2019-09-02,69,187,74,0,330
638,2019-09-03,101,12425,1212,1,13739
638,2019-09-04,957,47359,2649,2,50967
638,2019-09-05,88,229,2160,3,2480
638,2019-09-06,134,4510,1914,4,6562
638,2019-09-07,112,382,1598,1,2093
638,2019-09-08,1083,2385,1422,2,4892
638,2019-09-09,965,390,1935,1,3291
638,2019-09-10,131,388,2009,37,2565
638,2019-09-11,118,429,2637,31,3215
638,2019-09-12,79,413,1365,2,1859
638,2019-09-13,199,354,2437,1,2991
638,2019-09-14,161,494,2430,2,3087
638,2019-09-15,86,766,2639,1,3492
638,2019-09-16,911,445,208621,5,209982
638,2019-09-17,262,314,1724,7,2307
638,2019-09-18,75,585,1673,9,2342
638,2019-09-19,261,2036,1272,8,3577
638,2019-09-20,195,7919,1834,33,9981
638,2019-09-21,82,8035,2434,50,10601
638,2019-09-22,78,9739,1489,10,11316
638,2019-09-23,152,18124,1896,10,20182
638,2019-09-24,131,35826,2252,14,38223
638,2019-09-25,1140,13352,2291,8,16791
638,2019-09-26,121,9497,1528,12,11158
638,2019-09-27,106,9481,1895,3,11485
638,2019-09-28,123,14734,2031,3,16891
638,2019-09-29,362,17840,1270,1,19473
638,2019-09-30,177,16394,1887,12,18470
638,2019-10-01,494,20340,1582,7,22423
638,2019-10-02,953,13292,1379,6,15630
638,2019-10-03,98,22455,1908,11,24472
638,2019-10-04,96,14430,1584,9,16119
638,2019-10-05,115,13846,1696,11,15668
638,2019-10-06,798,8418,1814,12,11042
638,2019-10-07,118,4919,1854,11,6902
638,2019-10-08,133,17361,2198,10,19702
638,2019-10-09,117,33948,1713,11,35789
638,2019-10-10,119,40010,1297,12,41438
638,2019-10-11,84,14425,1831,10,16350
638,2019-10-12,1009,5980,1978,2,8969
638,2019-10-13,1967,5693,1404,2,9066
638,2019-10-14,3844,7049,2118,0,13011
638,2019-10-15,500,7203,2226,0,9929
638,2019-10-16,125,12723,969,2,13819
638,2019-10-17,161,16724,1562,1,18448
638,2019-10-18,170,36330,1938,0,38438
638,2019-10-19,102,7690,1765,0,9557
638,2019-10-20,1885,1176,2180,4,5245
638,2019-10-21,107,9786,2119,9,12021
638,2019-10-22,103,6252,1866,1,8222
638,2019-10-23,89,7349,1441,2,8881
638,2019-10-24,107,12752,1610,1,14470
638,2019-10-25,265,10262,1567,2,12096
638,2019-10-26,857,21350,1035,2,23244
638,2019-10-27,126,20510,737,0,21373
638,2019-10-28,98,13498,2769,0,16365
638,2019-10-29,1080,26119,1734,2,28935
638,2019-10-30,559,23276,1674,11,25520
638,2019-10-31,166,19892,1932,15,22005
638,2019-11-01,483,26948,1242,0,28673
638,2019-11-02,109,16167,1330,3,17609
638,2019-11-03,1747,36531,1380,1,39659
638,2019-11-04,913,10191,1823,0,12927
638,2019-11-05,166,1945,1833,1,3945
638,2019-11-06,737,10234,1105,0,12076
638,2019-11-07,318,13291,1304,0,14913
638,2019-11-08,146,9590,1404,0,11140
638,2019-11-09,120,8595,1272,0,9987
638,2019-11-10,120,13626,1276,0,15022
638,2019-11-11,156,12776,1060,0,13992
638,2019-11-12,148,12584,3435,0,16167
638,2019-11-13,639,11609,1610,0,13858
638,2019-11-14,533,8577,1840,0,10950
638,2019-11-15,165,5507,3671,0,9343
638,2019-11-16,128,2972,3005,0,6105
638,2019-11-17,184,3952,4352,0,8488
638,2019-11-18,154,3911,3904,0,7969
638,2019-11-19,212,10716,2769,1,13698
638,2019-11-20,140,1806,2487,2,4435
638,2019-11-21,126,4286,2086,1,6499
638,2019-11-22,627,5866,1412,1,7906
638,2019-11-23,123,6439,2275,2,8839
638,2019-11-24,147,7059,2067,1,9274
638,2019-11-25,139,7502,2476,0,10117
638,2019-11-26,137,7206,2148,1,9492
638,2019-11-27,91,6800,1458,0,8349
638,2019-11-28,107,13066,654,2,13829
638,2019-11-29,19,943,21,0,983
638,2019-08-04,75,2058,291,1,2425
638,2019-08-05,267,2066,120,2,2455
638,2019-08-06,90,2036,197,0,2323
638,2019-08-07,63,2160,373,1,2597
638,2019-08-08,247,1066,350,0,1663
638,2019-08-09,216,4111,211,1,4539
638,2019-08-10,87,1433,321,0,1841
638,2019-08-11,282,5348,448,1,6079
638,2019-08-12,64,1699,21,0,1784
638,2019-08-13,222,2410,125,0,2757
638,2019-08-14,221,1843,38,1,2103
638,2019-08-15,64,1839,13,0,1916
638,2019-08-16,72,5814,178,2,6066
638,2019-08-17,189,3657,706,2,4554
638,2019-08-18,76,3199,1600,0,4875
638,2019-08-19,54,6728,0,0,6782
638,2019-08-20,0,0,0,0,0
638,2019-08-21,0,0,0,0,0
638,2019-08-22,0,0,0,0,0
638,2019-08-23,0,0,0,0,0
638,2019-08-24,3,143,1170,0,1316
638,2019-08-25,136,962,2351,2,3451
638,2019-08-26,94,750,1375,1,2220
638,2019-08-27,86,666,1741,3,2496
638,2019-08-28,922,756,1720,1,3399
638,2019-08-29,196,1207,1003,0,2406
638,2019-08-30,70,735,790,1,1596
638,2019-08-31,62,391,4,0,457
638,2019-09-01,56,298,530,2,886
638,2019-09-02,69,187,74,0,330
638,2019-09-03,101,12425,1212,1,13739
638,2019-09-04,957,47359,2649,2,50967
638,2019-09-05,88,229,2160,3,2480
638,2019-09-06,134,4510,1914,4,6562
638,2019-09-07,112,382,1598,1,2093
638,2019-09-08,1083,2385,1422,2,4892
638,2019-09-09,965,390,1935,1,3291
638,2019-09-10,131,388,2009,37,2565
638,2019-09-11,118,429,2637,31,3215
638,2019-09-12,79,413,1365,2,1859
638,2019-09-13,199,354,2437,1,2991
638,2019-09-14,161,494,2430,2,3087
638,2019-09-15,86,766,2639,1,3492
638,2019-09-16,911,445,208621,5,209982
638,2019-09-17,262,314,1724,7,2307
638,2019-09-18,75,585,1673,9,2342
638,2019-09-19,261,2036,1272,8,3577
638,2019-09-20,195,7919,1834,33,9981
638,2019-09-21,82,8035,2434,50,10601
638,2019-09-22,78,9739,1489,10,11316
638,2019-09-23,152,18124,1896,10,20182
638,2019-09-24,131,35826,2252,14,38223
638,2019-09-25,1140,13352,2291,8,16791
638,2019-09-26,121,9497,1528,12,11158
638,2019-09-27,106,9481,1895,3,11485
638,2019-09-28,123,14734,2031,3,16891
638,2019-09-29,362,17840,1270,1,19473
638,2019-09-30,177,16394,1887,12,18470
638,2019-10-01,494,20340,1582,7,22423
638,2019-10-02,953,13292,1379,6,15630
638,2019-10-03,98,22455,1908,11,24472
638,2019-10-04,96,14430,1584,9,16119
638,2019-10-05,115,13846,1696,11,15668
638,2019-10-06,798,8418,1814,12,11042
638,2019-10-07,118,4919,1854,11,6902
638,2019-10-08,133,17361,2198,10,19702
638,2019-10-09,117,33948,1713,11,35789
638,2019-10-10,119,40010,1297,12,41438
638,2019-10-11,84,14425,1831,10,16350
638,2019-10-12,1009,5980,1978,2,8969
638,2019-10-13,1967,5693,1404,2,9066
638,2019-10-14,3844,7049,2118,0,13011
638,2019-10-15,500,7203,2226,0,9929
638,2019-10-16,125,12723,969,2,13819
638,2019-10-17,161,16724,1562,1,18448
638,2019-10-18,170,36330,1938,0,38438
638,2019-10-19,102,7690,1765,0,9557
638,2019-10-20,1885,1176,2180,4,5245
638,2019-10-21,107,9786,2119,9,12021
638,2019-10-22,103,6252,1866,1,8222
638,2019-10-23,89,7349,1441,2,8881
638,2019-10-24,107,12752,1610,1,14470
638,2019-10-25,265,10262,1567,2,12096
638,2019-10-26,857,21350,1035,2,23244
638,2019-10-27,126,20510,737,0,21373
638,2019-10-28,98,13498,2769,0,16365
638,2019-10-29,1080,26119,1734,2,28935
638,2019-10-30,559,23276,1674,11,25520
638,2019-10-31,166,19892,1932,15,22005
638,2019-11-01,483,26948,1242,0,28673
638,2019-11-02,109,16167,1330,3,17609
638,2019-11-03,1747,36531,1380,1,39659
638,2019-11-04,913,10191,1823,0,12927
638,2019-11-05,166,1945,1833,1,3945
638,2019-11-06,737,10234,1105,0,12076
638,2019-11-07,318,13291,1304,0,14913
638,2019-11-08,146,9590,1404,0,11140
638,2019-11-09,120,8595,1272,0,9987
638,2019-11-10,120,13626,1276,0,15022
638,2019-11-11,156,12776,1060,0,13992
638,2019-11-12,148,12584,3435,0,16167
638,2019-11-13,639,11609,1610,0,13858
638,2019-11-14,533,8577,1840,0,10950
638,2019-11-15,165,5507,3671,0,9343
638,2019-11-16,128,2972,3005,0,6105
638,2019-11-17,184,3952,4352,0,8488
638,2019-11-18,154,3911,3904,0,7969
638,2019-11-19,212,10716,2769,1,13698
638,2019-11-20,140,1806,2487,2,4435
638,2019-11-21,126,4286,2086,1,6499
638,2019-11-22,627,5866,1412,1,7906
638,2019-11-23,123,6439,2275,2,8839
638,2019-11-24,147,7059,2067,1,9274
638,2019-11-25,139,7502,2476,0,10117
638,2019-11-26,137,7206,2148,1,9492
638,2019-11-27,91,6800,1458,0,8349
638,2019-11-28,107,13066,654,2,13829
639,2019-08-01,31,38016,551,1,38599
639,2019-08-02,61,37787,627,1,38476
639,2019-08-03,248,9737,421,0,10406
639,2019-08-04,46,1075,368,2,1491
639,2019-08-05,53,1203,464,0,1720
639,2019-08-06,74,5092,307,1,5474
639,2019-08-07,299,3460,417,1,4177
639,2019-08-08,43,1279,245,1,1568
639,2019-08-09,66,1359,193,0,1618
639,2019-08-10,89,1406,406,0,1901
639,2019-08-11,42,5345,159,0,5546
639,2019-08-12,24,1714,50,0,1788
639,2019-08-13,133,4689,136,0,4958
639,2019-08-14,79,6173,173,0,6425
639,2019-08-15,27,1068,80,1,1176
639,2019-08-16,61,1873,74,1,2009
639,2019-08-17,139,3719,637,0,4495
639,2019-08-18,71,5509,1373,0,6953
639,2019-08-19,244,17841,1181,0,19266
639,2019-08-20,465,20214,1298,0,21977
639,2019-08-21,256,13243,1733,0,15232
639,2019-08-22,51,18810,968,1,19830
639,2019-08-23,177,9833,1281,0,11291
639,2019-08-24,72,13758,1330,5,15165
639,2019-08-25,50,31195,1446,1,32692
639,2019-08-26,59,28164,1572,1,29796
639,2019-08-27,335,9096,2159,1,11591
639,2019-08-28,58,38308,1800,3,40169
639,2019-08-29,137,21872,1097,1,23107
639,2019-08-30,29,3644,735,1,4409
639,2019-08-31,24,431,37,0,492
639,2019-09-01,38,1657,404,0,2099
639,2019-09-02,21,1507,13,1,1542
639,2019-09-03,65,5181,1392,2,6640
639,2019-09-04,854,12845,1925,0,15624
639,2019-09-05,86,7037,2587,2,9712
639,2019-09-06,137,17380,2265,0,19782
639,2019-09-07,188,8234,1931,3,10356
639,2019-09-08,210,5981,2656,0,8847
639,2019-09-09,941,10385,1827,1,13154
639,2019-09-10,93,10180,1879,1,12153
639,2019-09-11,100,6648,1453,2,8203
639,2019-09-12,898,9764,2122,1,12785
639,2019-09-13,928,7231,2322,1,10482
639,2019-09-14,1728,7609,2249,0,11586
639,2019-09-15,55,11186,1374,2,12617
639,2019-09-16,61,14273,1560,2,15896
639,2019-09-17,76,9030,1510,1,10617
639,2019-09-18,64,11814,1573,0,13451
639,2019-09-19,365,4467,1080,2,5914
639,2019-09-20,181,8946,2069,2,11198
639,2019-09-21,933,8675,1331,0,10939
639,2019-09-22,93,9702,1784,1,11580
639,2019-09-23,1516,10079,1646,2,13243
639,2019-09-24,98,9985,1314,2,11399
639,2019-09-25,148,10139,1219,2,11508
639,2019-09-26,89,10822,1903,0,12814
639,2019-09-27,70,10526,1238,3,11837
639,2019-09-28,73,16141,1457,3,17674
639,2019-09-29,45,17518,2182,1,19746
639,2019-09-30,959,16927,1811,0,19697
639,2019-10-01,1235,16958,2310,0,20503
639,2019-10-02,73,10843,1674,0,12590
639,2019-10-03,661,14764,1564,2,16991
639,2019-10-04,149,13073,1792,0,15014
639,2019-10-05,630,15298,816,1,16745
639,2019-10-06,2059,11258,1639,2,14958
639,2019-10-07,91,6961,954,12,8018
639,2019-10-08,126,11209,1757,4,13096
639,2019-10-09,98,15612,1444,1,17155
639,2019-10-10,287,11812,1148,2,13249
639,2019-10-11,318,10476,1517,1,12312
639,2019-10-12,952,8489,1557,0,10998
639,2019-10-13,89,7570,2004,4,9667
639,2019-10-14,78,12840,1838,0,14756
639,2019-10-15,214,10185,1640,2,12041
639,2019-10-16,182,13609,1553,3,15347
639,2019-10-17,84,6133,1686,5,7908
639,2019-10-18,97,9330,1887,1,11315
639,2019-10-19,960,6788,2112,0,9860
639,2019-10-20,63,5890,1947,1,7901
639,2019-10-21,1015,11566,1161,2,13744
639,2019-10-22,73,7013,2261,0,9347
639,2019-10-23,53,16446,1466,4,17969
639,2019-10-24,553,19222,1394,1,21170
639,2019-10-25,103,13319,1426,2,14850
639,2019-10-26,67,14930,1917,0,16914
639,2019-10-27,101,17008,1357,1,18467
639,2019-10-28,922,14637,1393,0,16952
639,2019-10-29,127,16141,1242,0,17510
639,2019-10-30,73,17245,1294,0,18612
639,2019-10-31,55,14020,1572,0,15647
639,2019-11-01,1274,26472,1873,0,29619
639,2019-11-02,40,27160,2483,3,29686
639,2019-11-03,872,40027,1083,1,41983
639,2019-11-04,985,11593,1787,0,14365
639,2019-11-05,100,4257,2006,0,6363
639,2019-11-06,148,11192,1389,621,13350
639,2019-11-07,544,22848,1096,0,24488
639,2019-11-08,80,18464,1490,0,20034
639,2019-11-09,96,16637,1317,0,18050
639,2019-11-10,66,15788,1562,0,17416
639,2019-11-11,1020,10486,1054,0,12560
639,2019-11-12,557,11822,3350,0,15729
639,2019-11-13,175,22983,1597,0,24755
639,2019-11-14,1019,10778,2247,0,14044
639,2019-11-15,72,4161,3342,0,7575
639,2019-11-16,66,2800,3194,0,6060
639,2019-11-17,896,3993,4168,0,9057
639,2019-11-18,385,3315,4019,0,7719
639,2019-11-19,135,5633,2372,0,8140
639,2019-11-20,189,1771,1836,0,3796
639,2019-11-21,105,6104,2222,0,8431
639,2019-11-22,111,5701,1568,4,7384
639,2019-11-23,75,10195,2043,1,12314
639,2019-11-24,90,9896,1889,0,11875
639,2019-11-25,104,12343,1280,0,13727
639,2019-11-26,63,7166,1767,0,8996
639,2019-11-27,65,6921,1965,3,8954
639,2019-11-28,50,9193,603,0,9846
639,2019-11-29,32,1001,2,0,1035
639,2019-08-01,31,38016,551,1,38599
639,2019-08-02,61,37787,627,1,38476
639,2019-08-03,248,9737,421,0,10406
639,2019-08-04,46,1075,368,2,1491
639,2019-08-05,53,1203,464,0,1720
639,2019-08-06,74,5092,307,1,5474
639,2019-08-07,299,3460,417,1,4177
639,2019-08-08,43,1279,245,1,1568
639,2019-08-09,66,1359,193,0,1618
639,2019-08-10,89,1406,406,0,1901
639,2019-08-11,42,5345,159,0,5546
639,2019-08-12,24,1714,50,0,1788
639,2019-08-13,133,4689,136,0,4958
639,2019-08-14,79,6173,173,0,6425
639,2019-08-15,27,1068,80,1,1176
639,2019-08-16,61,1873,74,1,2009
639,2019-08-17,139,3719,637,0,4495
639,2019-08-18,71,5509,1373,0,6953
639,2019-08-19,244,17841,1181,0,19266
639,2019-08-20,465,20214,1298,0,21977
639,2019-08-21,256,13243,1733,0,15232
639,2019-08-22,51,18810,968,1,19830
639,2019-08-23,177,9833,1281,0,11291
639,2019-08-24,72,13758,1330,5,15165
639,2019-08-25,50,31195,1446,1,32692
639,2019-08-26,59,28164,1572,1,29796
639,2019-08-27,335,9096,2159,1,11591
639,2019-08-28,58,38308,1800,3,40169
639,2019-08-29,137,21872,1097,1,23107
639,2019-08-30,29,3644,735,1,4409
639,2019-08-31,24,431,37,0,492
639,2019-09-01,38,1657,404,0,2099
639,2019-09-02,21,1507,13,1,1542
639,2019-09-03,65,5181,1392,2,6640
639,2019-09-04,854,12845,1925,0,15624
639,2019-09-05,86,7037,2587,2,9712
639,2019-09-06,137,17380,2265,0,19782
639,2019-09-07,188,8234,1931,3,10356
639,2019-09-08,210,5981,2656,0,8847
639,2019-09-09,941,10385,1827,1,13154
639,2019-09-10,93,10180,1879,1,12153
639,2019-09-11,100,6648,1453,2,8203
639,2019-09-12,898,9764,2122,1,12785
639,2019-09-13,928,7231,2322,1,10482
639,2019-09-14,1728,7609,2249,0,11586
639,2019-09-15,55,11186,1374,2,12617
639,2019-09-16,61,14273,1560,2,15896
639,2019-09-17,76,9030,1510,1,10617
639,2019-09-18,64,11814,1573,0,13451
639,2019-09-19,365,4467,1080,2,5914
639,2019-09-20,181,8946,2069,2,11198
639,2019-09-21,933,8675,1331,0,10939
639,2019-09-22,93,9702,1784,1,11580
639,2019-09-23,1516,10079,1646,2,13243
639,2019-09-24,98,9985,1314,2,11399
639,2019-09-25,148,10139,1219,2,11508
639,2019-09-26,89,10822,1903,0,12814
639,2019-09-27,70,10526,1238,3,11837
639,2019-09-28,73,16141,1457,3,17674
639,2019-09-29,45,17518,2182,1,19746
639,2019-09-30,959,16927,1811,0,19697
639,2019-10-01,1235,16958,2310,0,20503
639,2019-10-02,73,10843,1674,0,12590
639,2019-10-03,661,14764,1564,2,16991
639,2019-10-04,149,13073,1792,0,15014
639,2019-10-05,630,15298,816,1,16745
639,2019-10-06,2059,11258,1639,2,14958
639,2019-10-07,91,6961,954,12,8018
639,2019-10-08,126,11209,1757,4,13096
639,2019-10-09,98,15612,1444,1,17155
639,2019-10-10,287,11812,1148,2,13249
639,2019-10-11,318,10476,1517,1,12312
639,2019-10-12,952,8489,1557,0,10998
639,2019-10-13,89,7570,2004,4,9667
639,2019-10-14,78,12840,1838,0,14756
639,2019-10-15,214,10185,1640,2,12041
639,2019-10-16,182,13609,1553,3,15347
639,2019-10-17,84,6133,1686,5,7908
639,2019-10-18,97,9330,1887,1,11315
639,2019-10-19,960,6788,2112,0,9860
639,2019-10-20,63,5890,1947,1,7901
639,2019-10-21,1015,11566,1161,2,13744
639,2019-10-22,73,7013,2261,0,9347
639,2019-10-23,53,16446,1466,4,17969
639,2019-10-24,553,19222,1394,1,21170
639,2019-10-25,103,13319,1426,2,14850
639,2019-10-26,67,14930,1917,0,16914
639,2019-10-27,101,17008,1357,1,18467
639,2019-10-28,922,14637,1393,0,16952
639,2019-10-29,127,16141,1242,0,17510
639,2019-10-30,73,17245,1294,0,18612
639,2019-10-31,55,14020,1572,0,15647
639,2019-11-01,1274,26472,1873,0,29619
639,2019-11-02,40,27160,2483,3,29686
639,2019-11-03,872,40027,1083,1,41983
639,2019-11-04,985,11593,1787,0,14365
639,2019-11-05,100,4257,2006,0,6363
639,2019-11-06,148,11192,1389,621,13350
639,2019-11-07,544,22848,1096,0,24488
639,2019-11-08,80,18464,1490,0,20034
639,2019-11-09,96,16637,1317,0,18050
639,2019-11-10,66,15788,1562,0,17416
639,2019-11-11,1020,10486,1054,0,12560
639,2019-11-12,557,11822,3350,0,15729
639,2019-11-13,175,22983,1597,0,24755
639,2019-11-14,1019,10778,2247,0,14044
639,2019-11-15,72,4161,3342,0,7575
639,2019-11-16,66,2800,3194,0,6060
639,2019-11-17,896,3993,4168,0,9057
639,2019-11-18,385,3315,4019,0,7719
639,2019-11-19,135,5633,2372,0,8140
639,2019-11-20,189,1771,1836,0,3796
639,2019-11-21,105,6104,2222,0,8431
639,2019-11-22,111,5701,1568,4,7384
639,2019-11-23,75,10195,2043,1,12314
639,2019-11-24,90,9896,1889,0,11875
639,2019-11-25,104,12343,1280,0,13727
639,2019-11-26,63,7166,1767,0,8996
639,2019-11-27,65,6921,1965,3,8954
639,2019-11-28,50,9193,603,0,9846
639,2019-11-29,32,1001,2,0,1035
639,2019-08-01,31,38016,551,1,38599
639,2019-08-02,61,37787,627,1,38476
639,2019-08-03,248,9737,421,0,10406
639,2019-08-04,46,1075,368,2,1491
639,2019-08-05,53,1203,464,0,1720
639,2019-08-06,74,5092,307,1,5474
639,2019-08-07,299,3460,417,1,4177
639,2019-08-08,43,1279,245,1,1568
639,2019-08-09,66,1359,193,0,1618
639,2019-08-10,89,1406,406,0,1901
639,2019-08-11,42,5345,159,0,5546
639,2019-08-12,24,1714,50,0,1788
639,2019-08-13,133,4689,136,0,4958
639,2019-08-14,79,6173,173,0,6425
639,2019-08-15,27,1068,80,1,1176
639,2019-08-16,61,1873,74,1,2009
639,2019-08-17,139,3719,637,0,4495
639,2019-08-18,71,5509,1373,0,6953
639,2019-08-19,244,17841,1181,0,19266
639,2019-08-20,465,20214,1298,0,21977
639,2019-08-21,256,13243,1733,0,15232
639,2019-08-22,51,18810,968,1,19830
639,2019-08-23,177,9833,1281,0,11291
639,2019-08-24,72,13758,1330,5,15165
639,2019-08-25,50,31195,1446,1,32692
639,2019-08-26,59,28164,1572,1,29796
639,2019-08-27,335,9096,2159,1,11591
639,2019-08-28,58,38308,1800,3,40169
639,2019-08-29,137,21872,1097,1,23107
639,2019-08-30,29,3644,735,1,4409
639,2019-08-31,24,431,37,0,492
639,2019-09-01,38,1657,404,0,2099
639,2019-09-02,21,1507,13,1,1542
639,2019-09-03,65,5181,1392,2,6640
639,2019-09-04,854,12845,1925,0,15624
639,2019-09-05,86,7037,2587,2,9712
639,2019-09-06,137,17380,2265,0,19782
639,2019-09-07,188,8234,1931,3,10356
639,2019-09-08,210,5981,2656,0,8847
639,2019-09-09,941,10385,1827,1,13154
639,2019-09-10,93,10180,1879,1,12153
639,2019-09-11,100,6648,1453,2,8203
639,2019-09-12,898,9764,2122,1,12785
639,2019-09-13,928,7231,2322,1,10482
639,2019-09-14,1728,7609,2249,0,11586
639,2019-09-15,55,11186,1374,2,12617
639,2019-09-16,61,14273,1560,2,15896
639,2019-09-17,76,9030,1510,1,10617
639,2019-09-18,64,11814,1573,0,13451
639,2019-09-19,365,4467,1080,2,5914
639,2019-09-20,181,8946,2069,2,11198
639,2019-09-21,933,8675,1331,0,10939
639,2019-09-22,93,9702,1784,1,11580
639,2019-09-23,1516,10079,1646,2,13243
639,2019-09-24,98,9985,1314,2,11399
639,2019-09-25,148,10139,1219,2,11508
639,2019-09-26,89,10822,1903,0,12814
639,2019-09-27,70,10526,1238,3,11837
639,2019-09-28,73,16141,1457,3,17674
639,2019-09-29,45,17518,2182,1,19746
639,2019-09-30,959,16927,1811,0,19697
639,2019-10-01,1235,16958,2310,0,20503
639,2019-10-02,73,10843,1674,0,12590
639,2019-10-03,661,14764,1564,2,16991
639,2019-10-04,149,13073,1792,0,15014
639,2019-10-05,630,15298,816,1,16745
639,2019-10-06,2059,11258,1639,2,14958
639,2019-10-07,91,6961,954,12,8018
639,2019-10-08,126,11209,1757,4,13096
639,2019-10-09,98,15612,1444,1,17155
639,2019-10-10,287,11812,1148,2,13249
639,2019-10-11,318,10476,1517,1,12312
639,2019-10-12,952,8489,1557,0,10998
639,2019-10-13,89,7570,2004,4,9667
639,2019-10-14,78,12840,1838,0,14756
639,2019-10-15,214,10185,1640,2,12041
639,2019-10-16,182,13609,1553,3,15347
639,2019-10-17,84,6133,1686,5,7908
639,2019-10-18,97,9330,1887,1,11315
639,2019-10-19,960,6788,2112,0,9860
639,2019-10-20,63,5890,1947,1,7901
639,2019-10-21,1015,11566,1161,2,13744
639,2019-10-22,73,7013,2261,0,9347
639,2019-10-23,53,16446,1466,4,17969
639,2019-10-24,553,19222,1394,1,21170
639,2019-10-25,103,13319,1426,2,14850
639,2019-10-26,67,14930,1917,0,16914
639,2019-10-27,101,17008,1357,1,18467
639,2019-10-28,922,14637,1393,0,16952
639,2019-10-29,127,16141,1242,0,17510
639,2019-10-30,73,17245,1294,0,18612
639,2019-10-31,55,14020,1572,0,15647
639,2019-11-01,1274,26472,1873,0,29619
639,2019-11-02,40,27160,2483,3,29686
639,2019-11-03,872,40027,1083,1,41983
639,2019-11-04,985,11593,1787,0,14365
639,2019-11-05,100,4257,2006,0,6363
639,2019-11-06,148,11192,1389,621,13350
639,2019-11-07,544,22848,1096,0,24488
639,2019-11-08,80,18464,1490,0,20034
639,2019-11-09,96,16637,1317,0,18050
639,2019-11-10,66,15788,1562,0,17416
639,2019-11-11,1020,10486,1054,0,12560
639,2019-11-12,557,11822,3350,0,15729
639,2019-11-13,175,22983,1597,0,24755
639,2019-11-14,1019,10778,2247,0,14044
639,2019-11-15,72,4161,3342,0,7575
639,2019-11-16,66,2800,3194,0,6060
639,2019-11-17,896,3993,4168,0,9057
639,2019-11-18,385,3315,4019,0,7719
639,2019-11-19,135,5633,2372,0,8140
639,2019-11-20,189,1771,1836,0,3796
639,2019-11-21,105,6104,2222,0,8431
639,2019-11-22,111,5701,1568,4,7384
639,2019-11-23,75,10195,2043,1,12314
639,2019-11-24,90,9896,1889,0,11875
639,2019-11-25,104,12343,1280,0,13727
639,2019-11-26,63,7166,1767,0,8996
639,2019-11-27,65,6921,1965,3,8954
639,2019-11-28,50,9193,603,0,9846
639,2019-11-29,32,1001,2,0,1035
639,2019-08-01,31,38016,551,1,38599
639,2019-08-02,61,37787,627,1,38476
639,2019-08-03,248,9737,421,0,10406
639,2019-08-04,46,1075,368,2,1491
639,2019-08-05,53,1203,464,0,1720
639,2019-08-06,74,5092,307,1,5474
639,2019-08-07,299,3460,417,1,4177
639,2019-08-08,43,1279,245,1,1568
639,2019-08-09,66,1359,193,0,1618
639,2019-08-10,89,1406,406,0,1901
639,2019-08-11,42,5345,159,0,5546
639,2019-08-12,24,1714,50,0,1788
639,2019-08-13,133,4689,136,0,4958
639,2019-08-14,79,6173,173,0,6425
639,2019-08-15,27,1068,80,1,1176
639,2019-08-16,61,1873,74,1,2009
639,2019-08-17,139,3719,637,0,4495
639,2019-08-18,71,5509,1373,0,6953
639,2019-08-19,244,17841,1181,0,19266
639,2019-08-20,465,20214,1298,0,21977
639,2019-08-21,256,13243,1733,0,15232
639,2019-08-22,51,18810,968,1,19830
639,2019-08-23,177,9833,1281,0,11291
639,2019-08-24,72,13758,1330,5,15165
639,2019-08-25,50,31195,1446,1,32692
639,2019-08-26,59,28164,1572,1,29796
639,2019-08-27,335,9096,2159,1,11591
639,2019-08-28,58,38308,1800,3,40169
639,2019-08-29,137,21872,1097,1,23107
639,2019-08-30,29,3644,735,1,4409
639,2019-08-31,24,431,37,0,492
639,2019-09-01,38,1657,404,0,2099
639,2019-09-02,21,1507,13,1,1542
639,2019-09-03,65,5181,1392,2,6640
639,2019-09-04,854,12845,1925,0,15624
639,2019-09-05,86,7037,2587,2,9712
639,2019-09-06,137,17380,2265,0,19782
639,2019-09-07,188,8234,1931,3,10356
639,2019-09-08,210,5981,2656,0,8847
639,2019-09-09,941,10385,1827,1,13154
639,2019-09-10,93,10180,1879,1,12153
639,2019-09-11,100,6648,1453,2,8203
639,2019-09-12,898,9764,2122,1,12785
639,2019-09-13,928,7231,2322,1,10482
639,2019-09-14,1728,7609,2249,0,11586
639,2019-09-15,55,11186,1374,2,12617
639,2019-09-16,61,14273,1560,2,15896
639,2019-09-17,76,9030,1510,1,10617
639,2019-09-18,64,11814,1573,0,13451
639,2019-09-19,365,4467,1080,2,5914
639,2019-09-20,181,8946,2069,2,11198
639,2019-09-21,933,8675,1331,0,10939
639,2019-09-22,93,9702,1784,1,11580
639,2019-09-23,1516,10079,1646,2,13243
639,2019-09-24,98,9985,1314,2,11399
639,2019-09-25,148,10139,1219,2,11508
639,2019-09-26,89,10822,1903,0,12814
639,2019-09-27,70,10526,1238,3,11837
639,2019-09-28,73,16141,1457,3,17674
639,2019-09-29,45,17518,2182,1,19746
639,2019-09-30,959,16927,1811,0,19697
639,2019-10-01,1235,16958,2310,0,20503
639,2019-10-02,73,10843,1674,0,12590
639,2019-10-03,661,14764,1564,2,16991
639,2019-10-04,149,13073,1792,0,15014
639,2019-10-05,630,15298,816,1,16745
639,2019-10-06,2059,11258,1639,2,14958
639,2019-10-07,91,6961,954,12,8018
639,2019-10-08,126,11209,1757,4,13096
639,2019-10-09,98,15612,1444,1,17155
639,2019-10-10,287,11812,1148,2,13249
639,2019-10-11,318,10476,1517,1,12312
639,2019-10-12,952,8489,1557,0,10998
639,2019-10-13,89,7570,2004,4,9667
639,2019-10-14,78,12840,1838,0,14756
639,2019-10-15,214,10185,1640,2,12041
639,2019-10-16,182,13609,1553,3,15347
639,2019-10-17,84,6133,1686,5,7908
639,2019-10-18,97,9330,1887,1,11315
639,2019-10-19,960,6788,2112,0,9860
639,2019-10-20,63,5890,1947,1,7901
639,2019-10-21,1015,11566,1161,2,13744
639,2019-10-22,73,7013,2261,0,9347
639,2019-10-23,53,16446,1466,4,17969
639,2019-10-24,553,19222,1394,1,21170
639,2019-10-25,103,13319,1426,2,14850
639,2019-10-26,67,14930,1917,0,16914
639,2019-10-27,101,17008,1357,1,18467
639,2019-10-28,922,14637,1393,0,16952
639,2019-10-29,127,16141,1242,0,17510
639,2019-10-30,73,17245,1294,0,18612
639,2019-10-31,55,14020,1572,0,15647
639,2019-11-01,1274,26472,1873,0,29619
639,2019-11-02,40,27160,2483,3,29686
639,2019-11-03,872,40027,1083,1,41983
639,2019-11-04,985,11593,1787,0,14365
639,2019-11-05,100,4257,2006,0,6363
639,2019-11-06,148,11192,1389,621,13350
639,2019-11-07,544,22848,1096,0,24488
639,2019-11-08,80,18464,1490,0,20034
639,2019-11-09,96,16637,1317,0,18050
639,2019-11-10,66,15788,1562,0,17416
639,2019-11-11,1020,10486,1054,0,12560
639,2019-11-12,557,11822,3350,0,15729
639,2019-11-13,175,22983,1597,0,24755
639,2019-11-14,1019,10778,2247,0,14044
639,2019-11-15,72,4161,3342,0,7575
639,2019-11-16,66,2800,3194,0,6060
639,2019-11-17,896,3993,4168,0,9057
639,2019-11-18,385,3315,4019,0,7719
639,2019-11-19,135,5633,2372,0,8140
639,2019-11-20,189,1771,1836,0,3796
639,2019-11-21,105,6104,2222,0,8431
639,2019-11-22,111,5701,1568,4,7384
639,2019-11-23,75,10195,2043,1,12314
639,2019-11-24,90,9896,1889,0,11875
639,2019-11-25,104,12343,1280,0,13727
639,2019-11-26,63,7166,1767,0,8996
639,2019-11-27,65,6921,1965,3,8954
640,2019-08-01,0,29785,225,2,30012
640,2019-08-02,0,26270,271,1,26542
640,2019-08-03,0,7352,256,3,7611
640,2019-08-04,0,1727,760,0,2487
640,2019-08-05,0,1717,414,0,2131
640,2019-08-06,0,9057,294,1,9352
640,2019-08-07,0,6219,744,0,6963
640,2019-08-08,0,771,249,3,1023
640,2019-08-09,0,809,276,0,1085
640,2019-08-10,0,957,113,1,1071
640,2019-08-11,0,4926,142,0,5068
640,2019-08-12,0,1325,97,0,1422
640,2019-08-13,0,4369,347,0,4716
640,2019-08-14,0,3900,153,1,4054
640,2019-08-15,0,994,36,1,1031
640,2019-08-16,0,1706,427,0,2133
640,2019-08-17,0,3073,746,0,3819
640,2019-08-18,0,1662,1201,3,2866
640,2019-08-19,0,3124,500,0,3624
640,2019-08-20,0,3557,1388,0,4945
640,2019-08-21,0,28582,1440,2,30024
640,2019-08-22,0,33804,920,0,34724
640,2019-08-23,0,17439,728,1,18168
640,2019-08-24,0,7869,1352,3,9224
640,2019-08-25,0,24691,1362,1,26054
640,2019-08-26,0,28492,1509,1,30002
640,2019-08-27,0,19002,2400,0,21402
640,2019-08-28,0,28715,1529,3,30247
640,2019-08-29,0,18424,2351,0,20775
640,2019-08-30,0,6325,1220,1,7546
640,2019-08-31,0,1811,1,0,1812
640,2019-09-01,0,1624,384,0,2008
640,2019-09-02,0,321,21,0,342
640,2019-09-03,0,5630,1406,1,7037
640,2019-09-04,0,12303,2122,0,14425
640,2019-09-05,0,11038,1574,1,12613
640,2019-09-06,0,24101,2347,0,26448
640,2019-09-07,0,19993,1081,0,21074
640,2019-09-08,0,38547,1592,0,40139
640,2019-09-09,0,10960,1971,0,12931
640,2019-09-10,0,14311,2028,2,16341
640,2019-09-11,0,31211,2252,3,33466
640,2019-09-12,0,48801,2185,1,50987
640,2019-09-13,0,6553,2018,0,8571
640,2019-09-14,0,6652,1899,0,8551
640,2019-09-15,0,11885,1444,2,13331
640,2019-09-16,0,15060,1935,3,16998
640,2019-09-17,0,8625,2263,1,10889
640,2019-09-18,0,11478,1423,4,12905
640,2019-09-19,0,8138,1354,1,9493
640,2019-09-20,0,14184,1954,1,16139
640,2019-09-21,0,9685,1525,0,11210
640,2019-09-22,0,14620,1463,2,16085
640,2019-09-23,0,11295,1369,0,12664
640,2019-09-24,0,22006,1925,2,23933
640,2019-09-25,0,12173,2114,1,14288
640,2019-09-26,0,10658,1597,1,12256
640,2019-09-27,0,11272,1648,2,12922
640,2019-09-28,0,24602,1302,0,25904
640,2019-09-29,0,33222,1181,1,34404
640,2019-09-30,0,33344,1620,1,34965
640,2019-10-01,0,26816,1491,1,28308
640,2019-10-02,0,25866,1748,0,27614
640,2019-10-03,0,24029,1019,2,25050
640,2019-10-04,0,20547,1391,1,21939
640,2019-10-05,0,23519,2007,1,25527
640,2019-10-06,0,15796,1388,1,17185
640,2019-10-07,0,6524,1698,5,8227
640,2019-10-08,0,17207,1658,0,18865
640,2019-10-09,0,25541,1660,0,27201
640,2019-10-10,0,22966,2493,0,25459
640,2019-10-11,0,9454,1257,1,10712
640,2019-10-12,0,8773,1852,3,10628
640,2019-10-13,0,11104,2451,2,13557
640,2019-10-14,0,7122,1978,4,9104
640,2019-10-15,0,15012,2712,2,17726
640,2019-10-16,0,18761,1242,0,20003
640,2019-10-17,0,5873,1409,3,7285
640,2019-10-18,0,9297,1499,0,10796
640,2019-10-19,0,35254,1852,0,37106
640,2019-10-20,0,11754,1767,0,13521
640,2019-10-21,0,11582,1832,3,13417
640,2019-10-22,0,6528,1839,6,8373
640,2019-10-23,0,14143,1038,1,15182
640,2019-10-24,0,18629,1902,0,20531
640,2019-10-25,0,11589,1661,3,13253
640,2019-10-26,0,13860,1516,1,15377
640,2019-10-27,0,16887,1126,1,18014
640,2019-10-28,0,29498,1151,1,30650
640,2019-10-29,0,33487,1457,0,34944
640,2019-10-30,0,21633,1137,1,22771
640,2019-10-31,0,12816,1946,1,14763
640,2019-11-01,0,15364,1374,2,16740
640,2019-11-02,0,15347,1338,2,16687
640,2019-11-03,0,37793,1515,1,39309
640,2019-11-04,0,15156,1584,2,16742
640,2019-11-05,0,3661,1731,0,5392
640,2019-11-06,0,8719,1171,2,9892
640,2019-11-07,0,14477,1297,0,15774
640,2019-11-08,0,10350,901,0,11251
640,2019-11-09,0,9036,2338,0,11374
640,2019-11-10,0,15589,1069,0,16658
640,2019-11-11,0,14347,1688,0,16035
640,2019-11-12,0,18127,3280,0,21407
640,2019-11-13,0,16935,1986,0,18921
640,2019-11-14,0,9259,2370,0,11629
640,2019-11-15,0,3949,3237,0,7186
640,2019-11-16,0,2430,2972,0,5402
640,2019-11-17,0,5920,3616,0,9536
640,2019-11-18,0,2696,3411,0,6107
640,2019-11-19,0,3308,2698,0,6006
640,2019-11-20,0,1913,2034,0,3947
640,2019-11-21,0,3554,1985,1,5540
640,2019-11-22,0,5782,1407,2,7191
640,2019-11-23,0,9423,2298,2,11723
640,2019-11-24,0,6910,1651,0,8561
640,2019-11-25,0,11105,2131,0,13236
640,2019-11-26,0,6326,2027,3,8356
640,2019-11-27,0,11033,1728,0,12761
640,2019-11-28,0,9082,865,0,9947
640,2019-11-29,0,218,3,0,221
640,2019-08-01,0,29785,225,2,30012
640,2019-08-02,0,26270,271,1,26542
640,2019-08-03,0,7352,256,3,7611
640,2019-08-04,0,1727,760,0,2487
640,2019-08-05,0,1717,414,0,2131
640,2019-08-06,0,9057,294,1,9352
640,2019-08-07,0,6219,744,0,6963
640,2019-08-08,0,771,249,3,1023
640,2019-08-09,0,809,276,0,1085
640,2019-08-10,0,957,113,1,1071
640,2019-08-11,0,4926,142,0,5068
640,2019-08-12,0,1325,97,0,1422
640,2019-08-13,0,4369,347,0,4716
640,2019-08-14,0,3900,153,1,4054
640,2019-08-15,0,994,36,1,1031
640,2019-08-16,0,1706,427,0,2133
640,2019-08-17,0,3073,746,0,3819
640,2019-08-18,0,1662,1201,3,2866
640,2019-08-19,0,3124,500,0,3624
640,2019-08-20,0,3557,1388,0,4945
640,2019-08-21,0,28582,1440,2,30024
640,2019-08-22,0,33804,920,0,34724
640,2019-08-23,0,17439,728,1,18168
640,2019-08-24,0,7869,1352,3,9224
640,2019-08-25,0,24691,1362,1,26054
640,2019-08-26,0,28492,1509,1,30002
640,2019-08-27,0,19002,2400,0,21402
640,2019-08-28,0,28715,1529,3,30247
640,2019-08-29,0,18424,2351,0,20775
640,2019-08-30,0,6325,1220,1,7546
640,2019-08-31,0,1811,1,0,1812
640,2019-09-01,0,1624,384,0,2008
640,2019-09-02,0,321,21,0,342
640,2019-09-03,0,5630,1406,1,7037
640,2019-09-04,0,12303,2122,0,14425
640,2019-09-05,0,11038,1574,1,12613
640,2019-09-06,0,24101,2347,0,26448
640,2019-09-07,0,19993,1081,0,21074
640,2019-09-08,0,38547,1592,0,40139
640,2019-09-09,0,10960,1971,0,12931
640,2019-09-10,0,14311,2028,2,16341
640,2019-09-11,0,31211,2252,3,33466
640,2019-09-12,0,48801,2185,1,50987
640,2019-09-13,0,6553,2018,0,8571
640,2019-09-14,0,6652,1899,0,8551
640,2019-09-15,0,11885,1444,2,13331
640,2019-09-16,0,15060,1935,3,16998
640,2019-09-17,0,8625,2263,1,10889
640,2019-09-18,0,11478,1423,4,12905
640,2019-09-19,0,8138,1354,1,9493
640,2019-09-20,0,14184,1954,1,16139
640,2019-09-21,0,9685,1525,0,11210
640,2019-09-22,0,14620,1463,2,16085
640,2019-09-23,0,11295,1369,0,12664
640,2019-09-24,0,22006,1925,2,23933
640,2019-09-25,0,12173,2114,1,14288
640,2019-09-26,0,10658,1597,1,12256
640,2019-09-27,0,11272,1648,2,12922
640,2019-09-28,0,24602,1302,0,25904
640,2019-09-29,0,33222,1181,1,34404
640,2019-09-30,0,33344,1620,1,34965
640,2019-10-01,0,26816,1491,1,28308
640,2019-10-02,0,25866,1748,0,27614
640,2019-10-03,0,24029,1019,2,25050
640,2019-10-04,0,20547,1391,1,21939
640,2019-10-05,0,23519,2007,1,25527
640,2019-10-06,0,15796,1388,1,17185
640,2019-10-07,0,6524,1698,5,8227
640,2019-10-08,0,17207,1658,0,18865
640,2019-10-09,0,25541,1660,0,27201
640,2019-10-10,0,22966,2493,0,25459
640,2019-10-11,0,9454,1257,1,10712
640,2019-10-12,0,8773,1852,3,10628
640,2019-10-13,0,11104,2451,2,13557
640,2019-10-14,0,7122,1978,4,9104
640,2019-10-15,0,15012,2712,2,17726
640,2019-10-16,0,18761,1242,0,20003
640,2019-10-17,0,5873,1409,3,7285
640,2019-10-18,0,9297,1499,0,10796
640,2019-10-19,0,35254,1852,0,37106
640,2019-10-20,0,11754,1767,0,13521
640,2019-10-21,0,11582,1832,3,13417
640,2019-10-22,0,6528,1839,6,8373
640,2019-10-23,0,14143,1038,1,15182
640,2019-10-24,0,18629,1902,0,20531
640,2019-10-25,0,11589,1661,3,13253
640,2019-10-26,0,13860,1516,1,15377
640,2019-10-27,0,16887,1126,1,18014
640,2019-10-28,0,29498,1151,1,30650
640,2019-10-29,0,33487,1457,0,34944
640,2019-10-30,0,21633,1137,1,22771
640,2019-10-31,0,12816,1946,1,14763
640,2019-11-01,0,15364,1374,2,16740
640,2019-11-02,0,15347,1338,2,16687
640,2019-11-03,0,37793,1515,1,39309
640,2019-11-04,0,15156,1584,2,16742
640,2019-11-05,0,3661,1731,0,5392
640,2019-11-06,0,8719,1171,2,9892
640,2019-11-07,0,14477,1297,0,15774
640,2019-11-08,0,10350,901,0,11251
640,2019-11-09,0,9036,2338,0,11374
640,2019-11-10,0,15589,1069,0,16658
640,2019-11-11,0,14347,1688,0,16035
640,2019-11-12,0,18127,3280,0,21407
640,2019-11-13,0,16935,1986,0,18921
640,2019-11-14,0,9259,2370,0,11629
640,2019-11-15,0,3949,3237,0,7186
640,2019-11-16,0,2430,2972,0,5402
640,2019-11-17,0,5920,3616,0,9536
640,2019-11-18,0,2696,3411,0,6107
640,2019-11-19,0,3308,2698,0,6006
640,2019-11-20,0,1913,2034,0,3947
640,2019-11-21,0,3554,1985,1,5540
640,2019-11-22,0,5782,1407,2,7191
640,2019-11-23,0,9423,2298,2,11723
640,2019-11-24,0,6910,1651,0,8561
640,2019-11-25,0,11105,2131,0,13236
640,2019-11-26,0,6326,2027,3,8356
640,2019-11-27,0,11033,1728,0,12761
640,2019-11-28,0,9082,865,0,9947
640,2019-11-29,0,218,3,0,221
640,2019-08-01,0,29785,225,2,30012
640,2019-08-02,0,26270,271,1,26542
640,2019-08-03,0,7352,256,3,7611
640,2019-08-04,0,1727,760,0,2487
640,2019-08-05,0,1717,414,0,2131
640,2019-08-06,0,9057,294,1,9352
640,2019-08-07,0,6219,744,0,6963
640,2019-08-08,0,771,249,3,1023
640,2019-08-09,0,809,276,0,1085
640,2019-08-10,0,957,113,1,1071
640,2019-08-11,0,4926,142,0,5068
640,2019-08-12,0,1325,97,0,1422
640,2019-08-13,0,4369,347,0,4716
640,2019-08-14,0,3900,153,1,4054
640,2019-08-15,0,994,36,1,1031
640,2019-08-16,0,1706,427,0,2133
640,2019-08-17,0,3073,746,0,3819
640,2019-08-18,0,1662,1201,3,2866
640,2019-08-19,0,3124,500,0,3624
640,2019-08-20,0,3557,1388,0,4945
640,2019-08-21,0,28582,1440,2,30024
640,2019-08-22,0,33804,920,0,34724
640,2019-08-23,0,17439,728,1,18168
640,2019-08-24,0,7869,1352,3,9224
640,2019-08-25,0,24691,1362,1,26054
640,2019-08-26,0,28492,1509,1,30002
640,2019-08-27,0,19002,2400,0,21402
640,2019-08-28,0,28715,1529,3,30247
640,2019-08-29,0,18424,2351,0,20775
640,2019-08-30,0,6325,1220,1,7546
640,2019-08-31,0,1811,1,0,1812
640,2019-09-01,0,1624,384,0,2008
640,2019-09-02,0,321,21,0,342
640,2019-09-03,0,5630,1406,1,7037
640,2019-09-04,0,12303,2122,0,14425
640,2019-09-05,0,11038,1574,1,12613
640,2019-09-06,0,24101,2347,0,26448
640,2019-09-07,0,19993,1081,0,21074
640,2019-09-08,0,38547,1592,0,40139
640,2019-09-09,0,10960,1971,0,12931
640,2019-09-10,0,14311,2028,2,16341
640,2019-09-11,0,31211,2252,3,33466
640,2019-09-12,0,48801,2185,1,50987
640,2019-09-13,0,6553,2018,0,8571
640,2019-09-14,0,6652,1899,0,8551
640,2019-09-15,0,11885,1444,2,13331
640,2019-09-16,0,15060,1935,3,16998
640,2019-09-17,0,8625,2263,1,10889
640,2019-09-18,0,11478,1423,4,12905
640,2019-09-19,0,8138,1354,1,9493
640,2019-09-20,0,14184,1954,1,16139
640,2019-09-21,0,9685,1525,0,11210
640,2019-09-22,0,14620,1463,2,16085
640,2019-09-23,0,11295,1369,0,12664
640,2019-09-24,0,22006,1925,2,23933
640,2019-09-25,0,12173,2114,1,14288
640,2019-09-26,0,10658,1597,1,12256
640,2019-09-27,0,11272,1648,2,12922
640,2019-09-28,0,24602,1302,0,25904
640,2019-09-29,0,33222,1181,1,34404
640,2019-09-30,0,33344,1620,1,34965
640,2019-10-01,0,26816,1491,1,28308
640,2019-10-02,0,25866,1748,0,27614
640,2019-10-03,0,24029,1019,2,25050
640,2019-10-04,0,20547,1391,1,21939
640,2019-10-05,0,23519,2007,1,25527
640,2019-10-06,0,15796,1388,1,17185
640,2019-10-07,0,6524,1698,5,8227
640,2019-10-08,0,17207,1658,0,18865
640,2019-10-09,0,25541,1660,0,27201
640,2019-10-10,0,22966,2493,0,25459
640,2019-10-11,0,9454,1257,1,10712
640,2019-10-12,0,8773,1852,3,10628
640,2019-10-13,0,11104,2451,2,13557
640,2019-10-14,0,7122,1978,4,9104
640,2019-10-15,0,15012,2712,2,17726
640,2019-10-16,0,18761,1242,0,20003
640,2019-10-17,0,5873,1409,3,7285
640,2019-10-18,0,9297,1499,0,10796
640,2019-10-19,0,35254,1852,0,37106
640,2019-10-20,0,11754,1767,0,13521
640,2019-10-21,0,11582,1832,3,13417
640,2019-10-22,0,6528,1839,6,8373
640,2019-10-23,0,14143,1038,1,15182
640,2019-10-24,0,18629,1902,0,20531
640,2019-10-25,0,11589,1661,3,13253
640,2019-10-26,0,13860,1516,1,15377
640,2019-10-27,0,16887,1126,1,18014
640,2019-10-28,0,29498,1151,1,30650
640,2019-10-29,0,33487,1457,0,34944
640,2019-10-30,0,21633,1137,1,22771
640,2019-10-31,0,12816,1946,1,14763
640,2019-11-01,0,15364,1374,2,16740
640,2019-11-02,0,15347,1338,2,16687
640,2019-11-03,0,37793,1515,1,39309
640,2019-11-04,0,15156,1584,2,16742
640,2019-11-05,0,3661,1731,0,5392
640,2019-11-06,0,8719,1171,2,9892
640,2019-11-07,0,14477,1297,0,15774
640,2019-11-08,0,10350,901,0,11251
640,2019-11-09,0,9036,2338,0,11374
640,2019-11-10,0,15589,1069,0,16658
640,2019-11-11,0,14347,1688,0,16035
640,2019-11-12,0,18127,3280,0,21407
640,2019-11-13,0,16935,1986,0,18921
640,2019-11-14,0,9259,2370,0,11629
640,2019-11-15,0,3949,3237,0,7186
640,2019-11-16,0,2430,2972,0,5402
640,2019-11-17,0,5920,3616,0,9536
640,2019-11-18,0,2696,3411,0,6107
640,2019-11-19,0,3308,2698,0,6006
640,2019-11-20,0,1913,2034,0,3947
640,2019-11-21,0,3554,1985,1,5540
640,2019-11-22,0,5782,1407,2,7191
640,2019-11-23,0,9423,2298,2,11723
640,2019-11-24,0,6910,1651,0,8561
640,2019-11-25,0,11105,2131,0,13236
640,2019-11-26,0,6326,2027,3,8356
641,2019-08-01,24,38201,487,0,38712
641,2019-08-02,53,37447,373,0,37873
641,2019-08-03,56,9601,154,0,9811
641,2019-08-04,15,1238,254,0,1507
641,2019-08-05,38,1468,301,0,1807
641,2019-08-06,24,5615,344,0,5983
641,2019-08-07,41,9447,603,0,10091
641,2019-08-08,27,3760,623,0,4410
641,2019-08-09,21,1105,27,0,1153
641,2019-08-10,0,0,0,0,0
641,2019-08-11,0,0,0,0,0
641,2019-08-12,0,0,0,0,0
641,2019-08-13,0,0,0,0,0
641,2019-08-14,0,0,0,0,0
641,2019-08-15,0,0,0,0,0
641,2019-08-16,0,0,0,0,0
641,2019-08-17,0,0,0,0,0
641,2019-08-18,0,0,0,0,0
641,2019-08-19,0,0,0,0,0
641,2019-08-20,0,0,0,0,0
641,2019-08-21,0,0,0,0,0
641,2019-08-22,0,0,0,0,0
641,2019-08-23,0,0,0,0,0
641,2019-08-24,5,112,720,0,837
641,2019-08-25,81,967,1350,0,2398
641,2019-08-26,889,833,1242,0,2964
641,2019-08-27,67,661,1639,0,2367
641,2019-08-28,224,784,1634,0,2642
641,2019-08-29,828,1101,1145,0,3074
641,2019-08-30,109,782,363,0,1254
641,2019-08-31,16,338,1,0,355
641,2019-09-01,29,333,360,0,722
641,2019-09-02,141,209,99,0,449
641,2019-09-03,53,281,946,0,1280
641,2019-09-04,1004,466,1509,0,2979
641,2019-09-05,63,256,2248,0,2567
641,2019-09-06,98,624,1923,0,2645
641,2019-09-07,1032,600,3052,0,4684
641,2019-09-08,167,5638,2624,0,8429
641,2019-09-09,187,670,1761,0,2618
641,2019-09-10,43,1188,2829,0,4060
641,2019-09-11,85,684,1603,0,2372
641,2019-09-12,50,901,1620,0,2571
641,2019-09-13,51,901,1981,0,2933
641,2019-09-14,68,801,1961,0,2830
641,2019-09-15,888,1314,1120,0,3322
641,2019-09-16,236,543,1189,0,1968
641,2019-09-17,890,346,1434,0,2670
641,2019-09-18,74,670,1156,0,1900
641,2019-09-19,1027,2266,2523,0,5816
641,2019-09-20,176,20541,1130,0,21847
641,2019-09-21,45,7843,1980,0,9868
641,2019-09-22,52,15783,1826,0,17661
641,2019-09-23,187,10073,1805,0,12065
641,2019-09-24,120,25863,1254,0,27237
641,2019-09-25,121,12561,1365,0,14047
641,2019-09-26,171,9298,1770,0,11239
641,2019-09-27,53,8100,2077,0,10230
641,2019-09-28,77,14673,2057,0,16807
641,2019-09-29,46,16930,2037,0,19013
641,2019-09-30,601,26323,1844,0,28768
641,2019-10-01,100,21934,1567,0,23601
641,2019-10-02,60,11239,1671,0,12970
641,2019-10-03,64,34876,1488,0,36428
641,2019-10-04,595,13676,1167,0,15438
641,2019-10-05,47,20259,1745,0,22051
641,2019-10-06,1282,13843,2337,0,17462
641,2019-10-07,75,5154,1840,0,7069
641,2019-10-08,741,15266,1760,0,17767
641,2019-10-09,88,25095,1817,0,27000
641,2019-10-10,2083,30100,2109,0,34292
641,2019-10-11,165,16624,1582,0,18371
641,2019-10-12,60,6186,1545,0,7791
641,2019-10-13,1050,7536,1592,0,10178
641,2019-10-14,91,4600,1788,0,6479
641,2019-10-15,82,7259,1644,0,8985
641,2019-10-16,379,18055,1754,0,20188
641,2019-10-17,86,8151,2015,0,10252
641,2019-10-18,107,8131,1912,0,10150
641,2019-10-19,938,11501,1642,0,14081
641,2019-10-20,956,40345,2383,0,43684
641,2019-10-21,52,14501,1590,0,16143
641,2019-10-22,622,5134,1995,0,7751
641,2019-10-23,43,7422,2031,0,9496
641,2019-10-24,743,13004,1640,0,15387
641,2019-10-25,83,10583,1984,0,12650
641,2019-10-26,66,12947,1267,0,14280
641,2019-10-27,973,18288,1470,0,20731
641,2019-10-28,929,28684,1781,0,31394
641,2019-10-29,131,22415,1684,0,24230
641,2019-10-30,57,15966,1579,0,17602
641,2019-10-31,35,11726,1212,0,12973
641,2019-11-01,478,25232,1475,0,27185
641,2019-11-02,38,16043,1558,0,17639
641,2019-11-03,57,21903,1077,0,23037
641,2019-11-04,621,9670,1372,0,11663
641,2019-11-05,1288,1847,1870,0,5005
641,2019-11-06,71,7715,1185,0,8971
641,2019-11-07,153,13621,1650,0,15424
641,2019-11-08,487,9127,1696,0,11310
641,2019-11-09,796,7850,2826,0,11472
641,2019-11-10,1615,12428,1851,0,15894
641,2019-11-11,1125,8550,1105,0,10780
641,2019-11-12,71,14952,3069,0,18092
641,2019-11-13,1984,14088,1786,0,17858
641,2019-11-14,82,16040,1676,0,17798
641,2019-11-15,72,5254,2133,0,7459
641,2019-11-16,88,3054,2390,0,5532
641,2019-11-17,178,3660,3992,0,7830
641,2019-11-18,72,2826,2876,0,5774
641,2019-11-19,1016,3486,2125,0,6627
641,2019-11-20,996,3538,1371,0,5905
641,2019-11-21,74,3930,2393,0,6397
641,2019-11-22,93,5969,2027,0,8089
641,2019-11-23,64,6544,2353,0,8961
641,2019-11-24,166,7866,2142,0,10174
641,2019-11-25,73,7055,2428,0,9556
641,2019-11-26,72,6683,1728,0,8483
641,2019-11-27,162,6949,1812,0,8923
641,2019-11-28,66,8718,536,0,9320
641,2019-11-29,8,1128,2,0,1138
641,2019-08-01,24,38201,487,0,38712
641,2019-08-02,53,37447,373,0,37873
641,2019-08-03,56,9601,154,0,9811
641,2019-08-04,15,1238,254,0,1507
641,2019-08-05,38,1468,301,0,1807
641,2019-08-06,24,5615,344,0,5983
641,2019-08-07,41,9447,603,0,10091
641,2019-08-08,27,3760,623,0,4410
641,2019-08-09,21,1105,27,0,1153
641,2019-08-10,0,0,0,0,0
641,2019-08-11,0,0,0,0,0
641,2019-08-12,0,0,0,0,0
641,2019-08-13,0,0,0,0,0
641,2019-08-14,0,0,0,0,0
641,2019-08-15,0,0,0,0,0
641,2019-08-16,0,0,0,0,0
641,2019-08-17,0,0,0,0,0
641,2019-08-18,0,0,0,0,0
641,2019-08-19,0,0,0,0,0
641,2019-08-20,0,0,0,0,0
641,2019-08-21,0,0,0,0,0
641,2019-08-22,0,0,0,0,0
641,2019-08-23,0,0,0,0,0
641,2019-08-24,5,112,720,0,837
641,2019-08-25,81,967,1350,0,2398
641,2019-08-26,889,833,1242,0,2964
641,2019-08-27,67,661,1639,0,2367
641,2019-08-28,224,784,1634,0,2642
641,2019-08-29,828,1101,1145,0,3074
641,2019-08-30,109,782,363,0,1254
641,2019-08-31,16,338,1,0,355
641,2019-09-01,29,333,360,0,722
641,2019-09-02,141,209,99,0,449
641,2019-09-03,53,281,946,0,1280
641,2019-09-04,1004,466,1509,0,2979
641,2019-09-05,63,256,2248,0,2567
641,2019-09-06,98,624,1923,0,2645
641,2019-09-07,1032,600,3052,0,4684
641,2019-09-08,167,5638,2624,0,8429
641,2019-09-09,187,670,1761,0,2618
641,2019-09-10,43,1188,2829,0,4060
641,2019-09-11,85,684,1603,0,2372
641,2019-09-12,50,901,1620,0,2571
641,2019-09-13,51,901,1981,0,2933
641,2019-09-14,68,801,1961,0,2830
641,2019-09-15,888,1314,1120,0,3322
641,2019-09-16,236,543,1189,0,1968
641,2019-09-17,890,346,1434,0,2670
641,2019-09-18,74,670,1156,0,1900
641,2019-09-19,1027,2266,2523,0,5816
641,2019-09-20,176,20541,1130,0,21847
641,2019-09-21,45,7843,1980,0,9868
641,2019-09-22,52,15783,1826,0,17661
641,2019-09-23,187,10073,1805,0,12065
641,2019-09-24,120,25863,1254,0,27237
641,2019-09-25,121,12561,1365,0,14047
641,2019-09-26,171,9298,1770,0,11239
641,2019-09-27,53,8100,2077,0,10230
641,2019-09-28,77,14673,2057,0,16807
641,2019-09-29,46,16930,2037,0,19013
641,2019-09-30,601,26323,1844,0,28768
641,2019-10-01,100,21934,1567,0,23601
641,2019-10-02,60,11239,1671,0,12970
641,2019-10-03,64,34876,1488,0,36428
641,2019-10-04,595,13676,1167,0,15438
641,2019-10-05,47,20259,1745,0,22051
641,2019-10-06,1282,13843,2337,0,17462
641,2019-10-07,75,5154,1840,0,7069
641,2019-10-08,741,15266,1760,0,17767
641,2019-10-09,88,25095,1817,0,27000
641,2019-10-10,2083,30100,2109,0,34292
641,2019-10-11,165,16624,1582,0,18371
641,2019-10-12,60,6186,1545,0,7791
641,2019-10-13,1050,7536,1592,0,10178
641,2019-10-14,91,4600,1788,0,6479
641,2019-10-15,82,7259,1644,0,8985
641,2019-10-16,379,18055,1754,0,20188
641,2019-10-17,86,8151,2015,0,10252
641,2019-10-18,107,8131,1912,0,10150
641,2019-10-19,938,11501,1642,0,14081
641,2019-10-20,956,40345,2383,0,43684
641,2019-10-21,52,14501,1590,0,16143
641,2019-10-22,622,5134,1995,0,7751
641,2019-10-23,43,7422,2031,0,9496
641,2019-10-24,743,13004,1640,0,15387
641,2019-10-25,83,10583,1984,0,12650
641,2019-10-26,66,12947,1267,0,14280
641,2019-10-27,973,18288,1470,0,20731
641,2019-10-28,929,28684,1781,0,31394
641,2019-10-29,131,22415,1684,0,24230
641,2019-10-30,57,15966,1579,0,17602
641,2019-10-31,35,11726,1212,0,12973
641,2019-11-01,478,25232,1475,0,27185
641,2019-11-02,38,16043,1558,0,17639
641,2019-11-03,57,21903,1077,0,23037
641,2019-11-04,621,9670,1372,0,11663
641,2019-11-05,1288,1847,1870,0,5005
641,2019-11-06,71,7715,1185,0,8971
641,2019-11-07,153,13621,1650,0,15424
641,2019-11-08,487,9127,1696,0,11310
641,2019-11-09,796,7850,2826,0,11472
641,2019-11-10,1615,12428,1851,0,15894
641,2019-11-11,1125,8550,1105,0,10780
641,2019-11-12,71,14952,3069,0,18092
641,2019-11-13,1984,14088,1786,0,17858
641,2019-11-14,82,16040,1676,0,17798
641,2019-11-15,72,5254,2133,0,7459
641,2019-11-16,88,3054,2390,0,5532
641,2019-11-17,178,3660,3992,0,7830
641,2019-11-18,72,2826,2876,0,5774
641,2019-11-19,1016,3486,2125,0,6627
641,2019-11-20,996,3538,1371,0,5905
641,2019-11-21,74,3930,2393,0,6397
641,2019-11-22,93,5969,2027,0,8089
641,2019-11-23,64,6544,2353,0,8961
641,2019-11-24,166,7866,2142,0,10174
641,2019-11-25,73,7055,2428,0,9556
641,2019-11-26,72,6683,1728,0,8483
641,2019-11-27,162,6949,1812,0,8923
641,2019-11-28,66,8718,536,0,9320
641,2019-11-29,8,1128,2,0,1138
641,2019-08-01,24,38201,487,0,38712
641,2019-08-02,53,37447,373,0,37873
641,2019-08-03,56,9601,154,0,9811
641,2019-08-04,15,1238,254,0,1507
641,2019-08-05,38,1468,301,0,1807
641,2019-08-06,24,5615,344,0,5983
641,2019-08-07,41,9447,603,0,10091
641,2019-08-08,27,3760,623,0,4410
641,2019-08-09,21,1105,27,0,1153
641,2019-08-10,0,0,0,0,0
641,2019-08-11,0,0,0,0,0
641,2019-08-12,0,0,0,0,0
641,2019-08-13,0,0,0,0,0
641,2019-08-14,0,0,0,0,0
641,2019-08-15,0,0,0,0,0
641,2019-08-16,0,0,0,0,0
641,2019-08-17,0,0,0,0,0
641,2019-08-18,0,0,0,0,0
641,2019-08-19,0,0,0,0,0
641,2019-08-20,0,0,0,0,0
641,2019-08-21,0,0,0,0,0
641,2019-08-22,0,0,0,0,0
641,2019-08-23,0,0,0,0,0
641,2019-08-24,5,112,720,0,837
641,2019-08-25,81,967,1350,0,2398
641,2019-08-26,889,833,1242,0,2964
641,2019-08-27,67,661,1639,0,2367
641,2019-08-28,224,784,1634,0,2642
641,2019-08-29,828,1101,1145,0,3074
641,2019-08-30,109,782,363,0,1254
641,2019-08-31,16,338,1,0,355
641,2019-09-01,29,333,360,0,722
641,2019-09-02,141,209,99,0,449
641,2019-09-03,53,281,946,0,1280
641,2019-09-04,1004,466,1509,0,2979
641,2019-09-05,63,256,2248,0,2567
641,2019-09-06,98,624,1923,0,2645
641,2019-09-07,1032,600,3052,0,4684
641,2019-09-08,167,5638,2624,0,8429
641,2019-09-09,187,670,1761,0,2618
641,2019-09-10,43,1188,2829,0,4060
641,2019-09-11,85,684,1603,0,2372
641,2019-09-12,50,901,1620,0,2571
641,2019-09-13,51,901,1981,0,2933
641,2019-09-14,68,801,1961,0,2830
641,2019-09-15,888,1314,1120,0,3322
641,2019-09-16,236,543,1189,0,1968
641,2019-09-17,890,346,1434,0,2670
641,2019-09-18,74,670,1156,0,1900
641,2019-09-19,1027,2266,2523,0,5816
641,2019-09-20,176,20541,1130,0,21847
641,2019-09-21,45,7843,1980,0,9868
641,2019-09-22,52,15783,1826,0,17661
641,2019-09-23,187,10073,1805,0,12065
641,2019-09-24,120,25863,1254,0,27237
641,2019-09-25,121,12561,1365,0,14047
641,2019-09-26,171,9298,1770,0,11239
641,2019-09-27,53,8100,2077,0,10230
641,2019-09-28,77,14673,2057,0,16807
641,2019-09-29,46,16930,2037,0,19013
641,2019-09-30,601,26323,1844,0,28768
641,2019-10-01,100,21934,1567,0,23601
641,2019-10-02,60,11239,1671,0,12970
641,2019-10-03,64,34876,1488,0,36428
641,2019-10-04,595,13676,1167,0,15438
641,2019-10-05,47,20259,1745,0,22051
641,2019-10-06,1282,13843,2337,0,17462
641,2019-10-07,75,5154,1840,0,7069
641,2019-10-08,741,15266,1760,0,17767
641,2019-10-09,88,25095,1817,0,27000
641,2019-10-10,2083,30100,2109,0,34292
641,2019-10-11,165,16624,1582,0,18371
641,2019-10-12,60,6186,1545,0,7791
641,2019-10-13,1050,7536,1592,0,10178
641,2019-10-14,91,4600,1788,0,6479
641,2019-10-15,82,7259,1644,0,8985
641,2019-10-16,379,18055,1754,0,20188
641,2019-10-17,86,8151,2015,0,10252
641,2019-10-18,107,8131,1912,0,10150
641,2019-10-19,938,11501,1642,0,14081
641,2019-10-20,956,40345,2383,0,43684
641,2019-10-21,52,14501,1590,0,16143
641,2019-10-22,622,5134,1995,0,7751
641,2019-10-23,43,7422,2031,0,9496
641,2019-10-24,743,13004,1640,0,15387
641,2019-10-25,83,10583,1984,0,12650
641,2019-10-26,66,12947,1267,0,14280
641,2019-10-27,973,18288,1470,0,20731
641,2019-10-28,929,28684,1781,0,31394
641,2019-10-29,131,22415,1684,0,24230
641,2019-10-30,57,15966,1579,0,17602
641,2019-10-31,35,11726,1212,0,12973
641,2019-11-01,478,25232,1475,0,27185
641,2019-11-02,38,16043,1558,0,17639
641,2019-11-03,57,21903,1077,0,23037
641,2019-11-04,621,9670,1372,0,11663
641,2019-11-05,1288,1847,1870,0,5005
641,2019-11-06,71,7715,1185,0,8971
641,2019-11-07,153,13621,1650,0,15424
641,2019-11-08,487,9127,1696,0,11310
641,2019-11-09,796,7850,2826,0,11472
641,2019-11-10,1615,12428,1851,0,15894
641,2019-11-11,1125,8550,1105,0,10780
641,2019-11-12,71,14952,3069,0,18092
641,2019-11-13,1984,14088,1786,0,17858
641,2019-11-14,82,16040,1676,0,17798
641,2019-11-15,72,5254,2133,0,7459
641,2019-11-16,88,3054,2390,0,5532
641,2019-11-17,178,3660,3992,0,7830
641,2019-11-18,72,2826,2876,0,5774
641,2019-11-19,1016,3486,2125,0,6627
641,2019-11-20,996,3538,1371,0,5905
641,2019-11-21,74,3930,2393,0,6397
641,2019-11-22,93,5969,2027,0,8089
641,2019-11-23,64,6544,2353,0,8961
641,2019-11-24,166,7866,2142,0,10174
641,2019-11-25,73,7055,2428,0,9556
641,2019-11-26,72,6683,1728,0,8483
641,2019-11-27,162,6949,1812,0,8923
641,2019-11-28,66,8718,536,0,9320
641,2019-11-29,8,1128,2,0,1138
642,2019-08-01,187,19870,464,1,20522
642,2019-08-02,91,22724,238,0,23053
642,2019-08-03,68,6614,552,0,7234
642,2019-08-04,75,1416,245,2,1738
642,2019-08-05,102,1107,781,0,1990
642,2019-08-06,1405,9484,624,0,11513
642,2019-08-07,1717,11821,352,1,13891
642,2019-08-08,636,3622,433,0,4691
642,2019-08-09,122,2639,209,3,2973
642,2019-08-10,105,1747,237,0,2089
642,2019-08-11,127,5721,128,0,5976
642,2019-08-12,76,1967,139,0,2182
642,2019-08-13,95,6031,313,1,6440
642,2019-08-14,1828,2085,153,0,4066
642,2019-08-15,439,1668,10,1,2118
642,2019-08-16,87,3251,83,0,3421
642,2019-08-17,480,3676,717,1,4874
642,2019-08-18,2809,3687,1373,1,7870
642,2019-08-19,2232,6448,1215,2,9897
642,2019-08-20,3177,4098,906,1,8182
642,2019-08-21,592,20710,1350,0,22652
642,2019-08-22,213,42518,1070,1,43802
642,2019-08-23,107,13316,1169,1,14593
642,2019-08-24,2564,7508,1388,4,11464
642,2019-08-25,2066,22924,1620,2,26612
642,2019-08-26,1878,38760,1902,0,42540
642,2019-08-27,3210,11020,1892,0,16122
642,2019-08-28,2223,34649,1969,2,38843
642,2019-08-29,2383,21985,1710,2,26080
642,2019-08-30,2807,7138,553,2,10500
642,2019-08-31,971,3172,1,0,4144
642,2019-09-01,118,631,306,0,1055
642,2019-09-02,137,1067,39,0,1243
642,2019-09-03,103,3226,543,1,3873
642,2019-09-04,1579,9181,1642,2,12404
642,2019-09-05,1969,10033,1534,0,13536
642,2019-09-06,2637,10468,2600,0,15705
642,2019-09-07,2605,9141,125916,2,137664
642,2019-09-08,1842,49822,2211,0,53875
642,2019-09-09,1683,5162,1908,18,8771
642,2019-09-10,1599,37967,1847,0,41413
642,2019-09-11,1623,43068,1397,29,46117
642,2019-09-12,2536,55689,2356,4,60585
642,2019-09-13,1572,8342,1976,1,11891
642,2019-09-14,2427,7477,1319,1,11224
642,2019-09-15,1615,12180,1312,1,15108
642,2019-09-16,2391,12382,2374,5,17152
642,2019-09-17,2244,31363,2500,8,36115
642,2019-09-18,1391,15733,1484,9,18617
642,2019-09-19,2749,10633,1173,9,14564
642,2019-09-20,2521,18309,1811,9,22650
642,2019-09-21,1356,7194,2430,11,10991
642,2019-09-22,1811,9874,2050,5,13740
642,2019-09-23,1861,9109,1657,4,12631
642,2019-09-24,1748,14312,1728,1,17789
642,2019-09-25,1868,8465,2114,4,12451
642,2019-09-26,1557,10650,1918,31,14156
642,2019-09-27,2103,26373,1808,2,30286
642,2019-09-28,2488,35748,1791,3,40030
642,2019-09-29,2789,31340,2382,259,36770
642,2019-09-30,2236,26083,1613,3,29935
642,2019-10-01,2619,16535,1508,1,20663
642,2019-10-02,3621,10830,1400,1,15852
642,2019-10-03,3578,14256,1952,1,19787
642,2019-10-04,3525,12184,937,0,16646
642,2019-10-05,3347,14270,1847,0,19464
642,2019-10-06,3472,9985,2020,1,15478
642,2019-10-07,2519,6713,1713,0,10945
642,2019-10-08,2058,12638,1257,6,15959
642,2019-10-09,2660,31825,2074,2,36561
642,2019-10-10,1929,18382,1387,0,21698
642,2019-10-11,2932,17382,1298,0,21612
642,2019-10-12,3291,7565,1485,0,12341
642,2019-10-13,5280,8906,1938,3,16127
642,2019-10-14,3384,6587,2061,1,12033
642,2019-10-15,2562,9283,1966,0,13811
642,2019-10-16,3244,13176,1500,0,17920
642,2019-10-17,2872,5738,3164,2,11776
642,2019-10-18,2704,8532,1737,2,12975
642,2019-10-19,1239,7619,1841,57,10756
642,2019-10-20,3734,6887,1646,0,12267
642,2019-10-21,1696,11240,1249,2,14187
642,2019-10-22,2144,7138,2020,2,11304
642,2019-10-23,1887,14363,1826,3,18079
642,2019-10-24,1494,25815,1335,1,28645
642,2019-10-25,3407,16720,1550,2,21679
642,2019-10-26,1860,14007,2213,1,18081
642,2019-10-27,1895,28844,2113,0,32852
642,2019-10-28,1909,35450,898,0,38257
642,2019-10-29,2685,31774,1373,96,35928
642,2019-10-30,2438,23864,1479,0,27781
642,2019-10-31,2305,12660,2034,0,16999
642,2019-11-01,2434,15141,663,1,18239
642,2019-11-02,3184,14322,735,2,18243
642,2019-11-03,3601,25118,1584,0,30303
642,2019-11-04,2522,8155,1482,2,12161
642,2019-11-05,2506,3293,1724,0,7523
642,2019-11-06,3600,8764,879,0,13243
642,2019-11-07,3410,13834,503,5,17752
642,2019-11-08,3609,10024,1330,0,14963
642,2019-11-09,2822,13423,1752,0,17997
642,2019-11-10,2513,16391,1000,0,19904
642,2019-11-11,2296,10097,1601,1,13995
642,2019-11-12,2275,11545,2444,3,16267
642,2019-11-13,1527,12161,1728,1,15417
642,2019-11-14,1578,9038,2155,1,12772
642,2019-11-15,2361,4181,2094,2,8638
642,2019-11-16,1410,2846,2639,0,6895
642,2019-11-17,1184,3472,2380,0,7036
642,2019-11-18,1019,2737,3477,0,7233
642,2019-11-19,2062,3496,2873,0,8431
642,2019-11-20,903,2292,2244,0,5439
642,2019-11-21,968,3795,1376,0,6139
642,2019-11-22,925,5766,1859,2,8552
642,2019-11-23,735,6765,2872,8,10380
642,2019-11-24,1216,6768,2010,0,9994
642,2019-11-25,1367,10970,1936,0,14273
642,2019-11-26,1147,10117,1952,0,13216
642,2019-11-27,918,7070,1094,1,9083
642,2019-11-28,764,13624,481,1,14870
642,2019-11-29,480,684,3,0,1167
642,2019-08-01,187,19870,464,1,20522
642,2019-08-02,91,22724,238,0,23053
642,2019-08-03,68,6614,552,0,7234
642,2019-08-04,75,1416,245,2,1738
642,2019-08-05,102,1107,781,0,1990
642,2019-08-06,1405,9484,624,0,11513
642,2019-08-07,1717,11821,352,1,13891
642,2019-08-08,636,3622,433,0,4691
642,2019-08-09,122,2639,209,3,2973
642,2019-08-10,105,1747,237,0,2089
642,2019-08-11,127,5721,128,0,5976
642,2019-08-12,76,1967,139,0,2182
642,2019-08-13,95,6031,313,1,6440
642,2019-08-14,1828,2085,153,0,4066
642,2019-08-15,439,1668,10,1,2118
642,2019-08-16,87,3251,83,0,3421
642,2019-08-17,480,3676,717,1,4874
642,2019-08-18,2809,3687,1373,1,7870
642,2019-08-19,2232,6448,1215,2,9897
642,2019-08-20,3177,4098,906,1,8182
642,2019-08-21,592,20710,1350,0,22652
642,2019-08-22,213,42518,1070,1,43802
642,2019-08-23,107,13316,1169,1,14593
642,2019-08-24,2564,7508,1388,4,11464
642,2019-08-25,2066,22924,1620,2,26612
642,2019-08-26,1878,38760,1902,0,42540
642,2019-08-27,3210,11020,1892,0,16122
642,2019-08-28,2223,34649,1969,2,38843
642,2019-08-29,2383,21985,1710,2,26080
642,2019-08-30,2807,7138,553,2,10500
642,2019-08-31,971,3172,1,0,4144
642,2019-09-01,118,631,306,0,1055
642,2019-09-02,137,1067,39,0,1243
642,2019-09-03,103,3226,543,1,3873
642,2019-09-04,1579,9181,1642,2,12404
642,2019-09-05,1969,10033,1534,0,13536
642,2019-09-06,2637,10468,2600,0,15705
642,2019-09-07,2605,9141,125916,2,137664
642,2019-09-08,1842,49822,2211,0,53875
642,2019-09-09,1683,5162,1908,18,8771
642,2019-09-10,1599,37967,1847,0,41413
642,2019-09-11,1623,43068,1397,29,46117
642,2019-09-12,2536,55689,2356,4,60585
642,2019-09-13,1572,8342,1976,1,11891
642,2019-09-14,2427,7477,1319,1,11224
642,2019-09-15,1615,12180,1312,1,15108
642,2019-09-16,2391,12382,2374,5,17152
642,2019-09-17,2244,31363,2500,8,36115
642,2019-09-18,1391,15733,1484,9,18617
642,2019-09-19,2749,10633,1173,9,14564
642,2019-09-20,2521,18309,1811,9,22650
642,2019-09-21,1356,7194,2430,11,10991
642,2019-09-22,1811,9874,2050,5,13740
642,2019-09-23,1861,9109,1657,4,12631
642,2019-09-24,1748,14312,1728,1,17789
642,2019-09-25,1868,8465,2114,4,12451
642,2019-09-26,1557,10650,1918,31,14156
642,2019-09-27,2103,26373,1808,2,30286
642,2019-09-28,2488,35748,1791,3,40030
642,2019-09-29,2789,31340,2382,259,36770
642,2019-09-30,2236,26083,1613,3,29935
642,2019-10-01,2619,16535,1508,1,20663
642,2019-10-02,3621,10830,1400,1,15852
642,2019-10-03,3578,14256,1952,1,19787
642,2019-10-04,3525,12184,937,0,16646
642,2019-10-05,3347,14270,1847,0,19464
642,2019-10-06,3472,9985,2020,1,15478
642,2019-10-07,2519,6713,1713,0,10945
642,2019-10-08,2058,12638,1257,6,15959
642,2019-10-09,2660,31825,2074,2,36561
642,2019-10-10,1929,18382,1387,0,21698
642,2019-10-11,2932,17382,1298,0,21612
642,2019-10-12,3291,7565,1485,0,12341
642,2019-10-13,5280,8906,1938,3,16127
642,2019-10-14,3384,6587,2061,1,12033
642,2019-10-15,2562,9283,1966,0,13811
642,2019-10-16,3244,13176,1500,0,17920
642,2019-10-17,2872,5738,3164,2,11776
642,2019-10-18,2704,8532,1737,2,12975
642,2019-10-19,1239,7619,1841,57,10756
642,2019-10-20,3734,6887,1646,0,12267
642,2019-10-21,1696,11240,1249,2,14187
642,2019-10-22,2144,7138,2020,2,11304
642,2019-10-23,1887,14363,1826,3,18079
642,2019-10-24,1494,25815,1335,1,28645
642,2019-10-25,3407,16720,1550,2,21679
642,2019-10-26,1860,14007,2213,1,18081
642,2019-10-27,1895,28844,2113,0,32852
642,2019-10-28,1909,35450,898,0,38257
642,2019-10-29,2685,31774,1373,96,35928
642,2019-10-30,2438,23864,1479,0,27781
642,2019-10-31,2305,12660,2034,0,16999
642,2019-11-01,2434,15141,663,1,18239
642,2019-11-02,3184,14322,735,2,18243
642,2019-11-03,3601,25118,1584,0,30303
642,2019-11-04,2522,8155,1482,2,12161
642,2019-11-05,2506,3293,1724,0,7523
642,2019-11-06,3600,8764,879,0,13243
642,2019-11-07,3410,13834,503,5,17752
642,2019-11-08,3609,10024,1330,0,14963
642,2019-11-09,2822,13423,1752,0,17997
642,2019-11-10,2513,16391,1000,0,19904
642,2019-11-11,2296,10097,1601,1,13995
642,2019-11-12,2275,11545,2444,3,16267
642,2019-11-13,1527,12161,1728,1,15417
642,2019-11-14,1578,9038,2155,1,12772
642,2019-11-15,2361,4181,2094,2,8638
642,2019-11-16,1410,2846,2639,0,6895
642,2019-11-17,1184,3472,2380,0,7036
642,2019-11-18,1019,2737,3477,0,7233
642,2019-11-19,2062,3496,2873,0,8431
642,2019-11-20,903,2292,2244,0,5439
642,2019-11-21,968,3795,1376,0,6139
642,2019-11-22,925,5766,1859,2,8552
642,2019-11-23,735,6765,2872,8,10380
642,2019-11-24,1216,6768,2010,0,9994
642,2019-11-25,1367,10970,1936,0,14273
642,2019-11-26,1147,10117,1952,0,13216
642,2019-11-27,918,7070,1094,1,9083
642,2019-11-28,764,13624,481,1,14870
642,2019-11-29,480,684,3,0,1167
642,2019-08-01,187,19870,464,1,20522
642,2019-08-02,91,22724,238,0,23053
642,2019-08-03,68,6614,552,0,7234
642,2019-08-04,75,1416,245,2,1738
642,2019-08-05,102,1107,781,0,1990
642,2019-08-06,1405,9484,624,0,11513
642,2019-08-07,1717,11821,352,1,13891
642,2019-08-08,636,3622,433,0,4691
642,2019-08-09,122,2639,209,3,2973
642,2019-08-10,105,1747,237,0,2089
642,2019-08-11,127,5721,128,0,5976
642,2019-08-12,76,1967,139,0,2182
642,2019-08-13,95,6031,313,1,6440
642,2019-08-14,1828,2085,153,0,4066
642,2019-08-15,439,1668,10,1,2118
642,2019-08-16,87,3251,83,0,3421
642,2019-08-17,480,3676,717,1,4874
642,2019-08-18,2809,3687,1373,1,7870
642,2019-08-19,2232,6448,1215,2,9897
642,2019-08-20,3177,4098,906,1,8182
642,2019-08-21,592,20710,1350,0,22652
642,2019-08-22,213,42518,1070,1,43802
642,2019-08-23,107,13316,1169,1,14593
642,2019-08-24,2564,7508,1388,4,11464
642,2019-08-25,2066,22924,1620,2,26612
642,2019-08-26,1878,38760,1902,0,42540
642,2019-08-27,3210,11020,1892,0,16122
642,2019-08-28,2223,34649,1969,2,38843
642,2019-08-29,2383,21985,1710,2,26080
642,2019-08-30,2807,7138,553,2,10500
642,2019-08-31,971,3172,1,0,4144
642,2019-09-01,118,631,306,0,1055
642,2019-09-02,137,1067,39,0,1243
642,2019-09-03,103,3226,543,1,3873
642,2019-09-04,1579,9181,1642,2,12404
642,2019-09-05,1969,10033,1534,0,13536
642,2019-09-06,2637,10468,2600,0,15705
642,2019-09-07,2605,9141,125916,2,137664
642,2019-09-08,1842,49822,2211,0,53875
642,2019-09-09,1683,5162,1908,18,8771
642,2019-09-10,1599,37967,1847,0,41413
642,2019-09-11,1623,43068,1397,29,46117
642,2019-09-12,2536,55689,2356,4,60585
642,2019-09-13,1572,8342,1976,1,11891
642,2019-09-14,2427,7477,1319,1,11224
642,2019-09-15,1615,12180,1312,1,15108
642,2019-09-16,2391,12382,2374,5,17152
642,2019-09-17,2244,31363,2500,8,36115
642,2019-09-18,1391,15733,1484,9,18617
642,2019-09-19,2749,10633,1173,9,14564
642,2019-09-20,2521,18309,1811,9,22650
642,2019-09-21,1356,7194,2430,11,10991
642,2019-09-22,1811,9874,2050,5,13740
642,2019-09-23,1861,9109,1657,4,12631
642,2019-09-24,1748,14312,1728,1,17789
642,2019-09-25,1868,8465,2114,4,12451
642,2019-09-26,1557,10650,1918,31,14156
642,2019-09-27,2103,26373,1808,2,30286
642,2019-09-28,2488,35748,1791,3,40030
642,2019-09-29,2789,31340,2382,259,36770
642,2019-09-30,2236,26083,1613,3,29935
642,2019-10-01,2619,16535,1508,1,20663
642,2019-10-02,3621,10830,1400,1,15852
642,2019-10-03,3578,14256,1952,1,19787
642,2019-10-04,3525,12184,937,0,16646
642,2019-10-05,3347,14270,1847,0,19464
642,2019-10-06,3472,9985,2020,1,15478
642,2019-10-07,2519,6713,1713,0,10945
642,2019-10-08,2058,12638,1257,6,15959
642,2019-10-09,2660,31825,2074,2,36561
642,2019-10-10,1929,18382,1387,0,21698
642,2019-10-11,2932,17382,1298,0,21612
642,2019-10-12,3291,7565,1485,0,12341
642,2019-10-13,5280,8906,1938,3,16127
642,2019-10-14,3384,6587,2061,1,12033
642,2019-10-15,2562,9283,1966,0,13811
642,2019-10-16,3244,13176,1500,0,17920
642,2019-10-17,2872,5738,3164,2,11776
642,2019-10-18,2704,8532,1737,2,12975
642,2019-10-19,1239,7619,1841,57,10756
642,2019-10-20,3734,6887,1646,0,12267
642,2019-10-21,1696,11240,1249,2,14187
642,2019-10-22,2144,7138,2020,2,11304
642,2019-10-23,1887,14363,1826,3,18079
642,2019-10-24,1494,25815,1335,1,28645
642,2019-10-25,3407,16720,1550,2,21679
642,2019-10-26,1860,14007,2213,1,18081
642,2019-10-27,1895,28844,2113,0,32852
642,2019-10-28,1909,35450,898,0,38257
642,2019-10-29,2685,31774,1373,96,35928
642,2019-10-30,2438,23864,1479,0,27781
642,2019-10-31,2305,12660,2034,0,16999
642,2019-11-01,2434,15141,663,1,18239
642,2019-11-02,3184,14322,735,2,18243
642,2019-11-03,3601,25118,1584,0,30303
642,2019-11-04,2522,8155,1482,2,12161
642,2019-11-05,2506,3293,1724,0,7523
642,2019-11-06,3600,8764,879,0,13243
642,2019-11-07,3410,13834,503,5,17752
642,2019-11-08,3609,10024,1330,0,14963
642,2019-11-09,2822,13423,1752,0,17997
642,2019-11-10,2513,16391,1000,0,19904
642,2019-11-11,2296,10097,1601,1,13995
642,2019-11-12,2275,11545,2444,3,16267
642,2019-11-13,1527,12161,1728,1,15417
642,2019-11-14,1578,9038,2155,1,12772
642,2019-11-15,2361,4181,2094,2,8638
642,2019-11-16,1410,2846,2639,0,6895
642,2019-11-17,1184,3472,2380,0,7036
642,2019-11-18,1019,2737,3477,0,7233
642,2019-11-19,2062,3496,2873,0,8431
642,2019-11-20,903,2292,2244,0,5439
642,2019-11-21,968,3795,1376,0,6139
642,2019-11-22,925,5766,1859,2,8552
642,2019-11-23,735,6765,2872,8,10380
642,2019-11-24,1216,6768,2010,0,9994
642,2019-11-25,1367,10970,1936,0,14273
642,2019-11-26,1147,10117,1952,0,13216
642,2019-11-27,918,7070,1094,1,9083
642,2019-11-28,764,13624,481,1,14870
642,2019-11-29,480,684,3,0,1167
642,2019-08-01,187,19870,464,1,20522
642,2019-08-02,91,22724,238,0,23053
642,2019-08-03,68,6614,552,0,7234
642,2019-08-04,75,1416,245,2,1738
642,2019-08-05,102,1107,781,0,1990
642,2019-08-06,1405,9484,624,0,11513
642,2019-08-07,1717,11821,352,1,13891
642,2019-08-08,636,3622,433,0,4691
642,2019-08-09,122,2639,209,3,2973
642,2019-08-10,105,1747,237,0,2089
642,2019-08-11,127,5721,128,0,5976
642,2019-08-12,76,1967,139,0,2182
642,2019-08-13,95,6031,313,1,6440
642,2019-08-14,1828,2085,153,0,4066
642,2019-08-15,439,1668,10,1,2118
642,2019-08-16,87,3251,83,0,3421
642,2019-08-17,480,3676,717,1,4874
642,2019-08-18,2809,3687,1373,1,7870
642,2019-08-19,2232,6448,1215,2,9897
642,2019-08-20,3177,4098,906,1,8182
642,2019-08-21,592,20710,1350,0,22652
642,2019-08-22,213,42518,1070,1,43802
642,2019-08-23,107,13316,1169,1,14593
642,2019-08-24,2564,7508,1388,4,11464
642,2019-08-25,2066,22924,1620,2,26612
642,2019-08-26,1878,38760,1902,0,42540
642,2019-08-27,3210,11020,1892,0,16122
642,2019-08-28,2223,34649,1969,2,38843
642,2019-08-29,2383,21985,1710,2,26080
642,2019-08-30,2807,7138,553,2,10500
642,2019-08-31,971,3172,1,0,4144
642,2019-09-01,118,631,306,0,1055
642,2019-09-02,137,1067,39,0,1243
642,2019-09-03,103,3226,543,1,3873
642,2019-09-04,1579,9181,1642,2,12404
642,2019-09-05,1969,10033,1534,0,13536
642,2019-09-06,2637,10468,2600,0,15705
642,2019-09-07,2605,9141,125916,2,137664
642,2019-09-08,1842,49822,2211,0,53875
642,2019-09-09,1683,5162,1908,18,8771
642,2019-09-10,1599,37967,1847,0,41413
642,2019-09-11,1623,43068,1397,29,46117
642,2019-09-12,2536,55689,2356,4,60585
642,2019-09-13,1572,8342,1976,1,11891
642,2019-09-14,2427,7477,1319,1,11224
642,2019-09-15,1615,12180,1312,1,15108
642,2019-09-16,2391,12382,2374,5,17152
642,2019-09-17,2244,31363,2500,8,36115
642,2019-09-18,1391,15733,1484,9,18617
642,2019-09-19,2749,10633,1173,9,14564
642,2019-09-20,2521,18309,1811,9,22650
642,2019-09-21,1356,7194,2430,11,10991
642,2019-09-22,1811,9874,2050,5,13740
642,2019-09-23,1861,9109,1657,4,12631
642,2019-09-24,1748,14312,1728,1,17789
642,2019-09-25,1868,8465,2114,4,12451
642,2019-09-26,1557,10650,1918,31,14156
642,2019-09-27,2103,26373,1808,2,30286
642,2019-09-28,2488,35748,1791,3,40030
642,2019-09-29,2789,31340,2382,259,36770
642,2019-09-30,2236,26083,1613,3,29935
642,2019-10-01,2619,16535,1508,1,20663
642,2019-10-02,3621,10830,1400,1,15852
642,2019-10-03,3578,14256,1952,1,19787
642,2019-10-04,3525,12184,937,0,16646
642,2019-10-05,3347,14270,1847,0,19464
642,2019-10-06,3472,9985,2020,1,15478
642,2019-10-07,2519,6713,1713,0,10945
642,2019-10-08,2058,12638,1257,6,15959
642,2019-10-09,2660,31825,2074,2,36561
642,2019-10-10,1929,18382,1387,0,21698
642,2019-10-11,2932,17382,1298,0,21612
642,2019-10-12,3291,7565,1485,0,12341
642,2019-10-13,5280,8906,1938,3,16127
642,2019-10-14,3384,6587,2061,1,12033
642,2019-10-15,2562,9283,1966,0,13811
642,2019-10-16,3244,13176,1500,0,17920
642,2019-10-17,2872,5738,3164,2,11776
642,2019-10-18,2704,8532,1737,2,12975
642,2019-10-19,1239,7619,1841,57,10756
642,2019-10-20,3734,6887,1646,0,12267
642,2019-10-21,1696,11240,1249,2,14187
642,2019-10-22,2144,7138,2020,2,11304
642,2019-10-23,1887,14363,1826,3,18079
642,2019-10-24,1494,25815,1335,1,28645
642,2019-10-25,3407,16720,1550,2,21679
642,2019-10-26,1860,14007,2213,1,18081
642,2019-10-27,1895,28844,2113,0,32852
642,2019-10-28,1909,35450,898,0,38257
642,2019-10-29,2685,31774,1373,96,35928
642,2019-10-30,2438,23864,1479,0,27781
642,2019-10-31,2305,12660,2034,0,16999
642,2019-11-01,2434,15141,663,1,18239
642,2019-11-02,3184,14322,735,2,18243
642,2019-11-03,3601,25118,1584,0,30303
642,2019-11-04,2522,8155,1482,2,12161
642,2019-11-05,2506,3293,1724,0,7523
642,2019-11-06,3600,8764,879,0,13243
642,2019-11-07,3410,13834,503,5,17752
642,2019-11-08,3609,10024,1330,0,14963
642,2019-11-09,2822,13423,1752,0,17997
642,2019-11-10,2513,16391,1000,0,19904
642,2019-11-11,2296,10097,1601,1,13995
642,2019-11-12,2275,11545,2444,3,16267
642,2019-11-13,1527,12161,1728,1,15417
642,2019-11-14,1578,9038,2155,1,12772
642,2019-11-15,2361,4181,2094,2,8638
642,2019-11-16,1410,2846,2639,0,6895
642,2019-11-17,1184,3472,2380,0,7036
642,2019-11-18,1019,2737,3477,0,7233
642,2019-11-19,2062,3496,2873,0,8431
642,2019-11-20,903,2292,2244,0,5439
642,2019-11-21,968,3795,1376,0,6139
642,2019-11-22,925,5766,1859,2,8552
642,2019-11-23,735,6765,2872,8,10380
642,2019-11-24,1216,6768,2010,0,9994
642,2019-11-25,1367,10970,1936,0,14273
642,2019-11-26,1147,10117,1952,0,13216
642,2019-11-27,918,7070,1094,1,9083
642,2019-11-28,764,13624,481,1,14870
643,2019-08-01,25,31891,162,0,32078
643,2019-08-02,53,34502,387,0,34942
643,2019-08-03,27,9632,615,2,10276
643,2019-08-04,480,1258,542,0,2280
643,2019-08-05,33,7548,486,1,8068
643,2019-08-06,39,11440,462,0,11941
643,2019-08-07,64,6772,662,0,7498
643,2019-08-08,213,1475,804,0,2492
643,2019-08-09,14,1536,551,0,2101
643,2019-08-10,376,1627,213,1,2217
643,2019-08-11,92,5882,281,0,6255
643,2019-08-12,26,6811,137,0,6974
643,2019-08-13,68,10642,244,0,10954
643,2019-08-14,27,6232,234,1,6494
643,2019-08-15,20,1670,258,1,1949
643,2019-08-16,28,3022,237,1,3288
643,2019-08-17,26,4833,946,1,5806
643,2019-08-18,35,3058,701,1,3795
643,2019-08-19,33,11031,1101,0,12165
643,2019-08-20,48,27771,1163,0,28982
643,2019-08-21,56,18015,949,2,19022
643,2019-08-22,135,19329,1850,0,21314
643,2019-08-23,54,25148,1259,1,26462
643,2019-08-24,1379,7911,1896,3,11189
643,2019-08-25,109,15530,1633,3,17275
643,2019-08-26,87,5294,1440,1,6822
643,2019-08-27,117,3959,1986,0,6062
643,2019-08-28,199,7800,2109,0,10108
643,2019-08-29,252,11975,1814,2,14043
643,2019-08-30,123,3638,746,1,4508
643,2019-08-31,64,558,1,0,623
643,2019-09-01,46,1481,96,0,1623
643,2019-09-02,22,794,23,0,839
643,2019-09-03,911,8959,1855,1,11726
643,2019-09-04,906,13842,2688,2,17438
643,2019-09-05,86,8685,2055,0,10826
643,2019-09-06,116,16193,2094,0,18403
643,2019-09-07,71,13560,2176,0,15807
643,2019-09-08,1038,9528,2189,0,12755
643,2019-09-09,95,11528,1629,1,13253
643,2019-09-10,944,7995,1854,0,10793
643,2019-09-11,391,6486,2824,8,9709
643,2019-09-12,149,11269,2609,2,14029
643,2019-09-13,55,6704,2509,2,9270
643,2019-09-14,626,6975,2037,1,9639
643,2019-09-15,908,9274,1963,1,12146
643,2019-09-16,910,14258,1582,4,16754
643,2019-09-17,81,8513,1961,7,10562
643,2019-09-18,109,12033,742,8,12892
643,2019-09-19,207,2883,1800,14,4904
643,2019-09-20,1045,9305,2455,11,12816
643,2019-09-21,63,5769,1980,9,7821
643,2019-09-22,896,9631,2005,10,12542
643,2019-09-23,151,7796,2026,13,9986
643,2019-09-24,92,8066,1198,14,9370
643,2019-09-25,992,7136,1370,10,9508
643,2019-09-26,125,10440,1788,10,12363
643,2019-09-27,58,8702,1518,3,10281
643,2019-09-28,924,15735,1992,3,18654
643,2019-09-29,37,14297,1810,6,16150
643,2019-09-30,73,17363,1640,10,19086
643,2019-10-01,949,16317,1789,1,19056
643,2019-10-02,144,11918,2677,6,14745
643,2019-10-03,131,13405,1875,10,15421
643,2019-10-04,48,11397,757,13,12215
643,2019-10-05,1085,15452,2342,11,18890
643,2019-10-06,48,11880,1701,12,13641
643,2019-10-07,424,4711,1926,12,7073
643,2019-10-08,919,13271,1268,10,15468
643,2019-10-09,1498,14765,1765,13,18041
643,2019-10-10,1382,9652,1711,10,12755
643,2019-10-11,66,12478,1984,10,14538
643,2019-10-12,1034,6038,1997,1,9070
643,2019-10-13,919,5737,1181,3,7840
643,2019-10-14,95,5860,2327,1,8283
643,2019-10-15,1798,7789,1517,2,11106
643,2019-10-16,258,13153,977,1,14389
643,2019-10-17,70,4194,2448,1,6713
643,2019-10-18,164,7966,1830,0,9960
643,2019-10-19,930,4693,1977,1,7601
643,2019-10-20,100,1097,1695,0,2892
643,2019-10-21,54,9982,1603,2,11641
643,2019-10-22,59,5092,1981,1,7133
643,2019-10-23,42,13593,1914,3,15552
643,2019-10-24,131,18363,1126,1,19621
643,2019-10-25,768,10408,2284,3,13463
643,2019-10-26,479,12461,1187,0,14127
643,2019-10-27,179,16470,1627,0,18276
643,2019-10-28,68,13957,1831,0,15856
643,2019-10-29,364,26012,1337,4,27717
643,2019-10-30,111,28611,890,0,29612
643,2019-10-31,60,13859,1339,0,15258
643,2019-11-01,262,14099,1297,0,15658
643,2019-11-02,46,13499,1341,1,14887
643,2019-11-03,806,36305,1622,2,38735
643,2019-11-04,81,9530,1475,0,11086
643,2019-11-05,1021,1946,2194,0,5161
643,2019-11-06,88,7569,1360,1,9018
643,2019-11-07,653,13409,1078,2,15142
643,2019-11-08,565,8969,2153,1,11688
643,2019-11-09,63,7795,2705,1,10564
643,2019-11-10,172,12664,1079,1,13916
643,2019-11-11,110,8344,1494,0,9948
643,2019-11-12,992,11416,3465,0,15873
643,2019-11-13,834,14076,2131,0,17041
643,2019-11-14,211,12468,1785,0,14464
643,2019-11-15,92,3985,1948,0,6025
643,2019-11-16,992,1134,2730,0,4856
643,2019-11-17,2001,2507,3568,0,8076
643,2019-11-18,82,1366,3070,0,4518
643,2019-11-19,78,3162,2494,0,5734
643,2019-11-20,93,1514,2459,0,4066
643,2019-11-21,64,3346,2410,0,5820
643,2019-11-22,250,5416,1882,0,7548
643,2019-11-23,182,6402,2251,3,8838
643,2019-11-24,175,6313,2165,0,8653
643,2019-11-25,999,6262,2210,0,9471
643,2019-11-26,53,5480,1335,0,6868
643,2019-11-27,862,5571,1709,1,8143
643,2019-11-28,492,12739,656,0,13887
643,2019-11-29,18,193,1,0,212
643,2019-08-01,25,31891,162,0,32078
643,2019-08-02,53,34502,387,0,34942
643,2019-08-03,27,9632,615,2,10276
643,2019-08-04,480,1258,542,0,2280
643,2019-08-05,33,7548,486,1,8068
643,2019-08-06,39,11440,462,0,11941
643,2019-08-07,64,6772,662,0,7498
643,2019-08-08,213,1475,804,0,2492
643,2019-08-09,14,1536,551,0,2101
643,2019-08-10,376,1627,213,1,2217
643,2019-08-11,92,5882,281,0,6255
643,2019-08-12,26,6811,137,0,6974
643,2019-08-13,68,10642,244,0,10954
643,2019-08-14,27,6232,234,1,6494
643,2019-08-15,20,1670,258,1,1949
643,2019-08-16,28,3022,237,1,3288
643,2019-08-17,26,4833,946,1,5806
643,2019-08-18,35,3058,701,1,3795
643,2019-08-19,33,11031,1101,0,12165
643,2019-08-20,48,27771,1163,0,28982
643,2019-08-21,56,18015,949,2,19022
643,2019-08-22,135,19329,1850,0,21314
643,2019-08-23,54,25148,1259,1,26462
643,2019-08-24,1379,7911,1896,3,11189
643,2019-08-25,109,15530,1633,3,17275
643,2019-08-26,87,5294,1440,1,6822
643,2019-08-27,117,3959,1986,0,6062
643,2019-08-28,199,7800,2109,0,10108
643,2019-08-29,252,11975,1814,2,14043
643,2019-08-30,123,3638,746,1,4508
643,2019-08-31,64,558,1,0,623
643,2019-09-01,46,1481,96,0,1623
643,2019-09-02,22,794,23,0,839
643,2019-09-03,911,8959,1855,1,11726
643,2019-09-04,906,13842,2688,2,17438
643,2019-09-05,86,8685,2055,0,10826
643,2019-09-06,116,16193,2094,0,18403
643,2019-09-07,71,13560,2176,0,15807
643,2019-09-08,1038,9528,2189,0,12755
643,2019-09-09,95,11528,1629,1,13253
643,2019-09-10,944,7995,1854,0,10793
643,2019-09-11,391,6486,2824,8,9709
643,2019-09-12,149,11269,2609,2,14029
643,2019-09-13,55,6704,2509,2,9270
643,2019-09-14,626,6975,2037,1,9639
643,2019-09-15,908,9274,1963,1,12146
643,2019-09-16,910,14258,1582,4,16754
643,2019-09-17,81,8513,1961,7,10562
643,2019-09-18,109,12033,742,8,12892
643,2019-09-19,207,2883,1800,14,4904
643,2019-09-20,1045,9305,2455,11,12816
643,2019-09-21,63,5769,1980,9,7821
643,2019-09-22,896,9631,2005,10,12542
643,2019-09-23,151,7796,2026,13,9986
643,2019-09-24,92,8066,1198,14,9370
643,2019-09-25,992,7136,1370,10,9508
643,2019-09-26,125,10440,1788,10,12363
643,2019-09-27,58,8702,1518,3,10281
643,2019-09-28,924,15735,1992,3,18654
643,2019-09-29,37,14297,1810,6,16150
643,2019-09-30,73,17363,1640,10,19086
643,2019-10-01,949,16317,1789,1,19056
643,2019-10-02,144,11918,2677,6,14745
643,2019-10-03,131,13405,1875,10,15421
643,2019-10-04,48,11397,757,13,12215
643,2019-10-05,1085,15452,2342,11,18890
643,2019-10-06,48,11880,1701,12,13641
643,2019-10-07,424,4711,1926,12,7073
643,2019-10-08,919,13271,1268,10,15468
643,2019-10-09,1498,14765,1765,13,18041
643,2019-10-10,1382,9652,1711,10,12755
643,2019-10-11,66,12478,1984,10,14538
643,2019-10-12,1034,6038,1997,1,9070
643,2019-10-13,919,5737,1181,3,7840
643,2019-10-14,95,5860,2327,1,8283
643,2019-10-15,1798,7789,1517,2,11106
643,2019-10-16,258,13153,977,1,14389
643,2019-10-17,70,4194,2448,1,6713
643,2019-10-18,164,7966,1830,0,9960
643,2019-10-19,930,4693,1977,1,7601
643,2019-10-20,100,1097,1695,0,2892
643,2019-10-21,54,9982,1603,2,11641
643,2019-10-22,59,5092,1981,1,7133
643,2019-10-23,42,13593,1914,3,15552
643,2019-10-24,131,18363,1126,1,19621
643,2019-10-25,768,10408,2284,3,13463
643,2019-10-26,479,12461,1187,0,14127
643,2019-10-27,179,16470,1627,0,18276
643,2019-10-28,68,13957,1831,0,15856
643,2019-10-29,364,26012,1337,4,27717
643,2019-10-30,111,28611,890,0,29612
643,2019-10-31,60,13859,1339,0,15258
643,2019-11-01,262,14099,1297,0,15658
643,2019-11-02,46,13499,1341,1,14887
643,2019-11-03,806,36305,1622,2,38735
643,2019-11-04,81,9530,1475,0,11086
643,2019-11-05,1021,1946,2194,0,5161
643,2019-11-06,88,7569,1360,1,9018
643,2019-11-07,653,13409,1078,2,15142
643,2019-11-08,565,8969,2153,1,11688
643,2019-11-09,63,7795,2705,1,10564
643,2019-11-10,172,12664,1079,1,13916
643,2019-11-11,110,8344,1494,0,9948
643,2019-11-12,992,11416,3465,0,15873
643,2019-11-13,834,14076,2131,0,17041
643,2019-11-14,211,12468,1785,0,14464
643,2019-11-15,92,3985,1948,0,6025
643,2019-11-16,992,1134,2730,0,4856
643,2019-11-17,2001,2507,3568,0,8076
643,2019-11-18,82,1366,3070,0,4518
643,2019-11-19,78,3162,2494,0,5734
643,2019-11-20,93,1514,2459,0,4066
643,2019-11-21,64,3346,2410,0,5820
643,2019-11-22,250,5416,1882,0,7548
643,2019-11-23,182,6402,2251,3,8838
643,2019-11-24,175,6313,2165,0,8653
643,2019-11-25,999,6262,2210,0,9471
643,2019-11-26,53,5480,1335,0,6868
643,2019-11-27,862,5571,1709,1,8143
643,2019-11-28,492,12739,656,0,13887
643,2019-11-29,18,193,1,0,212
643,2019-08-01,25,31891,162,0,32078
643,2019-08-02,53,34502,387,0,34942
643,2019-08-03,27,9632,615,2,10276
643,2019-08-04,480,1258,542,0,2280
643,2019-08-05,33,7548,486,1,8068
643,2019-08-06,39,11440,462,0,11941
643,2019-08-07,64,6772,662,0,7498
643,2019-08-08,213,1475,804,0,2492
643,2019-08-09,14,1536,551,0,2101
643,2019-08-10,376,1627,213,1,2217
643,2019-08-11,92,5882,281,0,6255
643,2019-08-12,26,6811,137,0,6974
643,2019-08-13,68,10642,244,0,10954
643,2019-08-14,27,6232,234,1,6494
643,2019-08-15,20,1670,258,1,1949
643,2019-08-16,28,3022,237,1,3288
643,2019-08-17,26,4833,946,1,5806
643,2019-08-18,35,3058,701,1,3795
643,2019-08-19,33,11031,1101,0,12165
643,2019-08-20,48,27771,1163,0,28982
643,2019-08-21,56,18015,949,2,19022
643,2019-08-22,135,19329,1850,0,21314
643,2019-08-23,54,25148,1259,1,26462
643,2019-08-24,1379,7911,1896,3,11189
643,2019-08-25,109,15530,1633,3,17275
643,2019-08-26,87,5294,1440,1,6822
643,2019-08-27,117,3959,1986,0,6062
643,2019-08-28,199,7800,2109,0,10108
643,2019-08-29,252,11975,1814,2,14043
643,2019-08-30,123,3638,746,1,4508
643,2019-08-31,64,558,1,0,623
643,2019-09-01,46,1481,96,0,1623
643,2019-09-02,22,794,23,0,839
643,2019-09-03,911,8959,1855,1,11726
643,2019-09-04,906,13842,2688,2,17438
643,2019-09-05,86,8685,2055,0,10826
643,2019-09-06,116,16193,2094,0,18403
643,2019-09-07,71,13560,2176,0,15807
643,2019-09-08,1038,9528,2189,0,12755
643,2019-09-09,95,11528,1629,1,13253
643,2019-09-10,944,7995,1854,0,10793
643,2019-09-11,391,6486,2824,8,9709
643,2019-09-12,149,11269,2609,2,14029
643,2019-09-13,55,6704,2509,2,9270
643,2019-09-14,626,6975,2037,1,9639
643,2019-09-15,908,9274,1963,1,12146
643,2019-09-16,910,14258,1582,4,16754
643,2019-09-17,81,8513,1961,7,10562
643,2019-09-18,109,12033,742,8,12892
643,2019-09-19,207,2883,1800,14,4904
643,2019-09-20,1045,9305,2455,11,12816
643,2019-09-21,63,5769,1980,9,7821
643,2019-09-22,896,9631,2005,10,12542
643,2019-09-23,151,7796,2026,13,9986
643,2019-09-24,92,8066,1198,14,9370
643,2019-09-25,992,7136,1370,10,9508
643,2019-09-26,125,10440,1788,10,12363
643,2019-09-27,58,8702,1518,3,10281
643,2019-09-28,924,15735,1992,3,18654
643,2019-09-29,37,14297,1810,6,16150
643,2019-09-30,73,17363,1640,10,19086
643,2019-10-01,949,16317,1789,1,19056
643,2019-10-02,144,11918,2677,6,14745
643,2019-10-03,131,13405,1875,10,15421
643,2019-10-04,48,11397,757,13,12215
643,2019-10-05,1085,15452,2342,11,18890
643,2019-10-06,48,11880,1701,12,13641
643,2019-10-07,424,4711,1926,12,7073
643,2019-10-08,919,13271,1268,10,15468
643,2019-10-09,1498,14765,1765,13,18041
643,2019-10-10,1382,9652,1711,10,12755
643,2019-10-11,66,12478,1984,10,14538
643,2019-10-12,1034,6038,1997,1,9070
643,2019-10-13,919,5737,1181,3,7840
643,2019-10-14,95,5860,2327,1,8283
643,2019-10-15,1798,7789,1517,2,11106
643,2019-10-16,258,13153,977,1,14389
643,2019-10-17,70,4194,2448,1,6713
643,2019-10-18,164,7966,1830,0,9960
643,2019-10-19,930,4693,1977,1,7601
643,2019-10-20,100,1097,1695,0,2892
643,2019-10-21,54,9982,1603,2,11641
643,2019-10-22,59,5092,1981,1,7133
643,2019-10-23,42,13593,1914,3,15552
643,2019-10-24,131,18363,1126,1,19621
643,2019-10-25,768,10408,2284,3,13463
643,2019-10-26,479,12461,1187,0,14127
643,2019-10-27,179,16470,1627,0,18276
643,2019-10-28,68,13957,1831,0,15856
643,2019-10-29,364,26012,1337,4,27717
643,2019-10-30,111,28611,890,0,29612
643,2019-10-31,60,13859,1339,0,15258
643,2019-11-01,262,14099,1297,0,15658
643,2019-11-02,46,13499,1341,1,14887
643,2019-11-03,806,36305,1622,2,38735
643,2019-11-04,81,9530,1475,0,11086
643,2019-11-05,1021,1946,2194,0,5161
643,2019-11-06,88,7569,1360,1,9018
643,2019-11-07,653,13409,1078,2,15142
643,2019-11-08,565,8969,2153,1,11688
643,2019-11-09,63,7795,2705,1,10564
643,2019-11-10,172,12664,1079,1,13916
643,2019-11-11,110,8344,1494,0,9948
643,2019-11-12,992,11416,3465,0,15873
643,2019-11-13,834,14076,2131,0,17041
643,2019-11-14,211,12468,1785,0,14464
643,2019-11-15,92,3985,1948,0,6025
643,2019-11-16,992,1134,2730,0,4856
643,2019-11-17,2001,2507,3568,0,8076
643,2019-11-18,82,1366,3070,0,4518
643,2019-11-19,78,3162,2494,0,5734
643,2019-11-20,93,1514,2459,0,4066
643,2019-11-21,64,3346,2410,0,5820
643,2019-11-22,250,5416,1882,0,7548
643,2019-11-23,182,6402,2251,3,8838
643,2019-11-24,175,6313,2165,0,8653
643,2019-11-25,999,6262,2210,0,9471
643,2019-11-26,53,5480,1335,0,6868
643,2019-11-27,862,5571,1709,1,8143
643,2019-11-28,492,12739,656,0,13887
643,2019-11-29,18,193,1,0,212
643,2019-08-03,27,9632,615,2,10276
643,2019-08-04,480,1258,542,0,2280
643,2019-08-05,33,7548,486,1,8068
643,2019-08-06,39,11440,462,0,11941
643,2019-08-07,64,6772,662,0,7498
643,2019-08-08,213,1475,804,0,2492
643,2019-08-09,14,1536,551,0,2101
643,2019-08-10,376,1627,213,1,2217
643,2019-08-11,92,5882,281,0,6255
643,2019-08-12,26,6811,137,0,6974
643,2019-08-13,68,10642,244,0,10954
643,2019-08-14,27,6232,234,1,6494
643,2019-08-15,20,1670,258,1,1949
643,2019-08-16,28,3022,237,1,3288
643,2019-08-17,26,4833,946,1,5806
643,2019-08-18,35,3058,701,1,3795
643,2019-08-19,33,11031,1101,0,12165
643,2019-08-20,48,27771,1163,0,28982
643,2019-08-21,56,18015,949,2,19022
643,2019-08-22,135,19329,1850,0,21314
643,2019-08-23,54,25148,1259,1,26462
643,2019-08-24,1379,7911,1896,3,11189
643,2019-08-25,109,15530,1633,3,17275
643,2019-08-26,87,5294,1440,1,6822
643,2019-08-27,117,3959,1986,0,6062
643,2019-08-28,199,7800,2109,0,10108
643,2019-08-29,252,11975,1814,2,14043
643,2019-08-30,123,3638,746,1,4508
643,2019-08-31,64,558,1,0,623
643,2019-09-01,46,1481,96,0,1623
643,2019-09-02,22,794,23,0,839
643,2019-09-03,911,8959,1855,1,11726
643,2019-09-04,906,13842,2688,2,17438
643,2019-09-05,86,8685,2055,0,10826
643,2019-09-06,116,16193,2094,0,18403
643,2019-09-07,71,13560,2176,0,15807
643,2019-09-08,1038,9528,2189,0,12755
643,2019-09-09,95,11528,1629,1,13253
643,2019-09-10,944,7995,1854,0,10793
643,2019-09-11,391,6486,2824,8,9709
643,2019-09-12,149,11269,2609,2,14029
643,2019-09-13,55,6704,2509,2,9270
643,2019-09-14,626,6975,2037,1,9639
643,2019-09-15,908,9274,1963,1,12146
643,2019-09-16,910,14258,1582,4,16754
643,2019-09-17,81,8513,1961,7,10562
643,2019-09-18,109,12033,742,8,12892
643,2019-09-19,207,2883,1800,14,4904
643,2019-09-20,1045,9305,2455,11,12816
643,2019-09-21,63,5769,1980,9,7821
643,2019-09-22,896,9631,2005,10,12542
643,2019-09-23,151,7796,2026,13,9986
643,2019-09-24,92,8066,1198,14,9370
643,2019-09-25,992,7136,1370,10,9508
643,2019-09-26,125,10440,1788,10,12363
643,2019-09-27,58,8702,1518,3,10281
643,2019-09-28,924,15735,1992,3,18654
643,2019-09-29,37,14297,1810,6,16150
643,2019-09-30,73,17363,1640,10,19086
643,2019-10-01,949,16317,1789,1,19056
643,2019-10-02,144,11918,2677,6,14745
643,2019-10-03,131,13405,1875,10,15421
643,2019-10-04,48,11397,757,13,12215
643,2019-10-05,1085,15452,2342,11,18890
643,2019-10-06,48,11880,1701,12,13641
643,2019-10-07,424,4711,1926,12,7073
643,2019-10-08,919,13271,1268,10,15468
643,2019-10-09,1498,14765,1765,13,18041
643,2019-10-10,1382,9652,1711,10,12755
643,2019-10-11,66,12478,1984,10,14538
643,2019-10-12,1034,6038,1997,1,9070
643,2019-10-13,919,5737,1181,3,7840
643,2019-10-14,95,5860,2327,1,8283
643,2019-10-15,1798,7789,1517,2,11106
643,2019-10-16,258,13153,977,1,14389
643,2019-10-17,70,4194,2448,1,6713
643,2019-10-18,164,7966,1830,0,9960
643,2019-10-19,930,4693,1977,1,7601
643,2019-10-20,100,1097,1695,0,2892
643,2019-10-21,54,9982,1603,2,11641
643,2019-10-22,59,5092,1981,1,7133
643,2019-10-23,42,13593,1914,3,15552
643,2019-10-24,131,18363,1126,1,19621
643,2019-10-25,768,10408,2284,3,13463
643,2019-10-26,479,12461,1187,0,14127
643,2019-10-27,179,16470,1627,0,18276
643,2019-10-28,68,13957,1831,0,15856
643,2019-10-29,364,26012,1337,4,27717
643,2019-10-30,111,28611,890,0,29612
643,2019-10-31,60,13859,1339,0,15258
643,2019-11-01,262,14099,1297,0,15658
643,2019-11-02,46,13499,1341,1,14887
643,2019-11-03,806,36305,1622,2,38735
643,2019-11-04,81,9530,1475,0,11086
643,2019-11-05,1021,1946,2194,0,5161
643,2019-11-06,88,7569,1360,1,9018
643,2019-11-07,653,13409,1078,2,15142
643,2019-11-08,565,8969,2153,1,11688
643,2019-11-09,63,7795,2705,1,10564
643,2019-11-10,172,12664,1079,1,13916
643,2019-11-11,110,8344,1494,0,9948
643,2019-11-12,992,11416,3465,0,15873
643,2019-11-13,834,14076,2131,0,17041
643,2019-11-14,211,12468,1785,0,14464
643,2019-11-15,92,3985,1948,0,6025
643,2019-11-16,992,1134,2730,0,4856
643,2019-11-17,2001,2507,3568,0,8076
643,2019-11-18,82,1366,3070,0,4518
643,2019-11-19,78,3162,2494,0,5734
643,2019-11-20,93,1514,2459,0,4066
643,2019-11-21,64,3346,2410,0,5820
643,2019-11-22,250,5416,1882,0,7548
643,2019-11-23,182,6402,2251,3,8838
643,2019-11-24,175,6313,2165,0,8653
643,2019-11-25,999,6262,2210,0,9471
643,2019-11-26,53,5480,1335,0,6868
643,2019-11-27,862,5571,1709,1,8143
644,2019-08-01,55,19865,75,0,19995
644,2019-08-02,823,27997,512,0,29332
644,2019-08-03,65,9638,218,3,9924
644,2019-08-04,49,1416,244,1,1710
644,2019-08-05,74,38532,177,0,38783
644,2019-08-06,47,15555,612,0,16214
644,2019-08-07,69,1248,476,0,1793
644,2019-08-08,37,1229,390,1,1657
644,2019-08-09,52,1199,114,6,1371
644,2019-08-10,280,1653,368,2,2303
644,2019-08-11,86,1306,35,0,1427
644,2019-08-12,208,16028,20,0,16256
644,2019-08-13,183,14300,289,0,14772
644,2019-08-14,49,1912,149,0,2110
644,2019-08-15,111,1117,186,0,1414
644,2019-08-16,39,1346,46,0,1431
644,2019-08-17,170,2873,496,0,3539
644,2019-08-18,166,2209,484,1,2860
644,2019-08-19,407,17162,1474,2,19045
644,2019-08-20,919,18438,1153,0,20510
644,2019-08-21,352,34533,1161,0,36046
644,2019-08-22,84,24498,2102,1,26685
644,2019-08-23,197,20611,1243,1,22052
644,2019-08-24,76,27670,1361,2,29109
644,2019-08-25,116,31148,901,1,32166
644,2019-08-26,112,27286,1440,3,28841
644,2019-08-27,89,23102,1264,0,24455
644,2019-08-28,97,21058,2070,3,23228
644,2019-08-29,214,15530,1812,1,17557
644,2019-08-30,71,4076,770,1,4918
644,2019-08-31,18,7050,5,0,7073
644,2019-09-01,32,2430,180,0,2642
644,2019-09-02,28,667,83,0,778
644,2019-09-03,73,5805,1865,1,7744
644,2019-09-04,116,10329,2234,3,12682
644,2019-09-05,206,11781,1934,0,13921
644,2019-09-06,139,14057,1811,0,16007
644,2019-09-07,215,15878,2595,1,18689
644,2019-09-08,1035,15592,1933,0,18560
644,2019-09-09,141,6213,1999,3,8356
644,2019-09-10,584,14889,2092,0,17565
644,2019-09-11,169,7405,1556,3,9133
644,2019-09-12,991,6485,2642,2,10120
644,2019-09-13,225,4430,1927,1,6583
644,2019-09-14,125,7713,1262,3,9103
644,2019-09-15,951,8450,2638,11,12050
644,2019-09-16,503,20278,2438,5,23224
644,2019-09-17,116,13111,2842,11,16080
644,2019-09-18,138,12155,1497,11,13801
644,2019-09-19,1177,9759,1260,8,12204
644,2019-09-20,1067,13707,2154,10,16938
644,2019-09-21,1803,7649,2082,10,11544
644,2019-09-22,114,9306,2216,84,11720
644,2019-09-23,245,7897,1988,12,10142
644,2019-09-24,993,7971,2458,13,11435
644,2019-09-25,180,9506,2178,156,12020
644,2019-09-26,929,9245,2525,13,12712
644,2019-09-27,212,9261,2209,3,11685
644,2019-09-28,245,14732,1988,1,16966
644,2019-09-29,945,14195,1844,2,16986
644,2019-09-30,798,17795,2056,0,20649
644,2019-10-01,82,15769,1552,2,17405
644,2019-10-02,1028,12139,1436,6,14609
644,2019-10-03,69,13432,1648,11,15160
644,2019-10-04,671,11267,1679,17,13634
644,2019-10-05,59,13412,827,9,14307
644,2019-10-06,1053,10277,1376,15,12721
644,2019-10-07,1271,5465,2071,13,8820
644,2019-10-08,1565,11611,1250,11,14437
644,2019-10-09,93,14557,1673,10,16333
644,2019-10-10,291,9754,1593,10,11648
644,2019-10-11,609,11215,1514,10,13348
644,2019-10-12,1022,6489,1668,1,9180
644,2019-10-13,518,6338,2007,1,8864
644,2019-10-14,1032,6105,1271,2,8410
644,2019-10-15,1540,7692,1568,9,10809
644,2019-10-16,110,18216,1506,1,19833
644,2019-10-17,134,7405,1834,2,9375
644,2019-10-18,173,9498,2091,0,11762
644,2019-10-19,93,5042,1689,2,6826
644,2019-10-20,237,1438,3133,0,4808
644,2019-10-21,978,9634,1404,1,12017
644,2019-10-22,126,4921,1749,1,6797
644,2019-10-23,88,13144,1991,0,15223
644,2019-10-24,1058,18667,1579,1,21305
644,2019-10-25,873,11225,1760,2,13860
644,2019-10-26,93,13302,1348,0,14743
644,2019-10-27,112,16022,1434,1,17569
644,2019-10-28,1464,13734,1768,3,16969
644,2019-10-29,163,26935,1249,0,28347
644,2019-10-30,108,20091,1492,0,21691
644,2019-10-31,209,11680,2103,1,13993
644,2019-11-01,1008,14421,1093,2,16524
644,2019-11-02,98,13818,1251,1,15168
644,2019-11-03,590,22787,1115,1,24493
644,2019-11-04,158,6795,1967,2,8922
644,2019-11-05,1058,1869,2336,0,5263
644,2019-11-06,1030,14039,1287,2,16358
644,2019-11-07,201,16290,1520,2,18013
644,2019-11-08,107,9331,1758,0,11196
644,2019-11-09,1840,8032,1547,0,11419
644,2019-11-10,1754,13262,1828,0,16844
644,2019-11-11,193,8692,1356,3,10244
644,2019-11-12,141,9507,3465,0,13113
644,2019-11-13,174,11546,1816,0,13536
644,2019-11-14,1036,8899,1981,1,11917
644,2019-11-15,203,5030,3566,0,8799
644,2019-11-16,138,3036,5283,1,8458
644,2019-11-17,220,4272,3235,49,7776
644,2019-11-18,142,2889,3469,1,6501
644,2019-11-19,253,6825,3276,0,10354
644,2019-11-20,99,1797,2982,1,4879
644,2019-11-21,168,6427,2336,2,8933
644,2019-11-22,1020,6355,1716,2,9093
644,2019-11-23,97,9987,2130,267,12481
644,2019-11-24,227,9336,1617,0,11180
644,2019-11-25,135,11251,1608,0,12994
644,2019-11-26,145,10140,2020,3,12308
644,2019-11-27,1014,7476,1828,0,10318
644,2019-11-28,96,8982,600,0,9678
644,2019-11-29,21,1111,3,0,1135
644,2019-08-01,55,19865,75,0,19995
644,2019-08-02,823,27997,512,0,29332
644,2019-08-03,65,9638,218,3,9924
644,2019-08-04,49,1416,244,1,1710
644,2019-08-05,74,38532,177,0,38783
644,2019-08-06,47,15555,612,0,16214
644,2019-08-07,69,1248,476,0,1793
644,2019-08-08,37,1229,390,1,1657
644,2019-08-09,52,1199,114,6,1371
644,2019-08-10,280,1653,368,2,2303
644,2019-08-11,86,1306,35,0,1427
644,2019-08-12,208,16028,20,0,16256
644,2019-08-13,183,14300,289,0,14772
644,2019-08-14,49,1912,149,0,2110
644,2019-08-15,111,1117,186,0,1414
644,2019-08-16,39,1346,46,0,1431
644,2019-08-17,170,2873,496,0,3539
644,2019-08-18,166,2209,484,1,2860
644,2019-08-19,407,17162,1474,2,19045
644,2019-08-20,919,18438,1153,0,20510
644,2019-08-21,352,34533,1161,0,36046
644,2019-08-22,84,24498,2102,1,26685
644,2019-08-23,197,20611,1243,1,22052
644,2019-08-24,76,27670,1361,2,29109
644,2019-08-25,116,31148,901,1,32166
644,2019-08-26,112,27286,1440,3,28841
644,2019-08-27,89,23102,1264,0,24455
644,2019-08-28,97,21058,2070,3,23228
644,2019-08-29,214,15530,1812,1,17557
644,2019-08-30,71,4076,770,1,4918
644,2019-08-31,18,7050,5,0,7073
644,2019-09-01,32,2430,180,0,2642
644,2019-09-02,28,667,83,0,778
644,2019-09-03,73,5805,1865,1,7744
644,2019-09-04,116,10329,2234,3,12682
644,2019-09-05,206,11781,1934,0,13921
644,2019-09-06,139,14057,1811,0,16007
644,2019-09-07,215,15878,2595,1,18689
644,2019-09-08,1035,15592,1933,0,18560
644,2019-09-09,141,6213,1999,3,8356
644,2019-09-10,584,14889,2092,0,17565
644,2019-09-11,169,7405,1556,3,9133
644,2019-09-12,991,6485,2642,2,10120
644,2019-09-13,225,4430,1927,1,6583
644,2019-09-14,125,7713,1262,3,9103
644,2019-09-15,951,8450,2638,11,12050
644,2019-09-16,503,20278,2438,5,23224
644,2019-09-17,116,13111,2842,11,16080
644,2019-09-18,138,12155,1497,11,13801
644,2019-09-19,1177,9759,1260,8,12204
644,2019-09-20,1067,13707,2154,10,16938
644,2019-09-21,1803,7649,2082,10,11544
644,2019-09-22,114,9306,2216,84,11720
644,2019-09-23,245,7897,1988,12,10142
644,2019-09-24,993,7971,2458,13,11435
644,2019-09-25,180,9506,2178,156,12020
644,2019-09-26,929,9245,2525,13,12712
644,2019-09-27,212,9261,2209,3,11685
644,2019-09-28,245,14732,1988,1,16966
644,2019-09-29,945,14195,1844,2,16986
644,2019-09-30,798,17795,2056,0,20649
644,2019-10-01,82,15769,1552,2,17405
644,2019-10-02,1028,12139,1436,6,14609
644,2019-10-03,69,13432,1648,11,15160
644,2019-10-04,671,11267,1679,17,13634
644,2019-10-05,59,13412,827,9,14307
644,2019-10-06,1053,10277,1376,15,12721
644,2019-10-07,1271,5465,2071,13,8820
644,2019-10-08,1565,11611,1250,11,14437
644,2019-10-09,93,14557,1673,10,16333
644,2019-10-10,291,9754,1593,10,11648
644,2019-10-11,609,11215,1514,10,13348
644,2019-10-12,1022,6489,1668,1,9180
644,2019-10-13,518,6338,2007,1,8864
644,2019-10-14,1032,6105,1271,2,8410
644,2019-10-15,1540,7692,1568,9,10809
644,2019-10-16,110,18216,1506,1,19833
644,2019-10-17,134,7405,1834,2,9375
644,2019-10-18,173,9498,2091,0,11762
644,2019-10-19,93,5042,1689,2,6826
644,2019-10-20,237,1438,3133,0,4808
644,2019-10-21,978,9634,1404,1,12017
644,2019-10-22,126,4921,1749,1,6797
644,2019-10-23,88,13144,1991,0,15223
644,2019-10-24,1058,18667,1579,1,21305
644,2019-10-25,873,11225,1760,2,13860
644,2019-10-26,93,13302,1348,0,14743
644,2019-10-27,112,16022,1434,1,17569
644,2019-10-28,1464,13734,1768,3,16969
644,2019-10-29,163,26935,1249,0,28347
644,2019-10-30,108,20091,1492,0,21691
644,2019-10-31,209,11680,2103,1,13993
644,2019-11-01,1008,14421,1093,2,16524
644,2019-11-02,98,13818,1251,1,15168
644,2019-11-03,590,22787,1115,1,24493
644,2019-11-04,158,6795,1967,2,8922
644,2019-11-05,1058,1869,2336,0,5263
644,2019-11-06,1030,14039,1287,2,16358
644,2019-11-07,201,16290,1520,2,18013
644,2019-11-08,107,9331,1758,0,11196
644,2019-11-09,1840,8032,1547,0,11419
644,2019-11-10,1754,13262,1828,0,16844
644,2019-11-11,193,8692,1356,3,10244
644,2019-11-12,141,9507,3465,0,13113
644,2019-11-13,174,11546,1816,0,13536
644,2019-11-14,1036,8899,1981,1,11917
644,2019-11-15,203,5030,3566,0,8799
644,2019-11-16,138,3036,5283,1,8458
644,2019-11-17,220,4272,3235,49,7776
644,2019-11-18,142,2889,3469,1,6501
644,2019-11-19,253,6825,3276,0,10354
644,2019-11-20,99,1797,2982,1,4879
644,2019-11-21,168,6427,2336,2,8933
644,2019-11-22,1020,6355,1716,2,9093
644,2019-11-23,97,9987,2130,267,12481
644,2019-11-24,227,9336,1617,0,11180
644,2019-11-25,135,11251,1608,0,12994
644,2019-11-26,145,10140,2020,3,12308
644,2019-11-27,1014,7476,1828,0,10318
644,2019-11-28,96,8982,600,0,9678
644,2019-11-29,21,1111,3,0,1135
644,2019-08-01,55,19865,75,0,19995
644,2019-08-02,823,27997,512,0,29332
644,2019-08-03,65,9638,218,3,9924
644,2019-08-04,49,1416,244,1,1710
644,2019-08-05,74,38532,177,0,38783
644,2019-08-06,47,15555,612,0,16214
644,2019-08-07,69,1248,476,0,1793
644,2019-08-08,37,1229,390,1,1657
644,2019-08-09,52,1199,114,6,1371
644,2019-08-10,280,1653,368,2,2303
644,2019-08-11,86,1306,35,0,1427
644,2019-08-12,208,16028,20,0,16256
644,2019-08-13,183,14300,289,0,14772
644,2019-08-14,49,1912,149,0,2110
644,2019-08-15,111,1117,186,0,1414
644,2019-08-16,39,1346,46,0,1431
644,2019-08-17,170,2873,496,0,3539
644,2019-08-18,166,2209,484,1,2860
644,2019-08-19,407,17162,1474,2,19045
644,2019-08-20,919,18438,1153,0,20510
644,2019-08-21,352,34533,1161,0,36046
644,2019-08-22,84,24498,2102,1,26685
644,2019-08-23,197,20611,1243,1,22052
644,2019-08-24,76,27670,1361,2,29109
644,2019-08-25,116,31148,901,1,32166
644,2019-08-26,112,27286,1440,3,28841
644,2019-08-27,89,23102,1264,0,24455
644,2019-08-28,97,21058,2070,3,23228
644,2019-08-29,214,15530,1812,1,17557
644,2019-08-30,71,4076,770,1,4918
644,2019-08-31,18,7050,5,0,7073
644,2019-09-01,32,2430,180,0,2642
644,2019-09-02,28,667,83,0,778
644,2019-09-03,73,5805,1865,1,7744
644,2019-09-04,116,10329,2234,3,12682
644,2019-09-05,206,11781,1934,0,13921
644,2019-09-06,139,14057,1811,0,16007
644,2019-09-07,215,15878,2595,1,18689
644,2019-09-08,1035,15592,1933,0,18560
644,2019-09-09,141,6213,1999,3,8356
644,2019-09-10,584,14889,2092,0,17565
644,2019-09-11,169,7405,1556,3,9133
644,2019-09-12,991,6485,2642,2,10120
644,2019-09-13,225,4430,1927,1,6583
644,2019-09-14,125,7713,1262,3,9103
644,2019-09-15,951,8450,2638,11,12050
644,2019-09-16,503,20278,2438,5,23224
644,2019-09-17,116,13111,2842,11,16080
644,2019-09-18,138,12155,1497,11,13801
644,2019-09-19,1177,9759,1260,8,12204
644,2019-09-20,1067,13707,2154,10,16938
644,2019-09-21,1803,7649,2082,10,11544
644,2019-09-22,114,9306,2216,84,11720
644,2019-09-23,245,7897,1988,12,10142
644,2019-09-24,993,7971,2458,13,11435
644,2019-09-25,180,9506,2178,156,12020
644,2019-09-26,929,9245,2525,13,12712
644,2019-09-27,212,9261,2209,3,11685
644,2019-09-28,245,14732,1988,1,16966
644,2019-09-29,945,14195,1844,2,16986
644,2019-09-30,798,17795,2056,0,20649
644,2019-10-01,82,15769,1552,2,17405
644,2019-10-02,1028,12139,1436,6,14609
644,2019-10-03,69,13432,1648,11,15160
644,2019-10-04,671,11267,1679,17,13634
644,2019-10-05,59,13412,827,9,14307
644,2019-10-06,1053,10277,1376,15,12721
644,2019-10-07,1271,5465,2071,13,8820
644,2019-10-08,1565,11611,1250,11,14437
644,2019-10-09,93,14557,1673,10,16333
644,2019-10-10,291,9754,1593,10,11648
644,2019-10-11,609,11215,1514,10,13348
644,2019-10-12,1022,6489,1668,1,9180
644,2019-10-13,518,6338,2007,1,8864
644,2019-10-14,1032,6105,1271,2,8410
644,2019-10-15,1540,7692,1568,9,10809
644,2019-10-16,110,18216,1506,1,19833
644,2019-10-17,134,7405,1834,2,9375
644,2019-10-18,173,9498,2091,0,11762
644,2019-10-19,93,5042,1689,2,6826
644,2019-10-20,237,1438,3133,0,4808
644,2019-10-21,978,9634,1404,1,12017
644,2019-10-22,126,4921,1749,1,6797
644,2019-10-23,88,13144,1991,0,15223
644,2019-10-24,1058,18667,1579,1,21305
644,2019-10-25,873,11225,1760,2,13860
644,2019-10-26,93,13302,1348,0,14743
644,2019-10-27,112,16022,1434,1,17569
644,2019-10-28,1464,13734,1768,3,16969
644,2019-10-29,163,26935,1249,0,28347
644,2019-10-30,108,20091,1492,0,21691
644,2019-10-31,209,11680,2103,1,13993
644,2019-11-01,1008,14421,1093,2,16524
644,2019-11-02,98,13818,1251,1,15168
644,2019-11-03,590,22787,1115,1,24493
644,2019-11-04,158,6795,1967,2,8922
644,2019-11-05,1058,1869,2336,0,5263
644,2019-11-06,1030,14039,1287,2,16358
644,2019-11-07,201,16290,1520,2,18013
644,2019-11-08,107,9331,1758,0,11196
644,2019-11-09,1840,8032,1547,0,11419
644,2019-11-10,1754,13262,1828,0,16844
644,2019-11-11,193,8692,1356,3,10244
644,2019-11-12,141,9507,3465,0,13113
644,2019-11-13,174,11546,1816,0,13536
644,2019-11-14,1036,8899,1981,1,11917
644,2019-11-15,203,5030,3566,0,8799
644,2019-11-16,138,3036,5283,1,8458
644,2019-11-17,220,4272,3235,49,7776
644,2019-11-18,142,2889,3469,1,6501
644,2019-11-19,253,6825,3276,0,10354
644,2019-11-20,99,1797,2982,1,4879
644,2019-11-21,168,6427,2336,2,8933
644,2019-11-22,1020,6355,1716,2,9093
644,2019-11-23,97,9987,2130,267,12481
644,2019-11-24,227,9336,1617,0,11180
644,2019-11-25,135,11251,1608,0,12994
644,2019-11-26,145,10140,2020,3,12308
644,2019-11-27,1014,7476,1828,0,10318
644,2019-11-28,96,8982,600,0,9678
644,2019-11-29,21,1111,3,0,1135
644,2019-08-03,65,9638,218,3,9924
644,2019-08-04,49,1416,244,1,1710
644,2019-08-05,74,38532,177,0,38783
644,2019-08-06,47,15555,612,0,16214
644,2019-08-07,69,1248,476,0,1793
644,2019-08-08,37,1229,390,1,1657
644,2019-08-09,52,1199,114,6,1371
644,2019-08-10,280,1653,368,2,2303
644,2019-08-11,86,1306,35,0,1427
644,2019-08-12,208,16028,20,0,16256
644,2019-08-13,183,14300,289,0,14772
644,2019-08-14,49,1912,149,0,2110
644,2019-08-15,111,1117,186,0,1414
644,2019-08-16,39,1346,46,0,1431
644,2019-08-17,170,2873,496,0,3539
644,2019-08-18,166,2209,484,1,2860
644,2019-08-19,407,17162,1474,2,19045
644,2019-08-20,919,18438,1153,0,20510
644,2019-08-21,352,34533,1161,0,36046
644,2019-08-22,84,24498,2102,1,26685
644,2019-08-23,197,20611,1243,1,22052
644,2019-08-24,76,27670,1361,2,29109
644,2019-08-25,116,31148,901,1,32166
644,2019-08-26,112,27286,1440,3,28841
644,2019-08-27,89,23102,1264,0,24455
644,2019-08-28,97,21058,2070,3,23228
644,2019-08-29,214,15530,1812,1,17557
644,2019-08-30,71,4076,770,1,4918
644,2019-08-31,18,7050,5,0,7073
644,2019-09-01,32,2430,180,0,2642
644,2019-09-02,28,667,83,0,778
644,2019-09-03,73,5805,1865,1,7744
644,2019-09-04,116,10329,2234,3,12682
644,2019-09-05,206,11781,1934,0,13921
644,2019-09-06,139,14057,1811,0,16007
644,2019-09-07,215,15878,2595,1,18689
644,2019-09-08,1035,15592,1933,0,18560
644,2019-09-09,141,6213,1999,3,8356
644,2019-09-10,584,14889,2092,0,17565
644,2019-09-11,169,7405,1556,3,9133
644,2019-09-12,991,6485,2642,2,10120
644,2019-09-13,225,4430,1927,1,6583
644,2019-09-14,125,7713,1262,3,9103
644,2019-09-15,951,8450,2638,11,12050
644,2019-09-16,503,20278,2438,5,23224
644,2019-09-17,116,13111,2842,11,16080
644,2019-09-18,138,12155,1497,11,13801
644,2019-09-19,1177,9759,1260,8,12204
644,2019-09-20,1067,13707,2154,10,16938
644,2019-09-21,1803,7649,2082,10,11544
644,2019-09-22,114,9306,2216,84,11720
644,2019-09-23,245,7897,1988,12,10142
644,2019-09-24,993,7971,2458,13,11435
644,2019-09-25,180,9506,2178,156,12020
644,2019-09-26,929,9245,2525,13,12712
644,2019-09-27,212,9261,2209,3,11685
644,2019-09-28,245,14732,1988,1,16966
644,2019-09-29,945,14195,1844,2,16986
644,2019-09-30,798,17795,2056,0,20649
644,2019-10-01,82,15769,1552,2,17405
644,2019-10-02,1028,12139,1436,6,14609
644,2019-10-03,69,13432,1648,11,15160
644,2019-10-04,671,11267,1679,17,13634
644,2019-10-05,59,13412,827,9,14307
644,2019-10-06,1053,10277,1376,15,12721
644,2019-10-07,1271,5465,2071,13,8820
644,2019-10-08,1565,11611,1250,11,14437
644,2019-10-09,93,14557,1673,10,16333
644,2019-10-10,291,9754,1593,10,11648
644,2019-10-11,609,11215,1514,10,13348
644,2019-10-12,1022,6489,1668,1,9180
644,2019-10-13,518,6338,2007,1,8864
644,2019-10-14,1032,6105,1271,2,8410
644,2019-10-15,1540,7692,1568,9,10809
644,2019-10-16,110,18216,1506,1,19833
644,2019-10-17,134,7405,1834,2,9375
644,2019-10-18,173,9498,2091,0,11762
644,2019-10-19,93,5042,1689,2,6826
644,2019-10-20,237,1438,3133,0,4808
644,2019-10-21,978,9634,1404,1,12017
644,2019-10-22,126,4921,1749,1,6797
644,2019-10-23,88,13144,1991,0,15223
644,2019-10-24,1058,18667,1579,1,21305
644,2019-10-25,873,11225,1760,2,13860
644,2019-10-26,93,13302,1348,0,14743
644,2019-10-27,112,16022,1434,1,17569
644,2019-10-28,1464,13734,1768,3,16969
644,2019-10-29,163,26935,1249,0,28347
644,2019-10-30,108,20091,1492,0,21691
644,2019-10-31,209,11680,2103,1,13993
644,2019-11-01,1008,14421,1093,2,16524
644,2019-11-02,98,13818,1251,1,15168
644,2019-11-03,590,22787,1115,1,24493
644,2019-11-04,158,6795,1967,2,8922
644,2019-11-05,1058,1869,2336,0,5263
644,2019-11-06,1030,14039,1287,2,16358
644,2019-11-07,201,16290,1520,2,18013
644,2019-11-08,107,9331,1758,0,11196
644,2019-11-09,1840,8032,1547,0,11419
644,2019-11-10,1754,13262,1828,0,16844
644,2019-11-11,193,8692,1356,3,10244
644,2019-11-12,141,9507,3465,0,13113
644,2019-11-13,174,11546,1816,0,13536
644,2019-11-14,1036,8899,1981,1,11917
644,2019-11-15,203,5030,3566,0,8799
644,2019-11-16,138,3036,5283,1,8458
644,2019-11-17,220,4272,3235,49,7776
644,2019-11-18,142,2889,3469,1,6501
644,2019-11-19,253,6825,3276,0,10354
644,2019-11-20,99,1797,2982,1,4879
644,2019-11-21,168,6427,2336,2,8933
644,2019-11-22,1020,6355,1716,2,9093
644,2019-11-23,97,9987,2130,267,12481
644,2019-11-24,227,9336,1617,0,11180
644,2019-11-25,135,11251,1608,0,12994
644,2019-11-26,145,10140,2020,3,12308
645,2019-08-01,294,39009,381,0,39684
645,2019-08-02,154,38476,312,0,38942
645,2019-08-03,109,9792,374,1,10276
645,2019-08-04,329,1303,217,2,1851
645,2019-08-05,779,1371,319,1,2470
645,2019-08-06,316,9291,226,1,9834
645,2019-08-07,372,22488,226,1,23087
645,2019-08-08,111,7327,404,2,7844
645,2019-08-09,91,2422,103,3,2619
645,2019-08-10,317,1741,194,1,2253
645,2019-08-11,84,2571,237,1,2893
645,2019-08-12,110,2117,72,1,2300
645,2019-08-13,327,6155,89,1,6572
645,2019-08-14,164,2261,138,0,2563
645,2019-08-15,158,1400,7,0,1565
645,2019-08-16,354,2425,101,0,2880
645,2019-08-17,359,4057,441,0,4857
645,2019-08-18,264,4416,1656,1,6337
645,2019-08-19,395,10886,985,2,12268
645,2019-08-20,926,16682,1021,0,18629
645,2019-08-21,125,13533,1109,0,14767
645,2019-08-22,358,19263,1278,2,20901
645,2019-08-23,194,29191,1493,0,30878
645,2019-08-24,3144,10486,1652,2,15284
645,2019-08-25,2455,14623,1532,2,18612
645,2019-08-26,2539,5932,2203,1,10675
645,2019-08-27,5233,4288,1752,0,11273
645,2019-08-28,4505,14416,2610,2,21533
645,2019-08-29,3874,11047,1470,2,16393
645,2019-08-30,3137,3489,1057,0,7683
645,2019-08-31,1885,486,22,0,2393
645,2019-09-01,473,1495,183,1,2152
645,2019-09-02,407,415,14,0,836
645,2019-09-03,401,4863,970,2,6236
645,2019-09-04,1026,10495,1773,0,13294
645,2019-09-05,1542,9105,1375,1,12023
645,2019-09-06,917,13594,2287,1,16799
645,2019-09-07,1584,15315,2536,0,19435
645,2019-09-08,2459,9426,2370,1,14256
645,2019-09-09,1651,11901,1775,2,15329
645,2019-09-10,1493,13828,2851,2,18174
645,2019-09-11,427,11026,2271,3,13727
645,2019-09-12,240,9168,2409,0,11817
645,2019-09-13,389,9188,1925,15,11517
645,2019-09-14,202,6146,2623,44,9015
645,2019-09-15,126,10168,1593,3,11890
645,2019-09-16,393,18277,1981,1,20652
645,2019-09-17,998,11543,1623,0,14164
645,2019-09-18,792,28107,1382,2,30283
645,2019-09-19,491,12039,1132,1,13663
645,2019-09-20,235,10327,2133,1,12696
645,2019-09-21,116,8947,1760,0,10823
645,2019-09-22,304,9541,1270,0,11115
645,2019-09-23,667,9447,2001,9,12124
645,2019-09-24,1101,8490,1763,3,11357
645,2019-09-25,393,6667,1995,2,9057
645,2019-09-26,545,10447,2560,0,13552
645,2019-09-27,91,7694,1629,2,9416
645,2019-09-28,432,16761,1726,3,18922
645,2019-09-29,126,17464,2468,3,20061
645,2019-09-30,191,16622,1273,0,18086
645,2019-10-01,2446,16346,1937,1,20730
645,2019-10-02,242,11275,2043,0,13560
645,2019-10-03,165,13779,1670,1,15615
645,2019-10-04,328,11089,1541,0,12958
645,2019-10-05,556,13940,2286,1,16783
645,2019-10-06,1021,10238,1629,1,12889
645,2019-10-07,317,5147,2074,3,7541
645,2019-10-08,1018,11779,1869,4,14670
645,2019-10-09,145,14633,2032,2,16812
645,2019-10-10,1238,9054,2100,0,12392
645,2019-10-11,1014,11643,1437,1,14095
645,2019-10-12,1004,4425,1737,0,7166
645,2019-10-13,1583,7305,1688,3,10579
645,2019-10-14,467,4732,1877,0,7076
645,2019-10-15,1211,7776,1866,0,10853
645,2019-10-16,384,12843,1498,0,14725
645,2019-10-17,187,4610,1951,2,6750
645,2019-10-18,278,8661,1649,1,10589
645,2019-10-19,437,5612,2414,0,8463
645,2019-10-20,994,970,1228,0,3192
645,2019-10-21,127,9986,1867,1,11981
645,2019-10-22,336,5174,2121,2,7633
645,2019-10-23,462,13724,1840,3,16029
645,2019-10-24,1501,18653,1490,3,21647
645,2019-10-25,936,10096,1305,2,12339
645,2019-10-26,916,12811,1720,2,15449
645,2019-10-27,783,27232,1431,0,29446
645,2019-10-28,2068,15371,1336,0,18775
645,2019-10-29,1383,26015,1419,1,28818
645,2019-10-30,2564,19182,1431,0,23177
645,2019-10-31,1627,11520,1539,0,14686
645,2019-11-01,1711,14412,1040,1,17164
645,2019-11-02,399,22760,935,3,24097
645,2019-11-03,1158,37729,1770,0,40657
645,2019-11-04,734,9480,1170,0,11384
645,2019-11-05,984,2304,1822,0,5110
645,2019-11-06,2069,7334,746,2,10151
645,2019-11-07,585,13468,676,5,14734
645,2019-11-08,440,9129,1348,0,10917
645,2019-11-09,697,12529,1748,0,14974
645,2019-11-10,928,13434,1192,0,15554
645,2019-11-11,423,8584,1479,2,10488
645,2019-11-12,336,16388,2877,3,19604
645,2019-11-13,529,12716,1713,1,14959
645,2019-11-14,291,13842,2258,0,16391
645,2019-11-15,141,5200,3246,1,8588
645,2019-11-16,308,3176,2367,0,5851
645,2019-11-17,190,3984,3898,4,8076
645,2019-11-18,136,3540,3113,0,6789
645,2019-11-19,487,5785,2954,1,9227
645,2019-11-20,1610,1770,2117,1,5498
645,2019-11-21,211,6084,1859,0,8154
645,2019-11-22,229,6740,1538,0,8507
645,2019-11-23,219,10303,2074,0,12596
645,2019-11-24,264,8008,1268,0,9540
645,2019-11-25,605,10922,1977,0,13504
645,2019-11-26,102,9553,1544,0,11199
645,2019-11-27,120,10879,1716,0,12715
645,2019-11-28,183,13147,630,0,13960
645,2019-11-29,41,0,1,0,42
645,2019-08-01,294,39009,381,0,39684
645,2019-08-02,154,38476,312,0,38942
645,2019-08-03,109,9792,374,1,10276
645,2019-08-04,329,1303,217,2,1851
645,2019-08-05,779,1371,319,1,2470
645,2019-08-06,316,9291,226,1,9834
645,2019-08-07,372,22488,226,1,23087
645,2019-08-08,111,7327,404,2,7844
645,2019-08-09,91,2422,103,3,2619
645,2019-08-10,317,1741,194,1,2253
645,2019-08-11,84,2571,237,1,2893
645,2019-08-12,110,2117,72,1,2300
645,2019-08-13,327,6155,89,1,6572
645,2019-08-14,164,2261,138,0,2563
645,2019-08-15,158,1400,7,0,1565
645,2019-08-16,354,2425,101,0,2880
645,2019-08-17,359,4057,441,0,4857
645,2019-08-18,264,4416,1656,1,6337
645,2019-08-19,395,10886,985,2,12268
645,2019-08-20,926,16682,1021,0,18629
645,2019-08-21,125,13533,1109,0,14767
645,2019-08-22,358,19263,1278,2,20901
645,2019-08-23,194,29191,1493,0,30878
645,2019-08-24,3144,10486,1652,2,15284
645,2019-08-25,2455,14623,1532,2,18612
645,2019-08-26,2539,5932,2203,1,10675
645,2019-08-27,5233,4288,1752,0,11273
645,2019-08-28,4505,14416,2610,2,21533
645,2019-08-29,3874,11047,1470,2,16393
645,2019-08-30,3137,3489,1057,0,7683
645,2019-08-31,1885,486,22,0,2393
645,2019-09-01,473,1495,183,1,2152
645,2019-09-02,407,415,14,0,836
645,2019-09-03,401,4863,970,2,6236
645,2019-09-04,1026,10495,1773,0,13294
645,2019-09-05,1542,9105,1375,1,12023
645,2019-09-06,917,13594,2287,1,16799
645,2019-09-07,1584,15315,2536,0,19435
645,2019-09-08,2459,9426,2370,1,14256
645,2019-09-09,1651,11901,1775,2,15329
645,2019-09-10,1493,13828,2851,2,18174
645,2019-09-11,427,11026,2271,3,13727
645,2019-09-12,240,9168,2409,0,11817
645,2019-09-13,389,9188,1925,15,11517
645,2019-09-14,202,6146,2623,44,9015
645,2019-09-15,126,10168,1593,3,11890
645,2019-09-16,393,18277,1981,1,20652
645,2019-09-17,998,11543,1623,0,14164
645,2019-09-18,792,28107,1382,2,30283
645,2019-09-19,491,12039,1132,1,13663
645,2019-09-20,235,10327,2133,1,12696
645,2019-09-21,116,8947,1760,0,10823
645,2019-09-22,304,9541,1270,0,11115
645,2019-09-23,667,9447,2001,9,12124
645,2019-09-24,1101,8490,1763,3,11357
645,2019-09-25,393,6667,1995,2,9057
645,2019-09-26,545,10447,2560,0,13552
645,2019-09-27,91,7694,1629,2,9416
645,2019-09-28,432,16761,1726,3,18922
645,2019-09-29,126,17464,2468,3,20061
645,2019-09-30,191,16622,1273,0,18086
645,2019-10-01,2446,16346,1937,1,20730
645,2019-10-02,242,11275,2043,0,13560
645,2019-10-03,165,13779,1670,1,15615
645,2019-10-04,328,11089,1541,0,12958
645,2019-10-05,556,13940,2286,1,16783
645,2019-10-06,1021,10238,1629,1,12889
645,2019-10-07,317,5147,2074,3,7541
645,2019-10-08,1018,11779,1869,4,14670
645,2019-10-09,145,14633,2032,2,16812
645,2019-10-10,1238,9054,2100,0,12392
645,2019-10-11,1014,11643,1437,1,14095
645,2019-10-12,1004,4425,1737,0,7166
645,2019-10-13,1583,7305,1688,3,10579
645,2019-10-14,467,4732,1877,0,7076
645,2019-10-15,1211,7776,1866,0,10853
645,2019-10-16,384,12843,1498,0,14725
645,2019-10-17,187,4610,1951,2,6750
645,2019-10-18,278,8661,1649,1,10589
645,2019-10-19,437,5612,2414,0,8463
645,2019-10-20,994,970,1228,0,3192
645,2019-10-21,127,9986,1867,1,11981
645,2019-10-22,336,5174,2121,2,7633
645,2019-10-23,462,13724,1840,3,16029
645,2019-10-24,1501,18653,1490,3,21647
645,2019-10-25,936,10096,1305,2,12339
645,2019-10-26,916,12811,1720,2,15449
645,2019-10-27,783,27232,1431,0,29446
645,2019-10-28,2068,15371,1336,0,18775
645,2019-10-29,1383,26015,1419,1,28818
645,2019-10-30,2564,19182,1431,0,23177
645,2019-10-31,1627,11520,1539,0,14686
645,2019-11-01,1711,14412,1040,1,17164
645,2019-11-02,399,22760,935,3,24097
645,2019-11-03,1158,37729,1770,0,40657
645,2019-11-04,734,9480,1170,0,11384
645,2019-11-05,984,2304,1822,0,5110
645,2019-11-06,2069,7334,746,2,10151
645,2019-11-07,585,13468,676,5,14734
645,2019-11-08,440,9129,1348,0,10917
645,2019-11-09,697,12529,1748,0,14974
645,2019-11-10,928,13434,1192,0,15554
645,2019-11-11,423,8584,1479,2,10488
645,2019-11-12,336,16388,2877,3,19604
645,2019-11-13,529,12716,1713,1,14959
645,2019-11-14,291,13842,2258,0,16391
645,2019-11-15,141,5200,3246,1,8588
645,2019-11-16,308,3176,2367,0,5851
645,2019-11-17,190,3984,3898,4,8076
645,2019-11-18,136,3540,3113,0,6789
645,2019-11-19,487,5785,2954,1,9227
645,2019-11-20,1610,1770,2117,1,5498
645,2019-11-21,211,6084,1859,0,8154
645,2019-11-22,229,6740,1538,0,8507
645,2019-11-23,219,10303,2074,0,12596
645,2019-11-24,264,8008,1268,0,9540
645,2019-11-25,605,10922,1977,0,13504
645,2019-11-26,102,9553,1544,0,11199
645,2019-11-27,120,10879,1716,0,12715
645,2019-11-28,183,13147,630,0,13960
645,2019-08-01,294,39009,381,0,39684
645,2019-08-02,154,38476,312,0,38942
645,2019-08-03,109,9792,374,1,10276
645,2019-08-04,329,1303,217,2,1851
645,2019-08-05,779,1371,319,1,2470
645,2019-08-06,316,9291,226,1,9834
645,2019-08-07,372,22488,226,1,23087
645,2019-08-08,111,7327,404,2,7844
645,2019-08-09,91,2422,103,3,2619
645,2019-08-10,317,1741,194,1,2253
645,2019-08-11,84,2571,237,1,2893
645,2019-08-12,110,2117,72,1,2300
645,2019-08-13,327,6155,89,1,6572
645,2019-08-14,164,2261,138,0,2563
645,2019-08-15,158,1400,7,0,1565
645,2019-08-16,354,2425,101,0,2880
645,2019-08-17,359,4057,441,0,4857
645,2019-08-18,264,4416,1656,1,6337
645,2019-08-19,395,10886,985,2,12268
645,2019-08-20,926,16682,1021,0,18629
645,2019-08-21,125,13533,1109,0,14767
645,2019-08-22,358,19263,1278,2,20901
645,2019-08-23,194,29191,1493,0,30878
645,2019-08-24,3144,10486,1652,2,15284
645,2019-08-25,2455,14623,1532,2,18612
645,2019-08-26,2539,5932,2203,1,10675
645,2019-08-27,5233,4288,1752,0,11273
645,2019-08-28,4505,14416,2610,2,21533
645,2019-08-29,3874,11047,1470,2,16393
645,2019-08-30,3137,3489,1057,0,7683
645,2019-08-31,1885,486,22,0,2393
645,2019-09-01,473,1495,183,1,2152
645,2019-09-02,407,415,14,0,836
645,2019-09-03,401,4863,970,2,6236
645,2019-09-04,1026,10495,1773,0,13294
645,2019-09-05,1542,9105,1375,1,12023
645,2019-09-06,917,13594,2287,1,16799
645,2019-09-07,1584,15315,2536,0,19435
645,2019-09-08,2459,9426,2370,1,14256
645,2019-09-09,1651,11901,1775,2,15329
645,2019-09-10,1493,13828,2851,2,18174
645,2019-09-11,427,11026,2271,3,13727
645,2019-09-12,240,9168,2409,0,11817
645,2019-09-13,389,9188,1925,15,11517
645,2019-09-14,202,6146,2623,44,9015
645,2019-09-15,126,10168,1593,3,11890
645,2019-09-16,393,18277,1981,1,20652
645,2019-09-17,998,11543,1623,0,14164
645,2019-09-18,792,28107,1382,2,30283
645,2019-09-19,491,12039,1132,1,13663
645,2019-09-20,235,10327,2133,1,12696
645,2019-09-21,116,8947,1760,0,10823
645,2019-09-22,304,9541,1270,0,11115
645,2019-09-23,667,9447,2001,9,12124
645,2019-09-24,1101,8490,1763,3,11357
645,2019-09-25,393,6667,1995,2,9057
645,2019-09-26,545,10447,2560,0,13552
645,2019-09-27,91,7694,1629,2,9416
645,2019-09-28,432,16761,1726,3,18922
645,2019-09-29,126,17464,2468,3,20061
645,2019-09-30,191,16622,1273,0,18086
645,2019-10-01,2446,16346,1937,1,20730
645,2019-10-02,242,11275,2043,0,13560
645,2019-10-03,165,13779,1670,1,15615
645,2019-10-04,328,11089,1541,0,12958
645,2019-10-05,556,13940,2286,1,16783
645,2019-10-06,1021,10238,1629,1,12889
645,2019-10-07,317,5147,2074,3,7541
645,2019-10-08,1018,11779,1869,4,14670
645,2019-10-09,145,14633,2032,2,16812
645,2019-10-10,1238,9054,2100,0,12392
645,2019-10-11,1014,11643,1437,1,14095
645,2019-10-12,1004,4425,1737,0,7166
645,2019-10-13,1583,7305,1688,3,10579
645,2019-10-14,467,4732,1877,0,7076
645,2019-10-15,1211,7776,1866,0,10853
645,2019-10-16,384,12843,1498,0,14725
645,2019-10-17,187,4610,1951,2,6750
645,2019-10-18,278,8661,1649,1,10589
645,2019-10-19,437,5612,2414,0,8463
645,2019-10-20,994,970,1228,0,3192
645,2019-10-21,127,9986,1867,1,11981
645,2019-10-22,336,5174,2121,2,7633
645,2019-10-23,462,13724,1840,3,16029
645,2019-10-24,1501,18653,1490,3,21647
645,2019-10-25,936,10096,1305,2,12339
645,2019-10-26,916,12811,1720,2,15449
645,2019-10-27,783,27232,1431,0,29446
645,2019-10-28,2068,15371,1336,0,18775
645,2019-10-29,1383,26015,1419,1,28818
645,2019-10-30,2564,19182,1431,0,23177
645,2019-10-31,1627,11520,1539,0,14686
645,2019-11-01,1711,14412,1040,1,17164
645,2019-11-02,399,22760,935,3,24097
645,2019-11-03,1158,37729,1770,0,40657
645,2019-11-04,734,9480,1170,0,11384
645,2019-11-05,984,2304,1822,0,5110
645,2019-11-06,2069,7334,746,2,10151
645,2019-11-07,585,13468,676,5,14734
645,2019-11-08,440,9129,1348,0,10917
645,2019-11-09,697,12529,1748,0,14974
645,2019-11-10,928,13434,1192,0,15554
645,2019-11-11,423,8584,1479,2,10488
645,2019-11-12,336,16388,2877,3,19604
645,2019-11-13,529,12716,1713,1,14959
645,2019-11-14,291,13842,2258,0,16391
645,2019-11-15,141,5200,3246,1,8588
645,2019-11-16,308,3176,2367,0,5851
645,2019-11-17,190,3984,3898,4,8076
645,2019-11-18,136,3540,3113,0,6789
645,2019-11-19,487,5785,2954,1,9227
645,2019-11-20,1610,1770,2117,1,5498
645,2019-11-21,211,6084,1859,0,8154
645,2019-11-22,229,6740,1538,0,8507
645,2019-11-23,219,10303,2074,0,12596
645,2019-11-24,264,8008,1268,0,9540
645,2019-11-25,605,10922,1977,0,13504
645,2019-11-26,102,9553,1544,0,11199
645,2019-11-27,120,10879,1716,0,12715
645,2019-11-28,183,13147,630,0,13960
645,2019-11-29,41,0,1,0,42
645,2019-08-03,109,9792,374,1,10276
645,2019-08-04,329,1303,217,2,1851
645,2019-08-05,779,1371,319,1,2470
645,2019-08-06,316,9291,226,1,9834
645,2019-08-07,372,22488,226,1,23087
645,2019-08-08,111,7327,404,2,7844
645,2019-08-09,91,2422,103,3,2619
645,2019-08-10,317,1741,194,1,2253
645,2019-08-11,84,2571,237,1,2893
645,2019-08-12,110,2117,72,1,2300
645,2019-08-13,327,6155,89,1,6572
645,2019-08-14,164,2261,138,0,2563
645,2019-08-15,158,1400,7,0,1565
645,2019-08-16,354,2425,101,0,2880
645,2019-08-17,359,4057,441,0,4857
645,2019-08-18,264,4416,1656,1,6337
645,2019-08-19,395,10886,985,2,12268
645,2019-08-20,926,16682,1021,0,18629
645,2019-08-21,125,13533,1109,0,14767
645,2019-08-22,358,19263,1278,2,20901
645,2019-08-23,194,29191,1493,0,30878
645,2019-08-24,3144,10486,1652,2,15284
645,2019-08-25,2455,14623,1532,2,18612
645,2019-08-26,2539,5932,2203,1,10675
645,2019-08-27,5233,4288,1752,0,11273
645,2019-08-28,4505,14416,2610,2,21533
645,2019-08-29,3874,11047,1470,2,16393
645,2019-08-30,3137,3489,1057,0,7683
645,2019-08-31,1885,486,22,0,2393
645,2019-09-01,473,1495,183,1,2152
645,2019-09-02,407,415,14,0,836
645,2019-09-03,401,4863,970,2,6236
645,2019-09-04,1026,10495,1773,0,13294
645,2019-09-05,1542,9105,1375,1,12023
645,2019-09-06,917,13594,2287,1,16799
645,2019-09-07,1584,15315,2536,0,19435
645,2019-09-08,2459,9426,2370,1,14256
645,2019-09-09,1651,11901,1775,2,15329
645,2019-09-10,1493,13828,2851,2,18174
645,2019-09-11,427,11026,2271,3,13727
645,2019-09-12,240,9168,2409,0,11817
645,2019-09-13,389,9188,1925,15,11517
645,2019-09-14,202,6146,2623,44,9015
645,2019-09-15,126,10168,1593,3,11890
645,2019-09-16,393,18277,1981,1,20652
645,2019-09-17,998,11543,1623,0,14164
645,2019-09-18,792,28107,1382,2,30283
645,2019-09-19,491,12039,1132,1,13663
645,2019-09-20,235,10327,2133,1,12696
645,2019-09-21,116,8947,1760,0,10823
645,2019-09-22,304,9541,1270,0,11115
645,2019-09-23,667,9447,2001,9,12124
645,2019-09-24,1101,8490,1763,3,11357
645,2019-09-25,393,6667,1995,2,9057
645,2019-09-26,545,10447,2560,0,13552
645,2019-09-27,91,7694,1629,2,9416
645,2019-09-28,432,16761,1726,3,18922
645,2019-09-29,126,17464,2468,3,20061
645,2019-09-30,191,16622,1273,0,18086
645,2019-10-01,2446,16346,1937,1,20730
645,2019-10-02,242,11275,2043,0,13560
645,2019-10-03,165,13779,1670,1,15615
645,2019-10-04,328,11089,1541,0,12958
645,2019-10-05,556,13940,2286,1,16783
645,2019-10-06,1021,10238,1629,1,12889
645,2019-10-07,317,5147,2074,3,7541
645,2019-10-08,1018,11779,1869,4,14670
645,2019-10-09,145,14633,2032,2,16812
645,2019-10-10,1238,9054,2100,0,12392
645,2019-10-11,1014,11643,1437,1,14095
645,2019-10-12,1004,4425,1737,0,7166
645,2019-10-13,1583,7305,1688,3,10579
645,2019-10-14,467,4732,1877,0,7076
645,2019-10-15,1211,7776,1866,0,10853
645,2019-10-16,384,12843,1498,0,14725
645,2019-10-17,187,4610,1951,2,6750
645,2019-10-18,278,8661,1649,1,10589
645,2019-10-19,437,5612,2414,0,8463
645,2019-10-20,994,970,1228,0,3192
645,2019-10-21,127,9986,1867,1,11981
645,2019-10-22,336,5174,2121,2,7633
645,2019-10-23,462,13724,1840,3,16029
645,2019-10-24,1501,18653,1490,3,21647
645,2019-10-25,936,10096,1305,2,12339
645,2019-10-26,916,12811,1720,2,15449
645,2019-10-27,783,27232,1431,0,29446
645,2019-10-28,2068,15371,1336,0,18775
645,2019-10-29,1383,26015,1419,1,28818
645,2019-10-30,2564,19182,1431,0,23177
645,2019-10-31,1627,11520,1539,0,14686
645,2019-11-01,1711,14412,1040,1,17164
645,2019-11-02,399,22760,935,3,24097
645,2019-11-03,1158,37729,1770,0,40657
645,2019-11-04,734,9480,1170,0,11384
645,2019-11-05,984,2304,1822,0,5110
645,2019-11-06,2069,7334,746,2,10151
645,2019-11-07,585,13468,676,5,14734
645,2019-11-08,440,9129,1348,0,10917
645,2019-11-09,697,12529,1748,0,14974
645,2019-11-10,928,13434,1192,0,15554
645,2019-11-11,423,8584,1479,2,10488
645,2019-11-12,336,16388,2877,3,19604
645,2019-11-13,529,12716,1713,1,14959
645,2019-11-14,291,13842,2258,0,16391
645,2019-11-15,141,5200,3246,1,8588
645,2019-11-16,308,3176,2367,0,5851
645,2019-11-17,190,3984,3898,4,8076
645,2019-11-18,136,3540,3113,0,6789
645,2019-11-19,487,5785,2954,1,9227
645,2019-11-20,1610,1770,2117,1,5498
657,2019-08-01,6960578,0,90,0,6960668
657,2019-08-02,7592591,0,111,0,7592702
657,2019-08-03,7428711,0,17,0,7428728
657,2019-08-04,7693588,0,107,0,7693695
657,2019-08-05,8647175,0,33,0,8647208
657,2019-08-06,8588521,0,44,1,8588566
657,2019-08-07,8112366,0,26,0,8112392
657,2019-08-08,7603641,0,0,0,7603641
657,2019-08-09,7709835,0,106,0,7709941
657,2019-08-10,8289248,0,52,0,8289300
657,2019-08-11,7740531,0,0,0,7740531
657,2019-08-12,6904867,0,113,0,6904980
657,2019-08-13,6730739,0,1,0,6730740
657,2019-08-14,6795913,0,2,0,6795915
657,2019-08-15,6991071,0,0,0,6991071
657,2019-08-16,7340175,0,202,0,7340377
657,2019-08-17,6265268,0,453,0,6265721
657,2019-08-18,2913901,0,1528,1,2915430
657,2019-08-19,1820010,0,1066,0,1821076
657,2019-08-20,1325994,0,967,1,1326962
657,2019-08-21,1119509,0,620,0,1120129
657,2019-08-22,878405,0,1260,1,879666
657,2019-08-23,433431,0,1692,0,435123
657,2019-08-24,350123,0,1611,1,351735
657,2019-08-25,437447,0,900,3,438350
657,2019-08-26,396819,0,1900,0,398719
657,2019-08-27,314797,0,1173,0,315970
657,2019-08-28,287314,0,2431,1,289746
657,2019-08-29,289495,0,1620,1,291116
657,2019-08-30,214755,0,542,1,215298
657,2019-08-31,85483,0,1,0,85484
657,2019-09-01,36610,0,2,0,36612
657,2019-08-01,6960578,0,90,0,6960668
657,2019-08-02,7592591,0,111,0,7592702
657,2019-08-03,7428711,0,17,0,7428728
657,2019-08-04,7693588,0,107,0,7693695
657,2019-08-05,8647175,0,33,0,8647208
657,2019-08-06,8588521,0,44,1,8588566
657,2019-08-07,8112366,0,26,0,8112392
657,2019-08-08,7603641,0,0,0,7603641
657,2019-08-09,7709835,0,106,0,7709941
657,2019-08-10,8289248,0,52,0,8289300
657,2019-08-11,7740531,0,0,0,7740531
657,2019-08-12,6904867,0,113,0,6904980
657,2019-08-13,6730739,0,1,0,6730740
657,2019-08-14,6795913,0,2,0,6795915
657,2019-08-15,6991071,0,0,0,6991071
657,2019-08-16,7340175,0,202,0,7340377
657,2019-08-17,6265268,0,453,0,6265721
657,2019-08-18,2913901,0,1528,1,2915430
657,2019-08-19,1820010,0,1066,0,1821076
657,2019-08-20,1325994,0,967,1,1326962
657,2019-08-21,1119509,0,620,0,1120129
657,2019-08-22,878405,0,1260,1,879666
657,2019-08-23,433431,0,1692,0,435123
657,2019-08-24,350123,0,1611,1,351735
657,2019-08-25,437447,0,900,3,438350
657,2019-08-26,396819,0,1900,0,398719
657,2019-08-27,314797,0,1173,0,315970
657,2019-08-28,287314,0,2431,1,289746
657,2019-08-29,289495,0,1620,1,291116
657,2019-08-30,214755,0,542,1,215298
657,2019-08-31,85483,0,1,0,85484
657,2019-09-01,36610,0,2,0,36612
657,2019-08-06,8588521,0,44,1,8588566
657,2019-08-07,8112366,0,26,0,8112392
657,2019-08-08,7603641,0,0,0,7603641
657,2019-08-09,7709835,0,106,0,7709941
657,2019-08-10,8289248,0,52,0,8289300
657,2019-08-11,7740531,0,0,0,7740531
657,2019-08-12,6904867,0,113,0,6904980
657,2019-08-13,6730739,0,1,0,6730740
657,2019-08-14,6795913,0,2,0,6795915
657,2019-08-15,6991071,0,0,0,6991071
657,2019-08-16,7340175,0,202,0,7340377
657,2019-08-17,6265268,0,453,0,6265721
657,2019-08-18,2913901,0,1528,1,2915430
657,2019-08-19,1820010,0,1066,0,1821076
657,2019-08-20,1325994,0,967,1,1326962
657,2019-08-21,1119509,0,620,0,1120129
657,2019-08-22,878405,0,1260,1,879666
657,2019-08-23,433431,0,1692,0,435123
657,2019-08-24,350123,0,1611,1,351735
657,2019-08-25,437447,0,900,3,438350
657,2019-08-26,396819,0,1900,0,398719
657,2019-08-27,314797,0,1173,0,315970
657,2019-08-28,287314,0,2431,1,289746
657,2019-08-29,289495,0,1620,1,291116
657,2019-08-30,214755,0,542,1,215298
658,2019-08-04,5,8,90,0,103
658,2019-08-05,273,245,215,2,735
658,2019-08-06,149,285,186,0,620
658,2019-08-07,213,19447,348,0,20008
658,2019-08-08,81,6576,215,0,6872
658,2019-08-09,72,1145,221,3,1441
658,2019-08-10,109,452,112,0,673
658,2019-08-11,244,344,100,1,689
658,2019-08-12,57,333,33,0,423
658,2019-08-13,128,289,183,1,601
658,2019-08-14,80,982,262,0,1324
658,2019-08-15,92,563,120,0,775
658,2019-08-16,48,437,111,0,596
658,2019-08-17,173,1196,799,0,2168
658,2019-08-18,866,2355,763,1,3985
658,2019-08-19,210,2105,1098,0,3413
658,2019-08-20,979,4701,1021,0,6701
658,2019-08-21,295,974,814,0,2083
658,2019-08-22,92,5377,1282,0,6751
658,2019-08-23,179,2260,1939,0,4378
658,2019-08-24,114,10805,1425,2,12346
658,2019-08-25,133,26575,2317,3,29028
658,2019-08-26,1056,36034,1572,2,38664
658,2019-08-27,83,8628,1534,1,10246
658,2019-08-28,88,13867,1261,0,15216
658,2019-08-29,86,13441,2159,4,15690
658,2019-08-30,198,2877,910,1,3986
658,2019-08-31,32,13634,2,0,13668
658,2019-09-01,117,5031,0,0,5148
658,2019-09-02,35,731,60,0,826
658,2019-09-03,67,5156,1653,1,6877
658,2019-09-04,110,13638,1375,0,15123
658,2019-09-05,83,5089,2144,2,7318
658,2019-09-06,85,18149,1539,0,19773
658,2019-09-07,1041,12295,2075,0,15411
658,2019-09-08,213,6075,1808,1,8097
658,2019-09-09,1055,10525,2036,0,13616
658,2019-09-10,211,13055,1750,28,15044
658,2019-09-11,125,7601,1744,6,9476
658,2019-09-12,88,7578,2104,1,9771
658,2019-09-13,71,9039,2350,0,11460
658,2019-09-14,113,7354,2504,0,9971
658,2019-09-15,74,6983,1460,2,8519
658,2019-09-16,92,14777,1879,1,16749
658,2019-09-17,193,9203,2073,0,11469
658,2019-09-18,178,11415,1105,0,12698
658,2019-09-19,199,9899,1803,1,11902
658,2019-09-20,1119,18715,1964,2,21800
658,2019-09-21,905,7134,2703,0,10742
658,2019-09-22,165,14645,1581,1,16392
658,2019-09-23,100,11150,1653,1,12904
658,2019-09-24,100,10326,1608,2,12036
658,2019-09-25,139,10824,1801,4,12768
658,2019-09-26,1211,11258,1937,0,14406
658,2019-09-27,63,10024,1567,3,11657
658,2019-09-28,90,16350,1917,3,18360
658,2019-09-29,71,17404,1312,1,18788
658,2019-09-30,70,27657,1496,8,29231
658,2019-10-01,66,28317,1458,0,29841
658,2019-10-02,971,14919,1705,0,17595
658,2019-10-03,547,14339,2114,2,17002
658,2019-10-04,946,12833,1630,0,15409
658,2019-10-05,66,23357,1051,1,24475
658,2019-10-06,456,16081,1522,0,18059
658,2019-10-07,2110,6305,1543,3,9961
658,2019-10-08,103,12901,1731,2,14737
658,2019-10-09,1005,16029,2179,0,19213
658,2019-10-10,2181,11668,2673,0,16522
658,2019-10-11,61,13626,1628,3,15318
658,2019-10-12,157,7640,1543,2,9342
658,2019-10-13,925,9511,1780,3,12219
658,2019-10-14,66,7225,1621,0,8912
658,2019-10-15,967,8760,1519,0,11246
658,2019-10-16,81,26726,1432,0,28239
658,2019-10-17,167,12032,1940,0,14139
658,2019-10-18,319,9570,1531,2,11422
658,2019-10-19,96,7115,1222,1,8434
658,2019-10-20,65,3190,1995,28,5278
658,2019-10-21,2013,10618,1883,9,14523
658,2019-10-22,317,7649,2056,1,10023
658,2019-10-23,1849,9291,1056,4,12200
658,2019-10-24,1045,14038,1121,1,16205
658,2019-10-25,2675,16568,1219,5,20467
658,2019-10-26,801,25628,1242,0,27671
658,2019-10-27,104,31285,1707,0,33096
658,2019-10-28,50,25695,1561,1,27307
658,2019-10-29,140,29934,1790,0,31864
658,2019-10-30,74,29461,1703,124,31362
658,2019-10-31,86,15657,1874,8,17625
658,2019-11-01,73,15885,612,0,16570
658,2019-11-02,55,11813,0,0,11868
658,2019-11-03,979,21928,0,0,22907
658,2019-11-04,934,12459,0,0,13393
658,2019-11-05,22,43,0,0,65
658,2019-08-04,5,8,90,0,103
658,2019-08-05,273,245,215,2,735
658,2019-08-06,149,285,186,0,620
658,2019-08-07,213,19447,348,0,20008
658,2019-08-08,81,6576,215,0,6872
658,2019-08-09,72,1145,221,3,1441
658,2019-08-10,109,452,112,0,673
658,2019-08-11,244,344,100,1,689
658,2019-08-12,57,333,33,0,423
658,2019-08-13,128,289,183,1,601
658,2019-08-14,80,982,262,0,1324
658,2019-08-15,92,563,120,0,775
658,2019-08-16,48,437,111,0,596
658,2019-08-17,173,1196,799,0,2168
658,2019-08-18,866,2355,763,1,3985
658,2019-08-19,210,2105,1098,0,3413
658,2019-08-20,979,4701,1021,0,6701
658,2019-08-21,295,974,814,0,2083
658,2019-08-22,92,5377,1282,0,6751
658,2019-08-23,179,2260,1939,0,4378
658,2019-08-24,114,10805,1425,2,12346
658,2019-08-25,133,26575,2317,3,29028
658,2019-08-26,1056,36034,1572,2,38664
658,2019-08-27,83,8628,1534,1,10246
658,2019-08-28,88,13867,1261,0,15216
658,2019-08-29,86,13441,2159,4,15690
658,2019-08-30,198,2877,910,1,3986
658,2019-08-31,32,13634,2,0,13668
658,2019-09-01,117,5031,0,0,5148
658,2019-09-02,35,731,60,0,826
658,2019-09-03,67,5156,1653,1,6877
658,2019-09-04,110,13638,1375,0,15123
658,2019-09-05,83,5089,2144,2,7318
658,2019-09-06,85,18149,1539,0,19773
658,2019-09-07,1041,12295,2075,0,15411
658,2019-09-08,213,6075,1808,1,8097
658,2019-09-09,1055,10525,2036,0,13616
658,2019-09-10,211,13055,1750,28,15044
658,2019-09-11,125,7601,1744,6,9476
658,2019-09-12,88,7578,2104,1,9771
658,2019-09-13,71,9039,2350,0,11460
658,2019-09-14,113,7354,2504,0,9971
658,2019-09-15,74,6983,1460,2,8519
658,2019-09-16,92,14777,1879,1,16749
658,2019-09-17,193,9203,2073,0,11469
658,2019-09-18,178,11415,1105,0,12698
658,2019-09-19,199,9899,1803,1,11902
658,2019-09-20,1119,18715,1964,2,21800
658,2019-09-21,905,7134,2703,0,10742
658,2019-09-22,165,14645,1581,1,16392
658,2019-09-23,100,11150,1653,1,12904
658,2019-09-24,100,10326,1608,2,12036
658,2019-09-25,139,10824,1801,4,12768
658,2019-09-26,1211,11258,1937,0,14406
658,2019-09-27,63,10024,1567,3,11657
658,2019-09-28,90,16350,1917,3,18360
658,2019-09-29,71,17404,1312,1,18788
658,2019-09-30,70,27657,1496,8,29231
658,2019-10-01,66,28317,1458,0,29841
658,2019-10-02,971,14919,1705,0,17595
658,2019-10-03,547,14339,2114,2,17002
658,2019-10-04,946,12833,1630,0,15409
658,2019-10-05,66,23357,1051,1,24475
658,2019-10-06,456,16081,1522,0,18059
658,2019-10-07,2110,6305,1543,3,9961
658,2019-10-08,103,12901,1731,2,14737
658,2019-10-09,1005,16029,2179,0,19213
658,2019-10-10,2181,11668,2673,0,16522
658,2019-10-11,61,13626,1628,3,15318
658,2019-10-12,157,7640,1543,2,9342
658,2019-10-13,925,9511,1780,3,12219
658,2019-10-14,66,7225,1621,0,8912
658,2019-10-15,967,8760,1519,0,11246
658,2019-10-16,81,26726,1432,0,28239
658,2019-10-17,167,12032,1940,0,14139
658,2019-10-18,319,9570,1531,2,11422
658,2019-10-19,96,7115,1222,1,8434
658,2019-10-20,65,3190,1995,28,5278
658,2019-10-21,2013,10618,1883,9,14523
658,2019-10-22,317,7649,2056,1,10023
658,2019-10-23,1849,9291,1056,4,12200
658,2019-10-24,1045,14038,1121,1,16205
658,2019-10-25,2675,16568,1219,5,20467
658,2019-10-26,801,25628,1242,0,27671
658,2019-10-27,104,31285,1707,0,33096
658,2019-10-28,50,25695,1561,1,27307
658,2019-10-29,140,29934,1790,0,31864
658,2019-10-30,74,29461,1703,124,31362
658,2019-10-31,86,15657,1874,8,17625
658,2019-11-01,73,15885,612,0,16570
658,2019-11-02,55,11813,0,0,11868
658,2019-11-03,979,21928,0,0,22907
658,2019-11-04,934,12459,0,0,13393
658,2019-11-05,22,43,0,0,65
658,2019-11-06,0,21,0,0,21
658,2019-11-07,0,24,0,0,24
658,2019-11-08,0,12,0,0,12
658,2019-11-09,0,0,0,0,0
658,2019-11-10,0,10,0,0,10
658,2019-08-04,5,8,90,0,103
658,2019-08-05,273,245,215,2,735
658,2019-08-06,149,285,186,0,620
658,2019-08-07,213,19447,348,0,20008
658,2019-08-08,81,6576,215,0,6872
658,2019-08-09,72,1145,221,3,1441
658,2019-08-10,109,452,112,0,673
658,2019-08-11,244,344,100,1,689
658,2019-08-12,57,333,33,0,423
658,2019-08-13,128,289,183,1,601
658,2019-08-14,80,982,262,0,1324
658,2019-08-15,92,563,120,0,775
658,2019-08-16,48,437,111,0,596
658,2019-08-17,173,1196,799,0,2168
658,2019-08-18,866,2355,763,1,3985
658,2019-08-19,210,2105,1098,0,3413
658,2019-08-20,979,4701,1021,0,6701
658,2019-08-21,295,974,814,0,2083
658,2019-08-22,92,5377,1282,0,6751
658,2019-08-23,179,2260,1939,0,4378
658,2019-08-24,114,10805,1425,2,12346
658,2019-08-25,133,26575,2317,3,29028
658,2019-08-26,1056,36034,1572,2,38664
658,2019-08-27,83,8628,1534,1,10246
658,2019-08-28,88,13867,1261,0,15216
658,2019-08-29,86,13441,2159,4,15690
658,2019-08-30,198,2877,910,1,3986
658,2019-08-31,32,13634,2,0,13668
658,2019-09-01,117,5031,0,0,5148
658,2019-09-02,35,731,60,0,826
658,2019-09-03,67,5156,1653,1,6877
658,2019-09-04,110,13638,1375,0,15123
658,2019-09-05,83,5089,2144,2,7318
658,2019-09-06,85,18149,1539,0,19773
658,2019-09-07,1041,12295,2075,0,15411
658,2019-09-08,213,6075,1808,1,8097
658,2019-09-09,1055,10525,2036,0,13616
658,2019-09-10,211,13055,1750,28,15044
658,2019-09-11,125,7601,1744,6,9476
658,2019-09-12,88,7578,2104,1,9771
658,2019-09-13,71,9039,2350,0,11460
658,2019-09-14,113,7354,2504,0,9971
658,2019-09-15,74,6983,1460,2,8519
658,2019-09-16,92,14777,1879,1,16749
658,2019-09-17,193,9203,2073,0,11469
658,2019-09-18,178,11415,1105,0,12698
658,2019-09-19,199,9899,1803,1,11902
658,2019-09-20,1119,18715,1964,2,21800
658,2019-09-21,905,7134,2703,0,10742
658,2019-09-22,165,14645,1581,1,16392
658,2019-09-23,100,11150,1653,1,12904
658,2019-09-24,100,10326,1608,2,12036
658,2019-09-25,139,10824,1801,4,12768
658,2019-09-26,1211,11258,1937,0,14406
658,2019-09-27,63,10024,1567,3,11657
658,2019-09-28,90,16350,1917,3,18360
658,2019-09-29,71,17404,1312,1,18788
658,2019-09-30,70,27657,1496,8,29231
658,2019-10-01,66,28317,1458,0,29841
658,2019-10-02,971,14919,1705,0,17595
658,2019-10-03,547,14339,2114,2,17002
658,2019-10-04,946,12833,1630,0,15409
658,2019-10-05,66,23357,1051,1,24475
658,2019-10-06,456,16081,1522,0,18059
658,2019-10-07,2110,6305,1543,3,9961
658,2019-10-08,103,12901,1731,2,14737
658,2019-10-09,1005,16029,2179,0,19213
658,2019-10-10,2181,11668,2673,0,16522
658,2019-10-11,61,13626,1628,3,15318
658,2019-10-12,157,7640,1543,2,9342
658,2019-10-13,925,9511,1780,3,12219
658,2019-10-14,66,7225,1621,0,8912
658,2019-10-15,967,8760,1519,0,11246
658,2019-10-16,81,26726,1432,0,28239
658,2019-10-17,167,12032,1940,0,14139
658,2019-10-18,319,9570,1531,2,11422
658,2019-10-19,96,7115,1222,1,8434
658,2019-10-20,65,3190,1995,28,5278
658,2019-10-21,2013,10618,1883,9,14523
658,2019-10-22,317,7649,2056,1,10023
658,2019-10-23,1849,9291,1056,4,12200
658,2019-10-24,1045,14038,1121,1,16205
658,2019-10-25,2675,16568,1219,5,20467
658,2019-10-26,801,25628,1242,0,27671
658,2019-10-27,104,31285,1707,0,33096
658,2019-10-28,50,25695,1561,1,27307
658,2019-10-29,140,29934,1790,0,31864
658,2019-10-30,74,29461,1703,124,31362
658,2019-10-31,86,15657,1874,8,17625
658,2019-11-01,73,15885,612,0,16570
658,2019-08-05,273,245,215,2,735
658,2019-08-06,149,285,186,0,620
658,2019-08-07,213,19447,348,0,20008
658,2019-08-08,81,6576,215,0,6872
658,2019-08-09,72,1145,221,3,1441
658,2019-08-10,109,452,112,0,673
658,2019-08-11,244,344,100,1,689
658,2019-08-12,57,333,33,0,423
658,2019-08-13,128,289,183,1,601
658,2019-08-14,80,982,262,0,1324
658,2019-08-15,92,563,120,0,775
658,2019-08-16,48,437,111,0,596
658,2019-08-17,173,1196,799,0,2168
658,2019-08-18,866,2355,763,1,3985
658,2019-08-19,210,2105,1098,0,3413
658,2019-08-20,979,4701,1021,0,6701
658,2019-08-21,295,974,814,0,2083
658,2019-08-22,92,5377,1282,0,6751
658,2019-08-23,179,2260,1939,0,4378
658,2019-08-24,114,10805,1425,2,12346
658,2019-08-25,133,26575,2317,3,29028
658,2019-08-26,1056,36034,1572,2,38664
658,2019-08-27,83,8628,1534,1,10246
658,2019-08-28,88,13867,1261,0,15216
658,2019-08-29,86,13441,2159,4,15690
658,2019-08-30,198,2877,910,1,3986
658,2019-08-31,32,13634,2,0,13668
658,2019-09-01,117,5031,0,0,5148
658,2019-09-02,35,731,60,0,826
658,2019-09-03,67,5156,1653,1,6877
658,2019-09-04,110,13638,1375,0,15123
658,2019-09-05,83,5089,2144,2,7318
658,2019-09-06,85,18149,1539,0,19773
658,2019-09-07,1041,12295,2075,0,15411
658,2019-09-08,213,6075,1808,1,8097
658,2019-09-09,1055,10525,2036,0,13616
658,2019-09-10,211,13055,1750,28,15044
658,2019-09-11,125,7601,1744,6,9476
658,2019-09-12,88,7578,2104,1,9771
658,2019-09-13,71,9039,2350,0,11460
658,2019-09-14,113,7354,2504,0,9971
658,2019-09-15,74,6983,1460,2,8519
658,2019-09-16,92,14777,1879,1,16749
658,2019-09-17,193,9203,2073,0,11469
658,2019-09-18,178,11415,1105,0,12698
658,2019-09-19,199,9899,1803,1,11902
658,2019-09-20,1119,18715,1964,2,21800
658,2019-09-21,905,7134,2703,0,10742
658,2019-09-22,165,14645,1581,1,16392
658,2019-09-23,100,11150,1653,1,12904
658,2019-09-24,100,10326,1608,2,12036
658,2019-09-25,139,10824,1801,4,12768
658,2019-09-26,1211,11258,1937,0,14406
658,2019-09-27,63,10024,1567,3,11657
658,2019-09-28,90,16350,1917,3,18360
658,2019-09-29,71,17404,1312,1,18788
658,2019-09-30,70,27657,1496,8,29231
658,2019-10-01,66,28317,1458,0,29841
658,2019-10-02,971,14919,1705,0,17595
658,2019-10-03,547,14339,2114,2,17002
658,2019-10-04,946,12833,1630,0,15409
658,2019-10-05,66,23357,1051,1,24475
658,2019-10-06,456,16081,1522,0,18059
658,2019-10-07,2110,6305,1543,3,9961
658,2019-10-08,103,12901,1731,2,14737
658,2019-10-09,1005,16029,2179,0,19213
658,2019-10-10,2181,11668,2673,0,16522
658,2019-10-11,61,13626,1628,3,15318
658,2019-10-12,157,7640,1543,2,9342
658,2019-10-13,925,9511,1780,3,12219
658,2019-10-14,66,7225,1621,0,8912
658,2019-10-15,967,8760,1519,0,11246
658,2019-10-16,81,26726,1432,0,28239
658,2019-10-17,167,12032,1940,0,14139
658,2019-10-18,319,9570,1531,2,11422
658,2019-10-19,96,7115,1222,1,8434
658,2019-10-20,65,3190,1995,28,5278
658,2019-10-21,2013,10618,1883,9,14523
658,2019-10-22,317,7649,2056,1,10023
658,2019-10-23,1849,9291,1056,4,12200
658,2019-10-24,1045,14038,1121,1,16205
658,2019-10-25,2675,16568,1219,5,20467
658,2019-10-26,801,25628,1242,0,27671
658,2019-10-27,104,31285,1707,0,33096
658,2019-10-28,50,25695,1561,1,27307
658,2019-10-29,140,29934,1790,0,31864
658,2019-10-30,74,29461,1703,124,31362
658,2019-10-31,86,15657,1874,8,17625
659,2019-08-04,13,8,278,0,299
659,2019-08-05,858,352,310,2,1522
659,2019-08-06,734,8198,359,0,9291
659,2019-08-07,571,4928,339,0,5838
659,2019-08-08,370,400,341,0,1111
659,2019-08-09,478,1600,248,0,2326
659,2019-08-10,674,349,128,0,1151
659,2019-08-11,413,194,62,0,669
659,2019-08-12,613,306,148,0,1067
659,2019-08-13,335,395,317,0,1047
659,2019-08-14,369,921,151,0,1441
659,2019-08-15,606,533,57,0,1196
659,2019-08-16,569,390,74,0,1033
659,2019-08-17,959,1190,886,1,3036
659,2019-08-18,1394,7785,1228,0,10407
659,2019-08-19,667,3107,1623,2,5399
659,2019-08-20,720,2365,1447,3,4535
659,2019-08-21,888,1597,820,0,3305
659,2019-08-22,883,14803,1246,1,16933
659,2019-08-23,996,11858,1082,1,13937
659,2019-08-24,1119,7101,1520,2,9742
659,2019-08-25,2316,33072,2101,2,37491
659,2019-08-26,1004,31111,1983,1,34099
659,2019-08-27,937,5925,1802,2,8666
659,2019-08-28,836,16187,1571,42,18636
659,2019-08-29,980,12946,2267,0,16193
659,2019-08-30,803,2792,571,0,4166
659,2019-08-31,379,12509,0,0,12888
659,2019-09-01,287,3081,548,1,3917
659,2019-09-02,335,814,68,0,1217
659,2019-09-03,354,3955,1057,1,5367
659,2019-09-04,794,12891,1917,2,15604
659,2019-09-05,3037,4427,1627,1,9092
659,2019-09-06,1610,17820,2939,1,22370
659,2019-09-07,840,11262,1489,0,13591
659,2019-09-08,902,7472,1830,28,10232
659,2019-09-09,3519,9351,1815,44,14729
659,2019-09-10,1005,11314,2126,0,14445
659,2019-09-11,534,5823,2612,2,8971
659,2019-09-12,538,13022,2633,0,16193
659,2019-09-13,682,9228,3387,0,13297
659,2019-09-14,1432,9519,2160,0,13111
659,2019-09-15,2392,8119,1569,2,12082
659,2019-09-16,1437,13070,2433,0,16940
659,2019-09-17,1381,10374,2039,2,13796
659,2019-09-18,655,11922,1826,1,14404
659,2019-09-19,824,3426,2350,1,6601
659,2019-09-20,676,11795,1610,0,14081
659,2019-09-21,1427,5948,2163,1,9539
659,2019-09-22,1439,14823,1775,2,18039
659,2019-09-23,1428,9488,1548,1,12465
659,2019-09-24,1600,8017,2128,1,11746
659,2019-09-25,329,9832,1603,0,11764
659,2019-09-26,335,9213,1531,1,11080
659,2019-09-27,280,8966,1667,3,10916
659,2019-09-28,404,14831,1776,1,17012
659,2019-09-29,265,16789,1068,6,18128
659,2019-09-30,1090,26718,2427,0,30235
659,2019-10-01,1400,21780,2217,2,25399
659,2019-10-02,2286,12472,2125,0,16883
659,2019-10-03,1714,21906,2542,0,26162
659,2019-10-04,716,13131,1566,2,15415
659,2019-10-05,1237,20226,1050,1,22514
659,2019-10-06,292,15659,1665,0,17616
659,2019-10-07,280,4896,1517,5,6698
659,2019-10-08,1265,11535,1366,0,14166
659,2019-10-09,311,13303,1482,1,15097
659,2019-10-10,2070,9556,2168,2,13796
659,2019-10-11,972,16300,1938,1,19211
659,2019-10-12,696,7826,2201,3,10726
659,2019-10-13,631,7353,2025,0,10009
659,2019-10-14,493,4689,2343,2,7527
659,2019-10-15,573,12883,1665,3,15124
659,2019-10-16,925,28675,1388,2,30990
659,2019-10-17,832,9623,2493,4,12952
659,2019-10-18,562,8054,1834,0,10450
659,2019-10-19,598,3830,1704,12,6144
659,2019-10-20,540,621,1736,0,2897
659,2019-10-21,1534,9423,1761,0,12718
659,2019-10-22,424,4733,1983,5,7145
659,2019-10-23,1026,7095,1929,1,10051
659,2019-10-24,612,13099,1726,1,15438
659,2019-10-25,1884,10211,1961,2,14058
659,2019-10-26,475,14305,1148,0,15928
659,2019-10-27,547,16363,1408,0,18318
659,2019-10-28,1069,23311,1498,15,25893
659,2019-10-29,1014,28918,2246,0,32178
659,2019-10-30,501,20460,1337,0,22298
659,2019-10-31,2052,11289,2005,1,15347
659,2019-11-01,1060,14105,1760,2,16927
659,2019-11-02,1544,13196,2276,1,17017
659,2019-11-03,1166,23543,1630,1,26340
659,2019-11-04,1483,9306,1917,0,12706
659,2019-11-05,2308,1327,2436,1,6072
659,2019-11-06,1240,7302,872,2,9416
659,2019-11-07,836,21843,801,3,23483
659,2019-11-08,768,16774,1874,1,19417
659,2019-11-09,5287,14156,664,1,20108
659,2019-11-10,6410,11985,1821,0,20216
659,2019-11-11,9722,8296,2437,3,20458
659,2019-11-12,2019,9518,2757,0,14294
659,2019-11-13,1798,21108,1550,0,24456
659,2019-11-14,1623,9754,2543,0,13920
659,2019-11-15,1589,4272,2089,1,7951
659,2019-11-16,761,2747,1812,2,5322
659,2019-11-17,878,3701,2922,0,7501
659,2019-11-18,841,3340,3218,1,7400
659,2019-11-19,958,2855,0,0,3813
659,2019-11-20,816,1018,0,0,1834
659,2019-11-21,1377,3429,0,0,4806
659,2019-11-22,30,157,0,0,187
659,2019-08-04,13,8,278,0,299
659,2019-08-05,858,352,310,2,1522
659,2019-08-06,734,8198,359,0,9291
659,2019-08-07,571,4928,339,0,5838
659,2019-08-08,370,400,341,0,1111
659,2019-08-09,478,1600,248,0,2326
659,2019-08-10,674,349,128,0,1151
659,2019-08-11,413,194,62,0,669
659,2019-08-12,613,306,148,0,1067
659,2019-08-13,335,395,317,0,1047
659,2019-08-14,369,921,151,0,1441
659,2019-08-15,606,533,57,0,1196
659,2019-08-16,569,390,74,0,1033
659,2019-08-17,959,1190,886,1,3036
659,2019-08-18,1394,7785,1228,0,10407
659,2019-08-19,667,3107,1623,2,5399
659,2019-08-20,720,2365,1447,3,4535
659,2019-08-21,888,1597,820,0,3305
659,2019-08-22,883,14803,1246,1,16933
659,2019-08-23,996,11858,1082,1,13937
659,2019-08-24,1119,7101,1520,2,9742
659,2019-08-25,2316,33072,2101,2,37491
659,2019-08-26,1004,31111,1983,1,34099
659,2019-08-27,937,5925,1802,2,8666
659,2019-08-28,836,16187,1571,42,18636
659,2019-08-29,980,12946,2267,0,16193
659,2019-08-30,803,2792,571,0,4166
659,2019-08-31,379,12509,0,0,12888
659,2019-09-01,287,3081,548,1,3917
659,2019-09-02,335,814,68,0,1217
659,2019-09-03,354,3955,1057,1,5367
659,2019-09-04,794,12891,1917,2,15604
659,2019-09-05,3037,4427,1627,1,9092
659,2019-09-06,1610,17820,2939,1,22370
659,2019-09-07,840,11262,1489,0,13591
659,2019-09-08,902,7472,1830,28,10232
659,2019-09-09,3519,9351,1815,44,14729
659,2019-09-10,1005,11314,2126,0,14445
659,2019-09-11,534,5823,2612,2,8971
659,2019-09-12,538,13022,2633,0,16193
659,2019-09-13,682,9228,3387,0,13297
659,2019-09-14,1432,9519,2160,0,13111
659,2019-09-15,2392,8119,1569,2,12082
659,2019-09-16,1437,13070,2433,0,16940
659,2019-09-17,1381,10374,2039,2,13796
659,2019-09-18,655,11922,1826,1,14404
659,2019-09-19,824,3426,2350,1,6601
659,2019-09-20,676,11795,1610,0,14081
659,2019-09-21,1427,5948,2163,1,9539
659,2019-09-22,1439,14823,1775,2,18039
659,2019-09-23,1428,9488,1548,1,12465
659,2019-09-24,1600,8017,2128,1,11746
659,2019-09-25,329,9832,1603,0,11764
659,2019-09-26,335,9213,1531,1,11080
659,2019-09-27,280,8966,1667,3,10916
659,2019-09-28,404,14831,1776,1,17012
659,2019-09-29,265,16789,1068,6,18128
659,2019-09-30,1090,26718,2427,0,30235
659,2019-10-01,1400,21780,2217,2,25399
659,2019-10-02,2286,12472,2125,0,16883
659,2019-10-03,1714,21906,2542,0,26162
659,2019-10-04,716,13131,1566,2,15415
659,2019-10-05,1237,20226,1050,1,22514
659,2019-10-06,292,15659,1665,0,17616
659,2019-10-07,280,4896,1517,5,6698
659,2019-10-08,1265,11535,1366,0,14166
659,2019-10-09,311,13303,1482,1,15097
659,2019-10-10,2070,9556,2168,2,13796
659,2019-10-11,972,16300,1938,1,19211
659,2019-10-12,696,7826,2201,3,10726
659,2019-10-13,631,7353,2025,0,10009
659,2019-10-14,493,4689,2343,2,7527
659,2019-10-15,573,12883,1665,3,15124
659,2019-10-16,925,28675,1388,2,30990
659,2019-10-17,832,9623,2493,4,12952
659,2019-10-18,562,8054,1834,0,10450
659,2019-10-19,598,3830,1704,12,6144
659,2019-10-20,540,621,1736,0,2897
659,2019-10-21,1534,9423,1761,0,12718
659,2019-10-22,424,4733,1983,5,7145
659,2019-10-23,1026,7095,1929,1,10051
659,2019-10-24,612,13099,1726,1,15438
659,2019-10-25,1884,10211,1961,2,14058
659,2019-10-26,475,14305,1148,0,15928
659,2019-10-27,547,16363,1408,0,18318
659,2019-10-28,1069,23311,1498,15,25893
659,2019-10-29,1014,28918,2246,0,32178
659,2019-10-30,501,20460,1337,0,22298
659,2019-10-31,2052,11289,2005,1,15347
659,2019-11-01,1060,14105,1760,2,16927
659,2019-11-02,1544,13196,2276,1,17017
659,2019-11-03,1166,23543,1630,1,26340
659,2019-11-04,1483,9306,1917,0,12706
659,2019-11-05,2308,1327,2436,1,6072
659,2019-11-06,1240,7302,872,2,9416
659,2019-11-07,836,21843,801,3,23483
659,2019-11-08,768,16774,1874,1,19417
659,2019-11-09,5287,14156,664,1,20108
659,2019-11-10,6410,11985,1821,0,20216
659,2019-11-11,9722,8296,2437,3,20458
659,2019-11-12,2019,9518,2757,0,14294
659,2019-11-13,1798,21108,1550,0,24456
659,2019-11-14,1623,9754,2543,0,13920
659,2019-11-15,1589,4272,2089,1,7951
659,2019-11-16,761,2747,1812,2,5322
659,2019-11-17,878,3701,2922,0,7501
659,2019-11-18,841,3340,3218,1,7400
659,2019-11-19,958,2855,0,0,3813
659,2019-11-20,816,1018,0,0,1834
659,2019-11-21,1377,3429,0,0,4806
659,2019-11-22,30,157,0,0,187
659,2019-08-04,13,8,278,0,299
659,2019-08-05,858,352,310,2,1522
659,2019-08-06,734,8198,359,0,9291
659,2019-08-07,571,4928,339,0,5838
659,2019-08-08,370,400,341,0,1111
659,2019-08-09,478,1600,248,0,2326
659,2019-08-10,674,349,128,0,1151
659,2019-08-11,413,194,62,0,669
659,2019-08-12,613,306,148,0,1067
659,2019-08-13,335,395,317,0,1047
659,2019-08-14,369,921,151,0,1441
659,2019-08-15,606,533,57,0,1196
659,2019-08-16,569,390,74,0,1033
659,2019-08-17,959,1190,886,1,3036
659,2019-08-18,1394,7785,1228,0,10407
659,2019-08-19,667,3107,1623,2,5399
659,2019-08-20,720,2365,1447,3,4535
659,2019-08-21,888,1597,820,0,3305
659,2019-08-22,883,14803,1246,1,16933
659,2019-08-23,996,11858,1082,1,13937
659,2019-08-24,1119,7101,1520,2,9742
659,2019-08-25,2316,33072,2101,2,37491
659,2019-08-26,1004,31111,1983,1,34099
659,2019-08-27,937,5925,1802,2,8666
659,2019-08-28,836,16187,1571,42,18636
659,2019-08-29,980,12946,2267,0,16193
659,2019-08-30,803,2792,571,0,4166
659,2019-08-31,379,12509,0,0,12888
659,2019-09-01,287,3081,548,1,3917
659,2019-09-02,335,814,68,0,1217
659,2019-09-03,354,3955,1057,1,5367
659,2019-09-04,794,12891,1917,2,15604
659,2019-09-05,3037,4427,1627,1,9092
659,2019-09-06,1610,17820,2939,1,22370
659,2019-09-07,840,11262,1489,0,13591
659,2019-09-08,902,7472,1830,28,10232
659,2019-09-09,3519,9351,1815,44,14729
659,2019-09-10,1005,11314,2126,0,14445
659,2019-09-11,534,5823,2612,2,8971
659,2019-09-12,538,13022,2633,0,16193
659,2019-09-13,682,9228,3387,0,13297
659,2019-09-14,1432,9519,2160,0,13111
659,2019-09-15,2392,8119,1569,2,12082
659,2019-09-16,1437,13070,2433,0,16940
659,2019-09-17,1381,10374,2039,2,13796
659,2019-09-18,655,11922,1826,1,14404
659,2019-09-19,824,3426,2350,1,6601
659,2019-09-20,676,11795,1610,0,14081
659,2019-09-21,1427,5948,2163,1,9539
659,2019-09-22,1439,14823,1775,2,18039
659,2019-09-23,1428,9488,1548,1,12465
659,2019-09-24,1600,8017,2128,1,11746
659,2019-09-25,329,9832,1603,0,11764
659,2019-09-26,335,9213,1531,1,11080
659,2019-09-27,280,8966,1667,3,10916
659,2019-09-28,404,14831,1776,1,17012
659,2019-09-29,265,16789,1068,6,18128
659,2019-09-30,1090,26718,2427,0,30235
659,2019-10-01,1400,21780,2217,2,25399
659,2019-10-02,2286,12472,2125,0,16883
659,2019-10-03,1714,21906,2542,0,26162
659,2019-10-04,716,13131,1566,2,15415
659,2019-10-05,1237,20226,1050,1,22514
659,2019-10-06,292,15659,1665,0,17616
659,2019-10-07,280,4896,1517,5,6698
659,2019-10-08,1265,11535,1366,0,14166
659,2019-10-09,311,13303,1482,1,15097
659,2019-10-10,2070,9556,2168,2,13796
659,2019-10-11,972,16300,1938,1,19211
659,2019-10-12,696,7826,2201,3,10726
659,2019-10-13,631,7353,2025,0,10009
659,2019-10-14,493,4689,2343,2,7527
659,2019-10-15,573,12883,1665,3,15124
659,2019-10-16,925,28675,1388,2,30990
659,2019-10-17,832,9623,2493,4,12952
659,2019-10-18,562,8054,1834,0,10450
659,2019-10-19,598,3830,1704,12,6144
659,2019-10-20,540,621,1736,0,2897
659,2019-10-21,1534,9423,1761,0,12718
659,2019-10-22,424,4733,1983,5,7145
659,2019-10-23,1026,7095,1929,1,10051
659,2019-10-24,612,13099,1726,1,15438
659,2019-10-25,1884,10211,1961,2,14058
659,2019-10-26,475,14305,1148,0,15928
659,2019-10-27,547,16363,1408,0,18318
659,2019-10-28,1069,23311,1498,15,25893
659,2019-10-29,1014,28918,2246,0,32178
659,2019-10-30,501,20460,1337,0,22298
659,2019-10-31,2052,11289,2005,1,15347
659,2019-11-01,1060,14105,1760,2,16927
659,2019-11-02,1544,13196,2276,1,17017
659,2019-11-03,1166,23543,1630,1,26340
659,2019-11-04,1483,9306,1917,0,12706
659,2019-11-05,2308,1327,2436,1,6072
659,2019-11-06,1240,7302,872,2,9416
659,2019-11-07,836,21843,801,3,23483
659,2019-11-08,768,16774,1874,1,19417
659,2019-11-09,5287,14156,664,1,20108
659,2019-11-10,6410,11985,1821,0,20216
659,2019-11-11,9722,8296,2437,3,20458
659,2019-11-12,2019,9518,2757,0,14294
659,2019-11-13,1798,21108,1550,0,24456
659,2019-11-14,1623,9754,2543,0,13920
659,2019-11-15,1589,4272,2089,1,7951
659,2019-11-16,761,2747,1812,2,5322
659,2019-11-17,878,3701,2922,0,7501
659,2019-11-18,841,3340,3218,1,7400
659,2019-08-05,858,352,310,2,1522
659,2019-08-06,734,8198,359,0,9291
659,2019-08-07,571,4928,339,0,5838
659,2019-08-08,370,400,341,0,1111
659,2019-08-09,478,1600,248,0,2326
659,2019-08-10,674,349,128,0,1151
659,2019-08-11,413,194,62,0,669
659,2019-08-12,613,306,148,0,1067
659,2019-08-13,335,395,317,0,1047
659,2019-08-14,369,921,151,0,1441
659,2019-08-15,606,533,57,0,1196
659,2019-08-16,569,390,74,0,1033
659,2019-08-17,959,1190,886,1,3036
659,2019-08-18,1394,7785,1228,0,10407
659,2019-08-19,667,3107,1623,2,5399
659,2019-08-20,720,2365,1447,3,4535
659,2019-08-21,888,1597,820,0,3305
659,2019-08-22,883,14803,1246,1,16933
659,2019-08-23,996,11858,1082,1,13937
659,2019-08-24,1119,7101,1520,2,9742
659,2019-08-25,2316,33072,2101,2,37491
659,2019-08-26,1004,31111,1983,1,34099
659,2019-08-27,937,5925,1802,2,8666
659,2019-08-28,836,16187,1571,42,18636
659,2019-08-29,980,12946,2267,0,16193
659,2019-08-30,803,2792,571,0,4166
659,2019-08-31,379,12509,0,0,12888
659,2019-09-01,287,3081,548,1,3917
659,2019-09-02,335,814,68,0,1217
659,2019-09-03,354,3955,1057,1,5367
659,2019-09-04,794,12891,1917,2,15604
659,2019-09-05,3037,4427,1627,1,9092
659,2019-09-06,1610,17820,2939,1,22370
659,2019-09-07,840,11262,1489,0,13591
659,2019-09-08,902,7472,1830,28,10232
659,2019-09-09,3519,9351,1815,44,14729
659,2019-09-10,1005,11314,2126,0,14445
659,2019-09-11,534,5823,2612,2,8971
659,2019-09-12,538,13022,2633,0,16193
659,2019-09-13,682,9228,3387,0,13297
659,2019-09-14,1432,9519,2160,0,13111
659,2019-09-15,2392,8119,1569,2,12082
659,2019-09-16,1437,13070,2433,0,16940
659,2019-09-17,1381,10374,2039,2,13796
659,2019-09-18,655,11922,1826,1,14404
659,2019-09-19,824,3426,2350,1,6601
659,2019-09-20,676,11795,1610,0,14081
659,2019-09-21,1427,5948,2163,1,9539
659,2019-09-22,1439,14823,1775,2,18039
659,2019-09-23,1428,9488,1548,1,12465
659,2019-09-24,1600,8017,2128,1,11746
659,2019-09-25,329,9832,1603,0,11764
659,2019-09-26,335,9213,1531,1,11080
659,2019-09-27,280,8966,1667,3,10916
659,2019-09-28,404,14831,1776,1,17012
659,2019-09-29,265,16789,1068,6,18128
659,2019-09-30,1090,26718,2427,0,30235
659,2019-10-01,1400,21780,2217,2,25399
659,2019-10-02,2286,12472,2125,0,16883
659,2019-10-03,1714,21906,2542,0,26162
659,2019-10-04,716,13131,1566,2,15415
659,2019-10-05,1237,20226,1050,1,22514
659,2019-10-06,292,15659,1665,0,17616
659,2019-10-07,280,4896,1517,5,6698
659,2019-10-08,1265,11535,1366,0,14166
659,2019-10-09,311,13303,1482,1,15097
659,2019-10-10,2070,9556,2168,2,13796
659,2019-10-11,972,16300,1938,1,19211
659,2019-10-12,696,7826,2201,3,10726
659,2019-10-13,631,7353,2025,0,10009
659,2019-10-14,493,4689,2343,2,7527
659,2019-10-15,573,12883,1665,3,15124
659,2019-10-16,925,28675,1388,2,30990
659,2019-10-17,832,9623,2493,4,12952
659,2019-10-18,562,8054,1834,0,10450
659,2019-10-19,598,3830,1704,12,6144
659,2019-10-20,540,621,1736,0,2897
659,2019-10-21,1534,9423,1761,0,12718
659,2019-10-22,424,4733,1983,5,7145
659,2019-10-23,1026,7095,1929,1,10051
659,2019-10-24,612,13099,1726,1,15438
659,2019-10-25,1884,10211,1961,2,14058
659,2019-10-26,475,14305,1148,0,15928
659,2019-10-27,547,16363,1408,0,18318
659,2019-10-28,1069,23311,1498,15,25893
659,2019-10-29,1014,28918,2246,0,32178
659,2019-10-30,501,20460,1337,0,22298
659,2019-10-31,2052,11289,2005,1,15347
659,2019-11-01,1060,14105,1760,2,16927
659,2019-11-02,1544,13196,2276,1,17017
659,2019-11-03,1166,23543,1630,1,26340
659,2019-11-04,1483,9306,1917,0,12706
659,2019-11-05,2308,1327,2436,1,6072
659,2019-11-06,1240,7302,872,2,9416
659,2019-11-07,836,21843,801,3,23483
659,2019-11-08,768,16774,1874,1,19417
659,2019-11-09,5287,14156,664,1,20108
659,2019-11-10,6410,11985,1821,0,20216
659,2019-11-11,9722,8296,2437,3,20458
659,2019-11-12,2019,9518,2757,0,14294
659,2019-11-13,1798,21108,1550,0,24456
659,2019-11-14,1623,9754,2543,0,13920
659,2019-11-15,1589,4272,2089,1,7951
659,2019-11-16,761,2747,1812,2,5322
659,2019-11-17,878,3701,2922,0,7501
659,2019-11-18,841,3340,3218,1,7400
660,2019-08-04,2,2,90,0,94
660,2019-08-05,127,204,744,2,1077
660,2019-08-06,190,7883,124,1,8198
660,2019-08-07,199,4945,216,3,5363
660,2019-08-08,91,390,197,1,679
660,2019-08-09,176,250,241,0,667
660,2019-08-10,124,572,109,1,806
660,2019-08-11,103,248,191,2,544
660,2019-08-12,339,5046,179,0,5564
660,2019-08-13,138,4524,109,0,4771
660,2019-08-14,75,458,31,0,564
660,2019-08-15,64,222,127,0,413
660,2019-08-16,83,399,25,1,508
660,2019-08-17,248,783,661,1,1693
660,2019-08-18,417,1273,952,2,2644
660,2019-08-19,81,703,542,0,1326
660,2019-08-20,328,1257,1142,2,2729
660,2019-08-21,80,738,1556,0,2374
660,2019-08-22,715,12981,1950,1,15647
660,2019-08-23,113,16478,1092,1,17684
660,2019-08-24,99,9625,1886,1,11611
660,2019-08-25,175,13334,1350,2,14861
660,2019-08-26,100,23852,1709,2,25663
660,2019-08-27,98,6714,2457,1,9270
660,2019-08-28,94,20517,1170,0,21781
660,2019-08-29,281,13104,1623,2,15010
660,2019-08-30,73,3011,638,2,3724
660,2019-08-31,17,8086,4,1,8108
660,2019-09-01,54,2814,194,0,3062
660,2019-09-02,13,1044,98,0,1155
660,2019-09-03,71,3921,1134,0,5126
660,2019-09-04,79,8620,2335,4,11038
660,2019-09-05,99,7267,1634,1,9001
660,2019-09-06,79,13406,2061,2,15548
660,2019-09-07,104,18250,2764,1,21119
660,2019-09-08,186,9329,911,36,10462
660,2019-09-09,962,11272,1874,3,14111
660,2019-09-10,231,10583,1546,0,12360
660,2019-09-11,134,10465,2176,1,12776
660,2019-09-12,889,11657,2083,1,14630
660,2019-09-13,379,8573,1781,2,10735
660,2019-09-14,80,6409,1501,1,7991
660,2019-09-15,170,7649,1808,2,9629
660,2019-09-16,1535,12871,2115,5,16526
660,2019-09-17,930,14469,2139,8,17546
660,2019-09-18,183,11315,1331,11,12840
660,2019-09-19,816,3489,1440,9,5754
660,2019-09-20,311,11298,2318,9,13936
660,2019-09-21,97,8228,907,10,9242
660,2019-09-22,184,9489,1148,6,10827
660,2019-09-23,999,8048,1620,3,10670
660,2019-09-24,124,9074,2215,5,11418
660,2019-09-25,1036,8547,2181,2,11766
660,2019-09-26,119,9270,1497,0,10886
660,2019-09-27,209,10119,1728,2,12058
660,2019-09-28,213,15011,1501,1,16726
660,2019-09-29,134,16134,1682,8,17958
660,2019-09-30,107,17511,1820,0,19438
660,2019-10-01,94,15621,1872,2,17589
660,2019-10-02,722,11065,1904,1,13692
660,2019-10-03,99,15166,1447,1,16713
660,2019-10-04,76,11452,1478,2,13008
660,2019-10-05,555,13367,1423,1,15346
660,2019-10-06,961,10010,2380,1,13352
660,2019-10-07,947,4780,976,4,6707
660,2019-10-08,689,11285,1584,1,13559
660,2019-10-09,101,14153,2010,3,16267
660,2019-10-10,988,9221,3599,0,13808
660,2019-10-11,104,10060,1652,1,11817
660,2019-10-12,104,5403,2171,0,7678
660,2019-10-13,74,7689,1794,2,9559
660,2019-10-14,1848,9034,1552,1,12435
660,2019-10-15,71,7198,1256,0,8525
660,2019-10-16,78,18169,1691,1,19939
660,2019-10-17,67,6925,1936,2,8930
660,2019-10-18,471,7415,542,3,8431
660,2019-10-19,1847,3746,2059,10,7662
660,2019-10-20,165,760,1927,0,2852
660,2019-10-21,119,9654,1005,1,10779
660,2019-10-22,75,4931,752,2,5760
660,2019-10-23,73,13025,1450,1,14549
660,2019-10-24,1021,17903,2054,1,20979
660,2019-10-25,73,10282,2061,1,12417
660,2019-10-26,75,12904,1989,0,14968
660,2019-10-27,103,15374,1555,1,17033
660,2019-10-28,57,13237,1417,10,14721
660,2019-10-29,702,26541,1049,4,28296
660,2019-10-30,59,20201,1462,1,21723
660,2019-10-31,68,11762,1241,2,13073
660,2019-11-01,50,14017,1356,0,15423
660,2019-11-02,59,22848,1049,1,23957
660,2019-11-03,64,39031,1891,3,40989
660,2019-11-04,907,9240,1454,1,11602
660,2019-11-05,125,1430,2041,0,3596
660,2019-11-06,95,7182,892,0,8169
660,2019-11-07,199,13155,972,2,14328
660,2019-11-08,73,8731,1278,1,10083
660,2019-11-09,361,7668,1593,0,9622
660,2019-11-10,1255,11083,2331,1,14670
660,2019-11-11,787,12026,1389,0,14202
660,2019-11-12,100,17218,2633,2,19953
660,2019-11-13,435,15236,1789,0,17460
660,2019-11-14,88,8238,2143,0,10469
660,2019-11-15,84,4119,2358,0,6561
660,2019-11-16,81,2707,1818,0,4606
660,2019-11-17,1165,3853,3880,0,8898
660,2019-11-18,518,3397,2820,0,6735
660,2019-11-19,1054,5630,2693,0,9377
660,2019-11-20,275,1350,1769,0,3394
660,2019-11-21,98,5718,1374,0,7190
660,2019-11-22,101,5739,1624,0,7464
660,2019-11-23,113,6403,2044,0,8560
660,2019-11-24,214,5736,1382,0,7332
660,2019-11-25,85,10754,2221,0,13060
660,2019-11-26,988,7050,1887,0,9925
660,2019-11-27,1911,10604,1165,1,13681
660,2019-11-28,391,9998,773,0,11162
660,2019-11-29,27,770,58,0,855
660,2019-08-04,2,2,90,0,94
660,2019-08-05,127,204,744,2,1077
660,2019-08-06,190,7883,124,1,8198
660,2019-08-07,199,4945,216,3,5363
660,2019-08-08,91,390,197,1,679
660,2019-08-09,176,250,241,0,667
660,2019-08-10,124,572,109,1,806
660,2019-08-11,103,248,191,2,544
660,2019-08-12,339,5046,179,0,5564
660,2019-08-13,138,4524,109,0,4771
660,2019-08-14,75,458,31,0,564
660,2019-08-15,64,222,127,0,413
660,2019-08-16,83,399,25,1,508
660,2019-08-17,248,783,661,1,1693
660,2019-08-18,417,1273,952,2,2644
660,2019-08-19,81,703,542,0,1326
660,2019-08-20,328,1257,1142,2,2729
660,2019-08-21,80,738,1556,0,2374
660,2019-08-22,715,12981,1950,1,15647
660,2019-08-23,113,16478,1092,1,17684
660,2019-08-24,99,9625,1886,1,11611
660,2019-08-25,175,13334,1350,2,14861
660,2019-08-26,100,23852,1709,2,25663
660,2019-08-27,98,6714,2457,1,9270
660,2019-08-28,94,20517,1170,0,21781
660,2019-08-29,281,13104,1623,2,15010
660,2019-08-30,73,3011,638,2,3724
660,2019-08-31,17,8086,4,1,8108
660,2019-09-01,54,2814,194,0,3062
660,2019-09-02,13,1044,98,0,1155
660,2019-09-03,71,3921,1134,0,5126
660,2019-09-04,79,8620,2335,4,11038
660,2019-09-05,99,7267,1634,1,9001
660,2019-09-06,79,13406,2061,2,15548
660,2019-09-07,104,18250,2764,1,21119
660,2019-09-08,186,9329,911,36,10462
660,2019-09-09,962,11272,1874,3,14111
660,2019-09-10,231,10583,1546,0,12360
660,2019-09-11,134,10465,2176,1,12776
660,2019-09-12,889,11657,2083,1,14630
660,2019-09-13,379,8573,1781,2,10735
660,2019-09-14,80,6409,1501,1,7991
660,2019-09-15,170,7649,1808,2,9629
660,2019-09-16,1535,12871,2115,5,16526
660,2019-09-17,930,14469,2139,8,17546
660,2019-09-18,183,11315,1331,11,12840
660,2019-09-19,816,3489,1440,9,5754
660,2019-09-20,311,11298,2318,9,13936
660,2019-09-21,97,8228,907,10,9242
660,2019-09-22,184,9489,1148,6,10827
660,2019-09-23,999,8048,1620,3,10670
660,2019-09-24,124,9074,2215,5,11418
660,2019-09-25,1036,8547,2181,2,11766
660,2019-09-26,119,9270,1497,0,10886
660,2019-09-27,209,10119,1728,2,12058
660,2019-09-28,213,15011,1501,1,16726
660,2019-09-29,134,16134,1682,8,17958
660,2019-09-30,107,17511,1820,0,19438
660,2019-10-01,94,15621,1872,2,17589
660,2019-10-02,722,11065,1904,1,13692
660,2019-10-03,99,15166,1447,1,16713
660,2019-10-04,76,11452,1478,2,13008
660,2019-10-05,555,13367,1423,1,15346
660,2019-10-06,961,10010,2380,1,13352
660,2019-10-07,947,4780,976,4,6707
660,2019-10-08,689,11285,1584,1,13559
660,2019-10-09,101,14153,2010,3,16267
660,2019-10-10,988,9221,3599,0,13808
660,2019-10-11,104,10060,1652,1,11817
660,2019-10-12,104,5403,2171,0,7678
660,2019-10-13,74,7689,1794,2,9559
660,2019-10-14,1848,9034,1552,1,12435
660,2019-10-15,71,7198,1256,0,8525
660,2019-10-16,78,18169,1691,1,19939
660,2019-10-17,67,6925,1936,2,8930
660,2019-10-18,471,7415,542,3,8431
660,2019-10-19,1847,3746,2059,10,7662
660,2019-10-20,165,760,1927,0,2852
660,2019-10-21,119,9654,1005,1,10779
660,2019-10-22,75,4931,752,2,5760
660,2019-10-23,73,13025,1450,1,14549
660,2019-10-24,1021,17903,2054,1,20979
660,2019-10-25,73,10282,2061,1,12417
660,2019-10-26,75,12904,1989,0,14968
660,2019-10-27,103,15374,1555,1,17033
660,2019-10-28,57,13237,1417,10,14721
660,2019-10-29,702,26541,1049,4,28296
660,2019-10-30,59,20201,1462,1,21723
660,2019-10-31,68,11762,1241,2,13073
660,2019-11-01,50,14017,1356,0,15423
660,2019-11-02,59,22848,1049,1,23957
660,2019-11-03,64,39031,1891,3,40989
660,2019-11-04,907,9240,1454,1,11602
660,2019-11-05,125,1430,2041,0,3596
660,2019-11-06,95,7182,892,0,8169
660,2019-11-07,199,13155,972,2,14328
660,2019-11-08,73,8731,1278,1,10083
660,2019-11-09,361,7668,1593,0,9622
660,2019-11-10,1255,11083,2331,1,14670
660,2019-11-11,787,12026,1389,0,14202
660,2019-11-12,100,17218,2633,2,19953
660,2019-11-13,435,15236,1789,0,17460
660,2019-11-14,88,8238,2143,0,10469
660,2019-11-15,84,4119,2358,0,6561
660,2019-11-16,81,2707,1818,0,4606
660,2019-11-17,1165,3853,3880,0,8898
660,2019-11-18,518,3397,2820,0,6735
660,2019-11-19,1054,5630,2693,0,9377
660,2019-11-20,275,1350,1769,0,3394
660,2019-11-21,98,5718,1374,0,7190
660,2019-11-22,101,5739,1624,0,7464
660,2019-11-23,113,6403,2044,0,8560
660,2019-11-24,214,5736,1382,0,7332
660,2019-11-25,85,10754,2221,0,13060
660,2019-11-26,988,7050,1887,0,9925
660,2019-11-27,1911,10604,1165,1,13681
660,2019-11-28,391,9998,773,0,11162
660,2019-11-29,27,770,58,0,855
660,2019-08-04,2,2,90,0,94
660,2019-08-05,127,204,744,2,1077
660,2019-08-06,190,7883,124,1,8198
660,2019-08-07,199,4945,216,3,5363
660,2019-08-08,91,390,197,1,679
660,2019-08-09,176,250,241,0,667
660,2019-08-10,124,572,109,1,806
660,2019-08-11,103,248,191,2,544
660,2019-08-12,339,5046,179,0,5564
660,2019-08-13,138,4524,109,0,4771
660,2019-08-14,75,458,31,0,564
660,2019-08-15,64,222,127,0,413
660,2019-08-16,83,399,25,1,508
660,2019-08-17,248,783,661,1,1693
660,2019-08-18,417,1273,952,2,2644
660,2019-08-19,81,703,542,0,1326
660,2019-08-20,328,1257,1142,2,2729
660,2019-08-21,80,738,1556,0,2374
660,2019-08-22,715,12981,1950,1,15647
660,2019-08-23,113,16478,1092,1,17684
660,2019-08-24,99,9625,1886,1,11611
660,2019-08-25,175,13334,1350,2,14861
660,2019-08-26,100,23852,1709,2,25663
660,2019-08-27,98,6714,2457,1,9270
660,2019-08-28,94,20517,1170,0,21781
660,2019-08-29,281,13104,1623,2,15010
660,2019-08-30,73,3011,638,2,3724
660,2019-08-31,17,8086,4,1,8108
660,2019-09-01,54,2814,194,0,3062
660,2019-09-02,13,1044,98,0,1155
660,2019-09-03,71,3921,1134,0,5126
660,2019-09-04,79,8620,2335,4,11038
660,2019-09-05,99,7267,1634,1,9001
660,2019-09-06,79,13406,2061,2,15548
660,2019-09-07,104,18250,2764,1,21119
660,2019-09-08,186,9329,911,36,10462
660,2019-09-09,962,11272,1874,3,14111
660,2019-09-10,231,10583,1546,0,12360
660,2019-09-11,134,10465,2176,1,12776
660,2019-09-12,889,11657,2083,1,14630
660,2019-09-13,379,8573,1781,2,10735
660,2019-09-14,80,6409,1501,1,7991
660,2019-09-15,170,7649,1808,2,9629
660,2019-09-16,1535,12871,2115,5,16526
660,2019-09-17,930,14469,2139,8,17546
660,2019-09-18,183,11315,1331,11,12840
660,2019-09-19,816,3489,1440,9,5754
660,2019-09-20,311,11298,2318,9,13936
660,2019-09-21,97,8228,907,10,9242
660,2019-09-22,184,9489,1148,6,10827
660,2019-09-23,999,8048,1620,3,10670
660,2019-09-24,124,9074,2215,5,11418
660,2019-09-25,1036,8547,2181,2,11766
660,2019-09-26,119,9270,1497,0,10886
660,2019-09-27,209,10119,1728,2,12058
660,2019-09-28,213,15011,1501,1,16726
660,2019-09-29,134,16134,1682,8,17958
660,2019-09-30,107,17511,1820,0,19438
660,2019-10-01,94,15621,1872,2,17589
660,2019-10-02,722,11065,1904,1,13692
660,2019-10-03,99,15166,1447,1,16713
660,2019-10-04,76,11452,1478,2,13008
660,2019-10-05,555,13367,1423,1,15346
660,2019-10-06,961,10010,2380,1,13352
660,2019-10-07,947,4780,976,4,6707
660,2019-10-08,689,11285,1584,1,13559
660,2019-10-09,101,14153,2010,3,16267
660,2019-10-10,988,9221,3599,0,13808
660,2019-10-11,104,10060,1652,1,11817
660,2019-10-12,104,5403,2171,0,7678
660,2019-10-13,74,7689,1794,2,9559
660,2019-10-14,1848,9034,1552,1,12435
660,2019-10-15,71,7198,1256,0,8525
660,2019-10-16,78,18169,1691,1,19939
660,2019-10-17,67,6925,1936,2,8930
660,2019-10-18,471,7415,542,3,8431
660,2019-10-19,1847,3746,2059,10,7662
660,2019-10-20,165,760,1927,0,2852
660,2019-10-21,119,9654,1005,1,10779
660,2019-10-22,75,4931,752,2,5760
660,2019-10-23,73,13025,1450,1,14549
660,2019-10-24,1021,17903,2054,1,20979
660,2019-10-25,73,10282,2061,1,12417
660,2019-10-26,75,12904,1989,0,14968
660,2019-10-27,103,15374,1555,1,17033
660,2019-10-28,57,13237,1417,10,14721
660,2019-10-29,702,26541,1049,4,28296
660,2019-10-30,59,20201,1462,1,21723
660,2019-10-31,68,11762,1241,2,13073
660,2019-11-01,50,14017,1356,0,15423
660,2019-11-02,59,22848,1049,1,23957
660,2019-11-03,64,39031,1891,3,40989
660,2019-11-04,907,9240,1454,1,11602
660,2019-11-05,125,1430,2041,0,3596
660,2019-11-06,95,7182,892,0,8169
660,2019-11-07,199,13155,972,2,14328
660,2019-11-08,73,8731,1278,1,10083
660,2019-11-09,361,7668,1593,0,9622
660,2019-11-10,1255,11083,2331,1,14670
660,2019-11-11,787,12026,1389,0,14202
660,2019-11-12,100,17218,2633,2,19953
660,2019-11-13,435,15236,1789,0,17460
660,2019-11-14,88,8238,2143,0,10469
660,2019-11-15,84,4119,2358,0,6561
660,2019-11-16,81,2707,1818,0,4606
660,2019-11-17,1165,3853,3880,0,8898
660,2019-11-18,518,3397,2820,0,6735
660,2019-11-19,1054,5630,2693,0,9377
660,2019-11-20,275,1350,1769,0,3394
660,2019-11-21,98,5718,1374,0,7190
660,2019-11-22,101,5739,1624,0,7464
660,2019-11-23,113,6403,2044,0,8560
660,2019-11-24,214,5736,1382,0,7332
660,2019-11-25,85,10754,2221,0,13060
660,2019-11-26,988,7050,1887,0,9925
660,2019-11-27,1911,10604,1165,1,13681
660,2019-11-28,391,9998,773,0,11162
660,2019-11-29,27,770,58,0,855
660,2019-08-05,127,204,744,2,1077
660,2019-08-06,190,7883,124,1,8198
660,2019-08-07,199,4945,216,3,5363
660,2019-08-08,91,390,197,1,679
660,2019-08-09,176,250,241,0,667
660,2019-08-10,124,572,109,1,806
660,2019-08-11,103,248,191,2,544
660,2019-08-12,339,5046,179,0,5564
660,2019-08-13,138,4524,109,0,4771
660,2019-08-14,75,458,31,0,564
660,2019-08-15,64,222,127,0,413
660,2019-08-16,83,399,25,1,508
660,2019-08-17,248,783,661,1,1693
660,2019-08-18,417,1273,952,2,2644
660,2019-08-19,81,703,542,0,1326
660,2019-08-20,328,1257,1142,2,2729
660,2019-08-21,80,738,1556,0,2374
660,2019-08-22,715,12981,1950,1,15647
660,2019-08-23,113,16478,1092,1,17684
660,2019-08-24,99,9625,1886,1,11611
660,2019-08-25,175,13334,1350,2,14861
660,2019-08-26,100,23852,1709,2,25663
660,2019-08-27,98,6714,2457,1,9270
660,2019-08-28,94,20517,1170,0,21781
660,2019-08-29,281,13104,1623,2,15010
660,2019-08-30,73,3011,638,2,3724
660,2019-08-31,17,8086,4,1,8108
660,2019-09-01,54,2814,194,0,3062
660,2019-09-02,13,1044,98,0,1155
660,2019-09-03,71,3921,1134,0,5126
660,2019-09-04,79,8620,2335,4,11038
660,2019-09-05,99,7267,1634,1,9001
660,2019-09-06,79,13406,2061,2,15548
660,2019-09-07,104,18250,2764,1,21119
660,2019-09-08,186,9329,911,36,10462
660,2019-09-09,962,11272,1874,3,14111
660,2019-09-10,231,10583,1546,0,12360
660,2019-09-11,134,10465,2176,1,12776
660,2019-09-12,889,11657,2083,1,14630
660,2019-09-13,379,8573,1781,2,10735
660,2019-09-14,80,6409,1501,1,7991
660,2019-09-15,170,7649,1808,2,9629
660,2019-09-16,1535,12871,2115,5,16526
660,2019-09-17,930,14469,2139,8,17546
660,2019-09-18,183,11315,1331,11,12840
660,2019-09-19,816,3489,1440,9,5754
660,2019-09-20,311,11298,2318,9,13936
660,2019-09-21,97,8228,907,10,9242
660,2019-09-22,184,9489,1148,6,10827
660,2019-09-23,999,8048,1620,3,10670
660,2019-09-24,124,9074,2215,5,11418
660,2019-09-25,1036,8547,2181,2,11766
660,2019-09-26,119,9270,1497,0,10886
660,2019-09-27,209,10119,1728,2,12058
660,2019-09-28,213,15011,1501,1,16726
660,2019-09-29,134,16134,1682,8,17958
660,2019-09-30,107,17511,1820,0,19438
660,2019-10-01,94,15621,1872,2,17589
660,2019-10-02,722,11065,1904,1,13692
660,2019-10-03,99,15166,1447,1,16713
660,2019-10-04,76,11452,1478,2,13008
660,2019-10-05,555,13367,1423,1,15346
660,2019-10-06,961,10010,2380,1,13352
660,2019-10-07,947,4780,976,4,6707
660,2019-10-08,689,11285,1584,1,13559
660,2019-10-09,101,14153,2010,3,16267
660,2019-10-10,988,9221,3599,0,13808
660,2019-10-11,104,10060,1652,1,11817
660,2019-10-12,104,5403,2171,0,7678
660,2019-10-13,74,7689,1794,2,9559
660,2019-10-14,1848,9034,1552,1,12435
660,2019-10-15,71,7198,1256,0,8525
660,2019-10-16,78,18169,1691,1,19939
660,2019-10-17,67,6925,1936,2,8930
660,2019-10-18,471,7415,542,3,8431
660,2019-10-19,1847,3746,2059,10,7662
660,2019-10-20,165,760,1927,0,2852
660,2019-10-21,119,9654,1005,1,10779
660,2019-10-22,75,4931,752,2,5760
660,2019-10-23,73,13025,1450,1,14549
660,2019-10-24,1021,17903,2054,1,20979
660,2019-10-25,73,10282,2061,1,12417
660,2019-10-26,75,12904,1989,0,14968
660,2019-10-27,103,15374,1555,1,17033
660,2019-10-28,57,13237,1417,10,14721
660,2019-10-29,702,26541,1049,4,28296
660,2019-10-30,59,20201,1462,1,21723
660,2019-10-31,68,11762,1241,2,13073
660,2019-11-01,50,14017,1356,0,15423
660,2019-11-02,59,22848,1049,1,23957
660,2019-11-03,64,39031,1891,3,40989
660,2019-11-04,907,9240,1454,1,11602
660,2019-11-05,125,1430,2041,0,3596
660,2019-11-06,95,7182,892,0,8169
660,2019-11-07,199,13155,972,2,14328
660,2019-11-08,73,8731,1278,1,10083
660,2019-11-09,361,7668,1593,0,9622
660,2019-11-10,1255,11083,2331,1,14670
660,2019-11-11,787,12026,1389,0,14202
660,2019-11-12,100,17218,2633,2,19953
660,2019-11-13,435,15236,1789,0,17460
660,2019-11-14,88,8238,2143,0,10469
660,2019-11-15,84,4119,2358,0,6561
660,2019-11-16,81,2707,1818,0,4606
660,2019-11-17,1165,3853,3880,0,8898
660,2019-11-18,518,3397,2820,0,6735
660,2019-11-19,1054,5630,2693,0,9377
660,2019-11-20,275,1350,1769,0,3394
660,2019-11-21,98,5718,1374,0,7190
660,2019-11-22,101,5739,1624,0,7464
660,2019-11-23,113,6403,2044,0,8560
660,2019-11-24,214,5736,1382,0,7332
660,2019-11-25,85,10754,2221,0,13060
660,2019-11-26,988,7050,1887,0,9925
660,2019-11-27,1911,10604,1165,1,13681
661,2019-08-04,81,2,64,0,147
661,2019-08-05,1586,233,344,2,2165
661,2019-08-06,932,8288,303,0,9523
661,2019-08-07,960,24121,529,1,25611
661,2019-08-08,704,8085,334,1,9124
661,2019-08-09,628,1184,218,0,2030
661,2019-08-10,755,390,354,0,1499
661,2019-08-11,555,183,75,1,814
661,2019-08-12,445,295,123,1,864
661,2019-08-13,548,386,329,1,1264
661,2019-08-14,594,702,19,0,1315
661,2019-08-15,452,93,59,0,604
661,2019-08-16,384,543,110,0,1037
661,2019-08-17,712,1367,750,1,2830
661,2019-08-18,924,848,1641,0,3413
661,2019-08-19,937,8832,891,2,10662
661,2019-08-20,1897,13805,740,1,16443
661,2019-08-21,744,12182,1057,0,13983
661,2019-08-22,974,28019,1041,0,30034
661,2019-08-23,927,20709,1699,0,23335
661,2019-08-24,895,16485,1291,3,18674
661,2019-08-25,997,27610,2099,2,30708
661,2019-08-26,861,27615,1979,0,30455
661,2019-08-27,807,12721,1440,1,14969
661,2019-08-28,835,28694,1309,4,30842
661,2019-08-29,2549,15835,1710,2,20096
661,2019-08-30,766,3111,901,2,4780
661,2019-08-31,86,100,2,0,188
661,2019-09-01,119,1171,90,0,1380
661,2019-09-02,62,114,17,0,193
661,2019-09-03,208,4705,1651,1,6565
661,2019-09-04,997,8999,1614,2,11612
661,2019-09-05,857,8055,1938,1,10851
661,2019-09-06,1047,12913,2333,0,16293
661,2019-09-07,975,16721,1243,0,18939
661,2019-09-08,1075,5397,1575,2,8049
661,2019-09-09,1841,8265,1745,0,11851
661,2019-09-10,806,10114,2399,36,13355
661,2019-09-11,328,6376,1873,19,8596
661,2019-09-12,630,9710,1908,1,12249
661,2019-09-13,1463,5486,2373,1,9323
661,2019-09-14,870,9665,1985,2,12522
661,2019-09-15,1001,8095,2556,1,11653
661,2019-09-16,786,14966,1958,0,17710
661,2019-09-17,1549,13018,1594,0,16161
661,2019-09-18,1247,19789,2009,1,23046
661,2019-09-19,1241,4642,1721,0,7604
661,2019-09-20,975,7963,1912,12,10862
661,2019-09-21,950,7738,1531,0,10219
661,2019-09-22,734,15428,2318,1,18481
661,2019-09-23,1159,12281,1743,3,15186
661,2019-09-24,1239,12308,1725,3,15275
661,2019-09-25,456,11689,1776,3,13924
661,2019-09-26,318,12449,2036,1,14804
661,2019-09-27,958,10894,2271,3,14126
661,2019-09-28,277,24567,2179,3,27026
661,2019-09-29,1491,28354,1968,1,31814
661,2019-09-30,320,19727,1792,4,21843
661,2019-10-01,322,15686,1552,2,17562
661,2019-10-02,379,11768,2086,0,14233
661,2019-10-03,1624,13279,1695,1,16599
661,2019-10-04,1538,16991,1406,0,19935
661,2019-10-05,749,22744,1320,2,24815
661,2019-10-06,1229,15795,1593,0,18617
661,2019-10-07,925,4593,1562,2,7082
661,2019-10-08,316,17674,1300,3,19293
661,2019-10-09,346,23715,1571,1,25633
661,2019-10-10,2320,17034,1536,1,20891
661,2019-10-11,2108,16695,1774,1,20578
661,2019-10-12,1651,8037,2735,4,12427
661,2019-10-13,828,10797,2325,4,13954
661,2019-10-14,1634,5043,2358,1,9036
661,2019-10-15,1231,13096,2121,1,16449
661,2019-10-16,790,24359,1393,1,26543
661,2019-10-17,979,6703,1999,3,9684
661,2019-10-18,1789,13930,936,4,16659
661,2019-10-19,1485,8435,1616,2,11538
661,2019-10-20,974,1117,2071,0,4162
661,2019-10-21,840,9200,1702,8,11750
661,2019-10-22,885,5688,2367,0,8940
661,2019-10-23,1973,14216,1827,4,18020
661,2019-10-24,1572,18530,2235,1,22338
661,2019-10-25,1704,14802,1407,3,17916
661,2019-10-26,748,23745,1613,0,26106
661,2019-10-27,724,17962,1225,0,19911
661,2019-10-28,858,13685,1459,1,16003
661,2019-10-29,1008,26580,919,0,28507
661,2019-10-30,1753,19891,1743,6,23393
661,2019-10-31,911,19233,1481,28,21653
661,2019-11-01,1268,26688,1348,1,29305
661,2019-11-02,1374,16146,1723,4,19247
661,2019-11-03,734,22190,1802,0,24726
661,2019-11-04,1228,9288,1638,1,12155
661,2019-11-05,737,1151,1395,0,3283
661,2019-11-06,1377,7288,1185,0,9850
661,2019-11-07,1748,13166,1234,4,16152
661,2019-11-08,835,8894,2099,0,11828
661,2019-11-09,1494,7812,2311,0,11617
661,2019-11-10,795,12159,1422,0,14376
661,2019-11-11,793,8150,916,0,9859
661,2019-11-12,1093,9638,2345,6,13082
661,2019-11-13,778,13910,1915,2,16605
661,2019-11-14,826,7986,1501,1,10314
661,2019-11-15,768,3965,2216,0,6949
661,2019-11-16,1774,2807,2577,1,7159
661,2019-11-17,1039,3939,3110,4,8092
661,2019-11-18,863,2733,3506,2,7104
661,2019-11-19,954,5136,2868,1,8959
661,2019-11-20,1761,1818,2702,1,6282
661,2019-11-21,802,3554,1760,4,6120
661,2019-11-22,892,6155,1828,4,8879
661,2019-11-23,1274,6086,2300,0,9660
661,2019-11-24,929,9649,1415,0,11993
661,2019-11-25,2698,6805,1408,0,10911
661,2019-11-26,875,6193,1616,0,8684
661,2019-11-27,803,6676,1339,0,8818
661,2019-11-28,1741,2027,350,0,4118
661,2019-11-29,216,0,0,0,216
661,2019-08-04,81,2,64,0,147
661,2019-08-05,1586,233,344,2,2165
661,2019-08-06,932,8288,303,0,9523
661,2019-08-07,960,24121,529,1,25611
661,2019-08-08,704,8085,334,1,9124
661,2019-08-09,628,1184,218,0,2030
661,2019-08-10,755,390,354,0,1499
661,2019-08-11,555,183,75,1,814
661,2019-08-12,445,295,123,1,864
661,2019-08-13,548,386,329,1,1264
661,2019-08-14,594,702,19,0,1315
661,2019-08-15,452,93,59,0,604
661,2019-08-16,384,543,110,0,1037
661,2019-08-17,712,1367,750,1,2830
661,2019-08-18,924,848,1641,0,3413
661,2019-08-19,937,8832,891,2,10662
661,2019-08-20,1897,13805,740,1,16443
661,2019-08-21,744,12182,1057,0,13983
661,2019-08-22,974,28019,1041,0,30034
661,2019-08-23,927,20709,1699,0,23335
661,2019-08-24,895,16485,1291,3,18674
661,2019-08-25,997,27610,2099,2,30708
661,2019-08-26,861,27615,1979,0,30455
661,2019-08-27,807,12721,1440,1,14969
661,2019-08-28,835,28694,1309,4,30842
661,2019-08-29,2549,15835,1710,2,20096
661,2019-08-30,766,3111,901,2,4780
661,2019-08-31,86,100,2,0,188
661,2019-09-01,119,1171,90,0,1380
661,2019-09-02,62,114,17,0,193
661,2019-09-03,208,4705,1651,1,6565
661,2019-09-04,997,8999,1614,2,11612
661,2019-09-05,857,8055,1938,1,10851
661,2019-09-06,1047,12913,2333,0,16293
661,2019-09-07,975,16721,1243,0,18939
661,2019-09-08,1075,5397,1575,2,8049
661,2019-09-09,1841,8265,1745,0,11851
661,2019-09-10,806,10114,2399,36,13355
661,2019-09-11,328,6376,1873,19,8596
661,2019-09-12,630,9710,1908,1,12249
661,2019-09-13,1463,5486,2373,1,9323
661,2019-09-14,870,9665,1985,2,12522
661,2019-09-15,1001,8095,2556,1,11653
661,2019-09-16,786,14966,1958,0,17710
661,2019-09-17,1549,13018,1594,0,16161
661,2019-09-18,1247,19789,2009,1,23046
661,2019-09-19,1241,4642,1721,0,7604
661,2019-09-20,975,7963,1912,12,10862
661,2019-09-21,950,7738,1531,0,10219
661,2019-09-22,734,15428,2318,1,18481
661,2019-09-23,1159,12281,1743,3,15186
661,2019-09-24,1239,12308,1725,3,15275
661,2019-09-25,456,11689,1776,3,13924
661,2019-09-26,318,12449,2036,1,14804
661,2019-09-27,958,10894,2271,3,14126
661,2019-09-28,277,24567,2179,3,27026
661,2019-09-29,1491,28354,1968,1,31814
661,2019-09-30,320,19727,1792,4,21843
661,2019-10-01,322,15686,1552,2,17562
661,2019-10-02,379,11768,2086,0,14233
661,2019-10-03,1624,13279,1695,1,16599
661,2019-10-04,1538,16991,1406,0,19935
661,2019-10-05,749,22744,1320,2,24815
661,2019-10-06,1229,15795,1593,0,18617
661,2019-10-07,925,4593,1562,2,7082
661,2019-10-08,316,17674,1300,3,19293
661,2019-10-09,346,23715,1571,1,25633
661,2019-10-10,2320,17034,1536,1,20891
661,2019-10-11,2108,16695,1774,1,20578
661,2019-10-12,1651,8037,2735,4,12427
661,2019-10-13,828,10797,2325,4,13954
661,2019-10-14,1634,5043,2358,1,9036
661,2019-10-15,1231,13096,2121,1,16449
661,2019-10-16,790,24359,1393,1,26543
661,2019-10-17,979,6703,1999,3,9684
661,2019-10-18,1789,13930,936,4,16659
661,2019-10-19,1485,8435,1616,2,11538
661,2019-10-20,974,1117,2071,0,4162
661,2019-10-21,840,9200,1702,8,11750
661,2019-10-22,885,5688,2367,0,8940
661,2019-10-23,1973,14216,1827,4,18020
661,2019-10-24,1572,18530,2235,1,22338
661,2019-10-25,1704,14802,1407,3,17916
661,2019-10-26,748,23745,1613,0,26106
661,2019-10-27,724,17962,1225,0,19911
661,2019-10-28,858,13685,1459,1,16003
661,2019-10-29,1008,26580,919,0,28507
661,2019-10-30,1753,19891,1743,6,23393
661,2019-10-31,911,19233,1481,28,21653
661,2019-11-01,1268,26688,1348,1,29305
661,2019-11-02,1374,16146,1723,4,19247
661,2019-11-03,734,22190,1802,0,24726
661,2019-11-04,1228,9288,1638,1,12155
661,2019-11-05,737,1151,1395,0,3283
661,2019-11-06,1377,7288,1185,0,9850
661,2019-11-07,1748,13166,1234,4,16152
661,2019-11-08,835,8894,2099,0,11828
661,2019-11-09,1494,7812,2311,0,11617
661,2019-11-10,795,12159,1422,0,14376
661,2019-11-11,793,8150,916,0,9859
661,2019-11-12,1093,9638,2345,6,13082
661,2019-11-13,778,13910,1915,2,16605
661,2019-11-14,826,7986,1501,1,10314
661,2019-11-15,768,3965,2216,0,6949
661,2019-11-16,1774,2807,2577,1,7159
661,2019-11-17,1039,3939,3110,4,8092
661,2019-11-18,863,2733,3506,2,7104
661,2019-11-19,954,5136,2868,1,8959
661,2019-11-20,1761,1818,2702,1,6282
661,2019-11-21,802,3554,1760,4,6120
661,2019-11-22,892,6155,1828,4,8879
661,2019-11-23,1274,6086,2300,0,9660
661,2019-11-24,929,9649,1415,0,11993
661,2019-11-25,2698,6805,1408,0,10911
661,2019-11-26,875,6193,1616,0,8684
661,2019-11-27,803,6676,1339,0,8818
661,2019-11-28,1741,2027,350,0,4118
661,2019-08-04,81,2,64,0,147
661,2019-08-05,1586,233,344,2,2165
661,2019-08-06,932,8288,303,0,9523
661,2019-08-07,960,24121,529,1,25611
661,2019-08-08,704,8085,334,1,9124
661,2019-08-09,628,1184,218,0,2030
661,2019-08-10,755,390,354,0,1499
661,2019-08-11,555,183,75,1,814
661,2019-08-12,445,295,123,1,864
661,2019-08-13,548,386,329,1,1264
661,2019-08-14,594,702,19,0,1315
661,2019-08-15,452,93,59,0,604
661,2019-08-16,384,543,110,0,1037
661,2019-08-17,712,1367,750,1,2830
661,2019-08-18,924,848,1641,0,3413
661,2019-08-19,937,8832,891,2,10662
661,2019-08-20,1897,13805,740,1,16443
661,2019-08-21,744,12182,1057,0,13983
661,2019-08-22,974,28019,1041,0,30034
661,2019-08-23,927,20709,1699,0,23335
661,2019-08-24,895,16485,1291,3,18674
661,2019-08-25,997,27610,2099,2,30708
661,2019-08-26,861,27615,1979,0,30455
661,2019-08-27,807,12721,1440,1,14969
661,2019-08-28,835,28694,1309,4,30842
661,2019-08-29,2549,15835,1710,2,20096
661,2019-08-30,766,3111,901,2,4780
661,2019-08-31,86,100,2,0,188
661,2019-09-01,119,1171,90,0,1380
661,2019-09-02,62,114,17,0,193
661,2019-09-03,208,4705,1651,1,6565
661,2019-09-04,997,8999,1614,2,11612
661,2019-09-05,857,8055,1938,1,10851
661,2019-09-06,1047,12913,2333,0,16293
661,2019-09-07,975,16721,1243,0,18939
661,2019-09-08,1075,5397,1575,2,8049
661,2019-09-09,1841,8265,1745,0,11851
661,2019-09-10,806,10114,2399,36,13355
661,2019-09-11,328,6376,1873,19,8596
661,2019-09-12,630,9710,1908,1,12249
661,2019-09-13,1463,5486,2373,1,9323
661,2019-09-14,870,9665,1985,2,12522
661,2019-09-15,1001,8095,2556,1,11653
661,2019-09-16,786,14966,1958,0,17710
661,2019-09-17,1549,13018,1594,0,16161
661,2019-09-18,1247,19789,2009,1,23046
661,2019-09-19,1241,4642,1721,0,7604
661,2019-09-20,975,7963,1912,12,10862
661,2019-09-21,950,7738,1531,0,10219
661,2019-09-22,734,15428,2318,1,18481
661,2019-09-23,1159,12281,1743,3,15186
661,2019-09-24,1239,12308,1725,3,15275
661,2019-09-25,456,11689,1776,3,13924
661,2019-09-26,318,12449,2036,1,14804
661,2019-09-27,958,10894,2271,3,14126
661,2019-09-28,277,24567,2179,3,27026
661,2019-09-29,1491,28354,1968,1,31814
661,2019-09-30,320,19727,1792,4,21843
661,2019-10-01,322,15686,1552,2,17562
661,2019-10-02,379,11768,2086,0,14233
661,2019-10-03,1624,13279,1695,1,16599
661,2019-10-04,1538,16991,1406,0,19935
661,2019-10-05,749,22744,1320,2,24815
661,2019-10-06,1229,15795,1593,0,18617
661,2019-10-07,925,4593,1562,2,7082
661,2019-10-08,316,17674,1300,3,19293
661,2019-10-09,346,23715,1571,1,25633
661,2019-10-10,2320,17034,1536,1,20891
661,2019-10-11,2108,16695,1774,1,20578
661,2019-10-12,1651,8037,2735,4,12427
661,2019-10-13,828,10797,2325,4,13954
661,2019-10-14,1634,5043,2358,1,9036
661,2019-10-15,1231,13096,2121,1,16449
661,2019-10-16,790,24359,1393,1,26543
661,2019-10-17,979,6703,1999,3,9684
661,2019-10-18,1789,13930,936,4,16659
661,2019-10-19,1485,8435,1616,2,11538
661,2019-10-20,974,1117,2071,0,4162
661,2019-10-21,840,9200,1702,8,11750
661,2019-10-22,885,5688,2367,0,8940
661,2019-10-23,1973,14216,1827,4,18020
661,2019-10-24,1572,18530,2235,1,22338
661,2019-10-25,1704,14802,1407,3,17916
661,2019-10-26,748,23745,1613,0,26106
661,2019-10-27,724,17962,1225,0,19911
661,2019-10-28,858,13685,1459,1,16003
661,2019-10-29,1008,26580,919,0,28507
661,2019-10-30,1753,19891,1743,6,23393
661,2019-10-31,911,19233,1481,28,21653
661,2019-11-01,1268,26688,1348,1,29305
661,2019-11-02,1374,16146,1723,4,19247
661,2019-11-03,734,22190,1802,0,24726
661,2019-11-04,1228,9288,1638,1,12155
661,2019-11-05,737,1151,1395,0,3283
661,2019-11-06,1377,7288,1185,0,9850
661,2019-11-07,1748,13166,1234,4,16152
661,2019-11-08,835,8894,2099,0,11828
661,2019-11-09,1494,7812,2311,0,11617
661,2019-11-10,795,12159,1422,0,14376
661,2019-11-11,793,8150,916,0,9859
661,2019-11-12,1093,9638,2345,6,13082
661,2019-11-13,778,13910,1915,2,16605
661,2019-11-14,826,7986,1501,1,10314
661,2019-11-15,768,3965,2216,0,6949
661,2019-11-16,1774,2807,2577,1,7159
661,2019-11-17,1039,3939,3110,4,8092
661,2019-11-18,863,2733,3506,2,7104
661,2019-11-19,954,5136,2868,1,8959
661,2019-11-20,1761,1818,2702,1,6282
661,2019-11-21,802,3554,1760,4,6120
661,2019-11-22,892,6155,1828,4,8879
661,2019-11-23,1274,6086,2300,0,9660
661,2019-11-24,929,9649,1415,0,11993
661,2019-11-25,2698,6805,1408,0,10911
661,2019-11-26,875,6193,1616,0,8684
661,2019-11-27,803,6676,1339,0,8818
661,2019-11-28,1741,2027,350,0,4118
661,2019-08-05,1586,233,344,2,2165
661,2019-08-06,932,8288,303,0,9523
661,2019-08-07,960,24121,529,1,25611
661,2019-08-08,704,8085,334,1,9124
661,2019-08-09,628,1184,218,0,2030
661,2019-08-10,755,390,354,0,1499
661,2019-08-11,555,183,75,1,814
661,2019-08-12,445,295,123,1,864
661,2019-08-13,548,386,329,1,1264
661,2019-08-14,594,702,19,0,1315
661,2019-08-15,452,93,59,0,604
661,2019-08-16,384,543,110,0,1037
661,2019-08-17,712,1367,750,1,2830
661,2019-08-18,924,848,1641,0,3413
661,2019-08-19,937,8832,891,2,10662
661,2019-08-20,1897,13805,740,1,16443
661,2019-08-21,744,12182,1057,0,13983
661,2019-08-22,974,28019,1041,0,30034
661,2019-08-23,927,20709,1699,0,23335
661,2019-08-24,895,16485,1291,3,18674
661,2019-08-25,997,27610,2099,2,30708
661,2019-08-26,861,27615,1979,0,30455
661,2019-08-27,807,12721,1440,1,14969
661,2019-08-28,835,28694,1309,4,30842
661,2019-08-29,2549,15835,1710,2,20096
661,2019-08-30,766,3111,901,2,4780
661,2019-08-31,86,100,2,0,188
661,2019-09-01,119,1171,90,0,1380
661,2019-09-02,62,114,17,0,193
661,2019-09-03,208,4705,1651,1,6565
661,2019-09-04,997,8999,1614,2,11612
661,2019-09-05,857,8055,1938,1,10851
661,2019-09-06,1047,12913,2333,0,16293
661,2019-09-07,975,16721,1243,0,18939
661,2019-09-08,1075,5397,1575,2,8049
661,2019-09-09,1841,8265,1745,0,11851
661,2019-09-10,806,10114,2399,36,13355
661,2019-09-11,328,6376,1873,19,8596
661,2019-09-12,630,9710,1908,1,12249
661,2019-09-13,1463,5486,2373,1,9323
661,2019-09-14,870,9665,1985,2,12522
661,2019-09-15,1001,8095,2556,1,11653
661,2019-09-16,786,14966,1958,0,17710
661,2019-09-17,1549,13018,1594,0,16161
661,2019-09-18,1247,19789,2009,1,23046
661,2019-09-19,1241,4642,1721,0,7604
661,2019-09-20,975,7963,1912,12,10862
661,2019-09-21,950,7738,1531,0,10219
661,2019-09-22,734,15428,2318,1,18481
661,2019-09-23,1159,12281,1743,3,15186
661,2019-09-24,1239,12308,1725,3,15275
661,2019-09-25,456,11689,1776,3,13924
661,2019-09-26,318,12449,2036,1,14804
661,2019-09-27,958,10894,2271,3,14126
661,2019-09-28,277,24567,2179,3,27026
661,2019-09-29,1491,28354,1968,1,31814
661,2019-09-30,320,19727,1792,4,21843
661,2019-10-01,322,15686,1552,2,17562
661,2019-10-02,379,11768,2086,0,14233
661,2019-10-03,1624,13279,1695,1,16599
661,2019-10-04,1538,16991,1406,0,19935
661,2019-10-05,749,22744,1320,2,24815
661,2019-10-06,1229,15795,1593,0,18617
661,2019-10-07,925,4593,1562,2,7082
661,2019-10-08,316,17674,1300,3,19293
661,2019-10-09,346,23715,1571,1,25633
661,2019-10-10,2320,17034,1536,1,20891
661,2019-10-11,2108,16695,1774,1,20578
661,2019-10-12,1651,8037,2735,4,12427
661,2019-10-13,828,10797,2325,4,13954
661,2019-10-14,1634,5043,2358,1,9036
661,2019-10-15,1231,13096,2121,1,16449
661,2019-10-16,790,24359,1393,1,26543
661,2019-10-17,979,6703,1999,3,9684
661,2019-10-18,1789,13930,936,4,16659
661,2019-10-19,1485,8435,1616,2,11538
661,2019-10-20,974,1117,2071,0,4162
661,2019-10-21,840,9200,1702,8,11750
661,2019-10-22,885,5688,2367,0,8940
661,2019-10-23,1973,14216,1827,4,18020
661,2019-10-24,1572,18530,2235,1,22338
661,2019-10-25,1704,14802,1407,3,17916
661,2019-10-26,748,23745,1613,0,26106
661,2019-10-27,724,17962,1225,0,19911
661,2019-10-28,858,13685,1459,1,16003
661,2019-10-29,1008,26580,919,0,28507
661,2019-10-30,1753,19891,1743,6,23393
661,2019-10-31,911,19233,1481,28,21653
661,2019-11-01,1268,26688,1348,1,29305
661,2019-11-02,1374,16146,1723,4,19247
661,2019-11-03,734,22190,1802,0,24726
661,2019-11-04,1228,9288,1638,1,12155
661,2019-11-05,737,1151,1395,0,3283
661,2019-11-06,1377,7288,1185,0,9850
661,2019-11-07,1748,13166,1234,4,16152
661,2019-11-08,835,8894,2099,0,11828
661,2019-11-09,1494,7812,2311,0,11617
661,2019-11-10,795,12159,1422,0,14376
661,2019-11-11,793,8150,916,0,9859
661,2019-11-12,1093,9638,2345,6,13082
661,2019-11-13,778,13910,1915,2,16605
661,2019-11-14,826,7986,1501,1,10314
661,2019-11-15,768,3965,2216,0,6949
661,2019-11-16,1774,2807,2577,1,7159
661,2019-11-17,1039,3939,3110,4,8092
661,2019-11-18,863,2733,3506,2,7104
661,2019-11-19,954,5136,2868,1,8959
661,2019-11-20,1761,1818,2702,1,6282
661,2019-11-21,802,3554,1760,4,6120
661,2019-11-22,892,6155,1828,4,8879
662,2019-08-05,51,2,237,1,291
662,2019-08-06,1167,326,289,2,1784
662,2019-08-07,1111,423,484,1,2019
662,2019-08-08,1166,197,406,1,1770
662,2019-08-09,1116,198,147,1,1462
662,2019-08-10,1018,412,133,1,1564
662,2019-08-11,1224,345,352,0,1921
662,2019-08-12,1060,325,66,0,1451
662,2019-08-13,1006,421,440,0,1867
662,2019-08-14,1042,411,202,0,1655
662,2019-08-15,1082,370,100,1,1553
662,2019-08-16,1055,476,395,0,1926
662,2019-08-17,1113,3023,1278,0,5414
662,2019-08-18,1094,815,1711,2,3622
662,2019-08-19,1017,3431,1086,1,5535
662,2019-08-20,1818,2136,1502,2,5458
662,2019-08-21,1056,1259,1342,3,3660
662,2019-08-22,1090,14157,1580,0,16827
662,2019-08-23,1010,15255,1514,1,17780
662,2019-08-24,1066,6461,1531,0,9058
662,2019-08-25,1048,21673,630,2,23353
662,2019-08-26,1082,26612,1615,1,29310
662,2019-08-27,1088,15219,1891,1,18199
662,2019-08-28,1107,23242,1767,1,26117
662,2019-08-29,1139,14900,1080,1,17120
662,2019-08-30,1066,3361,563,0,4990
662,2019-08-31,929,192,0,0,1121
662,2019-09-01,910,1802,420,0,3132
662,2019-09-02,887,429,52,0,1368
662,2019-09-03,881,1368,1672,0,3921
662,2019-09-04,989,9795,2424,0,13208
662,2019-09-05,1240,13621,1874,4,16739
662,2019-09-06,2087,18812,2064,1,22964
662,2019-09-07,1097,11089,2525,21,14732
662,2019-09-08,1149,8379,1910,1,11439
662,2019-09-09,2311,7911,2451,1,12674
662,2019-09-10,1084,8959,2043,0,12086
662,2019-09-11,1080,11270,2667,29,15046
662,2019-09-12,1073,7225,1713,1,10012
662,2019-09-13,1982,4855,2439,0,9276
662,2019-09-14,1895,7988,1534,0,11417
662,2019-09-15,1259,7745,2089,3,11096
662,2019-09-16,1061,12946,2006,3,16016
662,2019-09-17,1020,11607,2057,1,14685
662,2019-09-18,1026,18872,1662,5,21565
662,2019-09-19,1198,4676,2071,1,7946
662,2019-09-20,2834,13988,1707,2,18531
662,2019-09-21,1106,8126,1865,0,11097
662,2019-09-22,2251,12624,2158,2,17035
662,2019-09-23,1489,11499,2447,0,15435
662,2019-09-24,1973,27959,1468,3,31403
662,2019-09-25,1229,16752,2060,0,20041
662,2019-09-26,1072,11662,2254,348,15336
662,2019-09-27,1460,9281,2174,1,12916
662,2019-09-28,1052,23990,1654,2,26698
662,2019-09-29,1077,27818,2037,3,30935
662,2019-09-30,1618,29635,1786,0,33039
662,2019-10-01,1013,26879,1045,2,28939
662,2019-10-02,1199,18778,1565,2,21544
662,2019-10-03,1952,22440,2604,1,26997
662,2019-10-04,1419,21425,1011,0,23855
662,2019-10-05,1734,26241,1296,0,29271
662,2019-10-06,1106,11440,2037,2,14585
662,2019-10-07,1930,6419,1675,3,10027
662,2019-10-08,2805,17650,1384,1,21840
662,2019-10-09,1005,25351,2030,1,28387
662,2019-10-10,1140,12756,2061,2,15959
662,2019-10-11,1022,12037,1313,3,14375
662,2019-10-12,1557,7221,1815,1,10594
662,2019-10-13,1956,8720,1522,2,12200
662,2019-10-14,1874,6220,2300,0,10394
662,2019-10-15,3267,10332,1391,0,14990
662,2019-10-16,1118,13227,1239,2,15586
662,2019-10-17,1181,5601,1846,2,8630
662,2019-10-18,1196,8772,1810,0,11778
662,2019-10-19,1068,6384,2136,2,9590
662,2019-10-20,1069,3508,2386,0,6963
662,2019-10-21,1070,10346,1468,4,12888
662,2019-10-22,1175,6958,1059,3,9195
662,2019-10-23,1054,17820,2459,1,21334
662,2019-10-24,1733,18998,872,0,21603
662,2019-10-25,1083,15610,1794,1,18488
662,2019-10-26,1229,17426,2106,1,20762
662,2019-10-27,1176,16251,1307,28,18762
662,2019-10-28,1076,16685,1970,0,19731
662,2019-10-29,2823,19880,2489,0,25192
662,2019-10-30,1931,24096,1267,1,27295
662,2019-10-31,1031,14710,1507,2,17250
662,2019-11-01,1032,14928,871,2,16833
662,2019-11-02,1042,23553,1030,2,25627
662,2019-11-03,1091,38329,1960,0,41380
662,2019-11-04,1084,10753,1477,1,13315
662,2019-11-05,1188,3855,2444,0,7487
662,2019-11-06,1175,8237,1198,3,10613
662,2019-11-07,1713,13710,1191,2,16616
662,2019-11-08,1156,15363,1361,0,17880
662,2019-11-09,1249,11044,1441,0,13734
662,2019-11-10,1058,14269,1913,3,17243
662,2019-11-11,1101,10105,2185,1,13392
662,2019-11-12,1986,10477,3429,0,15892
662,2019-11-13,1531,21620,1572,4,24727
662,2019-11-14,1430,15136,1936,31,18533
662,2019-11-15,1486,4846,2816,1,9149
662,2019-11-16,1184,2641,2626,1624,8075
662,2019-11-17,1175,3846,3075,1,8097
662,2019-11-18,1754,2406,3470,0,7630
662,2019-11-19,1143,3230,2894,2,7269
662,2019-11-20,1173,1793,2069,1,5036
662,2019-11-21,1242,6763,1602,1,9608
662,2019-11-22,1582,5847,1460,3,8892
662,2019-11-23,1050,5906,2248,7,9211
662,2019-11-24,1651,7405,1555,1,10612
662,2019-11-25,1824,10743,1642,0,14209
662,2019-11-26,1806,10128,1607,1,13542
662,2019-11-27,1891,6745,1760,1,10397
662,2019-11-28,1175,12328,919,1,14423
662,2019-11-29,283,555,2,0,840
662,2019-08-05,51,2,237,1,291
662,2019-08-06,1167,326,289,2,1784
662,2019-08-07,1111,423,484,1,2019
662,2019-08-08,1166,197,406,1,1770
662,2019-08-09,1116,198,147,1,1462
662,2019-08-10,1018,412,133,1,1564
662,2019-08-11,1224,345,352,0,1921
662,2019-08-12,1060,325,66,0,1451
662,2019-08-13,1006,421,440,0,1867
662,2019-08-14,1042,411,202,0,1655
662,2019-08-15,1082,370,100,1,1553
662,2019-08-16,1055,476,395,0,1926
662,2019-08-17,1113,3023,1278,0,5414
662,2019-08-18,1094,815,1711,2,3622
662,2019-08-19,1017,3431,1086,1,5535
662,2019-08-20,1818,2136,1502,2,5458
662,2019-08-21,1056,1259,1342,3,3660
662,2019-08-22,1090,14157,1580,0,16827
662,2019-08-23,1010,15255,1514,1,17780
662,2019-08-24,1066,6461,1531,0,9058
662,2019-08-25,1048,21673,630,2,23353
662,2019-08-26,1082,26612,1615,1,29310
662,2019-08-27,1088,15219,1891,1,18199
662,2019-08-28,1107,23242,1767,1,26117
662,2019-08-29,1139,14900,1080,1,17120
662,2019-08-30,1066,3361,563,0,4990
662,2019-08-31,929,192,0,0,1121
662,2019-09-01,910,1802,420,0,3132
662,2019-09-02,887,429,52,0,1368
662,2019-09-03,881,1368,1672,0,3921
662,2019-09-04,989,9795,2424,0,13208
662,2019-09-05,1240,13621,1874,4,16739
662,2019-09-06,2087,18812,2064,1,22964
662,2019-09-07,1097,11089,2525,21,14732
662,2019-09-08,1149,8379,1910,1,11439
662,2019-09-09,2311,7911,2451,1,12674
662,2019-09-10,1084,8959,2043,0,12086
662,2019-09-11,1080,11270,2667,29,15046
662,2019-09-12,1073,7225,1713,1,10012
662,2019-09-13,1982,4855,2439,0,9276
662,2019-09-14,1895,7988,1534,0,11417
662,2019-09-15,1259,7745,2089,3,11096
662,2019-09-16,1061,12946,2006,3,16016
662,2019-09-17,1020,11607,2057,1,14685
662,2019-09-18,1026,18872,1662,5,21565
662,2019-09-19,1198,4676,2071,1,7946
662,2019-09-20,2834,13988,1707,2,18531
662,2019-09-21,1106,8126,1865,0,11097
662,2019-09-22,2251,12624,2158,2,17035
662,2019-09-23,1489,11499,2447,0,15435
662,2019-09-24,1973,27959,1468,3,31403
662,2019-09-25,1229,16752,2060,0,20041
662,2019-09-26,1072,11662,2254,348,15336
662,2019-09-27,1460,9281,2174,1,12916
662,2019-09-28,1052,23990,1654,2,26698
662,2019-09-29,1077,27818,2037,3,30935
662,2019-09-30,1618,29635,1786,0,33039
662,2019-10-01,1013,26879,1045,2,28939
662,2019-10-02,1199,18778,1565,2,21544
662,2019-10-03,1952,22440,2604,1,26997
662,2019-10-04,1419,21425,1011,0,23855
662,2019-10-05,1734,26241,1296,0,29271
662,2019-10-06,1106,11440,2037,2,14585
662,2019-10-07,1930,6419,1675,3,10027
662,2019-10-08,2805,17650,1384,1,21840
662,2019-10-09,1005,25351,2030,1,28387
662,2019-10-10,1140,12756,2061,2,15959
662,2019-10-11,1022,12037,1313,3,14375
662,2019-10-12,1557,7221,1815,1,10594
662,2019-10-13,1956,8720,1522,2,12200
662,2019-10-14,1874,6220,2300,0,10394
662,2019-10-15,3267,10332,1391,0,14990
662,2019-10-16,1118,13227,1239,2,15586
662,2019-10-17,1181,5601,1846,2,8630
662,2019-10-18,1196,8772,1810,0,11778
662,2019-10-19,1068,6384,2136,2,9590
662,2019-10-20,1069,3508,2386,0,6963
662,2019-10-21,1070,10346,1468,4,12888
662,2019-10-22,1175,6958,1059,3,9195
662,2019-10-23,1054,17820,2459,1,21334
662,2019-10-24,1733,18998,872,0,21603
662,2019-10-25,1083,15610,1794,1,18488
662,2019-10-26,1229,17426,2106,1,20762
662,2019-10-27,1176,16251,1307,28,18762
662,2019-10-28,1076,16685,1970,0,19731
662,2019-10-29,2823,19880,2489,0,25192
662,2019-10-30,1931,24096,1267,1,27295
662,2019-10-31,1031,14710,1507,2,17250
662,2019-11-01,1032,14928,871,2,16833
662,2019-11-02,1042,23553,1030,2,25627
662,2019-11-03,1091,38329,1960,0,41380
662,2019-11-04,1084,10753,1477,1,13315
662,2019-11-05,1188,3855,2444,0,7487
662,2019-11-06,1175,8237,1198,3,10613
662,2019-11-07,1713,13710,1191,2,16616
662,2019-11-08,1156,15363,1361,0,17880
662,2019-11-09,1249,11044,1441,0,13734
662,2019-11-10,1058,14269,1913,3,17243
662,2019-11-11,1101,10105,2185,1,13392
662,2019-11-12,1986,10477,3429,0,15892
662,2019-11-13,1531,21620,1572,4,24727
662,2019-11-14,1430,15136,1936,31,18533
662,2019-11-15,1486,4846,2816,1,9149
662,2019-11-16,1184,2641,2626,1624,8075
662,2019-11-17,1175,3846,3075,1,8097
662,2019-11-18,1754,2406,3470,0,7630
662,2019-11-19,1143,3230,2894,2,7269
662,2019-11-20,1173,1793,2069,1,5036
662,2019-11-21,1242,6763,1602,1,9608
662,2019-11-22,1582,5847,1460,3,8892
662,2019-11-23,1050,5906,2248,7,9211
662,2019-11-24,1651,7405,1555,1,10612
662,2019-11-25,1824,10743,1642,0,14209
662,2019-11-26,1806,10128,1607,1,13542
662,2019-11-27,1891,6745,1760,1,10397
662,2019-11-28,1175,12328,919,1,14423
662,2019-11-29,283,555,2,0,840
662,2019-08-05,51,2,237,1,291
662,2019-08-06,1167,326,289,2,1784
662,2019-08-07,1111,423,484,1,2019
662,2019-08-08,1166,197,406,1,1770
662,2019-08-09,1116,198,147,1,1462
662,2019-08-10,1018,412,133,1,1564
662,2019-08-11,1224,345,352,0,1921
662,2019-08-12,1060,325,66,0,1451
662,2019-08-13,1006,421,440,0,1867
662,2019-08-14,1042,411,202,0,1655
662,2019-08-15,1082,370,100,1,1553
662,2019-08-16,1055,476,395,0,1926
662,2019-08-17,1113,3023,1278,0,5414
662,2019-08-18,1094,815,1711,2,3622
662,2019-08-19,1017,3431,1086,1,5535
662,2019-08-20,1818,2136,1502,2,5458
662,2019-08-21,1056,1259,1342,3,3660
662,2019-08-22,1090,14157,1580,0,16827
662,2019-08-23,1010,15255,1514,1,17780
662,2019-08-24,1066,6461,1531,0,9058
662,2019-08-25,1048,21673,630,2,23353
662,2019-08-26,1082,26612,1615,1,29310
662,2019-08-27,1088,15219,1891,1,18199
662,2019-08-28,1107,23242,1767,1,26117
662,2019-08-29,1139,14900,1080,1,17120
662,2019-08-30,1066,3361,563,0,4990
662,2019-08-31,929,192,0,0,1121
662,2019-09-01,910,1802,420,0,3132
662,2019-09-02,887,429,52,0,1368
662,2019-09-03,881,1368,1672,0,3921
662,2019-09-04,989,9795,2424,0,13208
662,2019-09-05,1240,13621,1874,4,16739
662,2019-09-06,2087,18812,2064,1,22964
662,2019-09-07,1097,11089,2525,21,14732
662,2019-09-08,1149,8379,1910,1,11439
662,2019-09-09,2311,7911,2451,1,12674
662,2019-09-10,1084,8959,2043,0,12086
662,2019-09-11,1080,11270,2667,29,15046
662,2019-09-12,1073,7225,1713,1,10012
662,2019-09-13,1982,4855,2439,0,9276
662,2019-09-14,1895,7988,1534,0,11417
662,2019-09-15,1259,7745,2089,3,11096
662,2019-09-16,1061,12946,2006,3,16016
662,2019-09-17,1020,11607,2057,1,14685
662,2019-09-18,1026,18872,1662,5,21565
662,2019-09-19,1198,4676,2071,1,7946
662,2019-09-20,2834,13988,1707,2,18531
662,2019-09-21,1106,8126,1865,0,11097
662,2019-09-22,2251,12624,2158,2,17035
662,2019-09-23,1489,11499,2447,0,15435
662,2019-09-24,1973,27959,1468,3,31403
662,2019-09-25,1229,16752,2060,0,20041
662,2019-09-26,1072,11662,2254,348,15336
662,2019-09-27,1460,9281,2174,1,12916
662,2019-09-28,1052,23990,1654,2,26698
662,2019-09-29,1077,27818,2037,3,30935
662,2019-09-30,1618,29635,1786,0,33039
662,2019-10-01,1013,26879,1045,2,28939
662,2019-10-02,1199,18778,1565,2,21544
662,2019-10-03,1952,22440,2604,1,26997
662,2019-10-04,1419,21425,1011,0,23855
662,2019-10-05,1734,26241,1296,0,29271
662,2019-10-06,1106,11440,2037,2,14585
662,2019-10-07,1930,6419,1675,3,10027
662,2019-10-08,2805,17650,1384,1,21840
662,2019-10-09,1005,25351,2030,1,28387
662,2019-10-10,1140,12756,2061,2,15959
662,2019-10-11,1022,12037,1313,3,14375
662,2019-10-12,1557,7221,1815,1,10594
662,2019-10-13,1956,8720,1522,2,12200
662,2019-10-14,1874,6220,2300,0,10394
662,2019-10-15,3267,10332,1391,0,14990
662,2019-10-16,1118,13227,1239,2,15586
662,2019-10-17,1181,5601,1846,2,8630
662,2019-10-18,1196,8772,1810,0,11778
662,2019-10-19,1068,6384,2136,2,9590
662,2019-10-20,1069,3508,2386,0,6963
662,2019-10-21,1070,10346,1468,4,12888
662,2019-10-22,1175,6958,1059,3,9195
662,2019-10-23,1054,17820,2459,1,21334
662,2019-10-24,1733,18998,872,0,21603
662,2019-10-25,1083,15610,1794,1,18488
662,2019-10-26,1229,17426,2106,1,20762
662,2019-10-27,1176,16251,1307,28,18762
662,2019-10-28,1076,16685,1970,0,19731
662,2019-10-29,2823,19880,2489,0,25192
662,2019-10-30,1931,24096,1267,1,27295
662,2019-10-31,1031,14710,1507,2,17250
662,2019-11-01,1032,14928,871,2,16833
662,2019-11-02,1042,23553,1030,2,25627
662,2019-11-03,1091,38329,1960,0,41380
662,2019-11-04,1084,10753,1477,1,13315
662,2019-11-05,1188,3855,2444,0,7487
662,2019-11-06,1175,8237,1198,3,10613
662,2019-11-07,1713,13710,1191,2,16616
662,2019-11-08,1156,15363,1361,0,17880
662,2019-11-09,1249,11044,1441,0,13734
662,2019-11-10,1058,14269,1913,3,17243
662,2019-11-11,1101,10105,2185,1,13392
662,2019-11-12,1986,10477,3429,0,15892
662,2019-11-13,1531,21620,1572,4,24727
662,2019-11-14,1430,15136,1936,31,18533
662,2019-11-15,1486,4846,2816,1,9149
662,2019-11-16,1184,2641,2626,1624,8075
662,2019-11-17,1175,3846,3075,1,8097
662,2019-11-18,1754,2406,3470,0,7630
662,2019-11-19,1143,3230,2894,2,7269
662,2019-11-20,1173,1793,2069,1,5036
662,2019-11-21,1242,6763,1602,1,9608
662,2019-11-22,1582,5847,1460,3,8892
662,2019-11-23,1050,5906,2248,7,9211
662,2019-11-24,1651,7405,1555,1,10612
662,2019-11-25,1824,10743,1642,0,14209
662,2019-11-26,1806,10128,1607,1,13542
662,2019-11-27,1891,6745,1760,1,10397
662,2019-11-28,1175,12328,919,1,14423
662,2019-11-29,283,555,2,0,840
662,2019-08-05,51,2,237,1,291
662,2019-08-06,1167,326,289,2,1784
662,2019-08-07,1111,423,484,1,2019
662,2019-08-08,1166,197,406,1,1770
662,2019-08-09,1116,198,147,1,1462
662,2019-08-10,1018,412,133,1,1564
662,2019-08-11,1224,345,352,0,1921
662,2019-08-12,1060,325,66,0,1451
662,2019-08-13,1006,421,440,0,1867
662,2019-08-14,1042,411,202,0,1655
662,2019-08-15,1082,370,100,1,1553
662,2019-08-16,1055,476,395,0,1926
662,2019-08-17,1113,3023,1278,0,5414
662,2019-08-18,1094,815,1711,2,3622
662,2019-08-19,1017,3431,1086,1,5535
662,2019-08-20,1818,2136,1502,2,5458
662,2019-08-21,1056,1259,1342,3,3660
662,2019-08-22,1090,14157,1580,0,16827
662,2019-08-23,1010,15255,1514,1,17780
662,2019-08-24,1066,6461,1531,0,9058
662,2019-08-25,1048,21673,630,2,23353
662,2019-08-26,1082,26612,1615,1,29310
662,2019-08-27,1088,15219,1891,1,18199
662,2019-08-28,1107,23242,1767,1,26117
662,2019-08-29,1139,14900,1080,1,17120
662,2019-08-30,1066,3361,563,0,4990
662,2019-08-31,929,192,0,0,1121
662,2019-09-01,910,1802,420,0,3132
662,2019-09-02,887,429,52,0,1368
662,2019-09-03,881,1368,1672,0,3921
662,2019-09-04,989,9795,2424,0,13208
662,2019-09-05,1240,13621,1874,4,16739
662,2019-09-06,2087,18812,2064,1,22964
662,2019-09-07,1097,11089,2525,21,14732
662,2019-09-08,1149,8379,1910,1,11439
662,2019-09-09,2311,7911,2451,1,12674
662,2019-09-10,1084,8959,2043,0,12086
662,2019-09-11,1080,11270,2667,29,15046
662,2019-09-12,1073,7225,1713,1,10012
662,2019-09-13,1982,4855,2439,0,9276
662,2019-09-14,1895,7988,1534,0,11417
662,2019-09-15,1259,7745,2089,3,11096
662,2019-09-16,1061,12946,2006,3,16016
662,2019-09-17,1020,11607,2057,1,14685
662,2019-09-18,1026,18872,1662,5,21565
662,2019-09-19,1198,4676,2071,1,7946
662,2019-09-20,2834,13988,1707,2,18531
662,2019-09-21,1106,8126,1865,0,11097
662,2019-09-22,2251,12624,2158,2,17035
662,2019-09-23,1489,11499,2447,0,15435
662,2019-09-24,1973,27959,1468,3,31403
662,2019-09-25,1229,16752,2060,0,20041
662,2019-09-26,1072,11662,2254,348,15336
662,2019-09-27,1460,9281,2174,1,12916
662,2019-09-28,1052,23990,1654,2,26698
662,2019-09-29,1077,27818,2037,3,30935
662,2019-09-30,1618,29635,1786,0,33039
662,2019-10-01,1013,26879,1045,2,28939
662,2019-10-02,1199,18778,1565,2,21544
662,2019-10-03,1952,22440,2604,1,26997
662,2019-10-04,1419,21425,1011,0,23855
662,2019-10-05,1734,26241,1296,0,29271
662,2019-10-06,1106,11440,2037,2,14585
662,2019-10-07,1930,6419,1675,3,10027
662,2019-10-08,2805,17650,1384,1,21840
662,2019-10-09,1005,25351,2030,1,28387
662,2019-10-10,1140,12756,2061,2,15959
662,2019-10-11,1022,12037,1313,3,14375
662,2019-10-12,1557,7221,1815,1,10594
662,2019-10-13,1956,8720,1522,2,12200
662,2019-10-14,1874,6220,2300,0,10394
662,2019-10-15,3267,10332,1391,0,14990
662,2019-10-16,1118,13227,1239,2,15586
662,2019-10-17,1181,5601,1846,2,8630
662,2019-10-18,1196,8772,1810,0,11778
662,2019-10-19,1068,6384,2136,2,9590
662,2019-10-20,1069,3508,2386,0,6963
662,2019-10-21,1070,10346,1468,4,12888
662,2019-10-22,1175,6958,1059,3,9195
662,2019-10-23,1054,17820,2459,1,21334
662,2019-10-24,1733,18998,872,0,21603
662,2019-10-25,1083,15610,1794,1,18488
662,2019-10-26,1229,17426,2106,1,20762
662,2019-10-27,1176,16251,1307,28,18762
662,2019-10-28,1076,16685,1970,0,19731
662,2019-10-29,2823,19880,2489,0,25192
662,2019-10-30,1931,24096,1267,1,27295
662,2019-10-31,1031,14710,1507,2,17250
662,2019-11-01,1032,14928,871,2,16833
662,2019-11-02,1042,23553,1030,2,25627
662,2019-11-03,1091,38329,1960,0,41380
662,2019-11-04,1084,10753,1477,1,13315
662,2019-11-05,1188,3855,2444,0,7487
662,2019-11-06,1175,8237,1198,3,10613
662,2019-11-07,1713,13710,1191,2,16616
662,2019-11-08,1156,15363,1361,0,17880
662,2019-11-09,1249,11044,1441,0,13734
662,2019-11-10,1058,14269,1913,3,17243
662,2019-11-11,1101,10105,2185,1,13392
662,2019-11-12,1986,10477,3429,0,15892
662,2019-11-13,1531,21620,1572,4,24727
662,2019-11-14,1430,15136,1936,31,18533
662,2019-11-15,1486,4846,2816,1,9149
662,2019-11-16,1184,2641,2626,1624,8075
662,2019-11-17,1175,3846,3075,1,8097
662,2019-11-18,1754,2406,3470,0,7630
662,2019-11-19,1143,3230,2894,2,7269
662,2019-11-20,1173,1793,2069,1,5036
662,2019-11-21,1242,6763,1602,1,9608
662,2019-11-22,1582,5847,1460,3,8892
662,2019-11-23,1050,5906,2248,7,9211
662,2019-11-24,1651,7405,1555,1,10612
662,2019-11-25,1824,10743,1642,0,14209
662,2019-11-26,1806,10128,1607,1,13542
662,2019-11-27,1891,6745,1760,1,10397
662,2019-11-28,1175,12328,919,1,14423
663,2019-08-06,20,117,316,0,453
663,2019-08-07,96,405,49,1,551
663,2019-08-08,63,228,430,0,721
663,2019-08-09,93,240,706,7,1046
663,2019-08-10,507,605,269,0,1381
663,2019-08-11,125,304,127,0,556
663,2019-08-12,265,4951,132,1,5349
663,2019-08-13,78,4270,327,0,4675
663,2019-08-14,114,511,91,1,717
663,2019-08-15,76,396,94,0,566
663,2019-08-16,55,546,77,0,678
663,2019-08-17,730,1037,755,0,2522
663,2019-08-18,103,3044,1296,0,4443
663,2019-08-19,85,3531,1266,0,4882
663,2019-08-20,113,2806,1453,0,4372
663,2019-08-21,99,1639,1415,1,3154
663,2019-08-22,83,13044,1615,1,14743
663,2019-08-23,68,6869,989,0,7926
663,2019-08-24,507,12164,1981,1,14653
663,2019-08-25,121,16630,2492,3,19246
663,2019-08-26,78,24556,1613,0,26247
663,2019-08-27,84,15039,1488,1,16612
663,2019-08-28,97,17381,2070,0,19548
663,2019-08-29,90,12219,1884,0,14193
663,2019-08-30,73,3129,932,2,4136
663,2019-08-31,18,176,3,0,197
663,2019-09-01,63,1756,180,0,1999
663,2019-09-02,15,1192,59,0,1266
663,2019-09-03,282,3768,1213,0,5263
663,2019-09-04,107,13055,1961,1,15124
663,2019-09-05,950,11552,2288,0,14790
663,2019-09-06,115,12143,2266,2,14526
663,2019-09-07,202,12968,2474,0,15644
663,2019-09-08,1906,6445,2126,1,10478
663,2019-09-09,105,6752,2381,1,9239
663,2019-09-10,968,6894,2905,1,10768
663,2019-09-11,315,5773,2175,1,8264
663,2019-09-12,173,6275,2266,2,8716
663,2019-09-13,203,9018,1728,0,10949
663,2019-09-14,1005,5801,1926,0,8732
663,2019-09-15,71,7387,1836,2,9296
663,2019-09-16,736,10001,2806,0,13543
663,2019-09-17,165,10994,1777,2,12938
663,2019-09-18,129,11216,1481,2,12828
663,2019-09-19,239,10767,1890,1,12897
663,2019-09-20,176,15066,2218,1,17461
663,2019-09-21,928,9710,2758,1,13397
663,2019-09-22,75,9659,1452,1,11187
663,2019-09-23,144,9576,2233,0,11953
663,2019-09-24,106,9097,2179,3,11385
663,2019-09-25,1256,14367,1913,2,17538
663,2019-09-26,154,14117,2061,0,16332
663,2019-09-27,241,7397,2242,6,9886
663,2019-09-28,137,16505,1514,0,18156
663,2019-09-29,85,19240,1234,0,20559
663,2019-09-30,208,18836,1873,0,20917
663,2019-10-01,102,17014,1697,1,18814
663,2019-10-02,67,13463,2100,1,15631
663,2019-10-03,1146,22918,1202,1,25267
663,2019-10-04,300,14368,2036,3,16707
663,2019-10-05,329,21574,1611,1,23515
663,2019-10-06,577,17079,1637,0,19293
663,2019-10-07,100,6677,1765,6,8548
663,2019-10-08,529,12998,1347,0,14874
663,2019-10-09,230,15881,1269,169,17549
663,2019-10-10,92,11798,1867,1,13758
663,2019-10-11,105,10609,2455,3,13172
663,2019-10-12,62,7842,1416,4,9324
663,2019-10-13,87,8966,1863,0,10916
663,2019-10-14,81,8589,2815,1,11486
663,2019-10-15,88,9177,1917,0,11182
663,2019-10-16,973,18954,1425,1,21353
663,2019-10-17,72,8730,1546,5,10353
663,2019-10-18,1073,9464,2024,1,12562
663,2019-10-19,956,6404,1217,0,8577
663,2019-10-20,962,3578,1866,0,6406
663,2019-10-21,380,19537,1170,0,21087
663,2019-10-22,87,10345,1860,2,12294
663,2019-10-23,949,8884,1159,0,10992
663,2019-10-24,979,14601,1203,1,16784
663,2019-10-25,158,11175,1820,1,13154
663,2019-10-26,212,22467,1588,2,24269
663,2019-10-27,426,19288,1717,1,21432
663,2019-10-28,968,14922,1664,1,17555
663,2019-10-29,122,16079,2205,0,18406
663,2019-10-30,79,15580,1465,0,17124
663,2019-10-31,70,21081,1995,3,23149
663,2019-11-01,51,27512,1535,2,29100
663,2019-11-02,1446,16910,1438,2,19796
663,2019-11-03,78,37387,1145,0,38610
663,2019-11-04,987,13945,1642,0,16574
663,2019-11-05,181,3683,2079,628,6571
663,2019-11-06,474,14791,1513,3,16781
663,2019-11-07,933,25825,967,3,27728
663,2019-11-08,459,18306,1301,0,20066
663,2019-11-09,73,16083,2163,0,18319
663,2019-11-10,84,15010,2390,0,17484
663,2019-11-11,111,14300,1804,4,16219
663,2019-11-12,223,19116,2336,1,21676
663,2019-11-13,183,16508,2069,0,18760
663,2019-11-14,93,9183,1717,1,10994
663,2019-11-15,1006,4441,1649,1,7097
663,2019-11-16,112,2627,1406,3,4148
663,2019-11-17,82,4053,2684,1,6820
663,2019-11-18,131,3409,2706,2,6248
663,2019-11-19,1185,5559,2583,0,9327
663,2019-11-20,93,1737,1971,1,3802
663,2019-11-21,463,7604,1279,3,9349
663,2019-11-22,86,6078,2069,3,8236
663,2019-11-23,75,6170,2359,0,8604
663,2019-11-24,231,6513,1687,0,8431
663,2019-11-25,1169,11157,1721,0,14047
663,2019-11-26,151,6835,2091,2,9079
663,2019-11-27,57,11291,1918,0,13266
663,2019-11-28,79,10153,562,0,10794
663,2019-11-29,15,1628,166,0,1809
663,2019-08-06,20,117,316,0,453
663,2019-08-07,96,405,49,1,551
663,2019-08-08,63,228,430,0,721
663,2019-08-09,93,240,706,7,1046
663,2019-08-10,507,605,269,0,1381
663,2019-08-11,125,304,127,0,556
663,2019-08-12,265,4951,132,1,5349
663,2019-08-13,78,4270,327,0,4675
663,2019-08-14,114,511,91,1,717
663,2019-08-15,76,396,94,0,566
663,2019-08-16,55,546,77,0,678
663,2019-08-17,730,1037,755,0,2522
663,2019-08-18,103,3044,1296,0,4443
663,2019-08-19,85,3531,1266,0,4882
663,2019-08-20,113,2806,1453,0,4372
663,2019-08-21,99,1639,1415,1,3154
663,2019-08-22,83,13044,1615,1,14743
663,2019-08-23,68,6869,989,0,7926
663,2019-08-24,507,12164,1981,1,14653
663,2019-08-25,121,16630,2492,3,19246
663,2019-08-26,78,24556,1613,0,26247
663,2019-08-27,84,15039,1488,1,16612
663,2019-08-28,97,17381,2070,0,19548
663,2019-08-29,90,12219,1884,0,14193
663,2019-08-30,73,3129,932,2,4136
663,2019-08-31,18,176,3,0,197
663,2019-09-01,63,1756,180,0,1999
663,2019-09-02,15,1192,59,0,1266
663,2019-09-03,282,3768,1213,0,5263
663,2019-09-04,107,13055,1961,1,15124
663,2019-09-05,950,11552,2288,0,14790
663,2019-09-06,115,12143,2266,2,14526
663,2019-09-07,202,12968,2474,0,15644
663,2019-09-08,1906,6445,2126,1,10478
663,2019-09-09,105,6752,2381,1,9239
663,2019-09-10,968,6894,2905,1,10768
663,2019-09-11,315,5773,2175,1,8264
663,2019-09-12,173,6275,2266,2,8716
663,2019-09-13,203,9018,1728,0,10949
663,2019-09-14,1005,5801,1926,0,8732
663,2019-09-15,71,7387,1836,2,9296
663,2019-09-16,736,10001,2806,0,13543
663,2019-09-17,165,10994,1777,2,12938
663,2019-09-18,129,11216,1481,2,12828
663,2019-09-19,239,10767,1890,1,12897
663,2019-09-20,176,15066,2218,1,17461
663,2019-09-21,928,9710,2758,1,13397
663,2019-09-22,75,9659,1452,1,11187
663,2019-09-23,144,9576,2233,0,11953
663,2019-09-24,106,9097,2179,3,11385
663,2019-09-25,1256,14367,1913,2,17538
663,2019-09-26,154,14117,2061,0,16332
663,2019-09-27,241,7397,2242,6,9886
663,2019-09-28,137,16505,1514,0,18156
663,2019-09-29,85,19240,1234,0,20559
663,2019-09-30,208,18836,1873,0,20917
663,2019-10-01,102,17014,1697,1,18814
663,2019-10-02,67,13463,2100,1,15631
663,2019-10-03,1146,22918,1202,1,25267
663,2019-10-04,300,14368,2036,3,16707
663,2019-10-05,329,21574,1611,1,23515
663,2019-10-06,577,17079,1637,0,19293
663,2019-10-07,100,6677,1765,6,8548
663,2019-10-08,529,12998,1347,0,14874
663,2019-10-09,230,15881,1269,169,17549
663,2019-10-10,92,11798,1867,1,13758
663,2019-10-11,105,10609,2455,3,13172
663,2019-10-12,62,7842,1416,4,9324
663,2019-10-13,87,8966,1863,0,10916
663,2019-10-14,81,8589,2815,1,11486
663,2019-10-15,88,9177,1917,0,11182
663,2019-10-16,973,18954,1425,1,21353
663,2019-10-17,72,8730,1546,5,10353
663,2019-10-18,1073,9464,2024,1,12562
663,2019-10-19,956,6404,1217,0,8577
663,2019-10-20,962,3578,1866,0,6406
663,2019-10-21,380,19537,1170,0,21087
663,2019-10-22,87,10345,1860,2,12294
663,2019-10-23,949,8884,1159,0,10992
663,2019-10-24,979,14601,1203,1,16784
663,2019-10-25,158,11175,1820,1,13154
663,2019-10-26,212,22467,1588,2,24269
663,2019-10-27,426,19288,1717,1,21432
663,2019-10-28,968,14922,1664,1,17555
663,2019-10-29,122,16079,2205,0,18406
663,2019-10-30,79,15580,1465,0,17124
663,2019-10-31,70,21081,1995,3,23149
663,2019-11-01,51,27512,1535,2,29100
663,2019-11-02,1446,16910,1438,2,19796
663,2019-11-03,78,37387,1145,0,38610
663,2019-11-04,987,13945,1642,0,16574
663,2019-11-05,181,3683,2079,628,6571
663,2019-11-06,474,14791,1513,3,16781
663,2019-11-07,933,25825,967,3,27728
663,2019-11-08,459,18306,1301,0,20066
663,2019-11-09,73,16083,2163,0,18319
663,2019-11-10,84,15010,2390,0,17484
663,2019-11-11,111,14300,1804,4,16219
663,2019-11-12,223,19116,2336,1,21676
663,2019-11-13,183,16508,2069,0,18760
663,2019-11-14,93,9183,1717,1,10994
663,2019-11-15,1006,4441,1649,1,7097
663,2019-11-16,112,2627,1406,3,4148
663,2019-11-17,82,4053,2684,1,6820
663,2019-11-18,131,3409,2706,2,6248
663,2019-11-19,1185,5559,2583,0,9327
663,2019-11-20,93,1737,1971,1,3802
663,2019-11-21,463,7604,1279,3,9349
663,2019-11-22,86,6078,2069,3,8236
663,2019-11-23,75,6170,2359,0,8604
663,2019-11-24,231,6513,1687,0,8431
663,2019-11-25,1169,11157,1721,0,14047
663,2019-11-26,151,6835,2091,2,9079
663,2019-11-27,57,11291,1918,0,13266
663,2019-11-28,79,10153,562,0,10794
663,2019-11-29,15,1628,166,0,1809
663,2019-08-06,20,117,316,0,453
663,2019-08-07,96,405,49,1,551
663,2019-08-08,63,228,430,0,721
663,2019-08-09,93,240,706,7,1046
663,2019-08-10,507,605,269,0,1381
663,2019-08-11,125,304,127,0,556
663,2019-08-12,265,4951,132,1,5349
663,2019-08-13,78,4270,327,0,4675
663,2019-08-14,114,511,91,1,717
663,2019-08-15,76,396,94,0,566
663,2019-08-16,55,546,77,0,678
663,2019-08-17,730,1037,755,0,2522
663,2019-08-18,103,3044,1296,0,4443
663,2019-08-19,85,3531,1266,0,4882
663,2019-08-20,113,2806,1453,0,4372
663,2019-08-21,99,1639,1415,1,3154
663,2019-08-22,83,13044,1615,1,14743
663,2019-08-23,68,6869,989,0,7926
663,2019-08-24,507,12164,1981,1,14653
663,2019-08-25,121,16630,2492,3,19246
663,2019-08-26,78,24556,1613,0,26247
663,2019-08-27,84,15039,1488,1,16612
663,2019-08-28,97,17381,2070,0,19548
663,2019-08-29,90,12219,1884,0,14193
663,2019-08-30,73,3129,932,2,4136
663,2019-08-31,18,176,3,0,197
663,2019-09-01,63,1756,180,0,1999
663,2019-09-02,15,1192,59,0,1266
663,2019-09-03,282,3768,1213,0,5263
663,2019-09-04,107,13055,1961,1,15124
663,2019-09-05,950,11552,2288,0,14790
663,2019-09-06,115,12143,2266,2,14526
663,2019-09-07,202,12968,2474,0,15644
663,2019-09-08,1906,6445,2126,1,10478
663,2019-09-09,105,6752,2381,1,9239
663,2019-09-10,968,6894,2905,1,10768
663,2019-09-11,315,5773,2175,1,8264
663,2019-09-12,173,6275,2266,2,8716
663,2019-09-13,203,9018,1728,0,10949
663,2019-09-14,1005,5801,1926,0,8732
663,2019-09-15,71,7387,1836,2,9296
663,2019-09-16,736,10001,2806,0,13543
663,2019-09-17,165,10994,1777,2,12938
663,2019-09-18,129,11216,1481,2,12828
663,2019-09-19,239,10767,1890,1,12897
663,2019-09-20,176,15066,2218,1,17461
663,2019-09-21,928,9710,2758,1,13397
663,2019-09-22,75,9659,1452,1,11187
663,2019-09-23,144,9576,2233,0,11953
663,2019-09-24,106,9097,2179,3,11385
663,2019-09-25,1256,14367,1913,2,17538
663,2019-09-26,154,14117,2061,0,16332
663,2019-09-27,241,7397,2242,6,9886
663,2019-09-28,137,16505,1514,0,18156
663,2019-09-29,85,19240,1234,0,20559
663,2019-09-30,208,18836,1873,0,20917
663,2019-10-01,102,17014,1697,1,18814
663,2019-10-02,67,13463,2100,1,15631
663,2019-10-03,1146,22918,1202,1,25267
663,2019-10-04,300,14368,2036,3,16707
663,2019-10-05,329,21574,1611,1,23515
663,2019-10-06,577,17079,1637,0,19293
663,2019-10-07,100,6677,1765,6,8548
663,2019-10-08,529,12998,1347,0,14874
663,2019-10-09,230,15881,1269,169,17549
663,2019-10-10,92,11798,1867,1,13758
663,2019-10-11,105,10609,2455,3,13172
663,2019-10-12,62,7842,1416,4,9324
663,2019-10-13,87,8966,1863,0,10916
663,2019-10-14,81,8589,2815,1,11486
663,2019-10-15,88,9177,1917,0,11182
663,2019-10-16,973,18954,1425,1,21353
663,2019-10-17,72,8730,1546,5,10353
663,2019-10-18,1073,9464,2024,1,12562
663,2019-10-19,956,6404,1217,0,8577
663,2019-10-20,962,3578,1866,0,6406
663,2019-10-21,380,19537,1170,0,21087
663,2019-10-22,87,10345,1860,2,12294
663,2019-10-23,949,8884,1159,0,10992
663,2019-10-24,979,14601,1203,1,16784
663,2019-10-25,158,11175,1820,1,13154
663,2019-10-26,212,22467,1588,2,24269
663,2019-10-27,426,19288,1717,1,21432
663,2019-10-28,968,14922,1664,1,17555
663,2019-10-29,122,16079,2205,0,18406
663,2019-10-30,79,15580,1465,0,17124
663,2019-10-31,70,21081,1995,3,23149
663,2019-11-01,51,27512,1535,2,29100
663,2019-11-02,1446,16910,1438,2,19796
663,2019-11-03,78,37387,1145,0,38610
663,2019-11-04,987,13945,1642,0,16574
663,2019-11-05,181,3683,2079,628,6571
663,2019-11-06,474,14791,1513,3,16781
663,2019-11-07,933,25825,967,3,27728
663,2019-11-08,459,18306,1301,0,20066
663,2019-11-09,73,16083,2163,0,18319
663,2019-11-10,84,15010,2390,0,17484
663,2019-11-11,111,14300,1804,4,16219
663,2019-11-12,223,19116,2336,1,21676
663,2019-11-13,183,16508,2069,0,18760
663,2019-11-14,93,9183,1717,1,10994
663,2019-11-15,1006,4441,1649,1,7097
663,2019-11-16,112,2627,1406,3,4148
663,2019-11-17,82,4053,2684,1,6820
663,2019-11-18,131,3409,2706,2,6248
663,2019-11-19,1185,5559,2583,0,9327
663,2019-11-20,93,1737,1971,1,3802
663,2019-11-21,463,7604,1279,3,9349
663,2019-11-22,86,6078,2069,3,8236
663,2019-11-23,75,6170,2359,0,8604
663,2019-11-24,231,6513,1687,0,8431
663,2019-11-25,1169,11157,1721,0,14047
663,2019-11-26,151,6835,2091,2,9079
663,2019-11-27,57,11291,1918,0,13266
663,2019-11-28,79,10153,562,0,10794
663,2019-11-29,15,1628,166,0,1809
663,2019-08-07,96,405,49,1,551
663,2019-08-08,63,228,430,0,721
663,2019-08-09,93,240,706,7,1046
663,2019-08-10,507,605,269,0,1381
663,2019-08-11,125,304,127,0,556
663,2019-08-12,265,4951,132,1,5349
663,2019-08-13,78,4270,327,0,4675
663,2019-08-14,114,511,91,1,717
663,2019-08-15,76,396,94,0,566
663,2019-08-16,55,546,77,0,678
663,2019-08-17,730,1037,755,0,2522
663,2019-08-18,103,3044,1296,0,4443
663,2019-08-19,85,3531,1266,0,4882
663,2019-08-20,113,2806,1453,0,4372
663,2019-08-21,99,1639,1415,1,3154
663,2019-08-22,83,13044,1615,1,14743
663,2019-08-23,68,6869,989,0,7926
663,2019-08-24,507,12164,1981,1,14653
663,2019-08-25,121,16630,2492,3,19246
663,2019-08-26,78,24556,1613,0,26247
663,2019-08-27,84,15039,1488,1,16612
663,2019-08-28,97,17381,2070,0,19548
663,2019-08-29,90,12219,1884,0,14193
663,2019-08-30,73,3129,932,2,4136
663,2019-08-31,18,176,3,0,197
663,2019-09-01,63,1756,180,0,1999
663,2019-09-02,15,1192,59,0,1266
663,2019-09-03,282,3768,1213,0,5263
663,2019-09-04,107,13055,1961,1,15124
663,2019-09-05,950,11552,2288,0,14790
663,2019-09-06,115,12143,2266,2,14526
663,2019-09-07,202,12968,2474,0,15644
663,2019-09-08,1906,6445,2126,1,10478
663,2019-09-09,105,6752,2381,1,9239
663,2019-09-10,968,6894,2905,1,10768
663,2019-09-11,315,5773,2175,1,8264
663,2019-09-12,173,6275,2266,2,8716
663,2019-09-13,203,9018,1728,0,10949
663,2019-09-14,1005,5801,1926,0,8732
663,2019-09-15,71,7387,1836,2,9296
663,2019-09-16,736,10001,2806,0,13543
663,2019-09-17,165,10994,1777,2,12938
663,2019-09-18,129,11216,1481,2,12828
663,2019-09-19,239,10767,1890,1,12897
663,2019-09-20,176,15066,2218,1,17461
663,2019-09-21,928,9710,2758,1,13397
663,2019-09-22,75,9659,1452,1,11187
663,2019-09-23,144,9576,2233,0,11953
663,2019-09-24,106,9097,2179,3,11385
663,2019-09-25,1256,14367,1913,2,17538
663,2019-09-26,154,14117,2061,0,16332
663,2019-09-27,241,7397,2242,6,9886
663,2019-09-28,137,16505,1514,0,18156
663,2019-09-29,85,19240,1234,0,20559
663,2019-09-30,208,18836,1873,0,20917
663,2019-10-01,102,17014,1697,1,18814
663,2019-10-02,67,13463,2100,1,15631
663,2019-10-03,1146,22918,1202,1,25267
663,2019-10-04,300,14368,2036,3,16707
663,2019-10-05,329,21574,1611,1,23515
663,2019-10-06,577,17079,1637,0,19293
663,2019-10-07,100,6677,1765,6,8548
663,2019-10-08,529,12998,1347,0,14874
663,2019-10-09,230,15881,1269,169,17549
663,2019-10-10,92,11798,1867,1,13758
663,2019-10-11,105,10609,2455,3,13172
663,2019-10-12,62,7842,1416,4,9324
663,2019-10-13,87,8966,1863,0,10916
663,2019-10-14,81,8589,2815,1,11486
663,2019-10-15,88,9177,1917,0,11182
663,2019-10-16,973,18954,1425,1,21353
663,2019-10-17,72,8730,1546,5,10353
663,2019-10-18,1073,9464,2024,1,12562
663,2019-10-19,956,6404,1217,0,8577
663,2019-10-20,962,3578,1866,0,6406
663,2019-10-21,380,19537,1170,0,21087
663,2019-10-22,87,10345,1860,2,12294
663,2019-10-23,949,8884,1159,0,10992
663,2019-10-24,979,14601,1203,1,16784
663,2019-10-25,158,11175,1820,1,13154
663,2019-10-26,212,22467,1588,2,24269
663,2019-10-27,426,19288,1717,1,21432
663,2019-10-28,968,14922,1664,1,17555
663,2019-10-29,122,16079,2205,0,18406
663,2019-10-30,79,15580,1465,0,17124
663,2019-10-31,70,21081,1995,3,23149
663,2019-11-01,51,27512,1535,2,29100
663,2019-11-02,1446,16910,1438,2,19796
663,2019-11-03,78,37387,1145,0,38610
663,2019-11-04,987,13945,1642,0,16574
663,2019-11-05,181,3683,2079,628,6571
663,2019-11-06,474,14791,1513,3,16781
663,2019-11-07,933,25825,967,3,27728
663,2019-11-08,459,18306,1301,0,20066
663,2019-11-09,73,16083,2163,0,18319
663,2019-11-10,84,15010,2390,0,17484
663,2019-11-11,111,14300,1804,4,16219
663,2019-11-12,223,19116,2336,1,21676
663,2019-11-13,183,16508,2069,0,18760
663,2019-11-14,93,9183,1717,1,10994
663,2019-11-15,1006,4441,1649,1,7097
663,2019-11-16,112,2627,1406,3,4148
663,2019-11-17,82,4053,2684,1,6820
663,2019-11-18,131,3409,2706,2,6248
663,2019-11-19,1185,5559,2583,0,9327
663,2019-11-20,93,1737,1971,1,3802
663,2019-11-21,463,7604,1279,3,9349
663,2019-11-22,86,6078,2069,3,8236
663,2019-11-23,75,6170,2359,0,8604
663,2019-11-24,231,6513,1687,0,8431
663,2019-11-25,1169,11157,1721,0,14047
663,2019-11-26,151,6835,2091,2,9079
664,2019-08-06,11,4,90,26,131
664,2019-08-07,104,16571,146,14,16835
664,2019-08-08,1216,6351,569,18,8154
664,2019-08-09,3983,1060,150,2194,7387
664,2019-08-10,889,391,401,3,1684
664,2019-08-11,273,204,10,0,487
664,2019-08-12,946,400,191,0,1537
664,2019-08-13,671,451,93,0,1215
664,2019-08-14,192,399,64,37,692
664,2019-08-15,446,383,121,0,950
664,2019-08-16,346,505,87,241,1179
664,2019-08-17,731,768,862,0,2361
664,2019-08-18,1250,433,823,0,2506
664,2019-08-19,1333,979,2263,0,4575
664,2019-08-20,1233,1817,1442,1,4493
664,2019-08-21,198,535,597,2,1332
664,2019-08-22,288,12556,1400,1623,15867
664,2019-08-23,348,20323,1654,0,22325
664,2019-08-24,1238,5637,1621,0,8496
664,2019-08-25,1508,12294,1646,1,15449
664,2019-08-26,603,12146,1208,0,13957
664,2019-08-27,638,3094,1210,1,4943
664,2019-08-28,2005,6940,1444,1,10390
664,2019-08-29,7312,8998,1912,216,18438
664,2019-08-30,5779,8760,816,333,15688
664,2019-08-31,529,95,0,0,624
664,2019-09-01,850,1751,360,215,3176
664,2019-09-02,290,769,104,5,1168
664,2019-09-03,674,4069,1223,141,6107
664,2019-09-04,821,8768,3104,352,13045
664,2019-09-05,2339,9628,2619,216,14802
664,2019-09-06,6137,9959,3411,361,19868
664,2019-09-07,5086,7248,1545,440,14319
664,2019-09-08,5915,6436,2430,331,15112
664,2019-09-09,14860,8517,2379,112,25868
664,2019-09-10,10687,8788,2238,220,21933
664,2019-09-11,5223,6591,2742,2,14558
664,2019-09-12,743,9004,2268,641,12656
664,2019-09-13,4706,7094,2757,1,14558
664,2019-09-14,4955,5414,1303,1280,12952
664,2019-09-15,4029,5631,2075,323,12058
664,2019-09-16,4583,7727,2364,2260,16934
664,2019-09-17,8942,11323,1440,322,22027
664,2019-09-18,3547,11281,1413,655,16896
664,2019-09-19,1693,3988,1798,0,7479
664,2019-09-20,11607,8222,1435,0,21264
664,2019-09-21,15323,6715,2472,0,24510
664,2019-09-22,6419,11873,2255,0,20547
664,2019-09-23,2537,31675,1870,1626,37708
664,2019-09-24,8171,17228,2120,4865,32384
664,2019-09-25,4250,6423,1542,0,12215
664,2019-09-26,1526,9748,1898,3,13175
664,2019-09-27,6904,9691,1268,1621,19484
664,2019-09-28,6760,27887,1109,2,35758
664,2019-09-29,1138,25820,1259,2,28219
664,2019-09-30,1561,28077,2111,0,31749
664,2019-10-01,6523,21219,1428,1,29171
664,2019-10-02,10776,16224,1808,0,28808
664,2019-10-03,12173,13462,1966,3249,30850
664,2019-10-04,7494,17717,1514,2,26727
664,2019-10-05,7005,20690,1654,1627,30976
664,2019-10-06,2967,16498,2074,2,21541
664,2019-10-07,3465,5773,1874,2,11114
664,2019-10-08,8201,17575,1598,2374,29748
664,2019-10-09,11747,24631,1695,0,38073
664,2019-10-10,5529,17714,1897,1622,26762
664,2019-10-11,7448,17291,1634,1629,28002
664,2019-10-12,12173,9253,1700,2,23128
664,2019-10-13,4666,11871,2434,1,18972
664,2019-10-14,2928,6223,1951,140,11242
664,2019-10-15,7832,14534,1613,0,23979
664,2019-10-16,4821,23317,1136,73,29347
664,2019-10-17,8886,8388,1849,0,19123
664,2019-10-18,12789,8841,1368,1,22999
664,2019-10-19,10299,5473,2352,1,18125
664,2019-10-20,1369,2853,1898,50,6170
664,2019-10-21,1763,11206,1954,145,15068
664,2019-10-22,7905,11555,1612,0,21072
664,2019-10-23,6169,7836,1373,1,15379
664,2019-10-24,4440,13445,1655,71,19611
664,2019-10-25,8486,15566,1830,1,25883
664,2019-10-26,19852,17104,2274,1,39231
664,2019-10-27,2555,16659,1635,1,20850
664,2019-10-28,3210,32551,1802,1,37564
664,2019-10-29,6441,19510,1708,0,27659
664,2019-10-30,5593,15612,1429,3,22637
664,2019-10-31,10250,20088,1577,3,31918
664,2019-11-01,3423,27208,1029,0,31660
664,2019-11-02,7285,16181,1296,0,24762
664,2019-11-03,6112,35723,752,0,42587
664,2019-11-04,3224,13625,2082,0,18931
664,2019-11-05,18415,2162,1785,0,22362
664,2019-11-06,6115,14238,1335,1,21689
664,2019-11-07,2336,16870,1318,3,20527
664,2019-11-08,5963,9482,1580,0,17025
664,2019-11-09,3885,9114,1378,0,14377
664,2019-11-10,1588,15244,2376,2,19210
664,2019-11-11,7692,13739,2459,2,23892
664,2019-11-12,8501,17377,3083,0,28961
664,2019-11-13,2519,15235,1547,3,19304
664,2019-11-14,1451,8287,1811,2,11551
664,2019-11-15,7289,3738,1577,1,12605
664,2019-11-16,6874,2575,2398,2,11849
664,2019-11-17,4045,4491,2076,0,10612
664,2019-11-18,7715,4630,2536,0,14881
664,2019-11-19,16170,3196,1855,2,21223
664,2019-11-20,7874,1370,2101,3,11348
664,2019-11-21,1782,7447,1088,0,10317
664,2019-11-22,5787,4917,1013,3,11720
664,2019-11-23,4683,5193,2230,1,12107
664,2019-11-24,502,5670,1608,0,7780
664,2019-11-25,1554,6319,1815,0,9688
664,2019-11-26,5280,6591,1527,0,13398
664,2019-11-27,3594,5926,1135,0,10655
664,2019-11-28,645,8170,836,0,9651
664,2019-11-29,703,856,3,0,1562
664,2019-08-06,11,4,90,26,131
664,2019-08-07,104,16571,146,14,16835
664,2019-08-08,1216,6351,569,18,8154
664,2019-08-09,3983,1060,150,2194,7387
664,2019-08-10,889,391,401,3,1684
664,2019-08-11,273,204,10,0,487
664,2019-08-12,946,400,191,0,1537
664,2019-08-13,671,451,93,0,1215
664,2019-08-14,192,399,64,37,692
664,2019-08-15,446,383,121,0,950
664,2019-08-16,346,505,87,241,1179
664,2019-08-17,731,768,862,0,2361
664,2019-08-18,1250,433,823,0,2506
664,2019-08-19,1333,979,2263,0,4575
664,2019-08-20,1233,1817,1442,1,4493
664,2019-08-21,198,535,597,2,1332
664,2019-08-22,288,12556,1400,1623,15867
664,2019-08-23,348,20323,1654,0,22325
664,2019-08-24,1238,5637,1621,0,8496
664,2019-08-25,1508,12294,1646,1,15449
664,2019-08-26,603,12146,1208,0,13957
664,2019-08-27,638,3094,1210,1,4943
664,2019-08-28,2005,6940,1444,1,10390
664,2019-08-29,7312,8998,1912,216,18438
664,2019-08-30,5779,8760,816,333,15688
664,2019-08-31,529,95,0,0,624
664,2019-09-01,850,1751,360,215,3176
664,2019-09-02,290,769,104,5,1168
664,2019-09-03,674,4069,1223,141,6107
664,2019-09-04,821,8768,3104,352,13045
664,2019-09-05,2339,9628,2619,216,14802
664,2019-09-06,6137,9959,3411,361,19868
664,2019-09-07,5086,7248,1545,440,14319
664,2019-09-08,5915,6436,2430,331,15112
664,2019-09-09,14860,8517,2379,112,25868
664,2019-09-10,10687,8788,2238,220,21933
664,2019-09-11,5223,6591,2742,2,14558
664,2019-09-12,743,9004,2268,641,12656
664,2019-09-13,4706,7094,2757,1,14558
664,2019-09-14,4955,5414,1303,1280,12952
664,2019-09-15,4029,5631,2075,323,12058
664,2019-09-16,4583,7727,2364,2260,16934
664,2019-09-17,8942,11323,1440,322,22027
664,2019-09-18,3547,11281,1413,655,16896
664,2019-09-19,1693,3988,1798,0,7479
664,2019-09-20,11607,8222,1435,0,21264
664,2019-09-21,15323,6715,2472,0,24510
664,2019-09-22,6419,11873,2255,0,20547
664,2019-09-23,2537,31675,1870,1626,37708
664,2019-09-24,8171,17228,2120,4865,32384
664,2019-09-25,4250,6423,1542,0,12215
664,2019-09-26,1526,9748,1898,3,13175
664,2019-09-27,6904,9691,1268,1621,19484
664,2019-09-28,6760,27887,1109,2,35758
664,2019-09-29,1138,25820,1259,2,28219
664,2019-09-30,1561,28077,2111,0,31749
664,2019-10-01,6523,21219,1428,1,29171
664,2019-10-02,10776,16224,1808,0,28808
664,2019-10-03,12173,13462,1966,3249,30850
664,2019-10-04,7494,17717,1514,2,26727
664,2019-10-05,7005,20690,1654,1627,30976
664,2019-10-06,2967,16498,2074,2,21541
664,2019-10-07,3465,5773,1874,2,11114
664,2019-10-08,8201,17575,1598,2374,29748
664,2019-10-09,11747,24631,1695,0,38073
664,2019-10-10,5529,17714,1897,1622,26762
664,2019-10-11,7448,17291,1634,1629,28002
664,2019-10-12,12173,9253,1700,2,23128
664,2019-10-13,4666,11871,2434,1,18972
664,2019-10-14,2928,6223,1951,140,11242
664,2019-10-15,7832,14534,1613,0,23979
664,2019-10-16,4821,23317,1136,73,29347
664,2019-10-17,8886,8388,1849,0,19123
664,2019-10-18,12789,8841,1368,1,22999
664,2019-10-19,10299,5473,2352,1,18125
664,2019-10-20,1369,2853,1898,50,6170
664,2019-10-21,1763,11206,1954,145,15068
664,2019-10-22,7905,11555,1612,0,21072
664,2019-10-23,6169,7836,1373,1,15379
664,2019-10-24,4440,13445,1655,71,19611
664,2019-10-25,8486,15566,1830,1,25883
664,2019-10-26,19852,17104,2274,1,39231
664,2019-10-27,2555,16659,1635,1,20850
664,2019-10-28,3210,32551,1802,1,37564
664,2019-10-29,6441,19510,1708,0,27659
664,2019-10-30,5593,15612,1429,3,22637
664,2019-10-31,10250,20088,1577,3,31918
664,2019-11-01,3423,27208,1029,0,31660
664,2019-11-02,7285,16181,1296,0,24762
664,2019-11-03,6112,35723,752,0,42587
664,2019-11-04,3224,13625,2082,0,18931
664,2019-11-05,18415,2162,1785,0,22362
664,2019-11-06,6115,14238,1335,1,21689
664,2019-11-07,2336,16870,1318,3,20527
664,2019-11-08,5963,9482,1580,0,17025
664,2019-11-09,3885,9114,1378,0,14377
664,2019-11-10,1588,15244,2376,2,19210
664,2019-11-11,7692,13739,2459,2,23892
664,2019-11-12,8501,17377,3083,0,28961
664,2019-11-13,2519,15235,1547,3,19304
664,2019-11-14,1451,8287,1811,2,11551
664,2019-11-15,7289,3738,1577,1,12605
664,2019-11-16,6874,2575,2398,2,11849
664,2019-11-17,4045,4491,2076,0,10612
664,2019-11-18,7715,4630,2536,0,14881
664,2019-11-19,16170,3196,1855,2,21223
664,2019-11-20,7874,1370,2101,3,11348
664,2019-11-21,1782,7447,1088,0,10317
664,2019-11-22,5787,4917,1013,3,11720
664,2019-11-23,4683,5193,2230,1,12107
664,2019-11-24,502,5670,1608,0,7780
664,2019-11-25,1554,6319,1815,0,9688
664,2019-11-26,5280,6591,1527,0,13398
664,2019-11-27,3594,5926,1135,0,10655
664,2019-11-28,645,8170,836,0,9651
664,2019-11-29,703,856,3,0,1562
664,2019-08-06,11,4,90,26,131
664,2019-08-07,104,16571,146,14,16835
664,2019-08-08,1216,6351,569,18,8154
664,2019-08-09,3983,1060,150,2194,7387
664,2019-08-10,889,391,401,3,1684
664,2019-08-11,273,204,10,0,487
664,2019-08-12,946,400,191,0,1537
664,2019-08-13,671,451,93,0,1215
664,2019-08-14,192,399,64,37,692
664,2019-08-15,446,383,121,0,950
664,2019-08-16,346,505,87,241,1179
664,2019-08-17,731,768,862,0,2361
664,2019-08-18,1250,433,823,0,2506
664,2019-08-19,1333,979,2263,0,4575
664,2019-08-20,1233,1817,1442,1,4493
664,2019-08-21,198,535,597,2,1332
664,2019-08-22,288,12556,1400,1623,15867
664,2019-08-23,348,20323,1654,0,22325
664,2019-08-24,1238,5637,1621,0,8496
664,2019-08-25,1508,12294,1646,1,15449
664,2019-08-26,603,12146,1208,0,13957
664,2019-08-27,638,3094,1210,1,4943
664,2019-08-28,2005,6940,1444,1,10390
664,2019-08-29,7312,8998,1912,216,18438
664,2019-08-30,5779,8760,816,333,15688
664,2019-08-31,529,95,0,0,624
664,2019-09-01,850,1751,360,215,3176
664,2019-09-02,290,769,104,5,1168
664,2019-09-03,674,4069,1223,141,6107
664,2019-09-04,821,8768,3104,352,13045
664,2019-09-05,2339,9628,2619,216,14802
664,2019-09-06,6137,9959,3411,361,19868
664,2019-09-07,5086,7248,1545,440,14319
664,2019-09-08,5915,6436,2430,331,15112
664,2019-09-09,14860,8517,2379,112,25868
664,2019-09-10,10687,8788,2238,220,21933
664,2019-09-11,5223,6591,2742,2,14558
664,2019-09-12,743,9004,2268,641,12656
664,2019-09-13,4706,7094,2757,1,14558
664,2019-09-14,4955,5414,1303,1280,12952
664,2019-09-15,4029,5631,2075,323,12058
664,2019-09-16,4583,7727,2364,2260,16934
664,2019-09-17,8942,11323,1440,322,22027
664,2019-09-18,3547,11281,1413,655,16896
664,2019-09-19,1693,3988,1798,0,7479
664,2019-09-20,11607,8222,1435,0,21264
664,2019-09-21,15323,6715,2472,0,24510
664,2019-09-22,6419,11873,2255,0,20547
664,2019-09-23,2537,31675,1870,1626,37708
664,2019-09-24,8171,17228,2120,4865,32384
664,2019-09-25,4250,6423,1542,0,12215
664,2019-09-26,1526,9748,1898,3,13175
664,2019-09-27,6904,9691,1268,1621,19484
664,2019-09-28,6760,27887,1109,2,35758
664,2019-09-29,1138,25820,1259,2,28219
664,2019-09-30,1561,28077,2111,0,31749
664,2019-10-01,6523,21219,1428,1,29171
664,2019-10-02,10776,16224,1808,0,28808
664,2019-10-03,12173,13462,1966,3249,30850
664,2019-10-04,7494,17717,1514,2,26727
664,2019-10-05,7005,20690,1654,1627,30976
664,2019-10-06,2967,16498,2074,2,21541
664,2019-10-07,3465,5773,1874,2,11114
664,2019-10-08,8201,17575,1598,2374,29748
664,2019-10-09,11747,24631,1695,0,38073
664,2019-10-10,5529,17714,1897,1622,26762
664,2019-10-11,7448,17291,1634,1629,28002
664,2019-10-12,12173,9253,1700,2,23128
664,2019-10-13,4666,11871,2434,1,18972
664,2019-10-14,2928,6223,1951,140,11242
664,2019-10-15,7832,14534,1613,0,23979
664,2019-10-16,4821,23317,1136,73,29347
664,2019-10-17,8886,8388,1849,0,19123
664,2019-10-18,12789,8841,1368,1,22999
664,2019-10-19,10299,5473,2352,1,18125
664,2019-10-20,1369,2853,1898,50,6170
664,2019-10-21,1763,11206,1954,145,15068
664,2019-10-22,7905,11555,1612,0,21072
664,2019-10-23,6169,7836,1373,1,15379
664,2019-10-24,4440,13445,1655,71,19611
664,2019-10-25,8486,15566,1830,1,25883
664,2019-10-26,19852,17104,2274,1,39231
664,2019-10-27,2555,16659,1635,1,20850
664,2019-10-28,3210,32551,1802,1,37564
664,2019-10-29,6441,19510,1708,0,27659
664,2019-10-30,5593,15612,1429,3,22637
664,2019-10-31,10250,20088,1577,3,31918
664,2019-11-01,3423,27208,1029,0,31660
664,2019-11-02,7285,16181,1296,0,24762
664,2019-11-03,6112,35723,752,0,42587
664,2019-11-04,3224,13625,2082,0,18931
664,2019-11-05,18415,2162,1785,0,22362
664,2019-11-06,6115,14238,1335,1,21689
664,2019-11-07,2336,16870,1318,3,20527
664,2019-11-08,5963,9482,1580,0,17025
664,2019-11-09,3885,9114,1378,0,14377
664,2019-11-10,1588,15244,2376,2,19210
664,2019-11-11,7692,13739,2459,2,23892
664,2019-11-12,8501,17377,3083,0,28961
664,2019-11-13,2519,15235,1547,3,19304
664,2019-11-14,1451,8287,1811,2,11551
664,2019-11-15,7289,3738,1577,1,12605
664,2019-11-16,6874,2575,2398,2,11849
664,2019-11-17,4045,4491,2076,0,10612
664,2019-11-18,7715,4630,2536,0,14881
664,2019-11-19,16170,3196,1855,2,21223
664,2019-11-20,7874,1370,2101,3,11348
664,2019-11-21,1782,7447,1088,0,10317
664,2019-11-22,5787,4917,1013,3,11720
664,2019-11-23,4683,5193,2230,1,12107
664,2019-11-24,502,5670,1608,0,7780
664,2019-11-25,1554,6319,1815,0,9688
664,2019-11-26,5280,6591,1527,0,13398
664,2019-11-27,3594,5926,1135,0,10655
664,2019-11-28,645,8170,836,0,9651
664,2019-11-29,703,856,3,0,1562
664,2019-08-06,11,4,90,26,131
664,2019-08-07,104,16571,146,14,16835
664,2019-08-08,1216,6351,569,18,8154
664,2019-08-09,3983,1060,150,2194,7387
664,2019-08-10,889,391,401,3,1684
664,2019-08-11,273,204,10,0,487
664,2019-08-12,946,400,191,0,1537
664,2019-08-13,671,451,93,0,1215
664,2019-08-14,192,399,64,37,692
664,2019-08-15,446,383,121,0,950
664,2019-08-16,346,505,87,241,1179
664,2019-08-17,731,768,862,0,2361
664,2019-08-18,1250,433,823,0,2506
664,2019-08-19,1333,979,2263,0,4575
664,2019-08-20,1233,1817,1442,1,4493
664,2019-08-21,198,535,597,2,1332
664,2019-08-22,288,12556,1400,1623,15867
664,2019-08-23,348,20323,1654,0,22325
664,2019-08-24,1238,5637,1621,0,8496
664,2019-08-25,1508,12294,1646,1,15449
664,2019-08-26,603,12146,1208,0,13957
664,2019-08-27,638,3094,1210,1,4943
664,2019-08-28,2005,6940,1444,1,10390
664,2019-08-29,7312,8998,1912,216,18438
664,2019-08-30,5779,8760,816,333,15688
664,2019-08-31,529,95,0,0,624
664,2019-09-01,850,1751,360,215,3176
664,2019-09-02,290,769,104,5,1168
664,2019-09-03,674,4069,1223,141,6107
664,2019-09-04,821,8768,3104,352,13045
664,2019-09-05,2339,9628,2619,216,14802
664,2019-09-06,6137,9959,3411,361,19868
664,2019-09-07,5086,7248,1545,440,14319
664,2019-09-08,5915,6436,2430,331,15112
664,2019-09-09,14860,8517,2379,112,25868
664,2019-09-10,10687,8788,2238,220,21933
664,2019-09-11,5223,6591,2742,2,14558
664,2019-09-12,743,9004,2268,641,12656
664,2019-09-13,4706,7094,2757,1,14558
664,2019-09-14,4955,5414,1303,1280,12952
664,2019-09-15,4029,5631,2075,323,12058
664,2019-09-16,4583,7727,2364,2260,16934
664,2019-09-17,8942,11323,1440,322,22027
664,2019-09-18,3547,11281,1413,655,16896
664,2019-09-19,1693,3988,1798,0,7479
664,2019-09-20,11607,8222,1435,0,21264
664,2019-09-21,15323,6715,2472,0,24510
664,2019-09-22,6419,11873,2255,0,20547
664,2019-09-23,2537,31675,1870,1626,37708
664,2019-09-24,8171,17228,2120,4865,32384
664,2019-09-25,4250,6423,1542,0,12215
664,2019-09-26,1526,9748,1898,3,13175
664,2019-09-27,6904,9691,1268,1621,19484
664,2019-09-28,6760,27887,1109,2,35758
664,2019-09-29,1138,25820,1259,2,28219
664,2019-09-30,1561,28077,2111,0,31749
664,2019-10-01,6523,21219,1428,1,29171
664,2019-10-02,10776,16224,1808,0,28808
664,2019-10-03,12173,13462,1966,3249,30850
664,2019-10-04,7494,17717,1514,2,26727
664,2019-10-05,7005,20690,1654,1627,30976
664,2019-10-06,2967,16498,2074,2,21541
664,2019-10-07,3465,5773,1874,2,11114
664,2019-10-08,8201,17575,1598,2374,29748
664,2019-10-09,11747,24631,1695,0,38073
664,2019-10-10,5529,17714,1897,1622,26762
664,2019-10-11,7448,17291,1634,1629,28002
664,2019-10-12,12173,9253,1700,2,23128
664,2019-10-13,4666,11871,2434,1,18972
664,2019-10-14,2928,6223,1951,140,11242
664,2019-10-15,7832,14534,1613,0,23979
664,2019-10-16,4821,23317,1136,73,29347
664,2019-10-17,8886,8388,1849,0,19123
664,2019-10-18,12789,8841,1368,1,22999
664,2019-10-19,10299,5473,2352,1,18125
664,2019-10-20,1369,2853,1898,50,6170
664,2019-10-21,1763,11206,1954,145,15068
664,2019-10-22,7905,11555,1612,0,21072
664,2019-10-23,6169,7836,1373,1,15379
664,2019-10-24,4440,13445,1655,71,19611
664,2019-10-25,8486,15566,1830,1,25883
664,2019-10-26,19852,17104,2274,1,39231
664,2019-10-27,2555,16659,1635,1,20850
664,2019-10-28,3210,32551,1802,1,37564
664,2019-10-29,6441,19510,1708,0,27659
664,2019-10-30,5593,15612,1429,3,22637
664,2019-10-31,10250,20088,1577,3,31918
664,2019-11-01,3423,27208,1029,0,31660
664,2019-11-02,7285,16181,1296,0,24762
664,2019-11-03,6112,35723,752,0,42587
664,2019-11-04,3224,13625,2082,0,18931
664,2019-11-05,18415,2162,1785,0,22362
664,2019-11-06,6115,14238,1335,1,21689
664,2019-11-07,2336,16870,1318,3,20527
664,2019-11-08,5963,9482,1580,0,17025
664,2019-11-09,3885,9114,1378,0,14377
664,2019-11-10,1588,15244,2376,2,19210
664,2019-11-11,7692,13739,2459,2,23892
664,2019-11-12,8501,17377,3083,0,28961
664,2019-11-13,2519,15235,1547,3,19304
664,2019-11-14,1451,8287,1811,2,11551
664,2019-11-15,7289,3738,1577,1,12605
664,2019-11-16,6874,2575,2398,2,11849
664,2019-11-17,4045,4491,2076,0,10612
664,2019-11-18,7715,4630,2536,0,14881
664,2019-11-19,16170,3196,1855,2,21223
664,2019-11-20,7874,1370,2101,3,11348
664,2019-11-21,1782,7447,1088,0,10317
664,2019-11-22,5787,4917,1013,3,11720
664,2019-11-23,4683,5193,2230,1,12107
665,2019-08-06,18,23,110,1,152
665,2019-08-07,77,5698,593,2,6370
665,2019-08-08,52,2105,157,10,2324
665,2019-08-09,75,617,222,2,916
665,2019-08-10,303,478,158,0,939
665,2019-08-11,144,287,116,0,547
665,2019-08-12,143,375,198,1,717
665,2019-08-13,98,349,291,0,738
665,2019-08-14,308,963,128,0,1399
665,2019-08-15,65,801,154,0,1020
665,2019-08-16,80,331,157,1,569
665,2019-08-17,148,1452,767,1,2368
665,2019-08-18,1375,1094,1301,0,3770
665,2019-08-19,117,8713,1392,1,10223
665,2019-08-20,85,13331,906,1,14323
665,2019-08-21,80,11355,1494,1,12930
665,2019-08-22,305,16711,900,1,17917
665,2019-08-23,893,21402,870,1,23166
665,2019-08-24,84,6000,1793,1,7878
665,2019-08-25,129,15375,1710,3,17217
665,2019-08-26,82,5011,1403,1,6497
665,2019-08-27,98,2897,1888,4,4887
665,2019-08-28,89,5833,2070,1,7993
665,2019-08-29,176,8777,1918,3,10874
665,2019-08-30,63,2866,369,0,3298
665,2019-08-31,25,68,8,0,101
665,2019-09-01,49,1649,390,0,2088
665,2019-09-02,112,315,28,0,455
665,2019-09-03,72,1097,1031,2,2202
665,2019-09-04,922,7300,2220,2,10444
665,2019-09-05,944,5272,1668,1,7885
665,2019-09-06,113,17685,1473,1,19272
665,2019-09-07,201,7363,2359,0,9923
665,2019-09-08,185,7066,2058,0,9309
665,2019-09-09,241,7795,1625,1,9662
665,2019-09-10,369,11621,1654,1,13645
665,2019-09-11,273,10457,1842,1,12573
665,2019-09-12,896,11642,1806,2,14346
665,2019-09-13,99,6614,1746,0,8459
665,2019-09-14,96,6585,2912,0,9593
665,2019-09-15,1900,6086,2180,2,10168
665,2019-09-16,120,12868,2126,2,15116
665,2019-09-17,656,8055,2385,2,11098
665,2019-09-18,683,10990,2544,0,14217
665,2019-09-19,203,8863,1118,0,10184
665,2019-09-20,169,11819,1912,0,13900
665,2019-09-21,931,7637,1081,2,9651
665,2019-09-22,921,14991,1267,0,17179
665,2019-09-23,999,9739,1872,0,12610
665,2019-09-24,123,9705,1843,2,11673
665,2019-09-25,195,5297,1873,3,7368
665,2019-09-26,882,14439,1435,2,16758
665,2019-09-27,92,8072,1559,2,9725
665,2019-09-28,141,14714,2802,3,17660
665,2019-09-29,91,17571,866,0,18528
665,2019-09-30,80,25978,1401,0,27459
665,2019-10-01,338,21818,2122,1,24279
665,2019-10-02,77,12531,2114,0,14722
665,2019-10-03,93,13133,2017,0,15243
665,2019-10-04,74,11411,2293,2,13780
665,2019-10-05,353,20879,1418,2,22652
665,2019-10-06,194,15742,1948,390,18274
665,2019-10-07,59,4555,1534,3,6151
665,2019-10-08,85,12039,2292,4,14420
665,2019-10-09,115,13313,995,2,14425
665,2019-10-10,88,9623,2538,2,12251
665,2019-10-11,92,9746,1503,0,11341
665,2019-10-12,1050,5982,1725,2,8759
665,2019-10-13,954,7496,1660,3,10113
665,2019-10-14,67,4307,2051,1,6426
665,2019-10-15,195,7207,1590,0,8992
665,2019-10-16,934,17774,1514,0,20222
665,2019-10-17,73,7494,2383,3,9953
665,2019-10-18,102,7448,1663,2,9215
665,2019-10-19,171,4512,1661,0,6344
665,2019-10-20,75,626,1495,0,2196
665,2019-10-21,70,17730,1922,2,19724
665,2019-10-22,959,8802,1541,1,11303
665,2019-10-23,61,7569,1337,5,8972
665,2019-10-24,147,12678,1742,1,14568
665,2019-10-25,137,15290,1264,1,16692
665,2019-10-26,968,16155,1252,0,18375
665,2019-10-27,88,16499,1221,0,17808
665,2019-10-28,885,13189,1529,1,15604
665,2019-10-29,114,25879,1705,0,27698
665,2019-10-30,68,20517,1728,1,22314
665,2019-10-31,1563,20133,1531,1,23228
665,2019-11-01,307,26540,1326,1,28174
665,2019-11-02,56,35650,1782,4,37492
665,2019-11-03,75,25833,1915,0,27823
665,2019-11-04,92,10081,1605,0,11778
665,2019-11-05,495,2135,1465,0,4095
665,2019-11-06,1210,13822,1619,0,16651
665,2019-11-07,184,16006,918,5,17113
665,2019-11-08,640,9517,1566,1,11724
665,2019-11-09,1405,9415,1830,0,12650
665,2019-11-10,100,12064,2128,667,14959
665,2019-11-11,106,11893,1995,0,13994
665,2019-11-12,369,10947,3234,3,14553
665,2019-11-13,1106,11958,2227,1,15292
665,2019-11-14,143,13379,2165,3,15690
665,2019-11-15,81,3690,2526,0,6297
665,2019-11-16,65,907,2311,1,3284
665,2019-11-17,630,3154,3019,4,6807
665,2019-11-18,78,1383,3400,2,4863
665,2019-11-19,107,2789,2735,2,5633
665,2019-11-20,101,917,2120,1,3139
665,2019-11-21,96,3154,1580,1,4831
665,2019-11-22,110,5614,2325,0,8049
665,2019-11-23,79,6198,2726,0,9003
665,2019-11-24,1053,6535,1883,0,9471
665,2019-11-25,298,5782,2256,0,8336
665,2019-11-26,763,9781,1380,0,11924
665,2019-11-27,62,5499,1177,0,6738
665,2019-11-28,80,12854,683,0,13617
665,2019-11-29,29,1846,11,0,1886
665,2019-08-06,18,23,110,1,152
665,2019-08-07,77,5698,593,2,6370
665,2019-08-08,52,2105,157,10,2324
665,2019-08-09,75,617,222,2,916
665,2019-08-10,303,478,158,0,939
665,2019-08-11,144,287,116,0,547
665,2019-08-12,143,375,198,1,717
665,2019-08-13,98,349,291,0,738
665,2019-08-14,308,963,128,0,1399
665,2019-08-15,65,801,154,0,1020
665,2019-08-16,80,331,157,1,569
665,2019-08-17,148,1452,767,1,2368
665,2019-08-18,1375,1094,1301,0,3770
665,2019-08-19,117,8713,1392,1,10223
665,2019-08-20,85,13331,906,1,14323
665,2019-08-21,80,11355,1494,1,12930
665,2019-08-22,305,16711,900,1,17917
665,2019-08-23,893,21402,870,1,23166
665,2019-08-24,84,6000,1793,1,7878
665,2019-08-25,129,15375,1710,3,17217
665,2019-08-26,82,5011,1403,1,6497
665,2019-08-27,98,2897,1888,4,4887
665,2019-08-28,89,5833,2070,1,7993
665,2019-08-29,176,8777,1918,3,10874
665,2019-08-30,63,2866,369,0,3298
665,2019-08-31,25,68,8,0,101
665,2019-09-01,49,1649,390,0,2088
665,2019-09-02,112,315,28,0,455
665,2019-09-03,72,1097,1031,2,2202
665,2019-09-04,922,7300,2220,2,10444
665,2019-09-05,944,5272,1668,1,7885
665,2019-09-06,113,17685,1473,1,19272
665,2019-09-07,201,7363,2359,0,9923
665,2019-09-08,185,7066,2058,0,9309
665,2019-09-09,241,7795,1625,1,9662
665,2019-09-10,369,11621,1654,1,13645
665,2019-09-11,273,10457,1842,1,12573
665,2019-09-12,896,11642,1806,2,14346
665,2019-09-13,99,6614,1746,0,8459
665,2019-09-14,96,6585,2912,0,9593
665,2019-09-15,1900,6086,2180,2,10168
665,2019-09-16,120,12868,2126,2,15116
665,2019-09-17,656,8055,2385,2,11098
665,2019-09-18,683,10990,2544,0,14217
665,2019-09-19,203,8863,1118,0,10184
665,2019-09-20,169,11819,1912,0,13900
665,2019-09-21,931,7637,1081,2,9651
665,2019-09-22,921,14991,1267,0,17179
665,2019-09-23,999,9739,1872,0,12610
665,2019-09-24,123,9705,1843,2,11673
665,2019-09-25,195,5297,1873,3,7368
665,2019-09-26,882,14439,1435,2,16758
665,2019-09-27,92,8072,1559,2,9725
665,2019-09-28,141,14714,2802,3,17660
665,2019-09-29,91,17571,866,0,18528
665,2019-09-30,80,25978,1401,0,27459
665,2019-10-01,338,21818,2122,1,24279
665,2019-10-02,77,12531,2114,0,14722
665,2019-10-03,93,13133,2017,0,15243
665,2019-10-04,74,11411,2293,2,13780
665,2019-10-05,353,20879,1418,2,22652
665,2019-10-06,194,15742,1948,390,18274
665,2019-10-07,59,4555,1534,3,6151
665,2019-10-08,85,12039,2292,4,14420
665,2019-10-09,115,13313,995,2,14425
665,2019-10-10,88,9623,2538,2,12251
665,2019-10-11,92,9746,1503,0,11341
665,2019-10-12,1050,5982,1725,2,8759
665,2019-10-13,954,7496,1660,3,10113
665,2019-10-14,67,4307,2051,1,6426
665,2019-10-15,195,7207,1590,0,8992
665,2019-10-16,934,17774,1514,0,20222
665,2019-10-17,73,7494,2383,3,9953
665,2019-10-18,102,7448,1663,2,9215
665,2019-10-19,171,4512,1661,0,6344
665,2019-10-20,75,626,1495,0,2196
665,2019-10-21,70,17730,1922,2,19724
665,2019-10-22,959,8802,1541,1,11303
665,2019-10-23,61,7569,1337,5,8972
665,2019-10-24,147,12678,1742,1,14568
665,2019-10-25,137,15290,1264,1,16692
665,2019-10-26,968,16155,1252,0,18375
665,2019-10-27,88,16499,1221,0,17808
665,2019-10-28,885,13189,1529,1,15604
665,2019-10-29,114,25879,1705,0,27698
665,2019-10-30,68,20517,1728,1,22314
665,2019-10-31,1563,20133,1531,1,23228
665,2019-11-01,307,26540,1326,1,28174
665,2019-11-02,56,35650,1782,4,37492
665,2019-11-03,75,25833,1915,0,27823
665,2019-11-04,92,10081,1605,0,11778
665,2019-11-05,495,2135,1465,0,4095
665,2019-11-06,1210,13822,1619,0,16651
665,2019-11-07,184,16006,918,5,17113
665,2019-11-08,640,9517,1566,1,11724
665,2019-11-09,1405,9415,1830,0,12650
665,2019-11-10,100,12064,2128,667,14959
665,2019-11-11,106,11893,1995,0,13994
665,2019-11-12,369,10947,3234,3,14553
665,2019-11-13,1106,11958,2227,1,15292
665,2019-11-14,143,13379,2165,3,15690
665,2019-11-15,81,3690,2526,0,6297
665,2019-11-16,65,907,2311,1,3284
665,2019-11-17,630,3154,3019,4,6807
665,2019-11-18,78,1383,3400,2,4863
665,2019-11-19,107,2789,2735,2,5633
665,2019-11-20,101,917,2120,1,3139
665,2019-11-21,96,3154,1580,1,4831
665,2019-11-22,110,5614,2325,0,8049
665,2019-11-23,79,6198,2726,0,9003
665,2019-11-24,1053,6535,1883,0,9471
665,2019-11-25,298,5782,2256,0,8336
665,2019-11-26,763,9781,1380,0,11924
665,2019-11-27,62,5499,1177,0,6738
665,2019-11-28,80,12854,683,0,13617
665,2019-11-29,29,1846,11,0,1886
665,2019-08-06,18,23,110,1,152
665,2019-08-07,77,5698,593,2,6370
665,2019-08-08,52,2105,157,10,2324
665,2019-08-09,75,617,222,2,916
665,2019-08-10,303,478,158,0,939
665,2019-08-11,144,287,116,0,547
665,2019-08-12,143,375,198,1,717
665,2019-08-13,98,349,291,0,738
665,2019-08-14,308,963,128,0,1399
665,2019-08-15,65,801,154,0,1020
665,2019-08-16,80,331,157,1,569
665,2019-08-17,148,1452,767,1,2368
665,2019-08-18,1375,1094,1301,0,3770
665,2019-08-19,117,8713,1392,1,10223
665,2019-08-20,85,13331,906,1,14323
665,2019-08-21,80,11355,1494,1,12930
665,2019-08-22,305,16711,900,1,17917
665,2019-08-23,893,21402,870,1,23166
665,2019-08-24,84,6000,1793,1,7878
665,2019-08-25,129,15375,1710,3,17217
665,2019-08-26,82,5011,1403,1,6497
665,2019-08-27,98,2897,1888,4,4887
665,2019-08-28,89,5833,2070,1,7993
665,2019-08-29,176,8777,1918,3,10874
665,2019-08-30,63,2866,369,0,3298
665,2019-08-31,25,68,8,0,101
665,2019-09-01,49,1649,390,0,2088
665,2019-09-02,112,315,28,0,455
665,2019-09-03,72,1097,1031,2,2202
665,2019-09-04,922,7300,2220,2,10444
665,2019-09-05,944,5272,1668,1,7885
665,2019-09-06,113,17685,1473,1,19272
665,2019-09-07,201,7363,2359,0,9923
665,2019-09-08,185,7066,2058,0,9309
665,2019-09-09,241,7795,1625,1,9662
665,2019-09-10,369,11621,1654,1,13645
665,2019-09-11,273,10457,1842,1,12573
665,2019-09-12,896,11642,1806,2,14346
665,2019-09-13,99,6614,1746,0,8459
665,2019-09-14,96,6585,2912,0,9593
665,2019-09-15,1900,6086,2180,2,10168
665,2019-09-16,120,12868,2126,2,15116
665,2019-09-17,656,8055,2385,2,11098
665,2019-09-18,683,10990,2544,0,14217
665,2019-09-19,203,8863,1118,0,10184
665,2019-09-20,169,11819,1912,0,13900
665,2019-09-21,931,7637,1081,2,9651
665,2019-09-22,921,14991,1267,0,17179
665,2019-09-23,999,9739,1872,0,12610
665,2019-09-24,123,9705,1843,2,11673
665,2019-09-25,195,5297,1873,3,7368
665,2019-09-26,882,14439,1435,2,16758
665,2019-09-27,92,8072,1559,2,9725
665,2019-09-28,141,14714,2802,3,17660
665,2019-09-29,91,17571,866,0,18528
665,2019-09-30,80,25978,1401,0,27459
665,2019-10-01,338,21818,2122,1,24279
665,2019-10-02,77,12531,2114,0,14722
665,2019-10-03,93,13133,2017,0,15243
665,2019-10-04,74,11411,2293,2,13780
665,2019-10-05,353,20879,1418,2,22652
665,2019-10-06,194,15742,1948,390,18274
665,2019-10-07,59,4555,1534,3,6151
665,2019-10-08,85,12039,2292,4,14420
665,2019-10-09,115,13313,995,2,14425
665,2019-10-10,88,9623,2538,2,12251
665,2019-10-11,92,9746,1503,0,11341
665,2019-10-12,1050,5982,1725,2,8759
665,2019-10-13,954,7496,1660,3,10113
665,2019-10-14,67,4307,2051,1,6426
665,2019-10-15,195,7207,1590,0,8992
665,2019-10-16,934,17774,1514,0,20222
665,2019-10-17,73,7494,2383,3,9953
665,2019-10-18,102,7448,1663,2,9215
665,2019-10-19,171,4512,1661,0,6344
665,2019-10-20,75,626,1495,0,2196
665,2019-10-21,70,17730,1922,2,19724
665,2019-10-22,959,8802,1541,1,11303
665,2019-10-23,61,7569,1337,5,8972
665,2019-10-24,147,12678,1742,1,14568
665,2019-10-25,137,15290,1264,1,16692
665,2019-10-26,968,16155,1252,0,18375
665,2019-10-27,88,16499,1221,0,17808
665,2019-10-28,885,13189,1529,1,15604
665,2019-10-29,114,25879,1705,0,27698
665,2019-10-30,68,20517,1728,1,22314
665,2019-10-31,1563,20133,1531,1,23228
665,2019-11-01,307,26540,1326,1,28174
665,2019-11-02,56,35650,1782,4,37492
665,2019-11-03,75,25833,1915,0,27823
665,2019-11-04,92,10081,1605,0,11778
665,2019-11-05,495,2135,1465,0,4095
665,2019-11-06,1210,13822,1619,0,16651
665,2019-11-07,184,16006,918,5,17113
665,2019-11-08,640,9517,1566,1,11724
665,2019-11-09,1405,9415,1830,0,12650
665,2019-11-10,100,12064,2128,667,14959
665,2019-11-11,106,11893,1995,0,13994
665,2019-11-12,369,10947,3234,3,14553
665,2019-11-13,1106,11958,2227,1,15292
665,2019-11-14,143,13379,2165,3,15690
665,2019-11-15,81,3690,2526,0,6297
665,2019-11-16,65,907,2311,1,3284
665,2019-11-17,630,3154,3019,4,6807
665,2019-11-18,78,1383,3400,2,4863
665,2019-11-19,107,2789,2735,2,5633
665,2019-11-20,101,917,2120,1,3139
665,2019-11-21,96,3154,1580,1,4831
665,2019-11-22,110,5614,2325,0,8049
665,2019-11-23,79,6198,2726,0,9003
665,2019-11-24,1053,6535,1883,0,9471
665,2019-11-25,298,5782,2256,0,8336
665,2019-11-26,763,9781,1380,0,11924
665,2019-11-27,62,5499,1177,0,6738
665,2019-11-28,80,12854,683,0,13617
665,2019-11-29,29,1846,11,0,1886
665,2019-08-06,18,23,110,1,152
665,2019-08-07,77,5698,593,2,6370
665,2019-08-08,52,2105,157,10,2324
665,2019-08-09,75,617,222,2,916
665,2019-08-10,303,478,158,0,939
665,2019-08-11,144,287,116,0,547
665,2019-08-12,143,375,198,1,717
665,2019-08-13,98,349,291,0,738
665,2019-08-14,308,963,128,0,1399
665,2019-08-15,65,801,154,0,1020
665,2019-08-16,80,331,157,1,569
665,2019-08-17,148,1452,767,1,2368
665,2019-08-18,1375,1094,1301,0,3770
665,2019-08-19,117,8713,1392,1,10223
665,2019-08-20,85,13331,906,1,14323
665,2019-08-21,80,11355,1494,1,12930
665,2019-08-22,305,16711,900,1,17917
665,2019-08-23,893,21402,870,1,23166
665,2019-08-24,84,6000,1793,1,7878
665,2019-08-25,129,15375,1710,3,17217
665,2019-08-26,82,5011,1403,1,6497
665,2019-08-27,98,2897,1888,4,4887
665,2019-08-28,89,5833,2070,1,7993
665,2019-08-29,176,8777,1918,3,10874
665,2019-08-30,63,2866,369,0,3298
665,2019-08-31,25,68,8,0,101
665,2019-09-01,49,1649,390,0,2088
665,2019-09-02,112,315,28,0,455
665,2019-09-03,72,1097,1031,2,2202
665,2019-09-04,922,7300,2220,2,10444
665,2019-09-05,944,5272,1668,1,7885
665,2019-09-06,113,17685,1473,1,19272
665,2019-09-07,201,7363,2359,0,9923
665,2019-09-08,185,7066,2058,0,9309
665,2019-09-09,241,7795,1625,1,9662
665,2019-09-10,369,11621,1654,1,13645
665,2019-09-11,273,10457,1842,1,12573
665,2019-09-12,896,11642,1806,2,14346
665,2019-09-13,99,6614,1746,0,8459
665,2019-09-14,96,6585,2912,0,9593
665,2019-09-15,1900,6086,2180,2,10168
665,2019-09-16,120,12868,2126,2,15116
665,2019-09-17,656,8055,2385,2,11098
665,2019-09-18,683,10990,2544,0,14217
665,2019-09-19,203,8863,1118,0,10184
665,2019-09-20,169,11819,1912,0,13900
665,2019-09-21,931,7637,1081,2,9651
665,2019-09-22,921,14991,1267,0,17179
665,2019-09-23,999,9739,1872,0,12610
665,2019-09-24,123,9705,1843,2,11673
665,2019-09-25,195,5297,1873,3,7368
665,2019-09-26,882,14439,1435,2,16758
665,2019-09-27,92,8072,1559,2,9725
665,2019-09-28,141,14714,2802,3,17660
665,2019-09-29,91,17571,866,0,18528
665,2019-09-30,80,25978,1401,0,27459
665,2019-10-01,338,21818,2122,1,24279
665,2019-10-02,77,12531,2114,0,14722
665,2019-10-03,93,13133,2017,0,15243
665,2019-10-04,74,11411,2293,2,13780
665,2019-10-05,353,20879,1418,2,22652
665,2019-10-06,194,15742,1948,390,18274
665,2019-10-07,59,4555,1534,3,6151
665,2019-10-08,85,12039,2292,4,14420
665,2019-10-09,115,13313,995,2,14425
665,2019-10-10,88,9623,2538,2,12251
665,2019-10-11,92,9746,1503,0,11341
665,2019-10-12,1050,5982,1725,2,8759
665,2019-10-13,954,7496,1660,3,10113
665,2019-10-14,67,4307,2051,1,6426
665,2019-10-15,195,7207,1590,0,8992
665,2019-10-16,934,17774,1514,0,20222
665,2019-10-17,73,7494,2383,3,9953
665,2019-10-18,102,7448,1663,2,9215
665,2019-10-19,171,4512,1661,0,6344
665,2019-10-20,75,626,1495,0,2196
665,2019-10-21,70,17730,1922,2,19724
665,2019-10-22,959,8802,1541,1,11303
665,2019-10-23,61,7569,1337,5,8972
665,2019-10-24,147,12678,1742,1,14568
665,2019-10-25,137,15290,1264,1,16692
665,2019-10-26,968,16155,1252,0,18375
665,2019-10-27,88,16499,1221,0,17808
665,2019-10-28,885,13189,1529,1,15604
665,2019-10-29,114,25879,1705,0,27698
665,2019-10-30,68,20517,1728,1,22314
665,2019-10-31,1563,20133,1531,1,23228
665,2019-11-01,307,26540,1326,1,28174
665,2019-11-02,56,35650,1782,4,37492
665,2019-11-03,75,25833,1915,0,27823
665,2019-11-04,92,10081,1605,0,11778
665,2019-11-05,495,2135,1465,0,4095
665,2019-11-06,1210,13822,1619,0,16651
665,2019-11-07,184,16006,918,5,17113
665,2019-11-08,640,9517,1566,1,11724
665,2019-11-09,1405,9415,1830,0,12650
665,2019-11-10,100,12064,2128,667,14959
665,2019-11-11,106,11893,1995,0,13994
665,2019-11-12,369,10947,3234,3,14553
665,2019-11-13,1106,11958,2227,1,15292
665,2019-11-14,143,13379,2165,3,15690
665,2019-11-15,81,3690,2526,0,6297
665,2019-11-16,65,907,2311,1,3284
665,2019-11-17,630,3154,3019,4,6807
665,2019-11-18,78,1383,3400,2,4863
665,2019-11-19,107,2789,2735,2,5633
665,2019-11-20,101,917,2120,1,3139
665,2019-11-21,96,3154,1580,1,4831
666,2019-08-06,13,27,605,0,645
666,2019-08-07,84,334,338,1,757
666,2019-08-08,124,222,389,1,736
666,2019-08-09,140,181,317,1,639
666,2019-08-10,169,351,306,2,828
666,2019-08-11,205,363,162,0,730
666,2019-08-12,433,4811,265,0,5509
666,2019-08-13,233,4487,166,0,4886
666,2019-08-14,78,519,158,0,755
666,2019-08-15,189,517,126,1,833
666,2019-08-16,221,214,126,0,561
666,2019-08-17,187,1317,553,5,2062
666,2019-08-18,382,525,1037,0,1944
666,2019-08-19,1172,592,1177,1,2942
666,2019-08-20,951,2507,1298,0,4756
666,2019-08-21,187,761,1724,0,2672
666,2019-08-22,160,4689,763,1,5613
666,2019-08-23,294,1016,1131,0,2441
666,2019-08-24,113,14750,2249,1,17113
666,2019-08-25,298,29475,2473,2,32248
666,2019-08-26,455,27633,1192,1,29281
666,2019-08-27,719,6037,1804,2,8562
666,2019-08-28,770,21769,2116,0,24655
666,2019-08-29,2459,13226,1080,0,16765
666,2019-08-30,145,3067,689,0,3901
666,2019-08-31,25,8463,4,0,8492
666,2019-09-01,78,3826,183,0,4087
666,2019-09-02,74,1763,7,1,1845
666,2019-09-03,131,3138,1153,2,4424
666,2019-09-04,218,9950,2407,0,12575
666,2019-09-05,184,6065,1821,0,8070
666,2019-09-06,162,25898,2030,1,28091
666,2019-09-07,197,12879,1829,0,14905
666,2019-09-08,1056,6444,2359,0,9859
666,2019-09-09,1042,8431,1881,0,11354
666,2019-09-10,1084,11795,1860,2,14741
666,2019-09-11,268,10054,1747,3,12072
666,2019-09-12,339,8469,2656,0,11464
666,2019-09-13,176,5600,1653,0,7429
666,2019-09-14,127,7030,2320,1,9478
666,2019-09-15,113,10154,2456,2,12725
666,2019-09-16,132,13570,1782,2,15486
666,2019-09-17,127,9237,1440,0,10804
666,2019-09-18,104,19969,1332,2,21407
666,2019-09-19,239,9858,1890,0,11987
666,2019-09-20,225,12222,1565,1,14013
666,2019-09-21,113,9476,2070,0,11659
666,2019-09-22,1157,15432,926,0,17515
666,2019-09-23,804,12350,1085,4,14243
666,2019-09-24,881,13921,1460,2,16264
666,2019-09-25,1555,8399,720,1,10675
666,2019-09-26,754,8989,1443,4,11190
666,2019-09-27,300,10688,2080,3,13071
666,2019-09-28,179,14697,2241,1,17118
666,2019-09-29,1044,15621,2117,0,18782
666,2019-09-30,962,26738,1717,1,29418
666,2019-10-01,96,26979,1744,3,28822
666,2019-10-02,197,17181,1558,0,18936
666,2019-10-03,1013,13089,1505,1,15608
666,2019-10-04,916,17108,1619,1,19644
666,2019-10-05,1007,23261,823,0,25091
666,2019-10-06,1392,15599,2201,2,19194
666,2019-10-07,131,4603,1833,2,6569
666,2019-10-08,1026,17190,1326,633,20175
666,2019-10-09,207,23404,2652,1,26264
666,2019-10-10,2525,10386,1508,2,14421
666,2019-10-11,733,15321,2041,2,18097
666,2019-10-12,222,8023,1605,1,9851
666,2019-10-13,1024,10898,2118,1,14041
666,2019-10-14,1004,4683,2057,2,7746
666,2019-10-15,136,13568,2098,0,15802
666,2019-10-16,684,23189,864,3,24740
666,2019-10-17,154,11037,1100,1,12292
666,2019-10-18,1045,8045,1421,0,10511
666,2019-10-19,179,4235,1789,3,6206
666,2019-10-20,149,748,2185,0,3082
666,2019-10-21,249,9544,1098,5,10896
666,2019-10-22,1909,4662,1743,1,8315
666,2019-10-23,141,13030,1465,1,14637
666,2019-10-24,134,18852,1780,0,20766
666,2019-10-25,243,10610,2197,1,13051
666,2019-10-26,1219,12689,1788,0,15696
666,2019-10-27,214,16292,1531,2,18039
666,2019-10-28,121,13034,1924,1,15080
666,2019-10-29,849,26890,1140,0,28879
666,2019-10-30,171,19953,1837,2,21963
666,2019-10-31,106,11289,1850,2,13247
666,2019-11-01,474,24901,1279,0,26654
666,2019-11-02,432,15774,1115,1,17322
666,2019-11-03,119,36101,1670,1,37891
666,2019-11-04,231,12925,1613,1,14770
666,2019-11-05,194,1186,2111,2,3493
666,2019-11-06,281,7480,1559,0,9320
666,2019-11-07,353,13336,1024,3,14716
666,2019-11-08,734,8822,1638,1,11195
666,2019-11-09,746,7894,1917,0,10557
666,2019-11-10,185,12643,2263,1,15092
666,2019-11-11,160,7795,2161,1,10117
666,2019-11-12,172,9003,3430,0,12605
666,2019-11-13,482,10358,1802,1,12643
666,2019-11-14,247,7898,1885,2,10032
666,2019-11-15,260,4257,2257,1,6775
666,2019-11-16,559,2764,2440,2,5765
666,2019-11-17,839,3826,3428,2,8095
666,2019-11-18,244,3336,2754,2,6336
666,2019-11-19,192,3385,2959,0,6536
666,2019-11-20,787,1398,2372,1,4558
666,2019-11-21,195,5717,1619,0,7531
666,2019-11-22,227,5714,2193,0,8134
666,2019-11-23,165,10288,1834,0,12287
666,2019-11-24,251,11199,1573,0,13023
666,2019-11-25,1122,12079,2121,0,15322
666,2019-11-26,197,11899,2411,0,14507
666,2019-11-27,320,10950,1601,0,12871
666,2019-11-28,585,13804,662,0,15051
666,2019-11-29,138,488,2,0,628
666,2019-08-06,13,27,605,0,645
666,2019-08-07,84,334,338,1,757
666,2019-08-08,124,222,389,1,736
666,2019-08-09,140,181,317,1,639
666,2019-08-10,169,351,306,2,828
666,2019-08-11,205,363,162,0,730
666,2019-08-12,433,4811,265,0,5509
666,2019-08-13,233,4487,166,0,4886
666,2019-08-14,78,519,158,0,755
666,2019-08-15,189,517,126,1,833
666,2019-08-16,221,214,126,0,561
666,2019-08-17,187,1317,553,5,2062
666,2019-08-18,382,525,1037,0,1944
666,2019-08-19,1172,592,1177,1,2942
666,2019-08-20,951,2507,1298,0,4756
666,2019-08-21,187,761,1724,0,2672
666,2019-08-22,160,4689,763,1,5613
666,2019-08-23,294,1016,1131,0,2441
666,2019-08-24,113,14750,2249,1,17113
666,2019-08-25,298,29475,2473,2,32248
666,2019-08-26,455,27633,1192,1,29281
666,2019-08-27,719,6037,1804,2,8562
666,2019-08-28,770,21769,2116,0,24655
666,2019-08-29,2459,13226,1080,0,16765
666,2019-08-30,145,3067,689,0,3901
666,2019-08-31,25,8463,4,0,8492
666,2019-09-01,78,3826,183,0,4087
666,2019-09-02,74,1763,7,1,1845
666,2019-09-03,131,3138,1153,2,4424
666,2019-09-04,218,9950,2407,0,12575
666,2019-09-05,184,6065,1821,0,8070
666,2019-09-06,162,25898,2030,1,28091
666,2019-09-07,197,12879,1829,0,14905
666,2019-09-08,1056,6444,2359,0,9859
666,2019-09-09,1042,8431,1881,0,11354
666,2019-09-10,1084,11795,1860,2,14741
666,2019-09-11,268,10054,1747,3,12072
666,2019-09-12,339,8469,2656,0,11464
666,2019-09-13,176,5600,1653,0,7429
666,2019-09-14,127,7030,2320,1,9478
666,2019-09-15,113,10154,2456,2,12725
666,2019-09-16,132,13570,1782,2,15486
666,2019-09-17,127,9237,1440,0,10804
666,2019-09-18,104,19969,1332,2,21407
666,2019-09-19,239,9858,1890,0,11987
666,2019-09-20,225,12222,1565,1,14013
666,2019-09-21,113,9476,2070,0,11659
666,2019-09-22,1157,15432,926,0,17515
666,2019-09-23,804,12350,1085,4,14243
666,2019-09-24,881,13921,1460,2,16264
666,2019-09-25,1555,8399,720,1,10675
666,2019-09-26,754,8989,1443,4,11190
666,2019-09-27,300,10688,2080,3,13071
666,2019-09-28,179,14697,2241,1,17118
666,2019-09-29,1044,15621,2117,0,18782
666,2019-09-30,962,26738,1717,1,29418
666,2019-10-01,96,26979,1744,3,28822
666,2019-10-02,197,17181,1558,0,18936
666,2019-10-03,1013,13089,1505,1,15608
666,2019-10-04,916,17108,1619,1,19644
666,2019-10-05,1007,23261,823,0,25091
666,2019-10-06,1392,15599,2201,2,19194
666,2019-10-07,131,4603,1833,2,6569
666,2019-10-08,1026,17190,1326,633,20175
666,2019-10-09,207,23404,2652,1,26264
666,2019-10-10,2525,10386,1508,2,14421
666,2019-10-11,733,15321,2041,2,18097
666,2019-10-12,222,8023,1605,1,9851
666,2019-10-13,1024,10898,2118,1,14041
666,2019-10-14,1004,4683,2057,2,7746
666,2019-10-15,136,13568,2098,0,15802
666,2019-10-16,684,23189,864,3,24740
666,2019-10-17,154,11037,1100,1,12292
666,2019-10-18,1045,8045,1421,0,10511
666,2019-10-19,179,4235,1789,3,6206
666,2019-10-20,149,748,2185,0,3082
666,2019-10-21,249,9544,1098,5,10896
666,2019-10-22,1909,4662,1743,1,8315
666,2019-10-23,141,13030,1465,1,14637
666,2019-10-24,134,18852,1780,0,20766
666,2019-10-25,243,10610,2197,1,13051
666,2019-10-26,1219,12689,1788,0,15696
666,2019-10-27,214,16292,1531,2,18039
666,2019-10-28,121,13034,1924,1,15080
666,2019-10-29,849,26890,1140,0,28879
666,2019-10-30,171,19953,1837,2,21963
666,2019-10-31,106,11289,1850,2,13247
666,2019-11-01,474,24901,1279,0,26654
666,2019-11-02,432,15774,1115,1,17322
666,2019-11-03,119,36101,1670,1,37891
666,2019-11-04,231,12925,1613,1,14770
666,2019-11-05,194,1186,2111,2,3493
666,2019-11-06,281,7480,1559,0,9320
666,2019-11-07,353,13336,1024,3,14716
666,2019-11-08,734,8822,1638,1,11195
666,2019-11-09,746,7894,1917,0,10557
666,2019-11-10,185,12643,2263,1,15092
666,2019-11-11,160,7795,2161,1,10117
666,2019-11-12,172,9003,3430,0,12605
666,2019-11-13,482,10358,1802,1,12643
666,2019-11-14,247,7898,1885,2,10032
666,2019-11-15,260,4257,2257,1,6775
666,2019-11-16,559,2764,2440,2,5765
666,2019-11-17,839,3826,3428,2,8095
666,2019-11-18,244,3336,2754,2,6336
666,2019-11-19,192,3385,2959,0,6536
666,2019-11-20,787,1398,2372,1,4558
666,2019-11-21,195,5717,1619,0,7531
666,2019-11-22,227,5714,2193,0,8134
666,2019-11-23,165,10288,1834,0,12287
666,2019-11-24,251,11199,1573,0,13023
666,2019-11-25,1122,12079,2121,0,15322
666,2019-11-26,197,11899,2411,0,14507
666,2019-11-27,320,10950,1601,0,12871
666,2019-11-28,585,13804,662,0,15051
666,2019-11-29,138,488,2,0,628
666,2019-08-06,13,27,605,0,645
666,2019-08-07,84,334,338,1,757
666,2019-08-08,124,222,389,1,736
666,2019-08-09,140,181,317,1,639
666,2019-08-10,169,351,306,2,828
666,2019-08-11,205,363,162,0,730
666,2019-08-12,433,4811,265,0,5509
666,2019-08-13,233,4487,166,0,4886
666,2019-08-14,78,519,158,0,755
666,2019-08-15,189,517,126,1,833
666,2019-08-16,221,214,126,0,561
666,2019-08-17,187,1317,553,5,2062
666,2019-08-18,382,525,1037,0,1944
666,2019-08-19,1172,592,1177,1,2942
666,2019-08-20,951,2507,1298,0,4756
666,2019-08-21,187,761,1724,0,2672
666,2019-08-22,160,4689,763,1,5613
666,2019-08-23,294,1016,1131,0,2441
666,2019-08-24,113,14750,2249,1,17113
666,2019-08-25,298,29475,2473,2,32248
666,2019-08-26,455,27633,1192,1,29281
666,2019-08-27,719,6037,1804,2,8562
666,2019-08-28,770,21769,2116,0,24655
666,2019-08-29,2459,13226,1080,0,16765
666,2019-08-30,145,3067,689,0,3901
666,2019-08-31,25,8463,4,0,8492
666,2019-09-01,78,3826,183,0,4087
666,2019-09-02,74,1763,7,1,1845
666,2019-09-03,131,3138,1153,2,4424
666,2019-09-04,218,9950,2407,0,12575
666,2019-09-05,184,6065,1821,0,8070
666,2019-09-06,162,25898,2030,1,28091
666,2019-09-07,197,12879,1829,0,14905
666,2019-09-08,1056,6444,2359,0,9859
666,2019-09-09,1042,8431,1881,0,11354
666,2019-09-10,1084,11795,1860,2,14741
666,2019-09-11,268,10054,1747,3,12072
666,2019-09-12,339,8469,2656,0,11464
666,2019-09-13,176,5600,1653,0,7429
666,2019-09-14,127,7030,2320,1,9478
666,2019-09-15,113,10154,2456,2,12725
666,2019-09-16,132,13570,1782,2,15486
666,2019-09-17,127,9237,1440,0,10804
666,2019-09-18,104,19969,1332,2,21407
666,2019-09-19,239,9858,1890,0,11987
666,2019-09-20,225,12222,1565,1,14013
666,2019-09-21,113,9476,2070,0,11659
666,2019-09-22,1157,15432,926,0,17515
666,2019-09-23,804,12350,1085,4,14243
666,2019-09-24,881,13921,1460,2,16264
666,2019-09-25,1555,8399,720,1,10675
666,2019-09-26,754,8989,1443,4,11190
666,2019-09-27,300,10688,2080,3,13071
666,2019-09-28,179,14697,2241,1,17118
666,2019-09-29,1044,15621,2117,0,18782
666,2019-09-30,962,26738,1717,1,29418
666,2019-10-01,96,26979,1744,3,28822
666,2019-10-02,197,17181,1558,0,18936
666,2019-10-03,1013,13089,1505,1,15608
666,2019-10-04,916,17108,1619,1,19644
666,2019-10-05,1007,23261,823,0,25091
666,2019-10-06,1392,15599,2201,2,19194
666,2019-10-07,131,4603,1833,2,6569
666,2019-10-08,1026,17190,1326,633,20175
666,2019-10-09,207,23404,2652,1,26264
666,2019-10-10,2525,10386,1508,2,14421
666,2019-10-11,733,15321,2041,2,18097
666,2019-10-12,222,8023,1605,1,9851
666,2019-10-13,1024,10898,2118,1,14041
666,2019-10-14,1004,4683,2057,2,7746
666,2019-10-15,136,13568,2098,0,15802
666,2019-10-16,684,23189,864,3,24740
666,2019-10-17,154,11037,1100,1,12292
666,2019-10-18,1045,8045,1421,0,10511
666,2019-10-19,179,4235,1789,3,6206
666,2019-10-20,149,748,2185,0,3082
666,2019-10-21,249,9544,1098,5,10896
666,2019-10-22,1909,4662,1743,1,8315
666,2019-10-23,141,13030,1465,1,14637
666,2019-10-24,134,18852,1780,0,20766
666,2019-10-25,243,10610,2197,1,13051
666,2019-10-26,1219,12689,1788,0,15696
666,2019-10-27,214,16292,1531,2,18039
666,2019-10-28,121,13034,1924,1,15080
666,2019-10-29,849,26890,1140,0,28879
666,2019-10-30,171,19953,1837,2,21963
666,2019-10-31,106,11289,1850,2,13247
666,2019-11-01,474,24901,1279,0,26654
666,2019-11-02,432,15774,1115,1,17322
666,2019-11-03,119,36101,1670,1,37891
666,2019-11-04,231,12925,1613,1,14770
666,2019-11-05,194,1186,2111,2,3493
666,2019-11-06,281,7480,1559,0,9320
666,2019-11-07,353,13336,1024,3,14716
666,2019-11-08,734,8822,1638,1,11195
666,2019-11-09,746,7894,1917,0,10557
666,2019-11-10,185,12643,2263,1,15092
666,2019-11-11,160,7795,2161,1,10117
666,2019-11-12,172,9003,3430,0,12605
666,2019-11-13,482,10358,1802,1,12643
666,2019-11-14,247,7898,1885,2,10032
666,2019-11-15,260,4257,2257,1,6775
666,2019-11-16,559,2764,2440,2,5765
666,2019-11-17,839,3826,3428,2,8095
666,2019-11-18,244,3336,2754,2,6336
666,2019-11-19,192,3385,2959,0,6536
666,2019-11-20,787,1398,2372,1,4558
666,2019-11-21,195,5717,1619,0,7531
666,2019-11-22,227,5714,2193,0,8134
666,2019-11-23,165,10288,1834,0,12287
666,2019-11-24,251,11199,1573,0,13023
666,2019-11-25,1122,12079,2121,0,15322
666,2019-11-26,197,11899,2411,0,14507
666,2019-11-27,320,10950,1601,0,12871
666,2019-11-28,585,13804,662,0,15051
666,2019-11-29,138,488,2,0,628
666,2019-08-07,84,334,338,1,757
666,2019-08-08,124,222,389,1,736
666,2019-08-09,140,181,317,1,639
666,2019-08-10,169,351,306,2,828
666,2019-08-11,205,363,162,0,730
666,2019-08-12,433,4811,265,0,5509
666,2019-08-13,233,4487,166,0,4886
666,2019-08-14,78,519,158,0,755
666,2019-08-15,189,517,126,1,833
666,2019-08-16,221,214,126,0,561
666,2019-08-17,187,1317,553,5,2062
666,2019-08-18,382,525,1037,0,1944
666,2019-08-19,1172,592,1177,1,2942
666,2019-08-20,951,2507,1298,0,4756
666,2019-08-21,187,761,1724,0,2672
666,2019-08-22,160,4689,763,1,5613
666,2019-08-23,294,1016,1131,0,2441
666,2019-08-24,113,14750,2249,1,17113
666,2019-08-25,298,29475,2473,2,32248
666,2019-08-26,455,27633,1192,1,29281
666,2019-08-27,719,6037,1804,2,8562
666,2019-08-28,770,21769,2116,0,24655
666,2019-08-29,2459,13226,1080,0,16765
666,2019-08-30,145,3067,689,0,3901
666,2019-08-31,25,8463,4,0,8492
666,2019-09-01,78,3826,183,0,4087
666,2019-09-02,74,1763,7,1,1845
666,2019-09-03,131,3138,1153,2,4424
666,2019-09-04,218,9950,2407,0,12575
666,2019-09-05,184,6065,1821,0,8070
666,2019-09-06,162,25898,2030,1,28091
666,2019-09-07,197,12879,1829,0,14905
666,2019-09-08,1056,6444,2359,0,9859
666,2019-09-09,1042,8431,1881,0,11354
666,2019-09-10,1084,11795,1860,2,14741
666,2019-09-11,268,10054,1747,3,12072
666,2019-09-12,339,8469,2656,0,11464
666,2019-09-13,176,5600,1653,0,7429
666,2019-09-14,127,7030,2320,1,9478
666,2019-09-15,113,10154,2456,2,12725
666,2019-09-16,132,13570,1782,2,15486
666,2019-09-17,127,9237,1440,0,10804
666,2019-09-18,104,19969,1332,2,21407
666,2019-09-19,239,9858,1890,0,11987
666,2019-09-20,225,12222,1565,1,14013
666,2019-09-21,113,9476,2070,0,11659
666,2019-09-22,1157,15432,926,0,17515
666,2019-09-23,804,12350,1085,4,14243
666,2019-09-24,881,13921,1460,2,16264
666,2019-09-25,1555,8399,720,1,10675
666,2019-09-26,754,8989,1443,4,11190
666,2019-09-27,300,10688,2080,3,13071
666,2019-09-28,179,14697,2241,1,17118
666,2019-09-29,1044,15621,2117,0,18782
666,2019-09-30,962,26738,1717,1,29418
666,2019-10-01,96,26979,1744,3,28822
666,2019-10-02,197,17181,1558,0,18936
666,2019-10-03,1013,13089,1505,1,15608
666,2019-10-04,916,17108,1619,1,19644
666,2019-10-05,1007,23261,823,0,25091
666,2019-10-06,1392,15599,2201,2,19194
666,2019-10-07,131,4603,1833,2,6569
666,2019-10-08,1026,17190,1326,633,20175
666,2019-10-09,207,23404,2652,1,26264
666,2019-10-10,2525,10386,1508,2,14421
666,2019-10-11,733,15321,2041,2,18097
666,2019-10-12,222,8023,1605,1,9851
666,2019-10-13,1024,10898,2118,1,14041
666,2019-10-14,1004,4683,2057,2,7746
666,2019-10-15,136,13568,2098,0,15802
666,2019-10-16,684,23189,864,3,24740
666,2019-10-17,154,11037,1100,1,12292
666,2019-10-18,1045,8045,1421,0,10511
666,2019-10-19,179,4235,1789,3,6206
666,2019-10-20,149,748,2185,0,3082
666,2019-10-21,249,9544,1098,5,10896
666,2019-10-22,1909,4662,1743,1,8315
666,2019-10-23,141,13030,1465,1,14637
666,2019-10-24,134,18852,1780,0,20766
666,2019-10-25,243,10610,2197,1,13051
666,2019-10-26,1219,12689,1788,0,15696
666,2019-10-27,214,16292,1531,2,18039
666,2019-10-28,121,13034,1924,1,15080
666,2019-10-29,849,26890,1140,0,28879
666,2019-10-30,171,19953,1837,2,21963
666,2019-10-31,106,11289,1850,2,13247
666,2019-11-01,474,24901,1279,0,26654
666,2019-11-02,432,15774,1115,1,17322
666,2019-11-03,119,36101,1670,1,37891
666,2019-11-04,231,12925,1613,1,14770
666,2019-11-05,194,1186,2111,2,3493
666,2019-11-06,281,7480,1559,0,9320
666,2019-11-07,353,13336,1024,3,14716
666,2019-11-08,734,8822,1638,1,11195
666,2019-11-09,746,7894,1917,0,10557
666,2019-11-10,185,12643,2263,1,15092
666,2019-11-11,160,7795,2161,1,10117
666,2019-11-12,172,9003,3430,0,12605
666,2019-11-13,482,10358,1802,1,12643
666,2019-11-14,247,7898,1885,2,10032
666,2019-11-15,260,4257,2257,1,6775
666,2019-11-16,559,2764,2440,2,5765
666,2019-11-17,839,3826,3428,2,8095
666,2019-11-18,244,3336,2754,2,6336
666,2019-11-19,192,3385,2959,0,6536
666,2019-11-20,787,1398,2372,1,4558
667,2019-08-06,19,8,142,0,169
667,2019-08-07,538,5968,613,1,7120
667,2019-08-08,586,2835,555,2,3978
667,2019-08-09,206,1171,509,1,1887
667,2019-08-10,142,400,242,0,784
667,2019-08-11,155,303,56,0,514
667,2019-08-12,84,267,277,1,629
667,2019-08-13,91,1091,220,82,1484
667,2019-08-14,513,415,234,0,1162
667,2019-08-15,65,421,48,0,534
667,2019-08-16,50,478,206,1,735
667,2019-08-17,155,1062,467,0,1684
667,2019-08-18,1413,1766,998,1,4178
667,2019-08-19,289,2802,1346,1,4438
667,2019-08-20,403,1539,723,0,2665
667,2019-08-21,131,1022,1229,0,2382
667,2019-08-22,131,1599,1069,0,2799
667,2019-08-23,94,2134,997,3,3228
667,2019-08-24,510,18675,1350,0,20535
667,2019-08-25,646,28987,990,4,30627
667,2019-08-26,1159,28829,1815,0,31803
667,2019-08-27,140,6455,2163,2,8760
667,2019-08-28,724,16352,2073,1,19150
667,2019-08-29,597,12731,2520,2,15850
667,2019-08-30,370,3570,697,1,4638
667,2019-08-31,41,89,1,0,131
667,2019-09-01,84,1294,370,0,1748
667,2019-09-02,52,31,19,0,102
667,2019-09-03,85,702,1436,2,2225
667,2019-09-04,231,13456,2154,1,15842
667,2019-09-05,289,7176,2148,1,9614
667,2019-09-06,1146,13618,1670,1,16435
667,2019-09-07,377,16837,1989,0,19203
667,2019-09-08,2045,8667,2403,0,13115
667,2019-09-09,18029,7637,2003,1,27670
667,2019-09-10,5677,14523,2458,0,22658
667,2019-09-11,904,8117,1998,2,11021
667,2019-09-12,130,8073,2095,0,10298
667,2019-09-13,550,7600,1380,4,9534
667,2019-09-14,209,6279,2763,1,9252
667,2019-09-15,381,10365,1442,2,12190
667,2019-09-16,414,11478,1604,7,13503
667,2019-09-17,308,8832,2251,6,11397
667,2019-09-18,257,27865,1389,8,29519
667,2019-09-19,674,10659,1374,9,12716
667,2019-09-20,2604,11267,1611,10,15492
667,2019-09-21,710,6713,2127,9,9559
667,2019-09-22,83,9553,2229,9,11874
667,2019-09-23,828,8510,1750,11,11099
667,2019-09-24,210,7790,1559,15,9574
667,2019-09-25,3387,7042,1981,11,12421
667,2019-09-26,404,8884,1147,10,10445
667,2019-09-27,787,8825,2366,2,11980
667,2019-09-28,1580,14447,2037,1,18065
667,2019-09-29,1637,17455,1663,4,20759
667,2019-09-30,861,16753,2555,2,20171
667,2019-10-01,1588,20318,1617,1,23524
667,2019-10-02,1321,17813,1760,6,20900
667,2019-10-03,127,21659,1546,11,23343
667,2019-10-04,1026,13263,1239,21,15549
667,2019-10-05,397,13977,1719,13,16106
667,2019-10-06,1587,10013,2014,15,13629
667,2019-10-07,215,4278,2144,11,6648
667,2019-10-08,276,16395,1736,9,18416
667,2019-10-09,1695,15669,1604,13,18981
667,2019-10-10,1340,9645,1957,10,12952
667,2019-10-11,556,8666,1129,9,10360
667,2019-10-12,292,6065,1574,2,7933
667,2019-10-13,985,7398,2065,2,10450
667,2019-10-14,840,7371,1674,1,9886
667,2019-10-15,1262,7221,1182,1,9666
667,2019-10-16,286,17444,1285,1,19016
667,2019-10-17,417,7168,1533,3,9121
667,2019-10-18,395,7186,1260,2,8843
667,2019-10-19,2206,4271,1451,1,7929
667,2019-10-20,532,921,1601,917,3971
667,2019-10-21,893,9368,1022,3,11286
667,2019-10-22,1327,4533,1544,2,7406
667,2019-10-23,2406,6825,1222,1,10454
667,2019-10-24,512,12494,1800,1,14807
667,2019-10-25,455,13608,1542,2,15607
667,2019-10-26,1231,16085,2154,2,19472
667,2019-10-27,1497,27404,1420,0,30321
667,2019-10-28,577,24765,1763,0,27105
667,2019-10-29,470,17012,1208,2,18692
667,2019-10-30,558,15307,1049,0,16914
667,2019-10-31,878,11746,1716,2,14342
667,2019-11-01,1160,14124,1511,0,16795
667,2019-11-02,1546,22712,1292,0,25550
667,2019-11-03,790,37937,1478,4,40209
667,2019-11-04,358,9620,2053,1,12032
667,2019-11-05,620,1252,1484,0,3356
667,2019-11-06,1389,6872,809,2,9072
667,2019-11-07,341,13083,949,1,14374
667,2019-11-08,382,14520,1220,0,16122
667,2019-11-09,1347,14933,1202,1,17483
667,2019-11-10,1061,12208,1969,1,15239
667,2019-11-11,336,7860,1809,1,10006
667,2019-11-12,194,9703,2889,4,12790
667,2019-11-13,142,18519,2388,4,21053
667,2019-11-14,197,9296,2531,1,12025
667,2019-11-15,760,2144,2548,1,5453
667,2019-11-16,1340,1062,2211,0,4613
667,2019-11-17,257,4047,3226,47,7577
667,2019-11-18,891,2025,3112,5,6033
667,2019-11-19,757,2885,2269,19,5930
667,2019-11-20,453,944,2843,0,4240
667,2019-11-21,121,3026,1710,0,4857
667,2019-11-22,749,1886,2033,0,4668
667,2019-11-23,735,8526,2080,0,11341
667,2019-11-24,110,10037,1420,0,11567
667,2019-11-25,900,10146,2211,0,13257
667,2019-11-26,139,7280,1071,0,8490
667,2019-11-27,869,9748,1466,0,12083
667,2019-11-28,703,9025,274,0,10002
667,2019-11-29,51,507,39,0,597
667,2019-08-06,19,8,142,0,169
667,2019-08-07,538,5968,613,1,7120
667,2019-08-08,586,2835,555,2,3978
667,2019-08-09,206,1171,509,1,1887
667,2019-08-10,142,400,242,0,784
667,2019-08-11,155,303,56,0,514
667,2019-08-12,84,267,277,1,629
667,2019-08-13,91,1091,220,82,1484
667,2019-08-14,513,415,234,0,1162
667,2019-08-15,65,421,48,0,534
667,2019-08-16,50,478,206,1,735
667,2019-08-17,155,1062,467,0,1684
667,2019-08-18,1413,1766,998,1,4178
667,2019-08-19,289,2802,1346,1,4438
667,2019-08-20,403,1539,723,0,2665
667,2019-08-21,131,1022,1229,0,2382
667,2019-08-22,131,1599,1069,0,2799
667,2019-08-23,94,2134,997,3,3228
667,2019-08-24,510,18675,1350,0,20535
667,2019-08-25,646,28987,990,4,30627
667,2019-08-26,1159,28829,1815,0,31803
667,2019-08-27,140,6455,2163,2,8760
667,2019-08-28,724,16352,2073,1,19150
667,2019-08-29,597,12731,2520,2,15850
667,2019-08-30,370,3570,697,1,4638
667,2019-08-31,41,89,1,0,131
667,2019-09-01,84,1294,370,0,1748
667,2019-09-02,52,31,19,0,102
667,2019-09-03,85,702,1436,2,2225
667,2019-09-04,231,13456,2154,1,15842
667,2019-09-05,289,7176,2148,1,9614
667,2019-09-06,1146,13618,1670,1,16435
667,2019-09-07,377,16837,1989,0,19203
667,2019-09-08,2045,8667,2403,0,13115
667,2019-09-09,18029,7637,2003,1,27670
667,2019-09-10,5677,14523,2458,0,22658
667,2019-09-11,904,8117,1998,2,11021
667,2019-09-12,130,8073,2095,0,10298
667,2019-09-13,550,7600,1380,4,9534
667,2019-09-14,209,6279,2763,1,9252
667,2019-09-15,381,10365,1442,2,12190
667,2019-09-16,414,11478,1604,7,13503
667,2019-09-17,308,8832,2251,6,11397
667,2019-09-18,257,27865,1389,8,29519
667,2019-09-19,674,10659,1374,9,12716
667,2019-09-20,2604,11267,1611,10,15492
667,2019-09-21,710,6713,2127,9,9559
667,2019-09-22,83,9553,2229,9,11874
667,2019-09-23,828,8510,1750,11,11099
667,2019-09-24,210,7790,1559,15,9574
667,2019-09-25,3387,7042,1981,11,12421
667,2019-09-26,404,8884,1147,10,10445
667,2019-09-27,787,8825,2366,2,11980
667,2019-09-28,1580,14447,2037,1,18065
667,2019-09-29,1637,17455,1663,4,20759
667,2019-09-30,861,16753,2555,2,20171
667,2019-10-01,1588,20318,1617,1,23524
667,2019-10-02,1321,17813,1760,6,20900
667,2019-10-03,127,21659,1546,11,23343
667,2019-10-04,1026,13263,1239,21,15549
667,2019-10-05,397,13977,1719,13,16106
667,2019-10-06,1587,10013,2014,15,13629
667,2019-10-07,215,4278,2144,11,6648
667,2019-10-08,276,16395,1736,9,18416
667,2019-10-09,1695,15669,1604,13,18981
667,2019-10-10,1340,9645,1957,10,12952
667,2019-10-11,556,8666,1129,9,10360
667,2019-10-12,292,6065,1574,2,7933
667,2019-10-13,985,7398,2065,2,10450
667,2019-10-14,840,7371,1674,1,9886
667,2019-10-15,1262,7221,1182,1,9666
667,2019-10-16,286,17444,1285,1,19016
667,2019-10-17,417,7168,1533,3,9121
667,2019-10-18,395,7186,1260,2,8843
667,2019-10-19,2206,4271,1451,1,7929
667,2019-10-20,532,921,1601,917,3971
667,2019-10-21,893,9368,1022,3,11286
667,2019-10-22,1327,4533,1544,2,7406
667,2019-10-23,2406,6825,1222,1,10454
667,2019-10-24,512,12494,1800,1,14807
667,2019-10-25,455,13608,1542,2,15607
667,2019-10-26,1231,16085,2154,2,19472
667,2019-10-27,1497,27404,1420,0,30321
667,2019-10-28,577,24765,1763,0,27105
667,2019-10-29,470,17012,1208,2,18692
667,2019-10-30,558,15307,1049,0,16914
667,2019-10-31,878,11746,1716,2,14342
667,2019-11-01,1160,14124,1511,0,16795
667,2019-11-02,1546,22712,1292,0,25550
667,2019-11-03,790,37937,1478,4,40209
667,2019-11-04,358,9620,2053,1,12032
667,2019-11-05,620,1252,1484,0,3356
667,2019-11-06,1389,6872,809,2,9072
667,2019-11-07,341,13083,949,1,14374
667,2019-11-08,382,14520,1220,0,16122
667,2019-11-09,1347,14933,1202,1,17483
667,2019-11-10,1061,12208,1969,1,15239
667,2019-11-11,336,7860,1809,1,10006
667,2019-11-12,194,9703,2889,4,12790
667,2019-11-13,142,18519,2388,4,21053
667,2019-11-14,197,9296,2531,1,12025
667,2019-11-15,760,2144,2548,1,5453
667,2019-11-16,1340,1062,2211,0,4613
667,2019-11-17,257,4047,3226,47,7577
667,2019-11-18,891,2025,3112,5,6033
667,2019-11-19,757,2885,2269,19,5930
667,2019-11-20,453,944,2843,0,4240
667,2019-11-21,121,3026,1710,0,4857
667,2019-11-22,749,1886,2033,0,4668
667,2019-11-23,735,8526,2080,0,11341
667,2019-11-24,110,10037,1420,0,11567
667,2019-11-25,900,10146,2211,0,13257
667,2019-11-26,139,7280,1071,0,8490
667,2019-11-27,869,9748,1466,0,12083
667,2019-11-28,703,9025,274,0,10002
667,2019-11-29,51,507,39,0,597
667,2019-08-06,19,8,142,0,169
667,2019-08-07,538,5968,613,1,7120
667,2019-08-08,586,2835,555,2,3978
667,2019-08-09,206,1171,509,1,1887
667,2019-08-10,142,400,242,0,784
667,2019-08-11,155,303,56,0,514
667,2019-08-12,84,267,277,1,629
667,2019-08-13,91,1091,220,82,1484
667,2019-08-14,513,415,234,0,1162
667,2019-08-15,65,421,48,0,534
667,2019-08-16,50,478,206,1,735
667,2019-08-17,155,1062,467,0,1684
667,2019-08-18,1413,1766,998,1,4178
667,2019-08-19,289,2802,1346,1,4438
667,2019-08-20,403,1539,723,0,2665
667,2019-08-21,131,1022,1229,0,2382
667,2019-08-22,131,1599,1069,0,2799
667,2019-08-23,94,2134,997,3,3228
667,2019-08-24,510,18675,1350,0,20535
667,2019-08-25,646,28987,990,4,30627
667,2019-08-26,1159,28829,1815,0,31803
667,2019-08-27,140,6455,2163,2,8760
667,2019-08-28,724,16352,2073,1,19150
667,2019-08-29,597,12731,2520,2,15850
667,2019-08-30,370,3570,697,1,4638
667,2019-08-31,41,89,1,0,131
667,2019-09-01,84,1294,370,0,1748
667,2019-09-02,52,31,19,0,102
667,2019-09-03,85,702,1436,2,2225
667,2019-09-04,231,13456,2154,1,15842
667,2019-09-05,289,7176,2148,1,9614
667,2019-09-06,1146,13618,1670,1,16435
667,2019-09-07,377,16837,1989,0,19203
667,2019-09-08,2045,8667,2403,0,13115
667,2019-09-09,18029,7637,2003,1,27670
667,2019-09-10,5677,14523,2458,0,22658
667,2019-09-11,904,8117,1998,2,11021
667,2019-09-12,130,8073,2095,0,10298
667,2019-09-13,550,7600,1380,4,9534
667,2019-09-14,209,6279,2763,1,9252
667,2019-09-15,381,10365,1442,2,12190
667,2019-09-16,414,11478,1604,7,13503
667,2019-09-17,308,8832,2251,6,11397
667,2019-09-18,257,27865,1389,8,29519
667,2019-09-19,674,10659,1374,9,12716
667,2019-09-20,2604,11267,1611,10,15492
667,2019-09-21,710,6713,2127,9,9559
667,2019-09-22,83,9553,2229,9,11874
667,2019-09-23,828,8510,1750,11,11099
667,2019-09-24,210,7790,1559,15,9574
667,2019-09-25,3387,7042,1981,11,12421
667,2019-09-26,404,8884,1147,10,10445
667,2019-09-27,787,8825,2366,2,11980
667,2019-09-28,1580,14447,2037,1,18065
667,2019-09-29,1637,17455,1663,4,20759
667,2019-09-30,861,16753,2555,2,20171
667,2019-10-01,1588,20318,1617,1,23524
667,2019-10-02,1321,17813,1760,6,20900
667,2019-10-03,127,21659,1546,11,23343
667,2019-10-04,1026,13263,1239,21,15549
667,2019-10-05,397,13977,1719,13,16106
667,2019-10-06,1587,10013,2014,15,13629
667,2019-10-07,215,4278,2144,11,6648
667,2019-10-08,276,16395,1736,9,18416
667,2019-10-09,1695,15669,1604,13,18981
667,2019-10-10,1340,9645,1957,10,12952
667,2019-10-11,556,8666,1129,9,10360
667,2019-10-12,292,6065,1574,2,7933
667,2019-10-13,985,7398,2065,2,10450
667,2019-10-14,840,7371,1674,1,9886
667,2019-10-15,1262,7221,1182,1,9666
667,2019-10-16,286,17444,1285,1,19016
667,2019-10-17,417,7168,1533,3,9121
667,2019-10-18,395,7186,1260,2,8843
667,2019-10-19,2206,4271,1451,1,7929
667,2019-10-20,532,921,1601,917,3971
667,2019-10-21,893,9368,1022,3,11286
667,2019-10-22,1327,4533,1544,2,7406
667,2019-10-23,2406,6825,1222,1,10454
667,2019-10-24,512,12494,1800,1,14807
667,2019-10-25,455,13608,1542,2,15607
667,2019-10-26,1231,16085,2154,2,19472
667,2019-10-27,1497,27404,1420,0,30321
667,2019-10-28,577,24765,1763,0,27105
667,2019-10-29,470,17012,1208,2,18692
667,2019-10-30,558,15307,1049,0,16914
667,2019-10-31,878,11746,1716,2,14342
667,2019-11-01,1160,14124,1511,0,16795
667,2019-11-02,1546,22712,1292,0,25550
667,2019-11-03,790,37937,1478,4,40209
667,2019-11-04,358,9620,2053,1,12032
667,2019-11-05,620,1252,1484,0,3356
667,2019-11-06,1389,6872,809,2,9072
667,2019-11-07,341,13083,949,1,14374
667,2019-11-08,382,14520,1220,0,16122
667,2019-11-09,1347,14933,1202,1,17483
667,2019-11-10,1061,12208,1969,1,15239
667,2019-11-11,336,7860,1809,1,10006
667,2019-11-12,194,9703,2889,4,12790
667,2019-11-13,142,18519,2388,4,21053
667,2019-11-14,197,9296,2531,1,12025
667,2019-11-15,760,2144,2548,1,5453
667,2019-11-16,1340,1062,2211,0,4613
667,2019-11-17,257,4047,3226,47,7577
667,2019-11-18,891,2025,3112,5,6033
667,2019-11-19,757,2885,2269,19,5930
667,2019-11-20,453,944,2843,0,4240
667,2019-11-21,121,3026,1710,0,4857
667,2019-11-22,749,1886,2033,0,4668
667,2019-11-23,735,8526,2080,0,11341
667,2019-11-24,110,10037,1420,0,11567
667,2019-11-25,900,10146,2211,0,13257
667,2019-11-26,139,7280,1071,0,8490
667,2019-11-27,869,9748,1466,0,12083
667,2019-11-28,703,9025,274,0,10002
667,2019-11-29,51,507,39,0,597
667,2019-08-07,538,5968,613,1,7120
667,2019-08-08,586,2835,555,2,3978
667,2019-08-09,206,1171,509,1,1887
667,2019-08-10,142,400,242,0,784
667,2019-08-11,155,303,56,0,514
667,2019-08-12,84,267,277,1,629
667,2019-08-13,91,1091,220,82,1484
667,2019-08-14,513,415,234,0,1162
667,2019-08-15,65,421,48,0,534
667,2019-08-16,50,478,206,1,735
667,2019-08-17,155,1062,467,0,1684
667,2019-08-18,1413,1766,998,1,4178
667,2019-08-19,289,2802,1346,1,4438
667,2019-08-20,403,1539,723,0,2665
667,2019-08-21,131,1022,1229,0,2382
667,2019-08-22,131,1599,1069,0,2799
667,2019-08-23,94,2134,997,3,3228
667,2019-08-24,510,18675,1350,0,20535
667,2019-08-25,646,28987,990,4,30627
667,2019-08-26,1159,28829,1815,0,31803
667,2019-08-27,140,6455,2163,2,8760
667,2019-08-28,724,16352,2073,1,19150
667,2019-08-29,597,12731,2520,2,15850
667,2019-08-30,370,3570,697,1,4638
667,2019-08-31,41,89,1,0,131
667,2019-09-01,84,1294,370,0,1748
667,2019-09-02,52,31,19,0,102
667,2019-09-03,85,702,1436,2,2225
667,2019-09-04,231,13456,2154,1,15842
667,2019-09-05,289,7176,2148,1,9614
667,2019-09-06,1146,13618,1670,1,16435
667,2019-09-07,377,16837,1989,0,19203
667,2019-09-08,2045,8667,2403,0,13115
667,2019-09-09,18029,7637,2003,1,27670
667,2019-09-10,5677,14523,2458,0,22658
667,2019-09-11,904,8117,1998,2,11021
667,2019-09-12,130,8073,2095,0,10298
667,2019-09-13,550,7600,1380,4,9534
667,2019-09-14,209,6279,2763,1,9252
667,2019-09-15,381,10365,1442,2,12190
667,2019-09-16,414,11478,1604,7,13503
667,2019-09-17,308,8832,2251,6,11397
667,2019-09-18,257,27865,1389,8,29519
667,2019-09-19,674,10659,1374,9,12716
667,2019-09-20,2604,11267,1611,10,15492
667,2019-09-21,710,6713,2127,9,9559
667,2019-09-22,83,9553,2229,9,11874
667,2019-09-23,828,8510,1750,11,11099
667,2019-09-24,210,7790,1559,15,9574
667,2019-09-25,3387,7042,1981,11,12421
667,2019-09-26,404,8884,1147,10,10445
667,2019-09-27,787,8825,2366,2,11980
667,2019-09-28,1580,14447,2037,1,18065
667,2019-09-29,1637,17455,1663,4,20759
667,2019-09-30,861,16753,2555,2,20171
667,2019-10-01,1588,20318,1617,1,23524
667,2019-10-02,1321,17813,1760,6,20900
667,2019-10-03,127,21659,1546,11,23343
667,2019-10-04,1026,13263,1239,21,15549
667,2019-10-05,397,13977,1719,13,16106
667,2019-10-06,1587,10013,2014,15,13629
667,2019-10-07,215,4278,2144,11,6648
667,2019-10-08,276,16395,1736,9,18416
667,2019-10-09,1695,15669,1604,13,18981
667,2019-10-10,1340,9645,1957,10,12952
667,2019-10-11,556,8666,1129,9,10360
667,2019-10-12,292,6065,1574,2,7933
667,2019-10-13,985,7398,2065,2,10450
667,2019-10-14,840,7371,1674,1,9886
667,2019-10-15,1262,7221,1182,1,9666
667,2019-10-16,286,17444,1285,1,19016
667,2019-10-17,417,7168,1533,3,9121
667,2019-10-18,395,7186,1260,2,8843
667,2019-10-19,2206,4271,1451,1,7929
667,2019-10-20,532,921,1601,917,3971
667,2019-10-21,893,9368,1022,3,11286
667,2019-10-22,1327,4533,1544,2,7406
667,2019-10-23,2406,6825,1222,1,10454
667,2019-10-24,512,12494,1800,1,14807
667,2019-10-25,455,13608,1542,2,15607
667,2019-10-26,1231,16085,2154,2,19472
667,2019-10-27,1497,27404,1420,0,30321
667,2019-10-28,577,24765,1763,0,27105
667,2019-10-29,470,17012,1208,2,18692
667,2019-10-30,558,15307,1049,0,16914
667,2019-10-31,878,11746,1716,2,14342
667,2019-11-01,1160,14124,1511,0,16795
667,2019-11-02,1546,22712,1292,0,25550
667,2019-11-03,790,37937,1478,4,40209
667,2019-11-04,358,9620,2053,1,12032
667,2019-11-05,620,1252,1484,0,3356
667,2019-11-06,1389,6872,809,2,9072
667,2019-11-07,341,13083,949,1,14374
667,2019-11-08,382,14520,1220,0,16122
667,2019-11-09,1347,14933,1202,1,17483
667,2019-11-10,1061,12208,1969,1,15239
667,2019-11-11,336,7860,1809,1,10006
667,2019-11-12,194,9703,2889,4,12790
667,2019-11-13,142,18519,2388,4,21053
667,2019-11-14,197,9296,2531,1,12025
667,2019-11-15,760,2144,2548,1,5453
667,2019-11-16,1340,1062,2211,0,4613
667,2019-11-17,257,4047,3226,47,7577
667,2019-11-18,891,2025,3112,5,6033
667,2019-11-19,757,2885,2269,19,5930
668,2019-08-06,14,9,141,0,164
668,2019-08-07,93,855,335,2,1285
668,2019-08-08,107,433,475,2,1017
668,2019-08-09,305,209,794,1,1309
668,2019-08-10,115,387,225,0,727
668,2019-08-11,265,395,281,0,941
668,2019-08-12,84,338,158,2,582
668,2019-08-13,53,496,46,1,596
668,2019-08-14,209,279,133,1,622
668,2019-08-15,199,465,35,0,699
668,2019-08-16,58,612,21,0,691
668,2019-08-17,81,1562,812,0,2455
668,2019-08-18,81,2005,1137,1,3224
668,2019-08-19,57,2159,1212,1,3429
668,2019-08-20,144,2402,1127,3,3676
668,2019-08-21,88,799,1220,0,2107
668,2019-08-22,127,14667,1341,1,16136
668,2019-08-23,97,12926,1370,0,14393
668,2019-08-24,94,4848,1703,1,6646
668,2019-08-25,121,44222,1965,2,46310
668,2019-08-26,117,32184,1621,1,33923
668,2019-08-27,130,6087,2071,1,8289
668,2019-08-28,104,13142,1440,0,14686
668,2019-08-29,993,12293,1669,1,14956
668,2019-08-30,70,2802,301,1,3174
668,2019-08-31,17,11515,4,0,11536
668,2019-09-01,41,3079,175,2,3297
668,2019-09-02,27,858,0,0,885
668,2019-09-03,75,3406,1790,1,5272
668,2019-09-04,957,10469,2109,0,13535
668,2019-09-05,137,12139,2555,1,14832
668,2019-09-06,923,22717,2541,0,26181
668,2019-09-07,1027,11389,1576,0,13992
668,2019-09-08,180,7524,2657,0,10361
668,2019-09-09,1043,6533,2486,2,10064
668,2019-09-10,69,11910,2434,0,14413
668,2019-09-11,1245,5948,1647,2,8842
668,2019-09-12,1020,7420,1749,1,10190
668,2019-09-13,55,3064,1512,2,4633
668,2019-09-14,74,9321,2467,0,11862
668,2019-09-15,917,9544,2245,2,12708
668,2019-09-16,99,17098,2241,1,19439
668,2019-09-17,94,7905,1867,2,9868
668,2019-09-18,76,11811,1450,2,13339
668,2019-09-19,213,3904,2502,0,6619
668,2019-09-20,306,15134,1833,4,17277
668,2019-09-21,84,8386,1669,0,10139
668,2019-09-22,85,14420,1109,0,15614
668,2019-09-23,183,12186,1920,2,14291
668,2019-09-24,596,10961,1874,2,13433
668,2019-09-25,173,6728,1197,0,8098
668,2019-09-26,133,10811,1777,2,12723
668,2019-09-27,88,9825,1886,5,11804
668,2019-09-28,105,24709,2189,1,27004
668,2019-09-29,104,28084,2063,2,30253
668,2019-09-30,960,19449,1967,2,22378
668,2019-10-01,83,15429,1296,2,16810
668,2019-10-02,845,12130,1581,1,14557
668,2019-10-03,732,21785,1354,1,23872
668,2019-10-04,525,32416,1021,1,33963
668,2019-10-05,946,41609,1193,3,43751
668,2019-10-06,926,18780,2488,0,22194
668,2019-10-07,963,4053,1623,4,6643
668,2019-10-08,861,17276,1066,1,19204
668,2019-10-09,119,22277,1887,2,24285
668,2019-10-10,1025,11231,2440,0,14696
668,2019-10-11,971,11939,2379,1,15290
668,2019-10-12,958,33754,1790,4,36506
668,2019-10-13,61,14184,1910,1,16156
668,2019-10-14,473,4828,1679,1,6981
668,2019-10-15,959,7202,1539,1,9701
668,2019-10-16,311,23156,1548,1,25016
668,2019-10-17,75,10914,2307,4,13300
668,2019-10-18,81,7542,1680,0,9303
668,2019-10-19,97,4198,1237,0,5532
668,2019-10-20,1565,639,2030,0,4234
668,2019-10-21,183,9153,2008,0,11344
668,2019-10-22,72,13101,2329,41,15543
668,2019-10-23,728,14046,1185,655,16614
668,2019-10-24,447,12860,1336,3,14646
668,2019-10-25,109,10342,1439,4,11894
668,2019-10-26,108,20995,1752,1,22856
668,2019-10-27,86,18269,1775,2,20132
668,2019-10-28,164,13284,1791,1,15240
668,2019-10-29,118,14811,1227,1,16157
668,2019-10-30,153,15103,1436,0,16692
668,2019-10-31,602,11248,1700,1,13551
668,2019-11-01,392,24910,1270,2,26574
668,2019-11-02,75,25538,980,1,26594
668,2019-11-03,62,38666,1149,0,39877
668,2019-11-04,543,11896,1116,0,13555
668,2019-11-05,1652,2725,2301,0,6678
668,2019-11-06,107,13367,1952,1,15427
668,2019-11-07,182,16013,1955,0,18150
668,2019-11-08,172,14237,1621,0,16030
668,2019-11-09,501,10417,1379,0,12297
668,2019-11-10,1330,22133,2202,0,25665
668,2019-11-11,89,14635,2016,0,16740
668,2019-11-12,86,16739,4213,0,21038
668,2019-11-13,255,20293,1851,0,22399
668,2019-11-14,128,9432,2103,0,11663
668,2019-11-15,1913,2037,1848,0,5798
668,2019-11-16,69,866,2228,0,3163
668,2019-11-17,1017,2563,3990,0,7570
668,2019-11-18,576,2003,3594,0,6173
668,2019-11-19,117,4707,2570,0,7394
668,2019-11-20,1006,931,1700,0,3637
668,2019-11-21,127,5155,2059,0,7341
668,2019-11-22,102,8257,2186,0,10545
668,2019-11-23,76,6659,2085,0,8820
668,2019-11-24,2053,7090,1454,1,10598
668,2019-11-25,2197,5821,1557,0,9575
668,2019-11-26,57,4896,1812,2,6767
668,2019-11-27,167,5295,2001,3,7466
668,2019-11-28,77,7857,398,0,8332
668,2019-11-29,22,322,2,0,346
668,2019-08-06,14,9,141,0,164
668,2019-08-07,93,855,335,2,1285
668,2019-08-08,107,433,475,2,1017
668,2019-08-09,305,209,794,1,1309
668,2019-08-10,115,387,225,0,727
668,2019-08-11,265,395,281,0,941
668,2019-08-12,84,338,158,2,582
668,2019-08-13,53,496,46,1,596
668,2019-08-14,209,279,133,1,622
668,2019-08-15,199,465,35,0,699
668,2019-08-16,58,612,21,0,691
668,2019-08-17,81,1562,812,0,2455
668,2019-08-18,81,2005,1137,1,3224
668,2019-08-19,57,2159,1212,1,3429
668,2019-08-20,144,2402,1127,3,3676
668,2019-08-21,88,799,1220,0,2107
668,2019-08-22,127,14667,1341,1,16136
668,2019-08-23,97,12926,1370,0,14393
668,2019-08-24,94,4848,1703,1,6646
668,2019-08-25,121,44222,1965,2,46310
668,2019-08-26,117,32184,1621,1,33923
668,2019-08-27,130,6087,2071,1,8289
668,2019-08-28,104,13142,1440,0,14686
668,2019-08-29,993,12293,1669,1,14956
668,2019-08-30,70,2802,301,1,3174
668,2019-08-31,17,11515,4,0,11536
668,2019-09-01,41,3079,175,2,3297
668,2019-09-02,27,858,0,0,885
668,2019-09-03,75,3406,1790,1,5272
668,2019-09-04,957,10469,2109,0,13535
668,2019-09-05,137,12139,2555,1,14832
668,2019-09-06,923,22717,2541,0,26181
668,2019-09-07,1027,11389,1576,0,13992
668,2019-09-08,180,7524,2657,0,10361
668,2019-09-09,1043,6533,2486,2,10064
668,2019-09-10,69,11910,2434,0,14413
668,2019-09-11,1245,5948,1647,2,8842
668,2019-09-12,1020,7420,1749,1,10190
668,2019-09-13,55,3064,1512,2,4633
668,2019-09-14,74,9321,2467,0,11862
668,2019-09-15,917,9544,2245,2,12708
668,2019-09-16,99,17098,2241,1,19439
668,2019-09-17,94,7905,1867,2,9868
668,2019-09-18,76,11811,1450,2,13339
668,2019-09-19,213,3904,2502,0,6619
668,2019-09-20,306,15134,1833,4,17277
668,2019-09-21,84,8386,1669,0,10139
668,2019-09-22,85,14420,1109,0,15614
668,2019-09-23,183,12186,1920,2,14291
668,2019-09-24,596,10961,1874,2,13433
668,2019-09-25,173,6728,1197,0,8098
668,2019-09-26,133,10811,1777,2,12723
668,2019-09-27,88,9825,1886,5,11804
668,2019-09-28,105,24709,2189,1,27004
668,2019-09-29,104,28084,2063,2,30253
668,2019-09-30,960,19449,1967,2,22378
668,2019-10-01,83,15429,1296,2,16810
668,2019-10-02,845,12130,1581,1,14557
668,2019-10-03,732,21785,1354,1,23872
668,2019-10-04,525,32416,1021,1,33963
668,2019-10-05,946,41609,1193,3,43751
668,2019-10-06,926,18780,2488,0,22194
668,2019-10-07,963,4053,1623,4,6643
668,2019-10-08,861,17276,1066,1,19204
668,2019-10-09,119,22277,1887,2,24285
668,2019-10-10,1025,11231,2440,0,14696
668,2019-10-11,971,11939,2379,1,15290
668,2019-10-12,958,33754,1790,4,36506
668,2019-10-13,61,14184,1910,1,16156
668,2019-10-14,473,4828,1679,1,6981
668,2019-10-15,959,7202,1539,1,9701
668,2019-10-16,311,23156,1548,1,25016
668,2019-10-17,75,10914,2307,4,13300
668,2019-10-18,81,7542,1680,0,9303
668,2019-10-19,97,4198,1237,0,5532
668,2019-10-20,1565,639,2030,0,4234
668,2019-10-21,183,9153,2008,0,11344
668,2019-10-22,72,13101,2329,41,15543
668,2019-10-23,728,14046,1185,655,16614
668,2019-10-24,447,12860,1336,3,14646
668,2019-10-25,109,10342,1439,4,11894
668,2019-10-26,108,20995,1752,1,22856
668,2019-10-27,86,18269,1775,2,20132
668,2019-10-28,164,13284,1791,1,15240
668,2019-10-29,118,14811,1227,1,16157
668,2019-10-30,153,15103,1436,0,16692
668,2019-10-31,602,11248,1700,1,13551
668,2019-11-01,392,24910,1270,2,26574
668,2019-11-02,75,25538,980,1,26594
668,2019-11-03,62,38666,1149,0,39877
668,2019-11-04,543,11896,1116,0,13555
668,2019-11-05,1652,2725,2301,0,6678
668,2019-11-06,107,13367,1952,1,15427
668,2019-11-07,182,16013,1955,0,18150
668,2019-11-08,172,14237,1621,0,16030
668,2019-11-09,501,10417,1379,0,12297
668,2019-11-10,1330,22133,2202,0,25665
668,2019-11-11,89,14635,2016,0,16740
668,2019-11-12,86,16739,4213,0,21038
668,2019-11-13,255,20293,1851,0,22399
668,2019-11-14,128,9432,2103,0,11663
668,2019-11-15,1913,2037,1848,0,5798
668,2019-11-16,69,866,2228,0,3163
668,2019-11-17,1017,2563,3990,0,7570
668,2019-11-18,576,2003,3594,0,6173
668,2019-11-19,117,4707,2570,0,7394
668,2019-11-20,1006,931,1700,0,3637
668,2019-11-21,127,5155,2059,0,7341
668,2019-11-22,102,8257,2186,0,10545
668,2019-11-23,76,6659,2085,0,8820
668,2019-11-24,2053,7090,1454,1,10598
668,2019-11-25,2197,5821,1557,0,9575
668,2019-11-26,57,4896,1812,2,6767
668,2019-11-27,167,5295,2001,3,7466
668,2019-11-28,77,7857,398,0,8332
668,2019-11-29,22,322,2,0,346
668,2019-08-06,14,9,141,0,164
668,2019-08-07,93,855,335,2,1285
668,2019-08-08,107,433,475,2,1017
668,2019-08-09,305,209,794,1,1309
668,2019-08-10,115,387,225,0,727
668,2019-08-11,265,395,281,0,941
668,2019-08-12,84,338,158,2,582
668,2019-08-13,53,496,46,1,596
668,2019-08-14,209,279,133,1,622
668,2019-08-15,199,465,35,0,699
668,2019-08-16,58,612,21,0,691
668,2019-08-17,81,1562,812,0,2455
668,2019-08-18,81,2005,1137,1,3224
668,2019-08-19,57,2159,1212,1,3429
668,2019-08-20,144,2402,1127,3,3676
668,2019-08-21,88,799,1220,0,2107
668,2019-08-22,127,14667,1341,1,16136
668,2019-08-23,97,12926,1370,0,14393
668,2019-08-24,94,4848,1703,1,6646
668,2019-08-25,121,44222,1965,2,46310
668,2019-08-26,117,32184,1621,1,33923
668,2019-08-27,130,6087,2071,1,8289
668,2019-08-28,104,13142,1440,0,14686
668,2019-08-29,993,12293,1669,1,14956
668,2019-08-30,70,2802,301,1,3174
668,2019-08-31,17,11515,4,0,11536
668,2019-09-01,41,3079,175,2,3297
668,2019-09-02,27,858,0,0,885
668,2019-09-03,75,3406,1790,1,5272
668,2019-09-04,957,10469,2109,0,13535
668,2019-09-05,137,12139,2555,1,14832
668,2019-09-06,923,22717,2541,0,26181
668,2019-09-07,1027,11389,1576,0,13992
668,2019-09-08,180,7524,2657,0,10361
668,2019-09-09,1043,6533,2486,2,10064
668,2019-09-10,69,11910,2434,0,14413
668,2019-09-11,1245,5948,1647,2,8842
668,2019-09-12,1020,7420,1749,1,10190
668,2019-09-13,55,3064,1512,2,4633
668,2019-09-14,74,9321,2467,0,11862
668,2019-09-15,917,9544,2245,2,12708
668,2019-09-16,99,17098,2241,1,19439
668,2019-09-17,94,7905,1867,2,9868
668,2019-09-18,76,11811,1450,2,13339
668,2019-09-19,213,3904,2502,0,6619
668,2019-09-20,306,15134,1833,4,17277
668,2019-09-21,84,8386,1669,0,10139
668,2019-09-22,85,14420,1109,0,15614
668,2019-09-23,183,12186,1920,2,14291
668,2019-09-24,596,10961,1874,2,13433
668,2019-09-25,173,6728,1197,0,8098
668,2019-09-26,133,10811,1777,2,12723
668,2019-09-27,88,9825,1886,5,11804
668,2019-09-28,105,24709,2189,1,27004
668,2019-09-29,104,28084,2063,2,30253
668,2019-09-30,960,19449,1967,2,22378
668,2019-10-01,83,15429,1296,2,16810
668,2019-10-02,845,12130,1581,1,14557
668,2019-10-03,732,21785,1354,1,23872
668,2019-10-04,525,32416,1021,1,33963
668,2019-10-05,946,41609,1193,3,43751
668,2019-10-06,926,18780,2488,0,22194
668,2019-10-07,963,4053,1623,4,6643
668,2019-10-08,861,17276,1066,1,19204
668,2019-10-09,119,22277,1887,2,24285
668,2019-10-10,1025,11231,2440,0,14696
668,2019-10-11,971,11939,2379,1,15290
668,2019-10-12,958,33754,1790,4,36506
668,2019-10-13,61,14184,1910,1,16156
668,2019-10-14,473,4828,1679,1,6981
668,2019-10-15,959,7202,1539,1,9701
668,2019-10-16,311,23156,1548,1,25016
668,2019-10-17,75,10914,2307,4,13300
668,2019-10-18,81,7542,1680,0,9303
668,2019-10-19,97,4198,1237,0,5532
668,2019-10-20,1565,639,2030,0,4234
668,2019-10-21,183,9153,2008,0,11344
668,2019-10-22,72,13101,2329,41,15543
668,2019-10-23,728,14046,1185,655,16614
668,2019-10-24,447,12860,1336,3,14646
668,2019-10-25,109,10342,1439,4,11894
668,2019-10-26,108,20995,1752,1,22856
668,2019-10-27,86,18269,1775,2,20132
668,2019-10-28,164,13284,1791,1,15240
668,2019-10-29,118,14811,1227,1,16157
668,2019-10-30,153,15103,1436,0,16692
668,2019-10-31,602,11248,1700,1,13551
668,2019-11-01,392,24910,1270,2,26574
668,2019-11-02,75,25538,980,1,26594
668,2019-11-03,62,38666,1149,0,39877
668,2019-11-04,543,11896,1116,0,13555
668,2019-11-05,1652,2725,2301,0,6678
668,2019-11-06,107,13367,1952,1,15427
668,2019-11-07,182,16013,1955,0,18150
668,2019-11-08,172,14237,1621,0,16030
668,2019-11-09,501,10417,1379,0,12297
668,2019-11-10,1330,22133,2202,0,25665
668,2019-11-11,89,14635,2016,0,16740
668,2019-11-12,86,16739,4213,0,21038
668,2019-11-13,255,20293,1851,0,22399
668,2019-11-14,128,9432,2103,0,11663
668,2019-11-15,1913,2037,1848,0,5798
668,2019-11-16,69,866,2228,0,3163
668,2019-11-17,1017,2563,3990,0,7570
668,2019-11-18,576,2003,3594,0,6173
668,2019-11-19,117,4707,2570,0,7394
668,2019-11-20,1006,931,1700,0,3637
668,2019-11-21,127,5155,2059,0,7341
668,2019-11-22,102,8257,2186,0,10545
668,2019-11-23,76,6659,2085,0,8820
668,2019-11-24,2053,7090,1454,1,10598
668,2019-11-25,2197,5821,1557,0,9575
668,2019-11-26,57,4896,1812,2,6767
668,2019-11-27,167,5295,2001,3,7466
668,2019-11-28,77,7857,398,0,8332
668,2019-11-29,22,322,2,0,346
668,2019-08-07,93,855,335,2,1285
668,2019-08-08,107,433,475,2,1017
668,2019-08-09,305,209,794,1,1309
668,2019-08-10,115,387,225,0,727
668,2019-08-11,265,395,281,0,941
668,2019-08-12,84,338,158,2,582
668,2019-08-13,53,496,46,1,596
668,2019-08-14,209,279,133,1,622
668,2019-08-15,199,465,35,0,699
668,2019-08-16,58,612,21,0,691
668,2019-08-17,81,1562,812,0,2455
668,2019-08-18,81,2005,1137,1,3224
668,2019-08-19,57,2159,1212,1,3429
668,2019-08-20,144,2402,1127,3,3676
668,2019-08-21,88,799,1220,0,2107
668,2019-08-22,127,14667,1341,1,16136
668,2019-08-23,97,12926,1370,0,14393
668,2019-08-24,94,4848,1703,1,6646
668,2019-08-25,121,44222,1965,2,46310
668,2019-08-26,117,32184,1621,1,33923
668,2019-08-27,130,6087,2071,1,8289
668,2019-08-28,104,13142,1440,0,14686
668,2019-08-29,993,12293,1669,1,14956
668,2019-08-30,70,2802,301,1,3174
668,2019-08-31,17,11515,4,0,11536
668,2019-09-01,41,3079,175,2,3297
668,2019-09-02,27,858,0,0,885
668,2019-09-03,75,3406,1790,1,5272
668,2019-09-04,957,10469,2109,0,13535
668,2019-09-05,137,12139,2555,1,14832
668,2019-09-06,923,22717,2541,0,26181
668,2019-09-07,1027,11389,1576,0,13992
668,2019-09-08,180,7524,2657,0,10361
668,2019-09-09,1043,6533,2486,2,10064
668,2019-09-10,69,11910,2434,0,14413
668,2019-09-11,1245,5948,1647,2,8842
668,2019-09-12,1020,7420,1749,1,10190
668,2019-09-13,55,3064,1512,2,4633
668,2019-09-14,74,9321,2467,0,11862
668,2019-09-15,917,9544,2245,2,12708
668,2019-09-16,99,17098,2241,1,19439
668,2019-09-17,94,7905,1867,2,9868
668,2019-09-18,76,11811,1450,2,13339
668,2019-09-19,213,3904,2502,0,6619
668,2019-09-20,306,15134,1833,4,17277
668,2019-09-21,84,8386,1669,0,10139
668,2019-09-22,85,14420,1109,0,15614
668,2019-09-23,183,12186,1920,2,14291
668,2019-09-24,596,10961,1874,2,13433
668,2019-09-25,173,6728,1197,0,8098
668,2019-09-26,133,10811,1777,2,12723
668,2019-09-27,88,9825,1886,5,11804
668,2019-09-28,105,24709,2189,1,27004
668,2019-09-29,104,28084,2063,2,30253
668,2019-09-30,960,19449,1967,2,22378
668,2019-10-01,83,15429,1296,2,16810
668,2019-10-02,845,12130,1581,1,14557
668,2019-10-03,732,21785,1354,1,23872
668,2019-10-04,525,32416,1021,1,33963
668,2019-10-05,946,41609,1193,3,43751
668,2019-10-06,926,18780,2488,0,22194
668,2019-10-07,963,4053,1623,4,6643
668,2019-10-08,861,17276,1066,1,19204
668,2019-10-09,119,22277,1887,2,24285
668,2019-10-10,1025,11231,2440,0,14696
668,2019-10-11,971,11939,2379,1,15290
668,2019-10-12,958,33754,1790,4,36506
668,2019-10-13,61,14184,1910,1,16156
668,2019-10-14,473,4828,1679,1,6981
668,2019-10-15,959,7202,1539,1,9701
668,2019-10-16,311,23156,1548,1,25016
668,2019-10-17,75,10914,2307,4,13300
668,2019-10-18,81,7542,1680,0,9303
668,2019-10-19,97,4198,1237,0,5532
668,2019-10-20,1565,639,2030,0,4234
668,2019-10-21,183,9153,2008,0,11344
668,2019-10-22,72,13101,2329,41,15543
668,2019-10-23,728,14046,1185,655,16614
668,2019-10-24,447,12860,1336,3,14646
668,2019-10-25,109,10342,1439,4,11894
668,2019-10-26,108,20995,1752,1,22856
668,2019-10-27,86,18269,1775,2,20132
668,2019-10-28,164,13284,1791,1,15240
668,2019-10-29,118,14811,1227,1,16157
668,2019-10-30,153,15103,1436,0,16692
668,2019-10-31,602,11248,1700,1,13551
668,2019-11-01,392,24910,1270,2,26574
668,2019-11-02,75,25538,980,1,26594
668,2019-11-03,62,38666,1149,0,39877
668,2019-11-04,543,11896,1116,0,13555
668,2019-11-05,1652,2725,2301,0,6678
668,2019-11-06,107,13367,1952,1,15427
668,2019-11-07,182,16013,1955,0,18150
668,2019-11-08,172,14237,1621,0,16030
668,2019-11-09,501,10417,1379,0,12297
668,2019-11-10,1330,22133,2202,0,25665
668,2019-11-11,89,14635,2016,0,16740
668,2019-11-12,86,16739,4213,0,21038
668,2019-11-13,255,20293,1851,0,22399
668,2019-11-14,128,9432,2103,0,11663
668,2019-11-15,1913,2037,1848,0,5798
668,2019-11-16,69,866,2228,0,3163
668,2019-11-17,1017,2563,3990,0,7570
668,2019-11-18,576,2003,3594,0,6173
668,2019-11-19,117,4707,2570,0,7394
668,2019-11-20,1006,931,1700,0,3637
668,2019-11-21,127,5155,2059,0,7341
668,2019-11-22,102,8257,2186,0,10545
668,2019-11-23,76,6659,2085,0,8820
668,2019-11-24,2053,7090,1454,1,10598
668,2019-11-25,2197,5821,1557,0,9575
668,2019-11-26,57,4896,1812,2,6767
668,2019-11-27,167,5295,2001,3,7466
669,2019-08-06,27,7,456,1,491
669,2019-08-07,490,816,478,0,1784
669,2019-08-08,238,543,222,0,1003
669,2019-08-09,264,550,777,1,1592
669,2019-08-10,479,328,195,0,1002
669,2019-08-11,245,261,196,1,703
669,2019-08-12,415,4981,22,2,5420
669,2019-08-13,433,4379,38,0,4850
669,2019-08-14,154,687,78,0,919
669,2019-08-15,139,991,50,0,1180
669,2019-08-16,125,211,14,0,350
669,2019-08-17,201,800,483,1,1485
669,2019-08-18,985,721,1257,0,2963
669,2019-08-19,279,2242,1061,1,3583
669,2019-08-20,274,1560,1660,1,3495
669,2019-08-21,214,922,1701,0,2837
669,2019-08-22,347,3644,1459,1,5451
669,2019-08-23,1866,5334,2445,0,9645
669,2019-08-24,401,14644,1354,2,16401
669,2019-08-25,359,25336,1623,5,27323
669,2019-08-26,758,26364,1440,3,28565
669,2019-08-27,269,6504,2357,1,9131
669,2019-08-28,296,29213,1620,1,31130
669,2019-08-29,480,15782,717,2,16981
669,2019-08-30,205,2844,622,1,3672
669,2019-08-31,31,28,5,0,64
669,2019-09-01,59,1332,183,0,1574
669,2019-09-02,34,836,2,0,872
669,2019-09-03,121,3459,1417,1,4998
669,2019-09-04,1124,13923,1865,1,16913
669,2019-09-05,323,11228,1637,1,13189
669,2019-09-06,319,18032,1902,0,20253
669,2019-09-07,387,9339,1989,0,11715
669,2019-09-08,497,30469,1782,0,32748
669,2019-09-09,1167,6785,1587,0,9539
669,2019-09-10,539,13807,1830,0,16176
669,2019-09-11,158,6720,2101,2,8981
669,2019-09-12,204,6292,1815,3,8314
669,2019-09-13,1376,8822,1537,1,11736
669,2019-09-14,1083,7861,1405,0,10349
669,2019-09-15,1095,8015,1938,2,11050
669,2019-09-16,271,14485,1869,0,16625
669,2019-09-17,231,12428,1814,0,14473
669,2019-09-18,343,19747,1751,0,21841
669,2019-09-19,1339,12025,2148,0,15512
669,2019-09-20,1214,10588,1379,0,13181
669,2019-09-21,2086,10333,4118,0,16537
669,2019-09-22,848,9458,1980,1,12287
669,2019-09-23,311,9026,1956,4,11297
669,2019-09-24,1277,9831,1529,3,12640
669,2019-09-25,1090,11329,2320,3,14742
669,2019-09-26,148,11373,1710,0,13231
669,2019-09-27,948,9171,1997,4,12120
669,2019-09-28,178,16474,2166,6,18824
669,2019-09-29,475,17111,1541,0,19127
669,2019-09-30,248,18684,1400,2,20334
669,2019-10-01,117,17199,1637,0,18953
669,2019-10-02,129,13390,1663,0,15182
669,2019-10-03,146,14623,1362,1,16132
669,2019-10-04,131,12409,1216,2,13758
669,2019-10-05,231,22051,1683,2,23967
669,2019-10-06,1514,17579,2267,0,21360
669,2019-10-07,1842,6814,1162,0,9818
669,2019-10-08,1730,12937,2085,4,16756
669,2019-10-09,135,13797,1543,1,15476
669,2019-10-10,1128,11476,1273,2,13879
669,2019-10-11,1217,14234,1655,0,17106
669,2019-10-12,242,9604,2229,3,12078
669,2019-10-13,1101,12464,2029,4,15598
669,2019-10-14,1122,6801,2324,2,10249
669,2019-10-15,241,14911,1667,0,16819
669,2019-10-16,248,23496,1514,0,25258
669,2019-10-17,268,8484,1410,0,10162
669,2019-10-18,1759,14866,1608,3,18236
669,2019-10-19,309,9092,1849,1,11251
669,2019-10-20,1165,3183,2222,0,6570
669,2019-10-21,335,10944,1759,0,13038
669,2019-10-22,277,6576,1909,1,8763
669,2019-10-23,1138,14251,1610,4,17003
669,2019-10-24,419,19290,1455,0,21164
669,2019-10-25,1144,16025,1633,1,18803
669,2019-10-26,2070,17101,1501,0,20672
669,2019-10-27,696,23551,1714,0,25961
669,2019-10-28,256,25844,1576,1,27677
669,2019-10-29,1946,24786,873,2,27607
669,2019-10-30,944,24632,1360,1,26937
669,2019-10-31,218,15206,2013,0,17437
669,2019-11-01,1952,18460,1020,2,21434
669,2019-11-02,685,24889,1841,3,27418
669,2019-11-03,746,39013,539,0,40298
669,2019-11-04,1140,11140,1409,0,13689
669,2019-11-05,2476,3619,2467,1,8563
669,2019-11-06,1164,14613,1050,2,16829
669,2019-11-07,342,16569,1109,1,18021
669,2019-11-08,385,16028,790,1,17204
669,2019-11-09,272,11790,1858,1,13921
669,2019-11-10,259,25174,1870,0,27303
669,2019-11-11,237,16494,2287,1,19019
669,2019-11-12,297,13609,3262,3,17171
669,2019-11-13,244,21563,2146,0,23953
669,2019-11-14,271,15475,2396,0,18142
669,2019-11-15,333,5082,3045,0,8460
669,2019-11-16,396,2846,2258,0,5500
669,2019-11-17,1313,3884,3477,0,8674
669,2019-11-18,303,2511,2676,0,5490
669,2019-11-19,636,3412,2607,0,6655
669,2019-11-20,269,1423,2173,0,3865
669,2019-11-21,1139,3695,2213,0,7047
669,2019-11-22,278,6050,1952,0,8280
669,2019-11-23,246,6521,2086,0,8853
669,2019-11-24,2972,4144,2561,0,9677
669,2019-11-25,228,6072,1630,0,7930
669,2019-11-26,235,6696,2123,0,9054
669,2019-11-27,231,6706,2170,0,9107
669,2019-11-28,217,8506,587,0,9310
669,2019-08-06,27,7,456,1,491
669,2019-08-07,490,816,478,0,1784
669,2019-08-08,238,543,222,0,1003
669,2019-08-09,264,550,777,1,1592
669,2019-08-10,479,328,195,0,1002
669,2019-08-11,245,261,196,1,703
669,2019-08-12,415,4981,22,2,5420
669,2019-08-13,433,4379,38,0,4850
669,2019-08-14,154,687,78,0,919
669,2019-08-15,139,991,50,0,1180
669,2019-08-16,125,211,14,0,350
669,2019-08-17,201,800,483,1,1485
669,2019-08-18,985,721,1257,0,2963
669,2019-08-19,279,2242,1061,1,3583
669,2019-08-20,274,1560,1660,1,3495
669,2019-08-21,214,922,1701,0,2837
669,2019-08-22,347,3644,1459,1,5451
669,2019-08-23,1866,5334,2445,0,9645
669,2019-08-24,401,14644,1354,2,16401
669,2019-08-25,359,25336,1623,5,27323
669,2019-08-26,758,26364,1440,3,28565
669,2019-08-27,269,6504,2357,1,9131
669,2019-08-28,296,29213,1620,1,31130
669,2019-08-29,480,15782,717,2,16981
669,2019-08-30,205,2844,622,1,3672
669,2019-08-31,31,28,5,0,64
669,2019-09-01,59,1332,183,0,1574
669,2019-09-02,34,836,2,0,872
669,2019-09-03,121,3459,1417,1,4998
669,2019-09-04,1124,13923,1865,1,16913
669,2019-09-05,323,11228,1637,1,13189
669,2019-09-06,319,18032,1902,0,20253
669,2019-09-07,387,9339,1989,0,11715
669,2019-09-08,497,30469,1782,0,32748
669,2019-09-09,1167,6785,1587,0,9539
669,2019-09-10,539,13807,1830,0,16176
669,2019-09-11,158,6720,2101,2,8981
669,2019-09-12,204,6292,1815,3,8314
669,2019-09-13,1376,8822,1537,1,11736
669,2019-09-14,1083,7861,1405,0,10349
669,2019-09-15,1095,8015,1938,2,11050
669,2019-09-16,271,14485,1869,0,16625
669,2019-09-17,231,12428,1814,0,14473
669,2019-09-18,343,19747,1751,0,21841
669,2019-09-19,1339,12025,2148,0,15512
669,2019-09-20,1214,10588,1379,0,13181
669,2019-09-21,2086,10333,4118,0,16537
669,2019-09-22,848,9458,1980,1,12287
669,2019-09-23,311,9026,1956,4,11297
669,2019-09-24,1277,9831,1529,3,12640
669,2019-09-25,1090,11329,2320,3,14742
669,2019-09-26,148,11373,1710,0,13231
669,2019-09-27,948,9171,1997,4,12120
669,2019-09-28,178,16474,2166,6,18824
669,2019-09-29,475,17111,1541,0,19127
669,2019-09-30,248,18684,1400,2,20334
669,2019-10-01,117,17199,1637,0,18953
669,2019-10-02,129,13390,1663,0,15182
669,2019-10-03,146,14623,1362,1,16132
669,2019-10-04,131,12409,1216,2,13758
669,2019-10-05,231,22051,1683,2,23967
669,2019-10-06,1514,17579,2267,0,21360
669,2019-10-07,1842,6814,1162,0,9818
669,2019-10-08,1730,12937,2085,4,16756
669,2019-10-09,135,13797,1543,1,15476
669,2019-10-10,1128,11476,1273,2,13879
669,2019-10-11,1217,14234,1655,0,17106
669,2019-10-12,242,9604,2229,3,12078
669,2019-10-13,1101,12464,2029,4,15598
669,2019-10-14,1122,6801,2324,2,10249
669,2019-10-15,241,14911,1667,0,16819
669,2019-10-16,248,23496,1514,0,25258
669,2019-10-17,268,8484,1410,0,10162
669,2019-10-18,1759,14866,1608,3,18236
669,2019-10-19,309,9092,1849,1,11251
669,2019-10-20,1165,3183,2222,0,6570
669,2019-10-21,335,10944,1759,0,13038
669,2019-10-22,277,6576,1909,1,8763
669,2019-10-23,1138,14251,1610,4,17003
669,2019-10-24,419,19290,1455,0,21164
669,2019-10-25,1144,16025,1633,1,18803
669,2019-10-26,2070,17101,1501,0,20672
669,2019-10-27,696,23551,1714,0,25961
669,2019-10-28,256,25844,1576,1,27677
669,2019-10-29,1946,24786,873,2,27607
669,2019-10-30,944,24632,1360,1,26937
669,2019-10-31,218,15206,2013,0,17437
669,2019-11-01,1952,18460,1020,2,21434
669,2019-11-02,685,24889,1841,3,27418
669,2019-11-03,746,39013,539,0,40298
669,2019-11-04,1140,11140,1409,0,13689
669,2019-11-05,2476,3619,2467,1,8563
669,2019-11-06,1164,14613,1050,2,16829
669,2019-11-07,342,16569,1109,1,18021
669,2019-11-08,385,16028,790,1,17204
669,2019-11-09,272,11790,1858,1,13921
669,2019-11-10,259,25174,1870,0,27303
669,2019-11-11,237,16494,2287,1,19019
669,2019-11-12,297,13609,3262,3,17171
669,2019-11-13,244,21563,2146,0,23953
669,2019-11-14,271,15475,2396,0,18142
669,2019-11-15,333,5082,3045,0,8460
669,2019-11-16,396,2846,2258,0,5500
669,2019-11-17,1313,3884,3477,0,8674
669,2019-11-18,303,2511,2676,0,5490
669,2019-11-19,636,3412,2607,0,6655
669,2019-11-20,269,1423,2173,0,3865
669,2019-11-21,1139,3695,2213,0,7047
669,2019-11-22,278,6050,1952,0,8280
669,2019-11-23,246,6521,2086,0,8853
669,2019-11-24,2972,4144,2561,0,9677
669,2019-11-25,228,6072,1630,0,7930
669,2019-11-26,235,6696,2123,0,9054
669,2019-11-27,231,6706,2170,0,9107
669,2019-11-28,217,8506,587,0,9310
669,2019-11-29,0,171,0,0,171
669,2019-08-06,27,7,456,1,491
669,2019-08-07,490,816,478,0,1784
669,2019-08-08,238,543,222,0,1003
669,2019-08-09,264,550,777,1,1592
669,2019-08-10,479,328,195,0,1002
669,2019-08-11,245,261,196,1,703
669,2019-08-12,415,4981,22,2,5420
669,2019-08-13,433,4379,38,0,4850
669,2019-08-14,154,687,78,0,919
669,2019-08-15,139,991,50,0,1180
669,2019-08-16,125,211,14,0,350
669,2019-08-17,201,800,483,1,1485
669,2019-08-18,985,721,1257,0,2963
669,2019-08-19,279,2242,1061,1,3583
669,2019-08-20,274,1560,1660,1,3495
669,2019-08-21,214,922,1701,0,2837
669,2019-08-22,347,3644,1459,1,5451
669,2019-08-23,1866,5334,2445,0,9645
669,2019-08-24,401,14644,1354,2,16401
669,2019-08-25,359,25336,1623,5,27323
669,2019-08-26,758,26364,1440,3,28565
669,2019-08-27,269,6504,2357,1,9131
669,2019-08-28,296,29213,1620,1,31130
669,2019-08-29,480,15782,717,2,16981
669,2019-08-30,205,2844,622,1,3672
669,2019-08-31,31,28,5,0,64
669,2019-09-01,59,1332,183,0,1574
669,2019-09-02,34,836,2,0,872
669,2019-09-03,121,3459,1417,1,4998
669,2019-09-04,1124,13923,1865,1,16913
669,2019-09-05,323,11228,1637,1,13189
669,2019-09-06,319,18032,1902,0,20253
669,2019-09-07,387,9339,1989,0,11715
669,2019-09-08,497,30469,1782,0,32748
669,2019-09-09,1167,6785,1587,0,9539
669,2019-09-10,539,13807,1830,0,16176
669,2019-09-11,158,6720,2101,2,8981
669,2019-09-12,204,6292,1815,3,8314
669,2019-09-13,1376,8822,1537,1,11736
669,2019-09-14,1083,7861,1405,0,10349
669,2019-09-15,1095,8015,1938,2,11050
669,2019-09-16,271,14485,1869,0,16625
669,2019-09-17,231,12428,1814,0,14473
669,2019-09-18,343,19747,1751,0,21841
669,2019-09-19,1339,12025,2148,0,15512
669,2019-09-20,1214,10588,1379,0,13181
669,2019-09-21,2086,10333,4118,0,16537
669,2019-09-22,848,9458,1980,1,12287
669,2019-09-23,311,9026,1956,4,11297
669,2019-09-24,1277,9831,1529,3,12640
669,2019-09-25,1090,11329,2320,3,14742
669,2019-09-26,148,11373,1710,0,13231
669,2019-09-27,948,9171,1997,4,12120
669,2019-09-28,178,16474,2166,6,18824
669,2019-09-29,475,17111,1541,0,19127
669,2019-09-30,248,18684,1400,2,20334
669,2019-10-01,117,17199,1637,0,18953
669,2019-10-02,129,13390,1663,0,15182
669,2019-10-03,146,14623,1362,1,16132
669,2019-10-04,131,12409,1216,2,13758
669,2019-10-05,231,22051,1683,2,23967
669,2019-10-06,1514,17579,2267,0,21360
669,2019-10-07,1842,6814,1162,0,9818
669,2019-10-08,1730,12937,2085,4,16756
669,2019-10-09,135,13797,1543,1,15476
669,2019-10-10,1128,11476,1273,2,13879
669,2019-10-11,1217,14234,1655,0,17106
669,2019-10-12,242,9604,2229,3,12078
669,2019-10-13,1101,12464,2029,4,15598
669,2019-10-14,1122,6801,2324,2,10249
669,2019-10-15,241,14911,1667,0,16819
669,2019-10-16,248,23496,1514,0,25258
669,2019-10-17,268,8484,1410,0,10162
669,2019-10-18,1759,14866,1608,3,18236
669,2019-10-19,309,9092,1849,1,11251
669,2019-10-20,1165,3183,2222,0,6570
669,2019-10-21,335,10944,1759,0,13038
669,2019-10-22,277,6576,1909,1,8763
669,2019-10-23,1138,14251,1610,4,17003
669,2019-10-24,419,19290,1455,0,21164
669,2019-10-25,1144,16025,1633,1,18803
669,2019-10-26,2070,17101,1501,0,20672
669,2019-10-27,696,23551,1714,0,25961
669,2019-10-28,256,25844,1576,1,27677
669,2019-10-29,1946,24786,873,2,27607
669,2019-10-30,944,24632,1360,1,26937
669,2019-10-31,218,15206,2013,0,17437
669,2019-11-01,1952,18460,1020,2,21434
669,2019-11-02,685,24889,1841,3,27418
669,2019-11-03,746,39013,539,0,40298
669,2019-11-04,1140,11140,1409,0,13689
669,2019-11-05,2476,3619,2467,1,8563
669,2019-11-06,1164,14613,1050,2,16829
669,2019-11-07,342,16569,1109,1,18021
669,2019-11-08,385,16028,790,1,17204
669,2019-11-09,272,11790,1858,1,13921
669,2019-11-10,259,25174,1870,0,27303
669,2019-11-11,237,16494,2287,1,19019
669,2019-11-12,297,13609,3262,3,17171
669,2019-11-13,244,21563,2146,0,23953
669,2019-11-14,271,15475,2396,0,18142
669,2019-11-15,333,5082,3045,0,8460
669,2019-11-16,396,2846,2258,0,5500
669,2019-11-17,1313,3884,3477,0,8674
669,2019-11-18,303,2511,2676,0,5490
669,2019-11-19,636,3412,2607,0,6655
669,2019-11-20,269,1423,2173,0,3865
669,2019-11-21,1139,3695,2213,0,7047
669,2019-11-22,278,6050,1952,0,8280
669,2019-11-23,246,6521,2086,0,8853
669,2019-11-24,2972,4144,2561,0,9677
669,2019-11-25,228,6072,1630,0,7930
669,2019-11-26,235,6696,2123,0,9054
669,2019-11-27,231,6706,2170,0,9107
669,2019-11-28,217,8506,587,0,9310
669,2019-08-06,27,7,456,1,491
669,2019-08-07,490,816,478,0,1784
669,2019-08-08,238,543,222,0,1003
669,2019-08-09,264,550,777,1,1592
669,2019-08-10,479,328,195,0,1002
669,2019-08-11,245,261,196,1,703
669,2019-08-12,415,4981,22,2,5420
669,2019-08-13,433,4379,38,0,4850
669,2019-08-14,154,687,78,0,919
669,2019-08-15,139,991,50,0,1180
669,2019-08-16,125,211,14,0,350
669,2019-08-17,201,800,483,1,1485
669,2019-08-18,985,721,1257,0,2963
669,2019-08-19,279,2242,1061,1,3583
669,2019-08-20,274,1560,1660,1,3495
669,2019-08-21,214,922,1701,0,2837
669,2019-08-22,347,3644,1459,1,5451
669,2019-08-23,1866,5334,2445,0,9645
669,2019-08-24,401,14644,1354,2,16401
669,2019-08-25,359,25336,1623,5,27323
669,2019-08-26,758,26364,1440,3,28565
669,2019-08-27,269,6504,2357,1,9131
669,2019-08-28,296,29213,1620,1,31130
669,2019-08-29,480,15782,717,2,16981
669,2019-08-30,205,2844,622,1,3672
669,2019-08-31,31,28,5,0,64
669,2019-09-01,59,1332,183,0,1574
669,2019-09-02,34,836,2,0,872
669,2019-09-03,121,3459,1417,1,4998
669,2019-09-04,1124,13923,1865,1,16913
669,2019-09-05,323,11228,1637,1,13189
669,2019-09-06,319,18032,1902,0,20253
669,2019-09-07,387,9339,1989,0,11715
669,2019-09-08,497,30469,1782,0,32748
669,2019-09-09,1167,6785,1587,0,9539
669,2019-09-10,539,13807,1830,0,16176
669,2019-09-11,158,6720,2101,2,8981
669,2019-09-12,204,6292,1815,3,8314
669,2019-09-13,1376,8822,1537,1,11736
669,2019-09-14,1083,7861,1405,0,10349
669,2019-09-15,1095,8015,1938,2,11050
669,2019-09-16,271,14485,1869,0,16625
669,2019-09-17,231,12428,1814,0,14473
669,2019-09-18,343,19747,1751,0,21841
669,2019-09-19,1339,12025,2148,0,15512
669,2019-09-20,1214,10588,1379,0,13181
669,2019-09-21,2086,10333,4118,0,16537
669,2019-09-22,848,9458,1980,1,12287
669,2019-09-23,311,9026,1956,4,11297
669,2019-09-24,1277,9831,1529,3,12640
669,2019-09-25,1090,11329,2320,3,14742
669,2019-09-26,148,11373,1710,0,13231
669,2019-09-27,948,9171,1997,4,12120
669,2019-09-28,178,16474,2166,6,18824
669,2019-09-29,475,17111,1541,0,19127
669,2019-09-30,248,18684,1400,2,20334
669,2019-10-01,117,17199,1637,0,18953
669,2019-10-02,129,13390,1663,0,15182
669,2019-10-03,146,14623,1362,1,16132
669,2019-10-04,131,12409,1216,2,13758
669,2019-10-05,231,22051,1683,2,23967
669,2019-10-06,1514,17579,2267,0,21360
669,2019-10-07,1842,6814,1162,0,9818
669,2019-10-08,1730,12937,2085,4,16756
669,2019-10-09,135,13797,1543,1,15476
669,2019-10-10,1128,11476,1273,2,13879
669,2019-10-11,1217,14234,1655,0,17106
669,2019-10-12,242,9604,2229,3,12078
669,2019-10-13,1101,12464,2029,4,15598
669,2019-10-14,1122,6801,2324,2,10249
669,2019-10-15,241,14911,1667,0,16819
669,2019-10-16,248,23496,1514,0,25258
669,2019-10-17,268,8484,1410,0,10162
669,2019-10-18,1759,14866,1608,3,18236
669,2019-10-19,309,9092,1849,1,11251
669,2019-10-20,1165,3183,2222,0,6570
669,2019-10-21,335,10944,1759,0,13038
669,2019-10-22,277,6576,1909,1,8763
669,2019-10-23,1138,14251,1610,4,17003
669,2019-10-24,419,19290,1455,0,21164
669,2019-10-25,1144,16025,1633,1,18803
669,2019-10-26,2070,17101,1501,0,20672
669,2019-10-27,696,23551,1714,0,25961
669,2019-10-28,256,25844,1576,1,27677
669,2019-10-29,1946,24786,873,2,27607
669,2019-10-30,944,24632,1360,1,26937
669,2019-10-31,218,15206,2013,0,17437
669,2019-11-01,1952,18460,1020,2,21434
669,2019-11-02,685,24889,1841,3,27418
669,2019-11-03,746,39013,539,0,40298
669,2019-11-04,1140,11140,1409,0,13689
669,2019-11-05,2476,3619,2467,1,8563
669,2019-11-06,1164,14613,1050,2,16829
669,2019-11-07,342,16569,1109,1,18021
669,2019-11-08,385,16028,790,1,17204
669,2019-11-09,272,11790,1858,1,13921
669,2019-11-10,259,25174,1870,0,27303
669,2019-11-11,237,16494,2287,1,19019
669,2019-11-12,297,13609,3262,3,17171
670,2019-08-07,429,245,602,2,1278
670,2019-08-08,102,205,444,0,751
670,2019-08-09,113,1085,584,1,1783
670,2019-08-10,395,450,193,3,1041
670,2019-08-11,151,169,121,1,442
670,2019-08-12,745,284,193,0,1222
670,2019-08-13,617,410,327,1,1355
670,2019-08-14,511,569,51,0,1131
670,2019-08-15,163,675,45,0,883
670,2019-08-16,313,522,214,1,1050
670,2019-08-17,864,560,695,0,2119
670,2019-08-18,370,1770,811,0,2951
670,2019-08-19,169,7995,1062,0,9226
670,2019-08-20,391,13350,1677,3,15421
670,2019-08-21,213,18811,1156,1,20181
670,2019-08-22,938,19075,886,1,20900
670,2019-08-23,368,22166,1264,3,23801
670,2019-08-24,320,6691,2519,2,9532
670,2019-08-25,256,13037,1891,1,15185
670,2019-08-26,566,4533,1616,0,6715
670,2019-08-27,217,2804,1442,0,4463
670,2019-08-28,304,4999,2070,2,7375
670,2019-08-29,1328,9109,1131,3,11571
670,2019-08-30,320,3030,903,1,4254
670,2019-08-31,132,136,5,0,273
670,2019-09-01,124,996,365,0,1485
670,2019-09-02,85,143,44,0,272
670,2019-09-03,156,3583,1560,0,5299
670,2019-09-04,1070,9442,1986,1,12499
670,2019-09-05,1056,8211,1916,3,11186
670,2019-09-06,243,11752,1241,1,13237
670,2019-09-07,428,11312,2799,2,14541
670,2019-09-08,200,5718,2296,0,8214
670,2019-09-09,439,6187,1148,0,7774
670,2019-09-10,407,15753,2248,1,18409
670,2019-09-11,248,8834,2659,2,11743
670,2019-09-12,183,6193,2244,1,8621
670,2019-09-13,453,5184,1648,1,7286
670,2019-09-14,421,7049,2137,0,9607
670,2019-09-15,133,7976,1629,2,9740
670,2019-09-16,488,16851,2185,1,19525
670,2019-09-17,1008,8895,1896,2,11801
670,2019-09-18,571,20099,1514,0,22184
670,2019-09-19,548,4778,1551,0,6877
670,2019-09-20,253,7503,1656,2,9414
670,2019-09-21,1045,10552,2147,0,13744
670,2019-09-22,355,10513,1440,0,12308
670,2019-09-23,326,9472,2100,0,11898
670,2019-09-24,1902,9382,1443,1,12728
670,2019-09-25,1086,9749,1258,9,12102
670,2019-09-26,1031,13768,1725,2,16526
670,2019-09-27,303,9496,2664,4,12467
670,2019-09-28,367,15584,1067,2,17020
670,2019-09-29,189,17242,1245,1,18677
670,2019-09-30,215,18564,1421,1,20201
670,2019-10-01,1156,17004,1311,4,19475
670,2019-10-02,159,12909,2014,0,15082
670,2019-10-03,184,14615,1759,0,16558
670,2019-10-04,376,18953,1898,6,21233
670,2019-10-05,1155,17429,1836,1,20421
670,2019-10-06,154,10285,1932,2,12373
670,2019-10-07,386,6594,1916,3,8899
670,2019-10-08,190,12550,1129,0,13869
670,2019-10-09,165,16052,1354,0,17571
670,2019-10-10,389,11443,3080,0,14912
670,2019-10-11,1079,14331,1909,608,17927
670,2019-10-12,311,7935,2221,4,10471
670,2019-10-13,386,9005,1289,0,10680
670,2019-10-14,150,6538,2267,2,8957
670,2019-10-15,289,9376,2915,0,12580
670,2019-10-16,336,13268,1169,1,14774
670,2019-10-17,129,5777,1470,3,7379
670,2019-10-18,235,9303,2397,1,11936
670,2019-10-19,381,5683,1845,0,7909
670,2019-10-20,3672,4697,1661,1,10031
670,2019-10-21,345,11310,1571,1,13227
670,2019-10-22,1480,6869,1315,3,9667
670,2019-10-23,272,9347,1511,2,11132
670,2019-10-24,619,14375,1247,2,16243
670,2019-10-25,665,11627,991,3,13286
670,2019-10-26,975,14745,1630,0,17350
670,2019-10-27,305,17560,1419,2,19286
670,2019-10-28,407,23799,1555,1,25762
670,2019-10-29,950,29751,1691,0,32392
670,2019-10-30,171,20806,1172,0,22149
670,2019-10-31,252,12978,1620,1,14851
670,2019-11-01,356,15649,833,2,16840
670,2019-11-02,651,14977,1755,0,17383
670,2019-11-03,162,37716,1374,0,39252
670,2019-11-04,1225,10980,1559,0,13764
670,2019-11-05,1074,3601,2060,0,6735
670,2019-11-06,242,8879,1368,2,10491
670,2019-11-07,424,14071,760,5,15260
670,2019-11-08,106,10163,1519,0,11788
670,2019-11-09,138,13723,2213,0,16074
670,2019-11-10,388,25198,1923,0,27509
670,2019-11-11,156,16432,2221,4,18813
670,2019-11-12,142,18260,3126,0,21528
670,2019-11-13,429,15056,2249,0,17734
670,2019-11-14,161,8991,2746,1,11899
670,2019-11-15,246,7364,2261,2,9873
670,2019-11-16,357,2759,2312,3,5431
670,2019-11-17,249,4316,3226,0,7791
670,2019-11-18,195,3454,3079,0,6728
670,2019-11-19,322,5599,3536,915,10372
670,2019-11-20,1958,1420,2332,0,5710
670,2019-11-21,123,5072,2145,0,7340
670,2019-11-22,1366,6263,1825,0,9454
670,2019-11-23,204,6454,1963,0,8621
670,2019-11-24,232,10541,2202,0,12975
670,2019-11-25,358,11952,1983,0,14293
670,2019-11-26,1098,6846,3160,0,11104
670,2019-11-27,156,11035,1216,0,12407
670,2019-11-28,770,10055,534,0,11359
670,2019-11-29,34,1134,89,0,1257
670,2019-08-07,429,245,602,2,1278
670,2019-08-08,102,205,444,0,751
670,2019-08-09,113,1085,584,1,1783
670,2019-08-10,395,450,193,3,1041
670,2019-08-11,151,169,121,1,442
670,2019-08-12,745,284,193,0,1222
670,2019-08-13,617,410,327,1,1355
670,2019-08-14,511,569,51,0,1131
670,2019-08-15,163,675,45,0,883
670,2019-08-16,313,522,214,1,1050
670,2019-08-17,864,560,695,0,2119
670,2019-08-18,370,1770,811,0,2951
670,2019-08-19,169,7995,1062,0,9226
670,2019-08-20,391,13350,1677,3,15421
670,2019-08-21,213,18811,1156,1,20181
670,2019-08-22,938,19075,886,1,20900
670,2019-08-23,368,22166,1264,3,23801
670,2019-08-24,320,6691,2519,2,9532
670,2019-08-25,256,13037,1891,1,15185
670,2019-08-26,566,4533,1616,0,6715
670,2019-08-27,217,2804,1442,0,4463
670,2019-08-28,304,4999,2070,2,7375
670,2019-08-29,1328,9109,1131,3,11571
670,2019-08-30,320,3030,903,1,4254
670,2019-08-31,132,136,5,0,273
670,2019-09-01,124,996,365,0,1485
670,2019-09-02,85,143,44,0,272
670,2019-09-03,156,3583,1560,0,5299
670,2019-09-04,1070,9442,1986,1,12499
670,2019-09-05,1056,8211,1916,3,11186
670,2019-09-06,243,11752,1241,1,13237
670,2019-09-07,428,11312,2799,2,14541
670,2019-09-08,200,5718,2296,0,8214
670,2019-09-09,439,6187,1148,0,7774
670,2019-09-10,407,15753,2248,1,18409
670,2019-09-11,248,8834,2659,2,11743
670,2019-09-12,183,6193,2244,1,8621
670,2019-09-13,453,5184,1648,1,7286
670,2019-09-14,421,7049,2137,0,9607
670,2019-09-15,133,7976,1629,2,9740
670,2019-09-16,488,16851,2185,1,19525
670,2019-09-17,1008,8895,1896,2,11801
670,2019-09-18,571,20099,1514,0,22184
670,2019-09-19,548,4778,1551,0,6877
670,2019-09-20,253,7503,1656,2,9414
670,2019-09-21,1045,10552,2147,0,13744
670,2019-09-22,355,10513,1440,0,12308
670,2019-09-23,326,9472,2100,0,11898
670,2019-09-24,1902,9382,1443,1,12728
670,2019-09-25,1086,9749,1258,9,12102
670,2019-09-26,1031,13768,1725,2,16526
670,2019-09-27,303,9496,2664,4,12467
670,2019-09-28,367,15584,1067,2,17020
670,2019-09-29,189,17242,1245,1,18677
670,2019-09-30,215,18564,1421,1,20201
670,2019-10-01,1156,17004,1311,4,19475
670,2019-10-02,159,12909,2014,0,15082
670,2019-10-03,184,14615,1759,0,16558
670,2019-10-04,376,18953,1898,6,21233
670,2019-10-05,1155,17429,1836,1,20421
670,2019-10-06,154,10285,1932,2,12373
670,2019-10-07,386,6594,1916,3,8899
670,2019-10-08,190,12550,1129,0,13869
670,2019-10-09,165,16052,1354,0,17571
670,2019-10-10,389,11443,3080,0,14912
670,2019-10-11,1079,14331,1909,608,17927
670,2019-10-12,311,7935,2221,4,10471
670,2019-10-13,386,9005,1289,0,10680
670,2019-10-14,150,6538,2267,2,8957
670,2019-10-15,289,9376,2915,0,12580
670,2019-10-16,336,13268,1169,1,14774
670,2019-10-17,129,5777,1470,3,7379
670,2019-10-18,235,9303,2397,1,11936
670,2019-10-19,381,5683,1845,0,7909
670,2019-10-20,3672,4697,1661,1,10031
670,2019-10-21,345,11310,1571,1,13227
670,2019-10-22,1480,6869,1315,3,9667
670,2019-10-23,272,9347,1511,2,11132
670,2019-10-24,619,14375,1247,2,16243
670,2019-10-25,665,11627,991,3,13286
670,2019-10-26,975,14745,1630,0,17350
670,2019-10-27,305,17560,1419,2,19286
670,2019-10-28,407,23799,1555,1,25762
670,2019-10-29,950,29751,1691,0,32392
670,2019-10-30,171,20806,1172,0,22149
670,2019-10-31,252,12978,1620,1,14851
670,2019-11-01,356,15649,833,2,16840
670,2019-11-02,651,14977,1755,0,17383
670,2019-11-03,162,37716,1374,0,39252
670,2019-11-04,1225,10980,1559,0,13764
670,2019-11-05,1074,3601,2060,0,6735
670,2019-11-06,242,8879,1368,2,10491
670,2019-11-07,424,14071,760,5,15260
670,2019-11-08,106,10163,1519,0,11788
670,2019-11-09,138,13723,2213,0,16074
670,2019-11-10,388,25198,1923,0,27509
670,2019-11-11,156,16432,2221,4,18813
670,2019-11-12,142,18260,3126,0,21528
670,2019-11-13,429,15056,2249,0,17734
670,2019-11-14,161,8991,2746,1,11899
670,2019-11-15,246,7364,2261,2,9873
670,2019-11-16,357,2759,2312,3,5431
670,2019-11-17,249,4316,3226,0,7791
670,2019-11-18,195,3454,3079,0,6728
670,2019-11-19,322,5599,3536,915,10372
670,2019-11-20,1958,1420,2332,0,5710
670,2019-11-21,123,5072,2145,0,7340
670,2019-11-22,1366,6263,1825,0,9454
670,2019-11-23,204,6454,1963,0,8621
670,2019-11-24,232,10541,2202,0,12975
670,2019-11-25,358,11952,1983,0,14293
670,2019-11-26,1098,6846,3160,0,11104
670,2019-11-27,156,11035,1216,0,12407
670,2019-11-28,770,10055,534,0,11359
670,2019-11-29,34,1134,89,0,1257
670,2019-08-06,0,0,1,0,1
670,2019-08-07,429,245,602,2,1278
670,2019-08-08,102,205,444,0,751
670,2019-08-09,113,1085,584,1,1783
670,2019-08-10,395,450,193,3,1041
670,2019-08-11,151,169,121,1,442
670,2019-08-12,745,284,193,0,1222
670,2019-08-13,617,410,327,1,1355
670,2019-08-14,511,569,51,0,1131
670,2019-08-15,163,675,45,0,883
670,2019-08-16,313,522,214,1,1050
670,2019-08-17,864,560,695,0,2119
670,2019-08-18,370,1770,811,0,2951
670,2019-08-19,169,7995,1062,0,9226
670,2019-08-20,391,13350,1677,3,15421
670,2019-08-21,213,18811,1156,1,20181
670,2019-08-22,938,19075,886,1,20900
670,2019-08-23,368,22166,1264,3,23801
670,2019-08-24,320,6691,2519,2,9532
670,2019-08-25,256,13037,1891,1,15185
670,2019-08-26,566,4533,1616,0,6715
670,2019-08-27,217,2804,1442,0,4463
670,2019-08-28,304,4999,2070,2,7375
670,2019-08-29,1328,9109,1131,3,11571
670,2019-08-30,320,3030,903,1,4254
670,2019-08-31,132,136,5,0,273
670,2019-09-01,124,996,365,0,1485
670,2019-09-02,85,143,44,0,272
670,2019-09-03,156,3583,1560,0,5299
670,2019-09-04,1070,9442,1986,1,12499
670,2019-09-05,1056,8211,1916,3,11186
670,2019-09-06,243,11752,1241,1,13237
670,2019-09-07,428,11312,2799,2,14541
670,2019-09-08,200,5718,2296,0,8214
670,2019-09-09,439,6187,1148,0,7774
670,2019-09-10,407,15753,2248,1,18409
670,2019-09-11,248,8834,2659,2,11743
670,2019-09-12,183,6193,2244,1,8621
670,2019-09-13,453,5184,1648,1,7286
670,2019-09-14,421,7049,2137,0,9607
670,2019-09-15,133,7976,1629,2,9740
670,2019-09-16,488,16851,2185,1,19525
670,2019-09-17,1008,8895,1896,2,11801
670,2019-09-18,571,20099,1514,0,22184
670,2019-09-19,548,4778,1551,0,6877
670,2019-09-20,253,7503,1656,2,9414
670,2019-09-21,1045,10552,2147,0,13744
670,2019-09-22,355,10513,1440,0,12308
670,2019-09-23,326,9472,2100,0,11898
670,2019-09-24,1902,9382,1443,1,12728
670,2019-09-25,1086,9749,1258,9,12102
670,2019-09-26,1031,13768,1725,2,16526
670,2019-09-27,303,9496,2664,4,12467
670,2019-09-28,367,15584,1067,2,17020
670,2019-09-29,189,17242,1245,1,18677
670,2019-09-30,215,18564,1421,1,20201
670,2019-10-01,1156,17004,1311,4,19475
670,2019-10-02,159,12909,2014,0,15082
670,2019-10-03,184,14615,1759,0,16558
670,2019-10-04,376,18953,1898,6,21233
670,2019-10-05,1155,17429,1836,1,20421
670,2019-10-06,154,10285,1932,2,12373
670,2019-10-07,386,6594,1916,3,8899
670,2019-10-08,190,12550,1129,0,13869
670,2019-10-09,165,16052,1354,0,17571
670,2019-10-10,389,11443,3080,0,14912
670,2019-10-11,1079,14331,1909,608,17927
670,2019-10-12,311,7935,2221,4,10471
670,2019-10-13,386,9005,1289,0,10680
670,2019-10-14,150,6538,2267,2,8957
670,2019-10-15,289,9376,2915,0,12580
670,2019-10-16,336,13268,1169,1,14774
670,2019-10-17,129,5777,1470,3,7379
670,2019-10-18,235,9303,2397,1,11936
670,2019-10-19,381,5683,1845,0,7909
670,2019-10-20,3672,4697,1661,1,10031
670,2019-10-21,345,11310,1571,1,13227
670,2019-10-22,1480,6869,1315,3,9667
670,2019-10-23,272,9347,1511,2,11132
670,2019-10-24,619,14375,1247,2,16243
670,2019-10-25,665,11627,991,3,13286
670,2019-10-26,975,14745,1630,0,17350
670,2019-10-27,305,17560,1419,2,19286
670,2019-10-28,407,23799,1555,1,25762
670,2019-10-29,950,29751,1691,0,32392
670,2019-10-30,171,20806,1172,0,22149
670,2019-10-31,252,12978,1620,1,14851
670,2019-11-01,356,15649,833,2,16840
670,2019-11-02,651,14977,1755,0,17383
670,2019-11-03,162,37716,1374,0,39252
670,2019-11-04,1225,10980,1559,0,13764
670,2019-11-05,1074,3601,2060,0,6735
670,2019-11-06,242,8879,1368,2,10491
670,2019-11-07,424,14071,760,5,15260
670,2019-11-08,106,10163,1519,0,11788
670,2019-11-09,138,13723,2213,0,16074
670,2019-11-10,388,25198,1923,0,27509
670,2019-11-11,156,16432,2221,4,18813
670,2019-11-12,142,18260,3126,0,21528
670,2019-11-13,429,15056,2249,0,17734
670,2019-11-14,161,8991,2746,1,11899
670,2019-11-15,246,7364,2261,2,9873
670,2019-11-16,357,2759,2312,3,5431
670,2019-11-17,249,4316,3226,0,7791
670,2019-11-18,195,3454,3079,0,6728
670,2019-11-19,322,5599,3536,915,10372
670,2019-11-20,1958,1420,2332,0,5710
670,2019-11-21,123,5072,2145,0,7340
670,2019-11-22,1366,6263,1825,0,9454
670,2019-11-23,204,6454,1963,0,8621
670,2019-11-24,232,10541,2202,0,12975
670,2019-11-25,358,11952,1983,0,14293
670,2019-11-26,1098,6846,3160,0,11104
670,2019-11-27,156,11035,1216,0,12407
670,2019-11-28,770,10055,534,0,11359
670,2019-11-29,34,1134,89,0,1257
670,2019-08-07,429,245,602,2,1278
670,2019-08-08,102,205,444,0,751
670,2019-08-09,113,1085,584,1,1783
670,2019-08-10,395,450,193,3,1041
670,2019-08-11,151,169,121,1,442
670,2019-08-12,745,284,193,0,1222
670,2019-08-13,617,410,327,1,1355
670,2019-08-14,511,569,51,0,1131
670,2019-08-15,163,675,45,0,883
670,2019-08-16,313,522,214,1,1050
670,2019-08-17,864,560,695,0,2119
670,2019-08-18,370,1770,811,0,2951
670,2019-08-19,169,7995,1062,0,9226
670,2019-08-20,391,13350,1677,3,15421
670,2019-08-21,213,18811,1156,1,20181
670,2019-08-22,938,19075,886,1,20900
670,2019-08-23,368,22166,1264,3,23801
670,2019-08-24,320,6691,2519,2,9532
670,2019-08-25,256,13037,1891,1,15185
670,2019-08-26,566,4533,1616,0,6715
670,2019-08-27,217,2804,1442,0,4463
670,2019-08-28,304,4999,2070,2,7375
670,2019-08-29,1328,9109,1131,3,11571
670,2019-08-30,320,3030,903,1,4254
670,2019-08-31,132,136,5,0,273
670,2019-09-01,124,996,365,0,1485
670,2019-09-02,85,143,44,0,272
670,2019-09-03,156,3583,1560,0,5299
670,2019-09-04,1070,9442,1986,1,12499
670,2019-09-05,1056,8211,1916,3,11186
670,2019-09-06,243,11752,1241,1,13237
670,2019-09-07,428,11312,2799,2,14541
670,2019-09-08,200,5718,2296,0,8214
670,2019-09-09,439,6187,1148,0,7774
670,2019-09-10,407,15753,2248,1,18409
670,2019-09-11,248,8834,2659,2,11743
670,2019-09-12,183,6193,2244,1,8621
670,2019-09-13,453,5184,1648,1,7286
670,2019-09-14,421,7049,2137,0,9607
670,2019-09-15,133,7976,1629,2,9740
670,2019-09-16,488,16851,2185,1,19525
670,2019-09-17,1008,8895,1896,2,11801
670,2019-09-18,571,20099,1514,0,22184
670,2019-09-19,548,4778,1551,0,6877
670,2019-09-20,253,7503,1656,2,9414
670,2019-09-21,1045,10552,2147,0,13744
670,2019-09-22,355,10513,1440,0,12308
670,2019-09-23,326,9472,2100,0,11898
670,2019-09-24,1902,9382,1443,1,12728
670,2019-09-25,1086,9749,1258,9,12102
670,2019-09-26,1031,13768,1725,2,16526
670,2019-09-27,303,9496,2664,4,12467
670,2019-09-28,367,15584,1067,2,17020
670,2019-09-29,189,17242,1245,1,18677
670,2019-09-30,215,18564,1421,1,20201
670,2019-10-01,1156,17004,1311,4,19475
670,2019-10-02,159,12909,2014,0,15082
670,2019-10-03,184,14615,1759,0,16558
670,2019-10-04,376,18953,1898,6,21233
670,2019-10-05,1155,17429,1836,1,20421
670,2019-10-06,154,10285,1932,2,12373
670,2019-10-07,386,6594,1916,3,8899
670,2019-10-08,190,12550,1129,0,13869
670,2019-10-09,165,16052,1354,0,17571
670,2019-10-10,389,11443,3080,0,14912
670,2019-10-11,1079,14331,1909,608,17927
670,2019-10-12,311,7935,2221,4,10471
670,2019-10-13,386,9005,1289,0,10680
670,2019-10-14,150,6538,2267,2,8957
670,2019-10-15,289,9376,2915,0,12580
670,2019-10-16,336,13268,1169,1,14774
670,2019-10-17,129,5777,1470,3,7379
670,2019-10-18,235,9303,2397,1,11936
670,2019-10-19,381,5683,1845,0,7909
670,2019-10-20,3672,4697,1661,1,10031
670,2019-10-21,345,11310,1571,1,13227
670,2019-10-22,1480,6869,1315,3,9667
670,2019-10-23,272,9347,1511,2,11132
670,2019-10-24,619,14375,1247,2,16243
670,2019-10-25,665,11627,991,3,13286
670,2019-10-26,975,14745,1630,0,17350
670,2019-10-27,305,17560,1419,2,19286
670,2019-10-28,407,23799,1555,1,25762
670,2019-10-29,950,29751,1691,0,32392
670,2019-10-30,171,20806,1172,0,22149
670,2019-10-31,252,12978,1620,1,14851
670,2019-11-01,356,15649,833,2,16840
670,2019-11-02,651,14977,1755,0,17383
670,2019-11-03,162,37716,1374,0,39252
670,2019-11-04,1225,10980,1559,0,13764
670,2019-11-05,1074,3601,2060,0,6735
670,2019-11-06,242,8879,1368,2,10491
670,2019-11-07,424,14071,760,5,15260
670,2019-11-08,106,10163,1519,0,11788
670,2019-11-09,138,13723,2213,0,16074
670,2019-11-10,388,25198,1923,0,27509
670,2019-11-11,156,16432,2221,4,18813
670,2019-11-12,142,18260,3126,0,21528
670,2019-11-13,429,15056,2249,0,17734
670,2019-11-14,161,8991,2746,1,11899
670,2019-11-15,246,7364,2261,2,9873
670,2019-11-16,357,2759,2312,3,5431
670,2019-11-17,249,4316,3226,0,7791
670,2019-11-18,195,3454,3079,0,6728
670,2019-11-19,322,5599,3536,915,10372
671,2019-08-07,226,210,319,1,756
671,2019-08-08,122,80,215,0,417
671,2019-08-09,69,328,298,0,695
671,2019-08-10,182,425,323,0,930
671,2019-08-11,285,269,237,0,791
671,2019-08-12,232,316,52,0,600
671,2019-08-13,214,529,202,0,945
671,2019-08-14,158,601,191,0,950
671,2019-08-15,110,738,92,0,940
671,2019-08-16,131,225,202,1,559
671,2019-08-17,109,1382,759,0,2250
671,2019-08-18,120,291,936,1,1348
671,2019-08-19,699,804,958,1,2462
671,2019-08-20,218,2646,920,0,3784
671,2019-08-21,162,886,1365,0,2413
671,2019-08-22,164,13318,1703,2,15187
671,2019-08-23,164,13088,1557,3,14812
671,2019-08-24,149,4156,1799,1,6105
671,2019-08-25,176,31723,2070,2,33971
671,2019-08-26,153,29252,1742,1,31148
671,2019-08-27,228,6439,2250,2,8919
671,2019-08-28,1084,4077,1620,2,6783
671,2019-08-29,414,9057,2005,0,11476
671,2019-08-30,207,2456,814,2,3479
671,2019-08-31,60,70,0,0,130
671,2019-09-01,78,1000,329,1,1408
671,2019-09-02,81,22,156,0,259
671,2019-09-03,117,556,1642,0,2315
671,2019-09-04,108,10230,2098,1,12437
671,2019-09-05,1008,7924,1766,2,10700
671,2019-09-06,164,10512,1559,0,12235
671,2019-09-07,272,11567,1393,1,13233
671,2019-09-08,235,6218,2812,0,9265
671,2019-09-09,240,8037,2618,0,10895
671,2019-09-10,217,12281,1729,0,14227
671,2019-09-11,188,8912,2547,2,11649
671,2019-09-12,277,6775,1818,3,8873
671,2019-09-13,237,6676,2340,1,9254
671,2019-09-14,130,10263,1484,0,11877
671,2019-09-15,145,8827,1763,1,10736
671,2019-09-16,997,12992,1743,1,15733
671,2019-09-17,142,8137,3203,0,11482
671,2019-09-18,168,11468,1405,2,13043
671,2019-09-19,268,9765,1439,0,11472
671,2019-09-20,240,17294,1929,0,19463
671,2019-09-21,1836,7241,1530,2,10609
671,2019-09-22,100,8938,1137,1,10176
671,2019-09-23,1119,10221,2024,0,13364
671,2019-09-24,160,8435,3007,2,11604
671,2019-09-25,167,9930,1976,2,12075
671,2019-09-26,168,10676,1614,3,12461
671,2019-09-27,123,8518,1512,1,10154
671,2019-09-28,174,23925,1153,2,25254
671,2019-09-29,399,19859,1735,1,21994
671,2019-09-30,1587,23749,1984,1,27321
671,2019-10-01,972,21766,1020,1,23759
671,2019-10-02,126,11120,1854,0,13100
671,2019-10-03,581,13340,1400,2,15323
671,2019-10-04,147,11587,1805,1,13540
671,2019-10-05,748,20441,1713,0,22902
671,2019-10-06,586,13526,1976,2,16090
671,2019-10-07,2720,4649,2267,0,9636
671,2019-10-08,241,16563,1318,0,18122
671,2019-10-09,98,24903,1210,1,26212
671,2019-10-10,144,17031,1974,3138,22287
671,2019-10-11,169,8547,2311,3,11030
671,2019-10-12,138,5895,1295,2,7330
671,2019-10-13,128,8209,2121,1,10459
671,2019-10-14,786,5393,3213,2,9394
671,2019-10-15,129,8706,2025,3,10863
671,2019-10-16,149,17808,1002,3,18962
671,2019-10-17,122,6672,1947,0,8741
671,2019-10-18,215,7990,2145,0,10350
671,2019-10-19,115,4288,1847,0,6250
671,2019-10-20,114,1503,2088,0,3705
671,2019-10-21,282,10543,1469,2,12296
671,2019-10-22,108,4927,1201,2,6238
671,2019-10-23,197,13312,1497,0,15006
671,2019-10-24,252,18558,1832,2,20644
671,2019-10-25,1046,5089,2435,2,8572
671,2019-10-26,100,17043,1183,0,18326
671,2019-10-27,132,17793,1339,0,19264
671,2019-10-28,510,13439,1517,0,15466
671,2019-10-29,459,14719,1034,1,16213
671,2019-10-30,203,15023,1724,3,16953
671,2019-10-31,80,11382,1375,2,12839
671,2019-11-01,1475,18707,1565,0,21747
671,2019-11-02,89,14437,773,0,15299
671,2019-11-03,801,22194,1206,0,24201
671,2019-11-04,260,6376,1436,2,8074
671,2019-11-05,165,1317,2310,0,3792
671,2019-11-06,147,13207,1374,1,14729
671,2019-11-07,251,16037,798,2,17088
671,2019-11-08,110,8966,1122,0,10198
671,2019-11-09,102,7830,1689,2,9623
671,2019-11-10,814,22293,2377,1,25485
671,2019-11-11,143,14328,2220,1,16692
671,2019-11-12,138,16221,3738,754,20851
671,2019-11-13,164,19138,1899,4,21205
671,2019-11-14,163,13741,1804,1,15709
671,2019-11-15,140,3288,1806,1,5235
671,2019-11-16,848,3702,2284,2,6836
671,2019-11-17,194,4764,3161,0,8119
671,2019-11-18,950,2067,3205,1,6223
671,2019-11-19,221,2740,2636,0,5597
671,2019-11-20,135,800,2607,5,3547
671,2019-11-21,139,3131,1856,0,5126
671,2019-11-22,142,8449,1986,2,10579
671,2019-11-23,1984,6616,2441,1,11042
671,2019-11-24,318,6072,1862,2,8254
671,2019-11-25,1058,5682,1608,1,8349
671,2019-11-26,84,4760,2563,1,7408
671,2019-11-27,235,5507,1408,0,7150
671,2019-11-28,108,7842,711,0,8661
671,2019-11-29,26,718,1,0,745
671,2019-08-07,226,210,319,1,756
671,2019-08-08,122,80,215,0,417
671,2019-08-09,69,328,298,0,695
671,2019-08-10,182,425,323,0,930
671,2019-08-11,285,269,237,0,791
671,2019-08-12,232,316,52,0,600
671,2019-08-13,214,529,202,0,945
671,2019-08-14,158,601,191,0,950
671,2019-08-15,110,738,92,0,940
671,2019-08-16,131,225,202,1,559
671,2019-08-17,109,1382,759,0,2250
671,2019-08-18,120,291,936,1,1348
671,2019-08-19,699,804,958,1,2462
671,2019-08-20,218,2646,920,0,3784
671,2019-08-21,162,886,1365,0,2413
671,2019-08-22,164,13318,1703,2,15187
671,2019-08-23,164,13088,1557,3,14812
671,2019-08-24,149,4156,1799,1,6105
671,2019-08-25,176,31723,2070,2,33971
671,2019-08-26,153,29252,1742,1,31148
671,2019-08-27,228,6439,2250,2,8919
671,2019-08-28,1084,4077,1620,2,6783
671,2019-08-29,414,9057,2005,0,11476
671,2019-08-30,207,2456,814,2,3479
671,2019-08-31,60,70,0,0,130
671,2019-09-01,78,1000,329,1,1408
671,2019-09-02,81,22,156,0,259
671,2019-09-03,117,556,1642,0,2315
671,2019-09-04,108,10230,2098,1,12437
671,2019-09-05,1008,7924,1766,2,10700
671,2019-09-06,164,10512,1559,0,12235
671,2019-09-07,272,11567,1393,1,13233
671,2019-09-08,235,6218,2812,0,9265
671,2019-09-09,240,8037,2618,0,10895
671,2019-09-10,217,12281,1729,0,14227
671,2019-09-11,188,8912,2547,2,11649
671,2019-09-12,277,6775,1818,3,8873
671,2019-09-13,237,6676,2340,1,9254
671,2019-09-14,130,10263,1484,0,11877
671,2019-09-15,145,8827,1763,1,10736
671,2019-09-16,997,12992,1743,1,15733
671,2019-09-17,142,8137,3203,0,11482
671,2019-09-18,168,11468,1405,2,13043
671,2019-09-19,268,9765,1439,0,11472
671,2019-09-20,240,17294,1929,0,19463
671,2019-09-21,1836,7241,1530,2,10609
671,2019-09-22,100,8938,1137,1,10176
671,2019-09-23,1119,10221,2024,0,13364
671,2019-09-24,160,8435,3007,2,11604
671,2019-09-25,167,9930,1976,2,12075
671,2019-09-26,168,10676,1614,3,12461
671,2019-09-27,123,8518,1512,1,10154
671,2019-09-28,174,23925,1153,2,25254
671,2019-09-29,399,19859,1735,1,21994
671,2019-09-30,1587,23749,1984,1,27321
671,2019-10-01,972,21766,1020,1,23759
671,2019-10-02,126,11120,1854,0,13100
671,2019-10-03,581,13340,1400,2,15323
671,2019-10-04,147,11587,1805,1,13540
671,2019-10-05,748,20441,1713,0,22902
671,2019-10-06,586,13526,1976,2,16090
671,2019-10-07,2720,4649,2267,0,9636
671,2019-10-08,241,16563,1318,0,18122
671,2019-10-09,98,24903,1210,1,26212
671,2019-10-10,144,17031,1974,3138,22287
671,2019-10-11,169,8547,2311,3,11030
671,2019-10-12,138,5895,1295,2,7330
671,2019-10-13,128,8209,2121,1,10459
671,2019-10-14,786,5393,3213,2,9394
671,2019-10-15,129,8706,2025,3,10863
671,2019-10-16,149,17808,1002,3,18962
671,2019-10-17,122,6672,1947,0,8741
671,2019-10-18,215,7990,2145,0,10350
671,2019-10-19,115,4288,1847,0,6250
671,2019-10-20,114,1503,2088,0,3705
671,2019-10-21,282,10543,1469,2,12296
671,2019-10-22,108,4927,1201,2,6238
671,2019-10-23,197,13312,1497,0,15006
671,2019-10-24,252,18558,1832,2,20644
671,2019-10-25,1046,5089,2435,2,8572
671,2019-10-26,100,17043,1183,0,18326
671,2019-10-27,132,17793,1339,0,19264
671,2019-10-28,510,13439,1517,0,15466
671,2019-10-29,459,14719,1034,1,16213
671,2019-10-30,203,15023,1724,3,16953
671,2019-10-31,80,11382,1375,2,12839
671,2019-11-01,1475,18707,1565,0,21747
671,2019-11-02,89,14437,773,0,15299
671,2019-11-03,801,22194,1206,0,24201
671,2019-11-04,260,6376,1436,2,8074
671,2019-11-05,165,1317,2310,0,3792
671,2019-11-06,147,13207,1374,1,14729
671,2019-11-07,251,16037,798,2,17088
671,2019-11-08,110,8966,1122,0,10198
671,2019-11-09,102,7830,1689,2,9623
671,2019-11-10,814,22293,2377,1,25485
671,2019-11-11,143,14328,2220,1,16692
671,2019-11-12,138,16221,3738,754,20851
671,2019-11-13,164,19138,1899,4,21205
671,2019-11-14,163,13741,1804,1,15709
671,2019-11-15,140,3288,1806,1,5235
671,2019-11-16,848,3702,2284,2,6836
671,2019-11-17,194,4764,3161,0,8119
671,2019-11-18,950,2067,3205,1,6223
671,2019-11-19,221,2740,2636,0,5597
671,2019-11-20,135,800,2607,5,3547
671,2019-11-21,139,3131,1856,0,5126
671,2019-11-22,142,8449,1986,2,10579
671,2019-11-23,1984,6616,2441,1,11042
671,2019-11-24,318,6072,1862,2,8254
671,2019-11-25,1058,5682,1608,1,8349
671,2019-11-26,84,4760,2563,1,7408
671,2019-11-27,235,5507,1408,0,7150
671,2019-11-28,108,7842,711,0,8661
671,2019-11-29,26,718,1,0,745
671,2019-08-06,0,0,89,0,89
671,2019-08-07,226,210,319,1,756
671,2019-08-08,122,80,215,0,417
671,2019-08-09,69,328,298,0,695
671,2019-08-10,182,425,323,0,930
671,2019-08-11,285,269,237,0,791
671,2019-08-12,232,316,52,0,600
671,2019-08-13,214,529,202,0,945
671,2019-08-14,158,601,191,0,950
671,2019-08-15,110,738,92,0,940
671,2019-08-16,131,225,202,1,559
671,2019-08-17,109,1382,759,0,2250
671,2019-08-18,120,291,936,1,1348
671,2019-08-19,699,804,958,1,2462
671,2019-08-20,218,2646,920,0,3784
671,2019-08-21,162,886,1365,0,2413
671,2019-08-22,164,13318,1703,2,15187
671,2019-08-23,164,13088,1557,3,14812
671,2019-08-24,149,4156,1799,1,6105
671,2019-08-25,176,31723,2070,2,33971
671,2019-08-26,153,29252,1742,1,31148
671,2019-08-27,228,6439,2250,2,8919
671,2019-08-28,1084,4077,1620,2,6783
671,2019-08-29,414,9057,2005,0,11476
671,2019-08-30,207,2456,814,2,3479
671,2019-08-31,60,70,0,0,130
671,2019-09-01,78,1000,329,1,1408
671,2019-09-02,81,22,156,0,259
671,2019-09-03,117,556,1642,0,2315
671,2019-09-04,108,10230,2098,1,12437
671,2019-09-05,1008,7924,1766,2,10700
671,2019-09-06,164,10512,1559,0,12235
671,2019-09-07,272,11567,1393,1,13233
671,2019-09-08,235,6218,2812,0,9265
671,2019-09-09,240,8037,2618,0,10895
671,2019-09-10,217,12281,1729,0,14227
671,2019-09-11,188,8912,2547,2,11649
671,2019-09-12,277,6775,1818,3,8873
671,2019-09-13,237,6676,2340,1,9254
671,2019-09-14,130,10263,1484,0,11877
671,2019-09-15,145,8827,1763,1,10736
671,2019-09-16,997,12992,1743,1,15733
671,2019-09-17,142,8137,3203,0,11482
671,2019-09-18,168,11468,1405,2,13043
671,2019-09-19,268,9765,1439,0,11472
671,2019-09-20,240,17294,1929,0,19463
671,2019-09-21,1836,7241,1530,2,10609
671,2019-09-22,100,8938,1137,1,10176
671,2019-09-23,1119,10221,2024,0,13364
671,2019-09-24,160,8435,3007,2,11604
671,2019-09-25,167,9930,1976,2,12075
671,2019-09-26,168,10676,1614,3,12461
671,2019-09-27,123,8518,1512,1,10154
671,2019-09-28,174,23925,1153,2,25254
671,2019-09-29,399,19859,1735,1,21994
671,2019-09-30,1587,23749,1984,1,27321
671,2019-10-01,972,21766,1020,1,23759
671,2019-10-02,126,11120,1854,0,13100
671,2019-10-03,581,13340,1400,2,15323
671,2019-10-04,147,11587,1805,1,13540
671,2019-10-05,748,20441,1713,0,22902
671,2019-10-06,586,13526,1976,2,16090
671,2019-10-07,2720,4649,2267,0,9636
671,2019-10-08,241,16563,1318,0,18122
671,2019-10-09,98,24903,1210,1,26212
671,2019-10-10,144,17031,1974,3138,22287
671,2019-10-11,169,8547,2311,3,11030
671,2019-10-12,138,5895,1295,2,7330
671,2019-10-13,128,8209,2121,1,10459
671,2019-10-14,786,5393,3213,2,9394
671,2019-10-15,129,8706,2025,3,10863
671,2019-10-16,149,17808,1002,3,18962
671,2019-10-17,122,6672,1947,0,8741
671,2019-10-18,215,7990,2145,0,10350
671,2019-10-19,115,4288,1847,0,6250
671,2019-10-20,114,1503,2088,0,3705
671,2019-10-21,282,10543,1469,2,12296
671,2019-10-22,108,4927,1201,2,6238
671,2019-10-23,197,13312,1497,0,15006
671,2019-10-24,252,18558,1832,2,20644
671,2019-10-25,1046,5089,2435,2,8572
671,2019-10-26,100,17043,1183,0,18326
671,2019-10-27,132,17793,1339,0,19264
671,2019-10-28,510,13439,1517,0,15466
671,2019-10-29,459,14719,1034,1,16213
671,2019-10-30,203,15023,1724,3,16953
671,2019-10-31,80,11382,1375,2,12839
671,2019-11-01,1475,18707,1565,0,21747
671,2019-11-02,89,14437,773,0,15299
671,2019-11-03,801,22194,1206,0,24201
671,2019-11-04,260,6376,1436,2,8074
671,2019-11-05,165,1317,2310,0,3792
671,2019-11-06,147,13207,1374,1,14729
671,2019-11-07,251,16037,798,2,17088
671,2019-11-08,110,8966,1122,0,10198
671,2019-11-09,102,7830,1689,2,9623
671,2019-11-10,814,22293,2377,1,25485
671,2019-11-11,143,14328,2220,1,16692
671,2019-11-12,138,16221,3738,754,20851
671,2019-11-13,164,19138,1899,4,21205
671,2019-11-14,163,13741,1804,1,15709
671,2019-11-15,140,3288,1806,1,5235
671,2019-11-16,848,3702,2284,2,6836
671,2019-11-17,194,4764,3161,0,8119
671,2019-11-18,950,2067,3205,1,6223
671,2019-11-19,221,2740,2636,0,5597
671,2019-11-20,135,800,2607,5,3547
671,2019-11-21,139,3131,1856,0,5126
671,2019-11-22,142,8449,1986,2,10579
671,2019-11-23,1984,6616,2441,1,11042
671,2019-11-24,318,6072,1862,2,8254
671,2019-11-25,1058,5682,1608,1,8349
671,2019-11-26,84,4760,2563,1,7408
671,2019-11-27,235,5507,1408,0,7150
671,2019-11-28,108,7842,711,0,8661
671,2019-11-29,26,718,1,0,745
671,2019-08-07,226,210,319,1,756
671,2019-08-08,122,80,215,0,417
671,2019-08-09,69,328,298,0,695
671,2019-08-10,182,425,323,0,930
671,2019-08-11,285,269,237,0,791
671,2019-08-12,232,316,52,0,600
671,2019-08-13,214,529,202,0,945
671,2019-08-14,158,601,191,0,950
671,2019-08-15,110,738,92,0,940
671,2019-08-16,131,225,202,1,559
671,2019-08-17,109,1382,759,0,2250
671,2019-08-18,120,291,936,1,1348
671,2019-08-19,699,804,958,1,2462
671,2019-08-20,218,2646,920,0,3784
671,2019-08-21,162,886,1365,0,2413
671,2019-08-22,164,13318,1703,2,15187
671,2019-08-23,164,13088,1557,3,14812
671,2019-08-24,149,4156,1799,1,6105
671,2019-08-25,176,31723,2070,2,33971
671,2019-08-26,153,29252,1742,1,31148
671,2019-08-27,228,6439,2250,2,8919
671,2019-08-28,1084,4077,1620,2,6783
671,2019-08-29,414,9057,2005,0,11476
671,2019-08-30,207,2456,814,2,3479
671,2019-08-31,60,70,0,0,130
671,2019-09-01,78,1000,329,1,1408
671,2019-09-02,81,22,156,0,259
671,2019-09-03,117,556,1642,0,2315
671,2019-09-04,108,10230,2098,1,12437
671,2019-09-05,1008,7924,1766,2,10700
671,2019-09-06,164,10512,1559,0,12235
671,2019-09-07,272,11567,1393,1,13233
671,2019-09-08,235,6218,2812,0,9265
671,2019-09-09,240,8037,2618,0,10895
671,2019-09-10,217,12281,1729,0,14227
671,2019-09-11,188,8912,2547,2,11649
671,2019-09-12,277,6775,1818,3,8873
671,2019-09-13,237,6676,2340,1,9254
671,2019-09-14,130,10263,1484,0,11877
671,2019-09-15,145,8827,1763,1,10736
671,2019-09-16,997,12992,1743,1,15733
671,2019-09-17,142,8137,3203,0,11482
671,2019-09-18,168,11468,1405,2,13043
671,2019-09-19,268,9765,1439,0,11472
671,2019-09-20,240,17294,1929,0,19463
671,2019-09-21,1836,7241,1530,2,10609
671,2019-09-22,100,8938,1137,1,10176
671,2019-09-23,1119,10221,2024,0,13364
671,2019-09-24,160,8435,3007,2,11604
671,2019-09-25,167,9930,1976,2,12075
671,2019-09-26,168,10676,1614,3,12461
671,2019-09-27,123,8518,1512,1,10154
671,2019-09-28,174,23925,1153,2,25254
671,2019-09-29,399,19859,1735,1,21994
671,2019-09-30,1587,23749,1984,1,27321
671,2019-10-01,972,21766,1020,1,23759
671,2019-10-02,126,11120,1854,0,13100
671,2019-10-03,581,13340,1400,2,15323
671,2019-10-04,147,11587,1805,1,13540
671,2019-10-05,748,20441,1713,0,22902
671,2019-10-06,586,13526,1976,2,16090
671,2019-10-07,2720,4649,2267,0,9636
671,2019-10-08,241,16563,1318,0,18122
671,2019-10-09,98,24903,1210,1,26212
671,2019-10-10,144,17031,1974,3138,22287
671,2019-10-11,169,8547,2311,3,11030
671,2019-10-12,138,5895,1295,2,7330
671,2019-10-13,128,8209,2121,1,10459
671,2019-10-14,786,5393,3213,2,9394
671,2019-10-15,129,8706,2025,3,10863
671,2019-10-16,149,17808,1002,3,18962
671,2019-10-17,122,6672,1947,0,8741
671,2019-10-18,215,7990,2145,0,10350
671,2019-10-19,115,4288,1847,0,6250
671,2019-10-20,114,1503,2088,0,3705
671,2019-10-21,282,10543,1469,2,12296
671,2019-10-22,108,4927,1201,2,6238
671,2019-10-23,197,13312,1497,0,15006
671,2019-10-24,252,18558,1832,2,20644
671,2019-10-25,1046,5089,2435,2,8572
671,2019-10-26,100,17043,1183,0,18326
671,2019-10-27,132,17793,1339,0,19264
671,2019-10-28,510,13439,1517,0,15466
671,2019-10-29,459,14719,1034,1,16213
671,2019-10-30,203,15023,1724,3,16953
671,2019-10-31,80,11382,1375,2,12839
671,2019-11-01,1475,18707,1565,0,21747
671,2019-11-02,89,14437,773,0,15299
671,2019-11-03,801,22194,1206,0,24201
671,2019-11-04,260,6376,1436,2,8074
671,2019-11-05,165,1317,2310,0,3792
671,2019-11-06,147,13207,1374,1,14729
671,2019-11-07,251,16037,798,2,17088
671,2019-11-08,110,8966,1122,0,10198
671,2019-11-09,102,7830,1689,2,9623
671,2019-11-10,814,22293,2377,1,25485
671,2019-11-11,143,14328,2220,1,16692
671,2019-11-12,138,16221,3738,754,20851
671,2019-11-13,164,19138,1899,4,21205
671,2019-11-14,163,13741,1804,1,15709
671,2019-11-15,140,3288,1806,1,5235
671,2019-11-16,848,3702,2284,2,6836
671,2019-11-17,194,4764,3161,0,8119
671,2019-11-18,950,2067,3205,1,6223
671,2019-11-19,221,2740,2636,0,5597
671,2019-11-20,135,800,2607,5,3547
671,2019-11-21,139,3131,1856,0,5126
671,2019-11-22,142,8449,1986,2,10579
671,2019-11-23,1984,6616,2441,1,11042
671,2019-11-24,318,6072,1862,2,8254
671,2019-11-25,1058,5682,1608,1,8349
671,2019-11-26,84,4760,2563,1,7408
672,2019-08-07,17,2,270,1,290
672,2019-08-08,83,234,259,0,576
672,2019-08-09,123,279,307,0,709
672,2019-08-10,229,300,152,1,682
672,2019-08-11,371,173,68,1,613
672,2019-08-12,897,296,150,2,1345
672,2019-08-13,702,321,397,0,1420
672,2019-08-14,517,340,166,0,1023
672,2019-08-15,518,969,43,0,1530
672,2019-08-16,514,290,102,0,906
672,2019-08-17,269,884,692,1,1846
672,2019-08-18,1154,459,1272,0,2885
672,2019-08-19,513,1239,1484,1,3237
672,2019-08-20,133,1197,1583,0,2913
672,2019-08-21,151,816,1140,0,2107
672,2019-08-22,122,14411,1980,0,16513
672,2019-08-23,108,28418,1674,3,30203
672,2019-08-24,146,7826,1586,1,9559
672,2019-08-25,1029,16194,1099,2,18324
672,2019-08-26,164,15179,1615,0,16958
672,2019-08-27,145,12522,1446,2,14115
672,2019-08-28,172,19012,1620,1,20805
672,2019-08-29,160,13230,1261,2,14653
672,2019-08-30,150,4227,911,2,5290
672,2019-08-31,39,16,3,0,58
672,2019-09-01,127,198,467,0,792
672,2019-09-02,53,104,7,0,164
672,2019-09-03,91,1603,933,2,2629
672,2019-09-04,977,8476,1952,1,11406
672,2019-09-05,125,7339,2559,2,10025
672,2019-09-06,147,17547,1619,1,19314
672,2019-09-07,199,11594,1784,0,13577
672,2019-09-08,283,32037,1584,0,33904
672,2019-09-09,320,9831,1802,0,11953
672,2019-09-10,1027,8651,1698,1,11377
672,2019-09-11,1018,9418,2254,2,12692
672,2019-09-12,910,6433,2415,0,9758
672,2019-09-13,131,9876,2185,1,12193
672,2019-09-14,109,7130,2142,0,9381
672,2019-09-15,954,9141,2737,2,12834
672,2019-09-16,995,13490,2814,1,17300
672,2019-09-17,224,13170,1800,879,16073
672,2019-09-18,125,11799,903,0,12827
672,2019-09-19,437,4154,1566,1,6158
672,2019-09-20,140,7562,2399,1,10102
672,2019-09-21,97,5867,1694,0,7658
672,2019-09-22,1773,13549,2507,0,17829
672,2019-09-23,276,9868,2656,3,12803
672,2019-09-24,137,7970,2564,2,10673
672,2019-09-25,216,9649,2001,2,11868
672,2019-09-26,136,9746,2153,2,12037
672,2019-09-27,212,8923,1536,2,10673
672,2019-09-28,1050,14694,1919,3,17666
672,2019-09-29,232,16085,1938,2,18257
672,2019-09-30,218,25761,1274,0,27253
672,2019-10-01,176,21624,2012,0,23812
672,2019-10-02,1344,11458,1497,0,14299
672,2019-10-03,862,13642,1553,2,16059
672,2019-10-04,136,11686,1442,0,13264
672,2019-10-05,1168,13611,1090,3,15872
672,2019-10-06,474,9748,1038,0,11260
672,2019-10-07,110,5208,1999,5,7322
672,2019-10-08,141,11687,1627,3,13458
672,2019-10-09,150,14030,1567,1,15748
672,2019-10-10,157,10087,1694,3,11941
672,2019-10-11,1474,11544,1829,0,14847
672,2019-10-12,1010,4261,2177,1,7449
672,2019-10-13,135,7461,1960,3,9559
672,2019-10-14,137,5406,1989,0,7532
672,2019-10-15,273,7347,1652,1,9273
672,2019-10-16,133,17940,1535,0,19608
672,2019-10-17,138,7393,1848,1,9380
672,2019-10-18,1124,7777,1703,4,10608
672,2019-10-19,154,4094,1714,1,5963
672,2019-10-20,1020,751,2948,0,4719
672,2019-10-21,811,9616,1205,0,11632
672,2019-10-22,129,4762,1706,1,6598
672,2019-10-23,153,13045,1322,3,14523
672,2019-10-24,739,24833,1962,0,27534
672,2019-10-25,193,18359,2094,1,20647
672,2019-10-26,163,24329,2309,1,26802
672,2019-10-27,170,18314,1226,0,19710
672,2019-10-28,1969,22685,1787,0,26441
672,2019-10-29,249,16732,1595,0,18576
672,2019-10-30,707,15340,1245,0,17292
672,2019-10-31,219,11535,1621,1,13376
672,2019-11-01,1109,26507,1801,0,29417
672,2019-11-02,112,16429,1647,5,18193
672,2019-11-03,171,36508,1358,0,38037
672,2019-11-04,184,13440,2178,0,15802
672,2019-11-05,207,1841,1648,1,3697
672,2019-11-06,1359,13136,1545,1,16041
672,2019-11-07,253,24751,894,3,25901
672,2019-11-08,156,16759,1558,3,18476
672,2019-11-09,165,19814,2109,0,22088
672,2019-11-10,437,12806,1541,0,14784
672,2019-11-11,712,12444,1895,1,15052
672,2019-11-12,148,12171,3072,3,15394
672,2019-11-13,132,19725,2326,2,22185
672,2019-11-14,204,14306,1323,0,15833
672,2019-11-15,130,4797,3587,0,8514
672,2019-11-16,629,2615,2857,0,6101
672,2019-11-17,123,3228,3634,0,6985
672,2019-11-18,192,2513,3728,0,6433
672,2019-11-19,246,5462,2818,0,8526
672,2019-11-20,158,1389,1589,0,3136
672,2019-11-21,183,3566,2189,0,5938
672,2019-11-22,152,5441,1849,0,7442
672,2019-11-23,95,6828,2671,0,9594
672,2019-11-24,1387,10797,1669,0,13853
672,2019-11-25,146,7466,1557,0,9169
672,2019-11-26,168,10094,2397,0,12659
672,2019-11-27,105,8332,2085,0,10522
672,2019-11-28,627,12695,476,0,13798
672,2019-08-07,17,2,270,1,290
672,2019-08-08,83,234,259,0,576
672,2019-08-09,123,279,307,0,709
672,2019-08-10,229,300,152,1,682
672,2019-08-11,371,173,68,1,613
672,2019-08-12,897,296,150,2,1345
672,2019-08-13,702,321,397,0,1420
672,2019-08-14,517,340,166,0,1023
672,2019-08-15,518,969,43,0,1530
672,2019-08-16,514,290,102,0,906
672,2019-08-17,269,884,692,1,1846
672,2019-08-18,1154,459,1272,0,2885
672,2019-08-19,513,1239,1484,1,3237
672,2019-08-20,133,1197,1583,0,2913
672,2019-08-21,151,816,1140,0,2107
672,2019-08-22,122,14411,1980,0,16513
672,2019-08-23,108,28418,1674,3,30203
672,2019-08-24,146,7826,1586,1,9559
672,2019-08-25,1029,16194,1099,2,18324
672,2019-08-26,164,15179,1615,0,16958
672,2019-08-27,145,12522,1446,2,14115
672,2019-08-28,172,19012,1620,1,20805
672,2019-08-29,160,13230,1261,2,14653
672,2019-08-30,150,4227,911,2,5290
672,2019-08-31,39,16,3,0,58
672,2019-09-01,127,198,467,0,792
672,2019-09-02,53,104,7,0,164
672,2019-09-03,91,1603,933,2,2629
672,2019-09-04,977,8476,1952,1,11406
672,2019-09-05,125,7339,2559,2,10025
672,2019-09-06,147,17547,1619,1,19314
672,2019-09-07,199,11594,1784,0,13577
672,2019-09-08,283,32037,1584,0,33904
672,2019-09-09,320,9831,1802,0,11953
672,2019-09-10,1027,8651,1698,1,11377
672,2019-09-11,1018,9418,2254,2,12692
672,2019-09-12,910,6433,2415,0,9758
672,2019-09-13,131,9876,2185,1,12193
672,2019-09-14,109,7130,2142,0,9381
672,2019-09-15,954,9141,2737,2,12834
672,2019-09-16,995,13490,2814,1,17300
672,2019-09-17,224,13170,1800,879,16073
672,2019-09-18,125,11799,903,0,12827
672,2019-09-19,437,4154,1566,1,6158
672,2019-09-20,140,7562,2399,1,10102
672,2019-09-21,97,5867,1694,0,7658
672,2019-09-22,1773,13549,2507,0,17829
672,2019-09-23,276,9868,2656,3,12803
672,2019-09-24,137,7970,2564,2,10673
672,2019-09-25,216,9649,2001,2,11868
672,2019-09-26,136,9746,2153,2,12037
672,2019-09-27,212,8923,1536,2,10673
672,2019-09-28,1050,14694,1919,3,17666
672,2019-09-29,232,16085,1938,2,18257
672,2019-09-30,218,25761,1274,0,27253
672,2019-10-01,176,21624,2012,0,23812
672,2019-10-02,1344,11458,1497,0,14299
672,2019-10-03,862,13642,1553,2,16059
672,2019-10-04,136,11686,1442,0,13264
672,2019-10-05,1168,13611,1090,3,15872
672,2019-10-06,474,9748,1038,0,11260
672,2019-10-07,110,5208,1999,5,7322
672,2019-10-08,141,11687,1627,3,13458
672,2019-10-09,150,14030,1567,1,15748
672,2019-10-10,157,10087,1694,3,11941
672,2019-10-11,1474,11544,1829,0,14847
672,2019-10-12,1010,4261,2177,1,7449
672,2019-10-13,135,7461,1960,3,9559
672,2019-10-14,137,5406,1989,0,7532
672,2019-10-15,273,7347,1652,1,9273
672,2019-10-16,133,17940,1535,0,19608
672,2019-10-17,138,7393,1848,1,9380
672,2019-10-18,1124,7777,1703,4,10608
672,2019-10-19,154,4094,1714,1,5963
672,2019-10-20,1020,751,2948,0,4719
672,2019-10-21,811,9616,1205,0,11632
672,2019-10-22,129,4762,1706,1,6598
672,2019-10-23,153,13045,1322,3,14523
672,2019-10-24,739,24833,1962,0,27534
672,2019-10-25,193,18359,2094,1,20647
672,2019-10-26,163,24329,2309,1,26802
672,2019-10-27,170,18314,1226,0,19710
672,2019-10-28,1969,22685,1787,0,26441
672,2019-10-29,249,16732,1595,0,18576
672,2019-10-30,707,15340,1245,0,17292
672,2019-10-31,219,11535,1621,1,13376
672,2019-11-01,1109,26507,1801,0,29417
672,2019-11-02,112,16429,1647,5,18193
672,2019-11-03,171,36508,1358,0,38037
672,2019-11-04,184,13440,2178,0,15802
672,2019-11-05,207,1841,1648,1,3697
672,2019-11-06,1359,13136,1545,1,16041
672,2019-11-07,253,24751,894,3,25901
672,2019-11-08,156,16759,1558,3,18476
672,2019-11-09,165,19814,2109,0,22088
672,2019-11-10,437,12806,1541,0,14784
672,2019-11-11,712,12444,1895,1,15052
672,2019-11-12,148,12171,3072,3,15394
672,2019-11-13,132,19725,2326,2,22185
672,2019-11-14,204,14306,1323,0,15833
672,2019-11-15,130,4797,3587,0,8514
672,2019-11-16,629,2615,2857,0,6101
672,2019-11-17,123,3228,3634,0,6985
672,2019-11-18,192,2513,3728,0,6433
672,2019-11-19,246,5462,2818,0,8526
672,2019-11-20,158,1389,1589,0,3136
672,2019-11-21,183,3566,2189,0,5938
672,2019-11-22,152,5441,1849,0,7442
672,2019-11-23,95,6828,2671,0,9594
672,2019-11-24,1387,10797,1669,0,13853
672,2019-11-25,146,7466,1557,0,9169
672,2019-11-26,168,10094,2397,0,12659
672,2019-11-27,105,8332,2085,0,10522
672,2019-11-28,627,12695,476,0,13798
672,2019-11-29,0,7,0,0,7
672,2019-08-07,17,2,270,1,290
672,2019-08-08,83,234,259,0,576
672,2019-08-09,123,279,307,0,709
672,2019-08-10,229,300,152,1,682
672,2019-08-11,371,173,68,1,613
672,2019-08-12,897,296,150,2,1345
672,2019-08-13,702,321,397,0,1420
672,2019-08-14,517,340,166,0,1023
672,2019-08-15,518,969,43,0,1530
672,2019-08-16,514,290,102,0,906
672,2019-08-17,269,884,692,1,1846
672,2019-08-18,1154,459,1272,0,2885
672,2019-08-19,513,1239,1484,1,3237
672,2019-08-20,133,1197,1583,0,2913
672,2019-08-21,151,816,1140,0,2107
672,2019-08-22,122,14411,1980,0,16513
672,2019-08-23,108,28418,1674,3,30203
672,2019-08-24,146,7826,1586,1,9559
672,2019-08-25,1029,16194,1099,2,18324
672,2019-08-26,164,15179,1615,0,16958
672,2019-08-27,145,12522,1446,2,14115
672,2019-08-28,172,19012,1620,1,20805
672,2019-08-29,160,13230,1261,2,14653
672,2019-08-30,150,4227,911,2,5290
672,2019-08-31,39,16,3,0,58
672,2019-09-01,127,198,467,0,792
672,2019-09-02,53,104,7,0,164
672,2019-09-03,91,1603,933,2,2629
672,2019-09-04,977,8476,1952,1,11406
672,2019-09-05,125,7339,2559,2,10025
672,2019-09-06,147,17547,1619,1,19314
672,2019-09-07,199,11594,1784,0,13577
672,2019-09-08,283,32037,1584,0,33904
672,2019-09-09,320,9831,1802,0,11953
672,2019-09-10,1027,8651,1698,1,11377
672,2019-09-11,1018,9418,2254,2,12692
672,2019-09-12,910,6433,2415,0,9758
672,2019-09-13,131,9876,2185,1,12193
672,2019-09-14,109,7130,2142,0,9381
672,2019-09-15,954,9141,2737,2,12834
672,2019-09-16,995,13490,2814,1,17300
672,2019-09-17,224,13170,1800,879,16073
672,2019-09-18,125,11799,903,0,12827
672,2019-09-19,437,4154,1566,1,6158
672,2019-09-20,140,7562,2399,1,10102
672,2019-09-21,97,5867,1694,0,7658
672,2019-09-22,1773,13549,2507,0,17829
672,2019-09-23,276,9868,2656,3,12803
672,2019-09-24,137,7970,2564,2,10673
672,2019-09-25,216,9649,2001,2,11868
672,2019-09-26,136,9746,2153,2,12037
672,2019-09-27,212,8923,1536,2,10673
672,2019-09-28,1050,14694,1919,3,17666
672,2019-09-29,232,16085,1938,2,18257
672,2019-09-30,218,25761,1274,0,27253
672,2019-10-01,176,21624,2012,0,23812
672,2019-10-02,1344,11458,1497,0,14299
672,2019-10-03,862,13642,1553,2,16059
672,2019-10-04,136,11686,1442,0,13264
672,2019-10-05,1168,13611,1090,3,15872
672,2019-10-06,474,9748,1038,0,11260
672,2019-10-07,110,5208,1999,5,7322
672,2019-10-08,141,11687,1627,3,13458
672,2019-10-09,150,14030,1567,1,15748
672,2019-10-10,157,10087,1694,3,11941
672,2019-10-11,1474,11544,1829,0,14847
672,2019-10-12,1010,4261,2177,1,7449
672,2019-10-13,135,7461,1960,3,9559
672,2019-10-14,137,5406,1989,0,7532
672,2019-10-15,273,7347,1652,1,9273
672,2019-10-16,133,17940,1535,0,19608
672,2019-10-17,138,7393,1848,1,9380
672,2019-10-18,1124,7777,1703,4,10608
672,2019-10-19,154,4094,1714,1,5963
672,2019-10-20,1020,751,2948,0,4719
672,2019-10-21,811,9616,1205,0,11632
672,2019-10-22,129,4762,1706,1,6598
672,2019-10-23,153,13045,1322,3,14523
672,2019-10-24,739,24833,1962,0,27534
672,2019-10-25,193,18359,2094,1,20647
672,2019-10-26,163,24329,2309,1,26802
672,2019-10-27,170,18314,1226,0,19710
672,2019-10-28,1969,22685,1787,0,26441
672,2019-10-29,249,16732,1595,0,18576
672,2019-10-30,707,15340,1245,0,17292
672,2019-10-31,219,11535,1621,1,13376
672,2019-11-01,1109,26507,1801,0,29417
672,2019-11-02,112,16429,1647,5,18193
672,2019-11-03,171,36508,1358,0,38037
672,2019-11-04,184,13440,2178,0,15802
672,2019-11-05,207,1841,1648,1,3697
672,2019-11-06,1359,13136,1545,1,16041
672,2019-11-07,253,24751,894,3,25901
672,2019-11-08,156,16759,1558,3,18476
672,2019-11-09,165,19814,2109,0,22088
672,2019-11-10,437,12806,1541,0,14784
672,2019-11-11,712,12444,1895,1,15052
672,2019-11-12,148,12171,3072,3,15394
672,2019-11-13,132,19725,2326,2,22185
672,2019-11-14,204,14306,1323,0,15833
672,2019-11-15,130,4797,3587,0,8514
672,2019-11-16,629,2615,2857,0,6101
672,2019-11-17,123,3228,3634,0,6985
672,2019-11-18,192,2513,3728,0,6433
672,2019-11-19,246,5462,2818,0,8526
672,2019-11-20,158,1389,1589,0,3136
672,2019-11-21,183,3566,2189,0,5938
672,2019-11-22,152,5441,1849,0,7442
672,2019-11-23,95,6828,2671,0,9594
672,2019-11-24,1387,10797,1669,0,13853
672,2019-11-25,146,7466,1557,0,9169
672,2019-11-26,168,10094,2397,0,12659
672,2019-11-27,105,8332,2085,0,10522
672,2019-11-28,627,12695,476,0,13798
672,2019-08-07,17,2,270,1,290
672,2019-08-08,83,234,259,0,576
672,2019-08-09,123,279,307,0,709
672,2019-08-10,229,300,152,1,682
672,2019-08-11,371,173,68,1,613
672,2019-08-12,897,296,150,2,1345
672,2019-08-13,702,321,397,0,1420
672,2019-08-14,517,340,166,0,1023
672,2019-08-15,518,969,43,0,1530
672,2019-08-16,514,290,102,0,906
672,2019-08-17,269,884,692,1,1846
672,2019-08-18,1154,459,1272,0,2885
672,2019-08-19,513,1239,1484,1,3237
672,2019-08-20,133,1197,1583,0,2913
672,2019-08-21,151,816,1140,0,2107
672,2019-08-22,122,14411,1980,0,16513
672,2019-08-23,108,28418,1674,3,30203
672,2019-08-24,146,7826,1586,1,9559
672,2019-08-25,1029,16194,1099,2,18324
672,2019-08-26,164,15179,1615,0,16958
672,2019-08-27,145,12522,1446,2,14115
672,2019-08-28,172,19012,1620,1,20805
672,2019-08-29,160,13230,1261,2,14653
672,2019-08-30,150,4227,911,2,5290
672,2019-08-31,39,16,3,0,58
672,2019-09-01,127,198,467,0,792
672,2019-09-02,53,104,7,0,164
672,2019-09-03,91,1603,933,2,2629
672,2019-09-04,977,8476,1952,1,11406
672,2019-09-05,125,7339,2559,2,10025
672,2019-09-06,147,17547,1619,1,19314
672,2019-09-07,199,11594,1784,0,13577
672,2019-09-08,283,32037,1584,0,33904
672,2019-09-09,320,9831,1802,0,11953
672,2019-09-10,1027,8651,1698,1,11377
672,2019-09-11,1018,9418,2254,2,12692
672,2019-09-12,910,6433,2415,0,9758
672,2019-09-13,131,9876,2185,1,12193
672,2019-09-14,109,7130,2142,0,9381
672,2019-09-15,954,9141,2737,2,12834
672,2019-09-16,995,13490,2814,1,17300
672,2019-09-17,224,13170,1800,879,16073
672,2019-09-18,125,11799,903,0,12827
672,2019-09-19,437,4154,1566,1,6158
672,2019-09-20,140,7562,2399,1,10102
672,2019-09-21,97,5867,1694,0,7658
672,2019-09-22,1773,13549,2507,0,17829
672,2019-09-23,276,9868,2656,3,12803
672,2019-09-24,137,7970,2564,2,10673
672,2019-09-25,216,9649,2001,2,11868
672,2019-09-26,136,9746,2153,2,12037
672,2019-09-27,212,8923,1536,2,10673
672,2019-09-28,1050,14694,1919,3,17666
672,2019-09-29,232,16085,1938,2,18257
672,2019-09-30,218,25761,1274,0,27253
672,2019-10-01,176,21624,2012,0,23812
672,2019-10-02,1344,11458,1497,0,14299
672,2019-10-03,862,13642,1553,2,16059
672,2019-10-04,136,11686,1442,0,13264
672,2019-10-05,1168,13611,1090,3,15872
672,2019-10-06,474,9748,1038,0,11260
672,2019-10-07,110,5208,1999,5,7322
672,2019-10-08,141,11687,1627,3,13458
672,2019-10-09,150,14030,1567,1,15748
672,2019-10-10,157,10087,1694,3,11941
672,2019-10-11,1474,11544,1829,0,14847
672,2019-10-12,1010,4261,2177,1,7449
672,2019-10-13,135,7461,1960,3,9559
672,2019-10-14,137,5406,1989,0,7532
672,2019-10-15,273,7347,1652,1,9273
672,2019-10-16,133,17940,1535,0,19608
672,2019-10-17,138,7393,1848,1,9380
672,2019-10-18,1124,7777,1703,4,10608
672,2019-10-19,154,4094,1714,1,5963
672,2019-10-20,1020,751,2948,0,4719
672,2019-10-21,811,9616,1205,0,11632
672,2019-10-22,129,4762,1706,1,6598
672,2019-10-23,153,13045,1322,3,14523
672,2019-10-24,739,24833,1962,0,27534
672,2019-10-25,193,18359,2094,1,20647
672,2019-10-26,163,24329,2309,1,26802
672,2019-10-27,170,18314,1226,0,19710
672,2019-10-28,1969,22685,1787,0,26441
672,2019-10-29,249,16732,1595,0,18576
672,2019-10-30,707,15340,1245,0,17292
672,2019-10-31,219,11535,1621,1,13376
672,2019-11-01,1109,26507,1801,0,29417
672,2019-11-02,112,16429,1647,5,18193
672,2019-11-03,171,36508,1358,0,38037
672,2019-11-04,184,13440,2178,0,15802
672,2019-11-05,207,1841,1648,1,3697
672,2019-11-06,1359,13136,1545,1,16041
672,2019-11-07,253,24751,894,3,25901
672,2019-11-08,156,16759,1558,3,18476
672,2019-11-09,165,19814,2109,0,22088
672,2019-11-10,437,12806,1541,0,14784
672,2019-11-11,712,12444,1895,1,15052
672,2019-11-12,148,12171,3072,3,15394
672,2019-11-13,132,19725,2326,2,22185
673,2019-08-07,221,2,192,0,415
673,2019-08-08,15454,186,379,0,16019
673,2019-08-09,14084,280,56,0,14420
673,2019-08-10,7435,545,132,0,8112
673,2019-08-11,6091,249,177,0,6517
673,2019-08-12,13081,14328,135,0,27544
673,2019-08-13,11478,12795,154,1,24428
673,2019-08-14,10994,117,100,0,11211
673,2019-08-15,9251,424,183,0,9858
673,2019-08-16,12116,746,153,1,13016
673,2019-08-17,45284,1254,617,1,47156
673,2019-08-18,58101,2577,1320,0,61998
673,2019-08-19,56610,9481,1297,3,67391
673,2019-08-20,19588,13546,1025,1,34160
673,2019-08-21,13988,10368,1018,1,25375
673,2019-08-22,2493,13856,2144,1,18494
673,2019-08-23,7882,23082,1321,4,32289
673,2019-08-24,2455,16050,1440,1,19946
673,2019-08-25,4176,30118,2212,2,36508
673,2019-08-26,5774,26516,1731,0,34021
673,2019-08-27,11751,13571,2089,1,27412
673,2019-08-28,17321,28688,1354,2,47365
673,2019-08-29,157,16730,2143,4,19034
673,2019-08-30,589,2821,363,1,3774
673,2019-08-31,76,8146,4,0,8226
673,2019-09-01,164,3121,294,0,3579
673,2019-09-02,845,238,48,0,1131
673,2019-09-03,15417,789,501,1,16708
673,2019-09-04,19341,10362,1699,1,31403
673,2019-09-05,150,5245,1909,0,7304
673,2019-09-06,6538,15658,1775,0,23971
673,2019-09-07,267,12022,1583,0,13872
673,2019-09-08,1166,7043,2160,2,10371
673,2019-09-09,331,7926,1328,3,9588
673,2019-09-10,5742,9021,2390,1,17154
673,2019-09-11,9369,6285,2993,1,18648
673,2019-09-12,1127,11445,2320,0,14892
673,2019-09-13,1578,7472,2063,1,11114
673,2019-09-14,1201,9814,1972,2,12989
673,2019-09-15,1035,6312,1687,1,9035
673,2019-09-16,16153,13913,1755,0,31821
673,2019-09-17,184,13017,1175,0,14376
673,2019-09-18,21836,11073,1628,2,34539
673,2019-09-19,49151,10035,1832,1,61019
673,2019-09-20,16507,13314,1336,0,31157
673,2019-09-21,1054,7975,3669,1,12699
673,2019-09-22,1839,9082,1393,0,12314
673,2019-09-23,2114,8998,1620,3,12735
673,2019-09-24,823,7628,1584,4,10039
673,2019-09-25,19088,6959,1180,2,27229
673,2019-09-26,33641,11547,2218,0,47406
673,2019-09-27,30701,7833,1903,3,40440
673,2019-09-28,209,25012,1714,3,26938
673,2019-09-29,229,18332,1633,1,20195
673,2019-09-30,22213,24094,1189,0,47496
673,2019-10-01,4737,26895,1675,1,33308
673,2019-10-02,39258,18451,760,0,58469
673,2019-10-03,30804,12946,1843,0,45593
673,2019-10-04,4143,19241,1537,2,24923
673,2019-10-05,178,23161,1360,1,24700
673,2019-10-06,2607,15500,1667,1,19775
673,2019-10-07,6919,4615,1709,0,13243
673,2019-10-08,4849,11569,1066,2,17486
673,2019-10-09,177,13127,1403,0,14707
673,2019-10-10,2557,9210,1515,0,13282
673,2019-10-11,163,11600,1592,2,13357
673,2019-10-12,1082,6272,2031,0,9385
673,2019-10-13,1056,7908,1483,4,10451
673,2019-10-14,210,7225,1475,2,8912
673,2019-10-15,1070,7140,1474,1,9685
673,2019-10-16,138,12550,1708,3,14399
673,2019-10-17,7084,3917,7898,1,18900
673,2019-10-18,14302,7157,2145,1,23605
673,2019-10-19,11617,3878,2374,0,17869
673,2019-10-20,15312,733,3230,0,19275
673,2019-10-21,10892,16922,1251,1,29066
673,2019-10-22,12257,8442,2290,1,22990
673,2019-10-23,9024,6893,2266,3,18186
673,2019-10-24,7206,12391,906,2,20505
673,2019-10-25,9864,14116,1057,1,25038
673,2019-10-26,10086,23507,2239,0,35832
673,2019-10-27,12922,17760,2158,0,32840
673,2019-10-28,10615,30397,2729,1,43742
673,2019-10-29,10568,29803,1728,0,42099
673,2019-10-30,7360,19664,1707,0,28731
673,2019-10-31,1462,11631,1261,0,14354
673,2019-11-01,212,25028,1756,1,26997
673,2019-11-02,249,16223,1865,3,18340
673,2019-11-03,452,36349,1588,0,38389
673,2019-11-04,295,9565,1961,0,11821
673,2019-11-05,515,1951,1769,0,4235
673,2019-11-06,219,15218,2122,0,17559
673,2019-11-07,352,17870,2277,0,20499
673,2019-11-08,175,9931,2562,0,12668
673,2019-11-09,867,9930,2829,0,13626
673,2019-11-10,204,12358,2197,0,14759
673,2019-11-11,260,7865,2226,0,10351
673,2019-11-12,187,9403,3205,0,12795
673,2019-11-13,318,18614,1709,0,20641
673,2019-11-14,191,9150,2432,0,11773
673,2019-11-15,562,2103,2329,0,4994
673,2019-11-16,184,830,1907,0,2921
673,2019-11-17,232,2528,3370,0,6130
673,2019-11-18,376,2103,2798,0,5277
673,2019-11-19,798,2623,2700,0,6121
673,2019-11-20,275,950,2580,0,3805
673,2019-11-21,205,5118,1818,0,7141
673,2019-11-22,242,5042,1369,4,6657
673,2019-11-23,207,5640,2659,2,8508
673,2019-11-24,339,7827,1731,1,9898
673,2019-11-25,1128,5835,2069,0,9032
673,2019-11-26,140,4660,1601,1,6402
673,2019-11-27,176,5228,1173,4,6581
673,2019-11-28,183,1697,423,0,2303
673,2019-11-29,42,0,20,0,62
673,2019-08-07,221,2,192,0,415
673,2019-08-08,15454,186,379,0,16019
673,2019-08-09,14084,280,56,0,14420
673,2019-08-10,7435,545,132,0,8112
673,2019-08-11,6091,249,177,0,6517
673,2019-08-12,13081,14328,135,0,27544
673,2019-08-13,11478,12795,154,1,24428
673,2019-08-14,10994,117,100,0,11211
673,2019-08-15,9251,424,183,0,9858
673,2019-08-16,12116,746,153,1,13016
673,2019-08-17,45284,1254,617,1,47156
673,2019-08-18,58101,2577,1320,0,61998
673,2019-08-19,56610,9481,1297,3,67391
673,2019-08-20,19588,13546,1025,1,34160
673,2019-08-21,13988,10368,1018,1,25375
673,2019-08-22,2493,13856,2144,1,18494
673,2019-08-23,7882,23082,1321,4,32289
673,2019-08-24,2455,16050,1440,1,19946
673,2019-08-25,4176,30118,2212,2,36508
673,2019-08-26,5774,26516,1731,0,34021
673,2019-08-27,11751,13571,2089,1,27412
673,2019-08-28,17321,28688,1354,2,47365
673,2019-08-29,157,16730,2143,4,19034
673,2019-08-30,589,2821,363,1,3774
673,2019-08-31,76,8146,4,0,8226
673,2019-09-01,164,3121,294,0,3579
673,2019-09-02,845,238,48,0,1131
673,2019-09-03,15417,789,501,1,16708
673,2019-09-04,19341,10362,1699,1,31403
673,2019-09-05,150,5245,1909,0,7304
673,2019-09-06,6538,15658,1775,0,23971
673,2019-09-07,267,12022,1583,0,13872
673,2019-09-08,1166,7043,2160,2,10371
673,2019-09-09,331,7926,1328,3,9588
673,2019-09-10,5742,9021,2390,1,17154
673,2019-09-11,9369,6285,2993,1,18648
673,2019-09-12,1127,11445,2320,0,14892
673,2019-09-13,1578,7472,2063,1,11114
673,2019-09-14,1201,9814,1972,2,12989
673,2019-09-15,1035,6312,1687,1,9035
673,2019-09-16,16153,13913,1755,0,31821
673,2019-09-17,184,13017,1175,0,14376
673,2019-09-18,21836,11073,1628,2,34539
673,2019-09-19,49151,10035,1832,1,61019
673,2019-09-20,16507,13314,1336,0,31157
673,2019-09-21,1054,7975,3669,1,12699
673,2019-09-22,1839,9082,1393,0,12314
673,2019-09-23,2114,8998,1620,3,12735
673,2019-09-24,823,7628,1584,4,10039
673,2019-09-25,19088,6959,1180,2,27229
673,2019-09-26,33641,11547,2218,0,47406
673,2019-09-27,30701,7833,1903,3,40440
673,2019-09-28,209,25012,1714,3,26938
673,2019-09-29,229,18332,1633,1,20195
673,2019-09-30,22213,24094,1189,0,47496
673,2019-10-01,4737,26895,1675,1,33308
673,2019-10-02,39258,18451,760,0,58469
673,2019-10-03,30804,12946,1843,0,45593
673,2019-10-04,4143,19241,1537,2,24923
673,2019-10-05,178,23161,1360,1,24700
673,2019-10-06,2607,15500,1667,1,19775
673,2019-10-07,6919,4615,1709,0,13243
673,2019-10-08,4849,11569,1066,2,17486
673,2019-10-09,177,13127,1403,0,14707
673,2019-10-10,2557,9210,1515,0,13282
673,2019-10-11,163,11600,1592,2,13357
673,2019-10-12,1082,6272,2031,0,9385
673,2019-10-13,1056,7908,1483,4,10451
673,2019-10-14,210,7225,1475,2,8912
673,2019-10-15,1070,7140,1474,1,9685
673,2019-10-16,138,12550,1708,3,14399
673,2019-10-17,7084,3917,7898,1,18900
673,2019-10-18,14302,7157,2145,1,23605
673,2019-10-19,11617,3878,2374,0,17869
673,2019-10-20,15312,733,3230,0,19275
673,2019-10-21,10892,16922,1251,1,29066
673,2019-10-22,12257,8442,2290,1,22990
673,2019-10-23,9024,6893,2266,3,18186
673,2019-10-24,7206,12391,906,2,20505
673,2019-10-25,9864,14116,1057,1,25038
673,2019-10-26,10086,23507,2239,0,35832
673,2019-10-27,12922,17760,2158,0,32840
673,2019-10-28,10615,30397,2729,1,43742
673,2019-10-29,10568,29803,1728,0,42099
673,2019-10-30,7360,19664,1707,0,28731
673,2019-10-31,1462,11631,1261,0,14354
673,2019-11-01,212,25028,1756,1,26997
673,2019-11-02,249,16223,1865,3,18340
673,2019-11-03,452,36349,1588,0,38389
673,2019-11-04,295,9565,1961,0,11821
673,2019-11-05,515,1951,1769,0,4235
673,2019-11-06,219,15218,2122,0,17559
673,2019-11-07,352,17870,2277,0,20499
673,2019-11-08,175,9931,2562,0,12668
673,2019-11-09,867,9930,2829,0,13626
673,2019-11-10,204,12358,2197,0,14759
673,2019-11-11,260,7865,2226,0,10351
673,2019-11-12,187,9403,3205,0,12795
673,2019-11-13,318,18614,1709,0,20641
673,2019-11-14,191,9150,2432,0,11773
673,2019-11-15,562,2103,2329,0,4994
673,2019-11-16,184,830,1907,0,2921
673,2019-11-17,232,2528,3370,0,6130
673,2019-11-18,376,2103,2798,0,5277
673,2019-11-19,798,2623,2700,0,6121
673,2019-11-20,275,950,2580,0,3805
673,2019-11-21,205,5118,1818,0,7141
673,2019-11-22,242,5042,1369,4,6657
673,2019-11-23,207,5640,2659,2,8508
673,2019-11-24,339,7827,1731,1,9898
673,2019-11-25,1128,5835,2069,0,9032
673,2019-11-26,140,4660,1601,1,6402
673,2019-11-27,176,5228,1173,4,6581
673,2019-11-28,183,1697,423,0,2303
673,2019-08-07,221,2,192,0,415
673,2019-08-08,15454,186,379,0,16019
673,2019-08-09,14084,280,56,0,14420
673,2019-08-10,7435,545,132,0,8112
673,2019-08-11,6091,249,177,0,6517
673,2019-08-12,13081,14328,135,0,27544
673,2019-08-13,11478,12795,154,1,24428
673,2019-08-14,10994,117,100,0,11211
673,2019-08-15,9251,424,183,0,9858
673,2019-08-16,12116,746,153,1,13016
673,2019-08-17,45284,1254,617,1,47156
673,2019-08-18,58101,2577,1320,0,61998
673,2019-08-19,56610,9481,1297,3,67391
673,2019-08-20,19588,13546,1025,1,34160
673,2019-08-21,13988,10368,1018,1,25375
673,2019-08-22,2493,13856,2144,1,18494
673,2019-08-23,7882,23082,1321,4,32289
673,2019-08-24,2455,16050,1440,1,19946
673,2019-08-25,4176,30118,2212,2,36508
673,2019-08-26,5774,26516,1731,0,34021
673,2019-08-27,11751,13571,2089,1,27412
673,2019-08-28,17321,28688,1354,2,47365
673,2019-08-29,157,16730,2143,4,19034
673,2019-08-30,589,2821,363,1,3774
673,2019-08-31,76,8146,4,0,8226
673,2019-09-01,164,3121,294,0,3579
673,2019-09-02,845,238,48,0,1131
673,2019-09-03,15417,789,501,1,16708
673,2019-09-04,19341,10362,1699,1,31403
673,2019-09-05,150,5245,1909,0,7304
673,2019-09-06,6538,15658,1775,0,23971
673,2019-09-07,267,12022,1583,0,13872
673,2019-09-08,1166,7043,2160,2,10371
673,2019-09-09,331,7926,1328,3,9588
673,2019-09-10,5742,9021,2390,1,17154
673,2019-09-11,9369,6285,2993,1,18648
673,2019-09-12,1127,11445,2320,0,14892
673,2019-09-13,1578,7472,2063,1,11114
673,2019-09-14,1201,9814,1972,2,12989
673,2019-09-15,1035,6312,1687,1,9035
673,2019-09-16,16153,13913,1755,0,31821
673,2019-09-17,184,13017,1175,0,14376
673,2019-09-18,21836,11073,1628,2,34539
673,2019-09-19,49151,10035,1832,1,61019
673,2019-09-20,16507,13314,1336,0,31157
673,2019-09-21,1054,7975,3669,1,12699
673,2019-09-22,1839,9082,1393,0,12314
673,2019-09-23,2114,8998,1620,3,12735
673,2019-09-24,823,7628,1584,4,10039
673,2019-09-25,19088,6959,1180,2,27229
673,2019-09-26,33641,11547,2218,0,47406
673,2019-09-27,30701,7833,1903,3,40440
673,2019-09-28,209,25012,1714,3,26938
673,2019-09-29,229,18332,1633,1,20195
673,2019-09-30,22213,24094,1189,0,47496
673,2019-10-01,4737,26895,1675,1,33308
673,2019-10-02,39258,18451,760,0,58469
673,2019-10-03,30804,12946,1843,0,45593
673,2019-10-04,4143,19241,1537,2,24923
673,2019-10-05,178,23161,1360,1,24700
673,2019-10-06,2607,15500,1667,1,19775
673,2019-10-07,6919,4615,1709,0,13243
673,2019-10-08,4849,11569,1066,2,17486
673,2019-10-09,177,13127,1403,0,14707
673,2019-10-10,2557,9210,1515,0,13282
673,2019-10-11,163,11600,1592,2,13357
673,2019-10-12,1082,6272,2031,0,9385
673,2019-10-13,1056,7908,1483,4,10451
673,2019-10-14,210,7225,1475,2,8912
673,2019-10-15,1070,7140,1474,1,9685
673,2019-10-16,138,12550,1708,3,14399
673,2019-10-17,7084,3917,7898,1,18900
673,2019-10-18,14302,7157,2145,1,23605
673,2019-10-19,11617,3878,2374,0,17869
673,2019-10-20,15312,733,3230,0,19275
673,2019-10-21,10892,16922,1251,1,29066
673,2019-10-22,12257,8442,2290,1,22990
673,2019-10-23,9024,6893,2266,3,18186
673,2019-10-24,7206,12391,906,2,20505
673,2019-10-25,9864,14116,1057,1,25038
673,2019-10-26,10086,23507,2239,0,35832
673,2019-10-27,12922,17760,2158,0,32840
673,2019-10-28,10615,30397,2729,1,43742
673,2019-10-29,10568,29803,1728,0,42099
673,2019-10-30,7360,19664,1707,0,28731
673,2019-10-31,1462,11631,1261,0,14354
673,2019-11-01,212,25028,1756,1,26997
673,2019-11-02,249,16223,1865,3,18340
673,2019-11-03,452,36349,1588,0,38389
673,2019-11-04,295,9565,1961,0,11821
673,2019-11-05,515,1951,1769,0,4235
673,2019-11-06,219,15218,2122,0,17559
673,2019-11-07,352,17870,2277,0,20499
673,2019-11-08,175,9931,2562,0,12668
673,2019-11-09,867,9930,2829,0,13626
673,2019-11-10,204,12358,2197,0,14759
673,2019-11-11,260,7865,2226,0,10351
673,2019-11-12,187,9403,3205,0,12795
673,2019-11-13,318,18614,1709,0,20641
673,2019-11-14,191,9150,2432,0,11773
673,2019-11-15,562,2103,2329,0,4994
673,2019-11-16,184,830,1907,0,2921
673,2019-11-17,232,2528,3370,0,6130
673,2019-11-18,376,2103,2798,0,5277
673,2019-11-19,798,2623,2700,0,6121
673,2019-11-20,275,950,2580,0,3805
673,2019-11-21,205,5118,1818,0,7141
673,2019-11-22,242,5042,1369,4,6657
673,2019-11-23,207,5640,2659,2,8508
673,2019-11-24,339,7827,1731,1,9898
673,2019-11-25,1128,5835,2069,0,9032
673,2019-11-26,140,4660,1601,1,6402
673,2019-11-27,176,5228,1173,4,6581
673,2019-11-28,183,1697,423,0,2303
673,2019-11-29,42,0,20,0,62
673,2019-08-13,11478,12795,154,1,24428
673,2019-08-14,10994,117,100,0,11211
673,2019-08-15,9251,424,183,0,9858
673,2019-08-16,12116,746,153,1,13016
673,2019-08-17,45284,1254,617,1,47156
673,2019-08-18,58101,2577,1320,0,61998
673,2019-08-19,56610,9481,1297,3,67391
673,2019-08-20,19588,13546,1025,1,34160
673,2019-08-21,13988,10368,1018,1,25375
673,2019-08-22,2493,13856,2144,1,18494
673,2019-08-23,7882,23082,1321,4,32289
673,2019-08-24,2455,16050,1440,1,19946
673,2019-08-25,4176,30118,2212,2,36508
673,2019-08-26,5774,26516,1731,0,34021
673,2019-08-27,11751,13571,2089,1,27412
673,2019-08-28,17321,28688,1354,2,47365
673,2019-08-29,157,16730,2143,4,19034
673,2019-08-30,589,2821,363,1,3774
673,2019-08-31,76,8146,4,0,8226
673,2019-09-01,164,3121,294,0,3579
673,2019-09-02,845,238,48,0,1131
673,2019-09-03,15417,789,501,1,16708
673,2019-09-04,19341,10362,1699,1,31403
673,2019-09-05,150,5245,1909,0,7304
673,2019-09-06,6538,15658,1775,0,23971
673,2019-09-07,267,12022,1583,0,13872
673,2019-09-08,1166,7043,2160,2,10371
673,2019-09-09,331,7926,1328,3,9588
673,2019-09-10,5742,9021,2390,1,17154
673,2019-09-11,9369,6285,2993,1,18648
673,2019-09-12,1127,11445,2320,0,14892
673,2019-09-13,1578,7472,2063,1,11114
673,2019-09-14,1201,9814,1972,2,12989
673,2019-09-15,1035,6312,1687,1,9035
673,2019-09-16,16153,13913,1755,0,31821
673,2019-09-17,184,13017,1175,0,14376
673,2019-09-18,21836,11073,1628,2,34539
673,2019-09-19,49151,10035,1832,1,61019
673,2019-09-20,16507,13314,1336,0,31157
673,2019-09-21,1054,7975,3669,1,12699
673,2019-09-22,1839,9082,1393,0,12314
673,2019-09-23,2114,8998,1620,3,12735
673,2019-09-24,823,7628,1584,4,10039
673,2019-09-25,19088,6959,1180,2,27229
673,2019-09-26,33641,11547,2218,0,47406
673,2019-09-27,30701,7833,1903,3,40440
673,2019-09-28,209,25012,1714,3,26938
673,2019-09-29,229,18332,1633,1,20195
673,2019-09-30,22213,24094,1189,0,47496
673,2019-10-01,4737,26895,1675,1,33308
673,2019-10-02,39258,18451,760,0,58469
673,2019-10-03,30804,12946,1843,0,45593
673,2019-10-04,4143,19241,1537,2,24923
673,2019-10-05,178,23161,1360,1,24700
673,2019-10-06,2607,15500,1667,1,19775
673,2019-10-07,6919,4615,1709,0,13243
673,2019-10-08,4849,11569,1066,2,17486
673,2019-10-09,177,13127,1403,0,14707
673,2019-10-10,2557,9210,1515,0,13282
673,2019-10-11,163,11600,1592,2,13357
673,2019-10-12,1082,6272,2031,0,9385
673,2019-10-13,1056,7908,1483,4,10451
673,2019-10-14,210,7225,1475,2,8912
673,2019-10-15,1070,7140,1474,1,9685
673,2019-10-16,138,12550,1708,3,14399
673,2019-10-17,7084,3917,7898,1,18900
673,2019-10-18,14302,7157,2145,1,23605
673,2019-10-19,11617,3878,2374,0,17869
673,2019-10-20,15312,733,3230,0,19275
673,2019-10-21,10892,16922,1251,1,29066
673,2019-10-22,12257,8442,2290,1,22990
673,2019-10-23,9024,6893,2266,3,18186
673,2019-10-24,7206,12391,906,2,20505
673,2019-10-25,9864,14116,1057,1,25038
673,2019-10-26,10086,23507,2239,0,35832
673,2019-10-27,12922,17760,2158,0,32840
673,2019-10-28,10615,30397,2729,1,43742
673,2019-10-29,10568,29803,1728,0,42099
673,2019-10-30,7360,19664,1707,0,28731
673,2019-10-31,1462,11631,1261,0,14354
673,2019-11-01,212,25028,1756,1,26997
673,2019-11-02,249,16223,1865,3,18340
673,2019-11-03,452,36349,1588,0,38389
673,2019-11-04,295,9565,1961,0,11821
673,2019-11-05,515,1951,1769,0,4235
673,2019-11-06,219,15218,2122,0,17559
673,2019-11-07,352,17870,2277,0,20499
673,2019-11-08,175,9931,2562,0,12668
673,2019-11-09,867,9930,2829,0,13626
673,2019-11-10,204,12358,2197,0,14759
673,2019-11-11,260,7865,2226,0,10351
673,2019-11-12,187,9403,3205,0,12795
673,2019-11-13,318,18614,1709,0,20641
673,2019-11-14,191,9150,2432,0,11773
673,2019-11-15,562,2103,2329,0,4994
673,2019-11-16,184,830,1907,0,2921
673,2019-11-17,232,2528,3370,0,6130
673,2019-11-18,376,2103,2798,0,5277
673,2019-11-19,798,2623,2700,0,6121
673,2019-11-20,275,950,2580,0,3805
673,2019-11-21,205,5118,1818,0,7141
673,2019-11-22,242,5042,1369,4,6657
673,2019-11-23,207,5640,2659,2,8508
673,2019-11-24,339,7827,1731,1,9898
673,2019-11-25,1128,5835,2069,0,9032
673,2019-11-26,140,4660,1601,1,6402
673,2019-11-27,176,5228,1173,4,6581
674,2019-08-07,18,2,292,1,313
674,2019-08-08,131,302,385,0,818
674,2019-08-09,111,1183,197,1,1492
674,2019-08-10,190,428,440,1,1059
674,2019-08-11,629,199,2,0,830
674,2019-08-12,489,348,52,0,889
674,2019-08-13,657,257,92,1,1007
674,2019-08-14,313,174,10,0,497
674,2019-08-15,164,411,43,0,618
674,2019-08-16,100,625,40,0,765
674,2019-08-17,211,1082,686,1,1980
674,2019-08-18,198,432,1258,1,1889
674,2019-08-19,124,2080,1583,1,3788
674,2019-08-20,160,1875,878,2,2915
674,2019-08-21,449,2585,1622,0,4656
674,2019-08-22,159,3188,959,1,4307
674,2019-08-23,183,17315,1767,3,19268
674,2019-08-24,185,8919,1441,1,10546
674,2019-08-25,265,14684,1591,3,16543
674,2019-08-26,252,15150,1170,0,16572
674,2019-08-27,1349,12091,1913,2,15355
674,2019-08-28,228,16969,1989,1,19187
674,2019-08-29,237,12047,2073,1,14358
674,2019-08-30,128,2983,904,1,4016
674,2019-08-31,61,126,4,0,191
674,2019-09-01,70,1457,297,0,1824
674,2019-09-02,63,264,20,0,347
674,2019-09-03,293,3636,1657,1,5587
674,2019-09-04,989,41086,1362,1,43438
674,2019-09-05,183,37383,2259,1,39826
674,2019-09-06,204,11392,1775,2,13373
674,2019-09-07,666,16344,2384,1,19395
674,2019-09-08,241,8072,2021,0,10334
674,2019-09-09,1970,10971,2341,1,15283
674,2019-09-10,1023,12049,1785,1,14858
674,2019-09-11,985,9605,2112,1,12703
674,2019-09-12,96,8195,2279,3,10573
674,2019-09-13,117,7555,1820,1,9493
674,2019-09-14,1082,6420,1745,1,9248
674,2019-09-15,914,9039,1536,1,11490
674,2019-09-16,1033,17013,1812,0,19858
674,2019-09-17,92,9824,2498,0,12414
674,2019-09-18,114,19458,1045,2,20619
674,2019-09-19,216,6412,2160,0,8788
674,2019-09-20,240,8774,1920,1,10935
674,2019-09-21,151,6293,1402,0,7846
674,2019-09-22,96,9418,2315,0,11829
674,2019-09-23,288,11271,1611,3,13173
674,2019-09-24,780,12524,2454,1,15759
674,2019-09-25,173,11462,1890,3,13528
674,2019-09-26,704,11254,2028,0,13986
674,2019-09-27,311,12125,1917,4,14357
674,2019-09-28,116,25647,1941,5,27709
674,2019-09-29,86,30278,1790,0,32154
674,2019-09-30,945,28449,1615,1,31010
674,2019-10-01,964,22433,1454,2,24853
674,2019-10-02,524,12720,1394,1,14639
674,2019-10-03,362,15194,1453,2,17011
674,2019-10-04,561,22807,1150,2,24520
674,2019-10-05,946,37566,1464,0,39976
674,2019-10-06,1520,13866,1947,1,17334
674,2019-10-07,543,7343,1802,2,9690
674,2019-10-08,100,27614,1558,4,29276
674,2019-10-09,1479,29190,1984,0,32653
674,2019-10-10,1025,17910,2697,1,21633
674,2019-10-11,1796,21152,1693,1,24642
674,2019-10-12,1958,11147,1969,2,15076
674,2019-10-13,315,9101,2014,2,11432
674,2019-10-14,72,10762,2018,0,12852
674,2019-10-15,259,15500,1183,0,16942
674,2019-10-16,121,24096,1201,1,25419
674,2019-10-17,993,9369,2370,1,12733
674,2019-10-18,1215,14866,1760,3,17844
674,2019-10-19,963,8681,1164,1,10809
674,2019-10-20,956,18387,1845,1,21189
674,2019-10-21,259,15632,1454,1,17346
674,2019-10-22,264,6898,2101,2,9265
674,2019-10-23,1047,8894,1497,3,11441
674,2019-10-24,152,13990,750,1,14893
674,2019-10-25,173,11638,1657,2,13470
674,2019-10-26,154,13545,2615,0,16314
674,2019-10-27,174,17217,2248,0,19639
674,2019-10-28,692,14070,2286,1,17049
674,2019-10-29,201,27028,2131,0,29360
674,2019-10-30,126,22683,1418,2,24229
674,2019-10-31,377,12714,1894,0,14985
674,2019-11-01,977,15462,1396,0,17835
674,2019-11-02,134,14454,1596,4,16188
674,2019-11-03,131,22730,1564,0,24425
674,2019-11-04,965,8420,1931,0,11316
674,2019-11-05,668,3120,2010,0,5798
674,2019-11-06,760,8379,2318,1,11458
674,2019-11-07,542,22207,1671,3,24423
674,2019-11-08,113,17640,2425,1,20179
674,2019-11-09,122,11101,2410,1,13634
674,2019-11-10,388,14274,1777,1,16440
674,2019-11-11,519,13722,2486,1,16728
674,2019-11-12,127,13549,3405,2,17083
674,2019-11-13,507,13318,1619,2,15446
674,2019-11-14,117,13297,2018,2,15434
674,2019-11-15,177,5246,2352,0,7775
674,2019-11-16,162,3883,2465,1,6511
674,2019-11-17,1152,4416,3716,4,9288
674,2019-11-18,764,2583,3229,2,6578
674,2019-11-19,1121,3533,2181,1,6836
674,2019-11-20,1004,1349,1963,0,4316
674,2019-11-21,115,3726,1792,0,5633
674,2019-11-22,201,6096,1802,0,8099
674,2019-11-23,359,6490,1771,0,8620
674,2019-11-24,322,10891,2027,0,13240
674,2019-11-25,1632,12021,1445,0,15098
674,2019-11-26,71,10800,2148,0,13019
674,2019-11-27,295,6917,1406,0,8618
674,2019-11-28,2400,12497,766,0,15663
674,2019-11-29,23,423,4,0,450
674,2019-08-07,18,2,292,1,313
674,2019-08-08,131,302,385,0,818
674,2019-08-09,111,1183,197,1,1492
674,2019-08-10,190,428,440,1,1059
674,2019-08-11,629,199,2,0,830
674,2019-08-12,489,348,52,0,889
674,2019-08-13,657,257,92,1,1007
674,2019-08-14,313,174,10,0,497
674,2019-08-15,164,411,43,0,618
674,2019-08-16,100,625,40,0,765
674,2019-08-17,211,1082,686,1,1980
674,2019-08-18,198,432,1258,1,1889
674,2019-08-19,124,2080,1583,1,3788
674,2019-08-20,160,1875,878,2,2915
674,2019-08-21,449,2585,1622,0,4656
674,2019-08-22,159,3188,959,1,4307
674,2019-08-23,183,17315,1767,3,19268
674,2019-08-24,185,8919,1441,1,10546
674,2019-08-25,265,14684,1591,3,16543
674,2019-08-26,252,15150,1170,0,16572
674,2019-08-27,1349,12091,1913,2,15355
674,2019-08-28,228,16969,1989,1,19187
674,2019-08-29,237,12047,2073,1,14358
674,2019-08-30,128,2983,904,1,4016
674,2019-08-31,61,126,4,0,191
674,2019-09-01,70,1457,297,0,1824
674,2019-09-02,63,264,20,0,347
674,2019-09-03,293,3636,1657,1,5587
674,2019-09-04,989,41086,1362,1,43438
674,2019-09-05,183,37383,2259,1,39826
674,2019-09-06,204,11392,1775,2,13373
674,2019-09-07,666,16344,2384,1,19395
674,2019-09-08,241,8072,2021,0,10334
674,2019-09-09,1970,10971,2341,1,15283
674,2019-09-10,1023,12049,1785,1,14858
674,2019-09-11,985,9605,2112,1,12703
674,2019-09-12,96,8195,2279,3,10573
674,2019-09-13,117,7555,1820,1,9493
674,2019-09-14,1082,6420,1745,1,9248
674,2019-09-15,914,9039,1536,1,11490
674,2019-09-16,1033,17013,1812,0,19858
674,2019-09-17,92,9824,2498,0,12414
674,2019-09-18,114,19458,1045,2,20619
674,2019-09-19,216,6412,2160,0,8788
674,2019-09-20,240,8774,1920,1,10935
674,2019-09-21,151,6293,1402,0,7846
674,2019-09-22,96,9418,2315,0,11829
674,2019-09-23,288,11271,1611,3,13173
674,2019-09-24,780,12524,2454,1,15759
674,2019-09-25,173,11462,1890,3,13528
674,2019-09-26,704,11254,2028,0,13986
674,2019-09-27,311,12125,1917,4,14357
674,2019-09-28,116,25647,1941,5,27709
674,2019-09-29,86,30278,1790,0,32154
674,2019-09-30,945,28449,1615,1,31010
674,2019-10-01,964,22433,1454,2,24853
674,2019-10-02,524,12720,1394,1,14639
674,2019-10-03,362,15194,1453,2,17011
674,2019-10-04,561,22807,1150,2,24520
674,2019-10-05,946,37566,1464,0,39976
674,2019-10-06,1520,13866,1947,1,17334
674,2019-10-07,543,7343,1802,2,9690
674,2019-10-08,100,27614,1558,4,29276
674,2019-10-09,1479,29190,1984,0,32653
674,2019-10-10,1025,17910,2697,1,21633
674,2019-10-11,1796,21152,1693,1,24642
674,2019-10-12,1958,11147,1969,2,15076
674,2019-10-13,315,9101,2014,2,11432
674,2019-10-14,72,10762,2018,0,12852
674,2019-10-15,259,15500,1183,0,16942
674,2019-10-16,121,24096,1201,1,25419
674,2019-10-17,993,9369,2370,1,12733
674,2019-10-18,1215,14866,1760,3,17844
674,2019-10-19,963,8681,1164,1,10809
674,2019-10-20,956,18387,1845,1,21189
674,2019-10-21,259,15632,1454,1,17346
674,2019-10-22,264,6898,2101,2,9265
674,2019-10-23,1047,8894,1497,3,11441
674,2019-10-24,152,13990,750,1,14893
674,2019-10-25,173,11638,1657,2,13470
674,2019-10-26,154,13545,2615,0,16314
674,2019-10-27,174,17217,2248,0,19639
674,2019-10-28,692,14070,2286,1,17049
674,2019-10-29,201,27028,2131,0,29360
674,2019-10-30,126,22683,1418,2,24229
674,2019-10-31,377,12714,1894,0,14985
674,2019-11-01,977,15462,1396,0,17835
674,2019-11-02,134,14454,1596,4,16188
674,2019-11-03,131,22730,1564,0,24425
674,2019-11-04,965,8420,1931,0,11316
674,2019-11-05,668,3120,2010,0,5798
674,2019-11-06,760,8379,2318,1,11458
674,2019-11-07,542,22207,1671,3,24423
674,2019-11-08,113,17640,2425,1,20179
674,2019-11-09,122,11101,2410,1,13634
674,2019-11-10,388,14274,1777,1,16440
674,2019-11-11,519,13722,2486,1,16728
674,2019-11-12,127,13549,3405,2,17083
674,2019-11-13,507,13318,1619,2,15446
674,2019-11-14,117,13297,2018,2,15434
674,2019-11-15,177,5246,2352,0,7775
674,2019-11-16,162,3883,2465,1,6511
674,2019-11-17,1152,4416,3716,4,9288
674,2019-11-18,764,2583,3229,2,6578
674,2019-11-19,1121,3533,2181,1,6836
674,2019-11-20,1004,1349,1963,0,4316
674,2019-11-21,115,3726,1792,0,5633
674,2019-11-22,201,6096,1802,0,8099
674,2019-11-23,359,6490,1771,0,8620
674,2019-11-24,322,10891,2027,0,13240
674,2019-11-25,1632,12021,1445,0,15098
674,2019-11-26,71,10800,2148,0,13019
674,2019-11-27,295,6917,1406,0,8618
674,2019-11-28,2400,12497,766,0,15663
674,2019-11-29,23,423,4,0,450
674,2019-08-07,18,2,292,1,313
674,2019-08-08,131,302,385,0,818
674,2019-08-09,111,1183,197,1,1492
674,2019-08-10,190,428,440,1,1059
674,2019-08-11,629,199,2,0,830
674,2019-08-12,489,348,52,0,889
674,2019-08-13,657,257,92,1,1007
674,2019-08-14,313,174,10,0,497
674,2019-08-15,164,411,43,0,618
674,2019-08-16,100,625,40,0,765
674,2019-08-17,211,1082,686,1,1980
674,2019-08-18,198,432,1258,1,1889
674,2019-08-19,124,2080,1583,1,3788
674,2019-08-20,160,1875,878,2,2915
674,2019-08-21,449,2585,1622,0,4656
674,2019-08-22,159,3188,959,1,4307
674,2019-08-23,183,17315,1767,3,19268
674,2019-08-24,185,8919,1441,1,10546
674,2019-08-25,265,14684,1591,3,16543
674,2019-08-26,252,15150,1170,0,16572
674,2019-08-27,1349,12091,1913,2,15355
674,2019-08-28,228,16969,1989,1,19187
674,2019-08-29,237,12047,2073,1,14358
674,2019-08-30,128,2983,904,1,4016
674,2019-08-31,61,126,4,0,191
674,2019-09-01,70,1457,297,0,1824
674,2019-09-02,63,264,20,0,347
674,2019-09-03,293,3636,1657,1,5587
674,2019-09-04,989,41086,1362,1,43438
674,2019-09-05,183,37383,2259,1,39826
674,2019-09-06,204,11392,1775,2,13373
674,2019-09-07,666,16344,2384,1,19395
674,2019-09-08,241,8072,2021,0,10334
674,2019-09-09,1970,10971,2341,1,15283
674,2019-09-10,1023,12049,1785,1,14858
674,2019-09-11,985,9605,2112,1,12703
674,2019-09-12,96,8195,2279,3,10573
674,2019-09-13,117,7555,1820,1,9493
674,2019-09-14,1082,6420,1745,1,9248
674,2019-09-15,914,9039,1536,1,11490
674,2019-09-16,1033,17013,1812,0,19858
674,2019-09-17,92,9824,2498,0,12414
674,2019-09-18,114,19458,1045,2,20619
674,2019-09-19,216,6412,2160,0,8788
674,2019-09-20,240,8774,1920,1,10935
674,2019-09-21,151,6293,1402,0,7846
674,2019-09-22,96,9418,2315,0,11829
674,2019-09-23,288,11271,1611,3,13173
674,2019-09-24,780,12524,2454,1,15759
674,2019-09-25,173,11462,1890,3,13528
674,2019-09-26,704,11254,2028,0,13986
674,2019-09-27,311,12125,1917,4,14357
674,2019-09-28,116,25647,1941,5,27709
674,2019-09-29,86,30278,1790,0,32154
674,2019-09-30,945,28449,1615,1,31010
674,2019-10-01,964,22433,1454,2,24853
674,2019-10-02,524,12720,1394,1,14639
674,2019-10-03,362,15194,1453,2,17011
674,2019-10-04,561,22807,1150,2,24520
674,2019-10-05,946,37566,1464,0,39976
674,2019-10-06,1520,13866,1947,1,17334
674,2019-10-07,543,7343,1802,2,9690
674,2019-10-08,100,27614,1558,4,29276
674,2019-10-09,1479,29190,1984,0,32653
674,2019-10-10,1025,17910,2697,1,21633
674,2019-10-11,1796,21152,1693,1,24642
674,2019-10-12,1958,11147,1969,2,15076
674,2019-10-13,315,9101,2014,2,11432
674,2019-10-14,72,10762,2018,0,12852
674,2019-10-15,259,15500,1183,0,16942
674,2019-10-16,121,24096,1201,1,25419
674,2019-10-17,993,9369,2370,1,12733
674,2019-10-18,1215,14866,1760,3,17844
674,2019-10-19,963,8681,1164,1,10809
674,2019-10-20,956,18387,1845,1,21189
674,2019-10-21,259,15632,1454,1,17346
674,2019-10-22,264,6898,2101,2,9265
674,2019-10-23,1047,8894,1497,3,11441
674,2019-10-24,152,13990,750,1,14893
674,2019-10-25,173,11638,1657,2,13470
674,2019-10-26,154,13545,2615,0,16314
674,2019-10-27,174,17217,2248,0,19639
674,2019-10-28,692,14070,2286,1,17049
674,2019-10-29,201,27028,2131,0,29360
674,2019-10-30,126,22683,1418,2,24229
674,2019-10-31,377,12714,1894,0,14985
674,2019-11-01,977,15462,1396,0,17835
674,2019-11-02,134,14454,1596,4,16188
674,2019-11-03,131,22730,1564,0,24425
674,2019-11-04,965,8420,1931,0,11316
674,2019-11-05,668,3120,2010,0,5798
674,2019-11-06,760,8379,2318,1,11458
674,2019-11-07,542,22207,1671,3,24423
674,2019-11-08,113,17640,2425,1,20179
674,2019-11-09,122,11101,2410,1,13634
674,2019-11-10,388,14274,1777,1,16440
674,2019-11-11,519,13722,2486,1,16728
674,2019-11-12,127,13549,3405,2,17083
674,2019-11-13,507,13318,1619,2,15446
674,2019-11-14,117,13297,2018,2,15434
674,2019-11-15,177,5246,2352,0,7775
674,2019-11-16,162,3883,2465,1,6511
674,2019-11-17,1152,4416,3716,4,9288
674,2019-11-18,764,2583,3229,2,6578
674,2019-11-19,1121,3533,2181,1,6836
674,2019-11-20,1004,1349,1963,0,4316
674,2019-11-21,115,3726,1792,0,5633
674,2019-11-22,201,6096,1802,0,8099
674,2019-11-23,359,6490,1771,0,8620
674,2019-11-24,322,10891,2027,0,13240
674,2019-11-25,1632,12021,1445,0,15098
674,2019-11-26,71,10800,2148,0,13019
674,2019-11-27,295,6917,1406,0,8618
674,2019-11-28,2400,12497,766,0,15663
674,2019-11-29,23,423,4,0,450
674,2019-08-07,18,2,292,1,313
674,2019-08-08,131,302,385,0,818
674,2019-08-09,111,1183,197,1,1492
674,2019-08-10,190,428,440,1,1059
674,2019-08-11,629,199,2,0,830
674,2019-08-12,489,348,52,0,889
674,2019-08-13,657,257,92,1,1007
674,2019-08-14,313,174,10,0,497
674,2019-08-15,164,411,43,0,618
674,2019-08-16,100,625,40,0,765
674,2019-08-17,211,1082,686,1,1980
674,2019-08-18,198,432,1258,1,1889
674,2019-08-19,124,2080,1583,1,3788
674,2019-08-20,160,1875,878,2,2915
674,2019-08-21,449,2585,1622,0,4656
674,2019-08-22,159,3188,959,1,4307
674,2019-08-23,183,17315,1767,3,19268
674,2019-08-24,185,8919,1441,1,10546
674,2019-08-25,265,14684,1591,3,16543
674,2019-08-26,252,15150,1170,0,16572
674,2019-08-27,1349,12091,1913,2,15355
674,2019-08-28,228,16969,1989,1,19187
674,2019-08-29,237,12047,2073,1,14358
674,2019-08-30,128,2983,904,1,4016
674,2019-08-31,61,126,4,0,191
674,2019-09-01,70,1457,297,0,1824
674,2019-09-02,63,264,20,0,347
674,2019-09-03,293,3636,1657,1,5587
674,2019-09-04,989,41086,1362,1,43438
674,2019-09-05,183,37383,2259,1,39826
674,2019-09-06,204,11392,1775,2,13373
674,2019-09-07,666,16344,2384,1,19395
674,2019-09-08,241,8072,2021,0,10334
674,2019-09-09,1970,10971,2341,1,15283
674,2019-09-10,1023,12049,1785,1,14858
674,2019-09-11,985,9605,2112,1,12703
674,2019-09-12,96,8195,2279,3,10573
674,2019-09-13,117,7555,1820,1,9493
674,2019-09-14,1082,6420,1745,1,9248
674,2019-09-15,914,9039,1536,1,11490
674,2019-09-16,1033,17013,1812,0,19858
674,2019-09-17,92,9824,2498,0,12414
674,2019-09-18,114,19458,1045,2,20619
674,2019-09-19,216,6412,2160,0,8788
674,2019-09-20,240,8774,1920,1,10935
674,2019-09-21,151,6293,1402,0,7846
674,2019-09-22,96,9418,2315,0,11829
674,2019-09-23,288,11271,1611,3,13173
674,2019-09-24,780,12524,2454,1,15759
674,2019-09-25,173,11462,1890,3,13528
674,2019-09-26,704,11254,2028,0,13986
674,2019-09-27,311,12125,1917,4,14357
674,2019-09-28,116,25647,1941,5,27709
674,2019-09-29,86,30278,1790,0,32154
674,2019-09-30,945,28449,1615,1,31010
674,2019-10-01,964,22433,1454,2,24853
674,2019-10-02,524,12720,1394,1,14639
674,2019-10-03,362,15194,1453,2,17011
674,2019-10-04,561,22807,1150,2,24520
674,2019-10-05,946,37566,1464,0,39976
674,2019-10-06,1520,13866,1947,1,17334
674,2019-10-07,543,7343,1802,2,9690
674,2019-10-08,100,27614,1558,4,29276
674,2019-10-09,1479,29190,1984,0,32653
674,2019-10-10,1025,17910,2697,1,21633
674,2019-10-11,1796,21152,1693,1,24642
674,2019-10-12,1958,11147,1969,2,15076
674,2019-10-13,315,9101,2014,2,11432
674,2019-10-14,72,10762,2018,0,12852
674,2019-10-15,259,15500,1183,0,16942
674,2019-10-16,121,24096,1201,1,25419
674,2019-10-17,993,9369,2370,1,12733
674,2019-10-18,1215,14866,1760,3,17844
674,2019-10-19,963,8681,1164,1,10809
674,2019-10-20,956,18387,1845,1,21189
674,2019-10-21,259,15632,1454,1,17346
674,2019-10-22,264,6898,2101,2,9265
674,2019-10-23,1047,8894,1497,3,11441
674,2019-10-24,152,13990,750,1,14893
674,2019-10-25,173,11638,1657,2,13470
674,2019-10-26,154,13545,2615,0,16314
674,2019-10-27,174,17217,2248,0,19639
674,2019-10-28,692,14070,2286,1,17049
674,2019-10-29,201,27028,2131,0,29360
674,2019-10-30,126,22683,1418,2,24229
674,2019-10-31,377,12714,1894,0,14985
674,2019-11-01,977,15462,1396,0,17835
674,2019-11-02,134,14454,1596,4,16188
674,2019-11-03,131,22730,1564,0,24425
674,2019-11-04,965,8420,1931,0,11316
674,2019-11-05,668,3120,2010,0,5798
674,2019-11-06,760,8379,2318,1,11458
674,2019-11-07,542,22207,1671,3,24423
674,2019-11-08,113,17640,2425,1,20179
674,2019-11-09,122,11101,2410,1,13634
674,2019-11-10,388,14274,1777,1,16440
674,2019-11-11,519,13722,2486,1,16728
674,2019-11-12,127,13549,3405,2,17083
674,2019-11-13,507,13318,1619,2,15446
674,2019-11-14,117,13297,2018,2,15434
674,2019-11-15,177,5246,2352,0,7775
674,2019-11-16,162,3883,2465,1,6511
674,2019-11-17,1152,4416,3716,4,9288
674,2019-11-18,764,2583,3229,2,6578
674,2019-11-19,1121,3533,2181,1,6836
675,2019-08-07,13,2,83,1,99
675,2019-08-08,30,207,360,0,597
675,2019-08-09,61,113,127,0,301
675,2019-08-10,126,435,195,1,757
675,2019-08-11,74,242,180,1,497
675,2019-08-12,255,274,176,0,705
675,2019-08-13,39,461,475,0,975
675,2019-08-14,143,1214,115,1,1473
675,2019-08-15,66,630,14,0,710
675,2019-08-16,46,152,102,0,300
675,2019-08-17,57,1078,501,0,1636
675,2019-08-18,84,627,1456,3,2170
675,2019-08-19,114,7952,1130,1,9197
675,2019-08-20,130,13042,1467,2,14641
675,2019-08-21,71,10798,1494,0,12363
675,2019-08-22,55,14079,1147,1,15282
675,2019-08-23,66,20754,1057,0,21877
675,2019-08-24,56,6773,1711,2,8542
675,2019-08-25,1212,12619,2290,4,16125
675,2019-08-26,90,4276,1366,1,5733
675,2019-08-27,54,3159,1675,2,4890
675,2019-08-28,69,3710,1776,0,5555
675,2019-08-29,80,7991,2000,0,10071
675,2019-08-30,49,2503,547,0,3099
675,2019-08-31,26,12875,10,0,12911
675,2019-09-01,41,4369,90,0,4500
675,2019-09-02,21,67,2,5,95
675,2019-09-03,50,3609,1456,1,5116
675,2019-09-04,62,9244,2827,2,12135
675,2019-09-05,288,5913,1759,1,7961
675,2019-09-06,947,16077,2080,0,19104
675,2019-09-07,1016,18038,1218,0,20272
675,2019-09-08,327,9697,2017,0,12041
675,2019-09-09,102,7629,2079,2,9812
675,2019-09-10,91,10104,1472,3,11670
675,2019-09-11,110,7030,2149,2,9291
675,2019-09-12,73,3296,1713,2,5084
675,2019-09-13,897,7721,2480,1,11099
675,2019-09-14,83,6765,2737,0,9585
675,2019-09-15,87,6133,1882,2,8104
675,2019-09-16,98,13743,2094,1,15936
675,2019-09-17,1771,13028,2291,0,17090
675,2019-09-18,63,10819,1418,1,12301
675,2019-09-19,221,16850,1984,3,19058
675,2019-09-20,201,14412,1171,0,15784
675,2019-09-21,70,6821,2160,2,9053
675,2019-09-22,159,8329,1393,1,9882
675,2019-09-23,204,6966,3008,1,10179
675,2019-09-24,120,7291,1754,5,9170
675,2019-09-25,131,6410,1597,0,8138
675,2019-09-26,121,11205,1422,1,12749
675,2019-09-27,1089,7887,2142,1,11119
675,2019-09-28,116,14117,1760,3,15996
675,2019-09-29,1812,14912,1405,3,18132
675,2019-09-30,51,16625,1587,0,18263
675,2019-10-01,97,19924,2130,0,22151
675,2019-10-02,145,12397,1937,1,14480
675,2019-10-03,472,21369,1244,0,23085
675,2019-10-04,591,19103,1797,74,21565
675,2019-10-05,625,22618,1208,2,24453
675,2019-10-06,957,15936,1948,0,18841
675,2019-10-07,947,4055,1781,1,6784
675,2019-10-08,1086,10913,1806,1,13806
675,2019-10-09,2439,13032,1826,4,17301
675,2019-10-10,208,9463,1330,0,11001
675,2019-10-11,984,14187,2046,1,17218
675,2019-10-12,161,7613,2272,1,10047
675,2019-10-13,1851,7322,2128,1,11302
675,2019-10-14,67,10087,1844,0,11998
675,2019-10-15,90,12751,1249,0,14090
675,2019-10-16,71,22503,1131,1,23706
675,2019-10-17,171,6518,2019,0,8708
675,2019-10-18,136,7442,1536,1,9115
675,2019-10-19,1953,3648,1901,1,7503
675,2019-10-20,1736,773,2208,0,4717
675,2019-10-21,299,16862,1198,0,18359
675,2019-10-22,939,8244,2490,1,11674
675,2019-10-23,52,6411,1398,0,7861
675,2019-10-24,238,12131,1324,2,13695
675,2019-10-25,671,14275,1063,2,16011
675,2019-10-26,76,23837,1614,1,25528
675,2019-10-27,119,29045,1471,0,30635
675,2019-10-28,950,15020,1373,0,17343
675,2019-10-29,805,14174,1749,4,16732
675,2019-10-30,85,14211,1435,2,15733
675,2019-10-31,1117,10700,1384,0,13201
675,2019-11-01,76,24452,1687,0,26215
675,2019-11-02,53,15224,1591,1,16869
675,2019-11-03,81,21010,1233,3,22327
675,2019-11-04,105,6179,1154,0,7438
675,2019-11-05,131,1190,2012,0,3333
675,2019-11-06,462,13443,1502,1,15408
675,2019-11-07,1093,15634,1250,2,17979
675,2019-11-08,72,8844,1110,0,10026
675,2019-11-09,339,7467,2150,0,9956
675,2019-11-10,102,11677,2066,0,13845
675,2019-11-11,260,7614,1778,0,9652
675,2019-11-12,198,9068,2504,0,11770
675,2019-11-13,76,18568,1657,0,20301
675,2019-11-14,91,8672,2536,0,11299
675,2019-11-15,144,2198,1864,0,4206
675,2019-11-16,94,696,2213,0,3003
675,2019-11-17,458,1656,2631,0,4745
675,2019-11-18,115,1834,2179,0,4128
675,2019-11-19,112,2712,2551,0,5375
675,2019-11-20,81,819,2023,0,2923
675,2019-11-21,102,2836,1563,0,4501
675,2019-11-22,71,1820,1890,2,3783
675,2019-11-23,90,4585,1806,3,6484
675,2019-11-24,163,7665,1808,2,9638
675,2019-11-25,82,9670,1435,0,11187
675,2019-11-26,677,7566,1959,0,10202
675,2019-11-27,330,4840,1665,2,6837
675,2019-11-28,399,11722,708,0,12829
675,2019-11-29,26,374,0,0,400
675,2019-08-07,13,2,83,1,99
675,2019-08-08,30,207,360,0,597
675,2019-08-09,61,113,127,0,301
675,2019-08-10,126,435,195,1,757
675,2019-08-11,74,242,180,1,497
675,2019-08-12,255,274,176,0,705
675,2019-08-13,39,461,475,0,975
675,2019-08-14,143,1214,115,1,1473
675,2019-08-15,66,630,14,0,710
675,2019-08-16,46,152,102,0,300
675,2019-08-17,57,1078,501,0,1636
675,2019-08-18,84,627,1456,3,2170
675,2019-08-19,114,7952,1130,1,9197
675,2019-08-20,130,13042,1467,2,14641
675,2019-08-21,71,10798,1494,0,12363
675,2019-08-22,55,14079,1147,1,15282
675,2019-08-23,66,20754,1057,0,21877
675,2019-08-24,56,6773,1711,2,8542
675,2019-08-25,1212,12619,2290,4,16125
675,2019-08-26,90,4276,1366,1,5733
675,2019-08-27,54,3159,1675,2,4890
675,2019-08-28,69,3710,1776,0,5555
675,2019-08-29,80,7991,2000,0,10071
675,2019-08-30,49,2503,547,0,3099
675,2019-08-31,26,12875,10,0,12911
675,2019-09-01,41,4369,90,0,4500
675,2019-09-02,21,67,2,5,95
675,2019-09-03,50,3609,1456,1,5116
675,2019-09-04,62,9244,2827,2,12135
675,2019-09-05,288,5913,1759,1,7961
675,2019-09-06,947,16077,2080,0,19104
675,2019-09-07,1016,18038,1218,0,20272
675,2019-09-08,327,9697,2017,0,12041
675,2019-09-09,102,7629,2079,2,9812
675,2019-09-10,91,10104,1472,3,11670
675,2019-09-11,110,7030,2149,2,9291
675,2019-09-12,73,3296,1713,2,5084
675,2019-09-13,897,7721,2480,1,11099
675,2019-09-14,83,6765,2737,0,9585
675,2019-09-15,87,6133,1882,2,8104
675,2019-09-16,98,13743,2094,1,15936
675,2019-09-17,1771,13028,2291,0,17090
675,2019-09-18,63,10819,1418,1,12301
675,2019-09-19,221,16850,1984,3,19058
675,2019-09-20,201,14412,1171,0,15784
675,2019-09-21,70,6821,2160,2,9053
675,2019-09-22,159,8329,1393,1,9882
675,2019-09-23,204,6966,3008,1,10179
675,2019-09-24,120,7291,1754,5,9170
675,2019-09-25,131,6410,1597,0,8138
675,2019-09-26,121,11205,1422,1,12749
675,2019-09-27,1089,7887,2142,1,11119
675,2019-09-28,116,14117,1760,3,15996
675,2019-09-29,1812,14912,1405,3,18132
675,2019-09-30,51,16625,1587,0,18263
675,2019-10-01,97,19924,2130,0,22151
675,2019-10-02,145,12397,1937,1,14480
675,2019-10-03,472,21369,1244,0,23085
675,2019-10-04,591,19103,1797,74,21565
675,2019-10-05,625,22618,1208,2,24453
675,2019-10-06,957,15936,1948,0,18841
675,2019-10-07,947,4055,1781,1,6784
675,2019-10-08,1086,10913,1806,1,13806
675,2019-10-09,2439,13032,1826,4,17301
675,2019-10-10,208,9463,1330,0,11001
675,2019-10-11,984,14187,2046,1,17218
675,2019-10-12,161,7613,2272,1,10047
675,2019-10-13,1851,7322,2128,1,11302
675,2019-10-14,67,10087,1844,0,11998
675,2019-10-15,90,12751,1249,0,14090
675,2019-10-16,71,22503,1131,1,23706
675,2019-10-17,171,6518,2019,0,8708
675,2019-10-18,136,7442,1536,1,9115
675,2019-10-19,1953,3648,1901,1,7503
675,2019-10-20,1736,773,2208,0,4717
675,2019-10-21,299,16862,1198,0,18359
675,2019-10-22,939,8244,2490,1,11674
675,2019-10-23,52,6411,1398,0,7861
675,2019-10-24,238,12131,1324,2,13695
675,2019-10-25,671,14275,1063,2,16011
675,2019-10-26,76,23837,1614,1,25528
675,2019-10-27,119,29045,1471,0,30635
675,2019-10-28,950,15020,1373,0,17343
675,2019-10-29,805,14174,1749,4,16732
675,2019-10-30,85,14211,1435,2,15733
675,2019-10-31,1117,10700,1384,0,13201
675,2019-11-01,76,24452,1687,0,26215
675,2019-11-02,53,15224,1591,1,16869
675,2019-11-03,81,21010,1233,3,22327
675,2019-11-04,105,6179,1154,0,7438
675,2019-11-05,131,1190,2012,0,3333
675,2019-11-06,462,13443,1502,1,15408
675,2019-11-07,1093,15634,1250,2,17979
675,2019-11-08,72,8844,1110,0,10026
675,2019-11-09,339,7467,2150,0,9956
675,2019-11-10,102,11677,2066,0,13845
675,2019-11-11,260,7614,1778,0,9652
675,2019-11-12,198,9068,2504,0,11770
675,2019-11-13,76,18568,1657,0,20301
675,2019-11-14,91,8672,2536,0,11299
675,2019-11-15,144,2198,1864,0,4206
675,2019-11-16,94,696,2213,0,3003
675,2019-11-17,458,1656,2631,0,4745
675,2019-11-18,115,1834,2179,0,4128
675,2019-11-19,112,2712,2551,0,5375
675,2019-11-20,81,819,2023,0,2923
675,2019-11-21,102,2836,1563,0,4501
675,2019-11-22,71,1820,1890,2,3783
675,2019-11-23,90,4585,1806,3,6484
675,2019-11-24,163,7665,1808,2,9638
675,2019-11-25,82,9670,1435,0,11187
675,2019-11-26,677,7566,1959,0,10202
675,2019-11-27,330,4840,1665,2,6837
675,2019-11-28,399,11722,708,0,12829
675,2019-11-29,26,374,0,0,400
675,2019-08-07,13,2,83,1,99
675,2019-08-08,30,207,360,0,597
675,2019-08-09,61,113,127,0,301
675,2019-08-10,126,435,195,1,757
675,2019-08-11,74,242,180,1,497
675,2019-08-12,255,274,176,0,705
675,2019-08-13,39,461,475,0,975
675,2019-08-14,143,1214,115,1,1473
675,2019-08-15,66,630,14,0,710
675,2019-08-16,46,152,102,0,300
675,2019-08-17,57,1078,501,0,1636
675,2019-08-18,84,627,1456,3,2170
675,2019-08-19,114,7952,1130,1,9197
675,2019-08-20,130,13042,1467,2,14641
675,2019-08-21,71,10798,1494,0,12363
675,2019-08-22,55,14079,1147,1,15282
675,2019-08-23,66,20754,1057,0,21877
675,2019-08-24,56,6773,1711,2,8542
675,2019-08-25,1212,12619,2290,4,16125
675,2019-08-26,90,4276,1366,1,5733
675,2019-08-27,54,3159,1675,2,4890
675,2019-08-28,69,3710,1776,0,5555
675,2019-08-29,80,7991,2000,0,10071
675,2019-08-30,49,2503,547,0,3099
675,2019-08-31,26,12875,10,0,12911
675,2019-09-01,41,4369,90,0,4500
675,2019-09-02,21,67,2,5,95
675,2019-09-03,50,3609,1456,1,5116
675,2019-09-04,62,9244,2827,2,12135
675,2019-09-05,288,5913,1759,1,7961
675,2019-09-06,947,16077,2080,0,19104
675,2019-09-07,1016,18038,1218,0,20272
675,2019-09-08,327,9697,2017,0,12041
675,2019-09-09,102,7629,2079,2,9812
675,2019-09-10,91,10104,1472,3,11670
675,2019-09-11,110,7030,2149,2,9291
675,2019-09-12,73,3296,1713,2,5084
675,2019-09-13,897,7721,2480,1,11099
675,2019-09-14,83,6765,2737,0,9585
675,2019-09-15,87,6133,1882,2,8104
675,2019-09-16,98,13743,2094,1,15936
675,2019-09-17,1771,13028,2291,0,17090
675,2019-09-18,63,10819,1418,1,12301
675,2019-09-19,221,16850,1984,3,19058
675,2019-09-20,201,14412,1171,0,15784
675,2019-09-21,70,6821,2160,2,9053
675,2019-09-22,159,8329,1393,1,9882
675,2019-09-23,204,6966,3008,1,10179
675,2019-09-24,120,7291,1754,5,9170
675,2019-09-25,131,6410,1597,0,8138
675,2019-09-26,121,11205,1422,1,12749
675,2019-09-27,1089,7887,2142,1,11119
675,2019-09-28,116,14117,1760,3,15996
675,2019-09-29,1812,14912,1405,3,18132
675,2019-09-30,51,16625,1587,0,18263
675,2019-10-01,97,19924,2130,0,22151
675,2019-10-02,145,12397,1937,1,14480
675,2019-10-03,472,21369,1244,0,23085
675,2019-10-04,591,19103,1797,74,21565
675,2019-10-05,625,22618,1208,2,24453
675,2019-10-06,957,15936,1948,0,18841
675,2019-10-07,947,4055,1781,1,6784
675,2019-10-08,1086,10913,1806,1,13806
675,2019-10-09,2439,13032,1826,4,17301
675,2019-10-10,208,9463,1330,0,11001
675,2019-10-11,984,14187,2046,1,17218
675,2019-10-12,161,7613,2272,1,10047
675,2019-10-13,1851,7322,2128,1,11302
675,2019-10-14,67,10087,1844,0,11998
675,2019-10-15,90,12751,1249,0,14090
675,2019-10-16,71,22503,1131,1,23706
675,2019-10-17,171,6518,2019,0,8708
675,2019-10-18,136,7442,1536,1,9115
675,2019-10-19,1953,3648,1901,1,7503
675,2019-10-20,1736,773,2208,0,4717
675,2019-10-21,299,16862,1198,0,18359
675,2019-10-22,939,8244,2490,1,11674
675,2019-10-23,52,6411,1398,0,7861
675,2019-10-24,238,12131,1324,2,13695
675,2019-10-25,671,14275,1063,2,16011
675,2019-10-26,76,23837,1614,1,25528
675,2019-10-27,119,29045,1471,0,30635
675,2019-10-28,950,15020,1373,0,17343
675,2019-10-29,805,14174,1749,4,16732
675,2019-10-30,85,14211,1435,2,15733
675,2019-10-31,1117,10700,1384,0,13201
675,2019-11-01,76,24452,1687,0,26215
675,2019-11-02,53,15224,1591,1,16869
675,2019-11-03,81,21010,1233,3,22327
675,2019-11-04,105,6179,1154,0,7438
675,2019-11-05,131,1190,2012,0,3333
675,2019-11-06,462,13443,1502,1,15408
675,2019-11-07,1093,15634,1250,2,17979
675,2019-11-08,72,8844,1110,0,10026
675,2019-11-09,339,7467,2150,0,9956
675,2019-11-10,102,11677,2066,0,13845
675,2019-11-11,260,7614,1778,0,9652
675,2019-11-12,198,9068,2504,0,11770
675,2019-11-13,76,18568,1657,0,20301
675,2019-11-14,91,8672,2536,0,11299
675,2019-11-15,144,2198,1864,0,4206
675,2019-11-16,94,696,2213,0,3003
675,2019-11-17,458,1656,2631,0,4745
675,2019-11-18,115,1834,2179,0,4128
675,2019-11-19,112,2712,2551,0,5375
675,2019-11-20,81,819,2023,0,2923
675,2019-11-21,102,2836,1563,0,4501
675,2019-11-22,71,1820,1890,2,3783
675,2019-11-23,90,4585,1806,3,6484
675,2019-11-24,163,7665,1808,2,9638
675,2019-11-25,82,9670,1435,0,11187
675,2019-11-26,677,7566,1959,0,10202
675,2019-11-27,330,4840,1665,2,6837
675,2019-11-28,399,11722,708,0,12829
675,2019-08-07,13,2,83,1,99
675,2019-08-08,30,207,360,0,597
675,2019-08-09,61,113,127,0,301
675,2019-08-10,126,435,195,1,757
675,2019-08-11,74,242,180,1,497
675,2019-08-12,255,274,176,0,705
675,2019-08-13,39,461,475,0,975
675,2019-08-14,143,1214,115,1,1473
675,2019-08-15,66,630,14,0,710
675,2019-08-16,46,152,102,0,300
675,2019-08-17,57,1078,501,0,1636
675,2019-08-18,84,627,1456,3,2170
675,2019-08-19,114,7952,1130,1,9197
675,2019-08-20,130,13042,1467,2,14641
675,2019-08-21,71,10798,1494,0,12363
675,2019-08-22,55,14079,1147,1,15282
675,2019-08-23,66,20754,1057,0,21877
675,2019-08-24,56,6773,1711,2,8542
675,2019-08-25,1212,12619,2290,4,16125
675,2019-08-26,90,4276,1366,1,5733
675,2019-08-27,54,3159,1675,2,4890
675,2019-08-28,69,3710,1776,0,5555
675,2019-08-29,80,7991,2000,0,10071
675,2019-08-30,49,2503,547,0,3099
675,2019-08-31,26,12875,10,0,12911
675,2019-09-01,41,4369,90,0,4500
675,2019-09-02,21,67,2,5,95
675,2019-09-03,50,3609,1456,1,5116
675,2019-09-04,62,9244,2827,2,12135
675,2019-09-05,288,5913,1759,1,7961
675,2019-09-06,947,16077,2080,0,19104
675,2019-09-07,1016,18038,1218,0,20272
675,2019-09-08,327,9697,2017,0,12041
675,2019-09-09,102,7629,2079,2,9812
675,2019-09-10,91,10104,1472,3,11670
675,2019-09-11,110,7030,2149,2,9291
675,2019-09-12,73,3296,1713,2,5084
675,2019-09-13,897,7721,2480,1,11099
675,2019-09-14,83,6765,2737,0,9585
675,2019-09-15,87,6133,1882,2,8104
675,2019-09-16,98,13743,2094,1,15936
675,2019-09-17,1771,13028,2291,0,17090
675,2019-09-18,63,10819,1418,1,12301
675,2019-09-19,221,16850,1984,3,19058
675,2019-09-20,201,14412,1171,0,15784
675,2019-09-21,70,6821,2160,2,9053
675,2019-09-22,159,8329,1393,1,9882
675,2019-09-23,204,6966,3008,1,10179
675,2019-09-24,120,7291,1754,5,9170
675,2019-09-25,131,6410,1597,0,8138
675,2019-09-26,121,11205,1422,1,12749
675,2019-09-27,1089,7887,2142,1,11119
675,2019-09-28,116,14117,1760,3,15996
675,2019-09-29,1812,14912,1405,3,18132
675,2019-09-30,51,16625,1587,0,18263
675,2019-10-01,97,19924,2130,0,22151
675,2019-10-02,145,12397,1937,1,14480
675,2019-10-03,472,21369,1244,0,23085
675,2019-10-04,591,19103,1797,74,21565
675,2019-10-05,625,22618,1208,2,24453
675,2019-10-06,957,15936,1948,0,18841
675,2019-10-07,947,4055,1781,1,6784
675,2019-10-08,1086,10913,1806,1,13806
675,2019-10-09,2439,13032,1826,4,17301
675,2019-10-10,208,9463,1330,0,11001
675,2019-10-11,984,14187,2046,1,17218
675,2019-10-12,161,7613,2272,1,10047
675,2019-10-13,1851,7322,2128,1,11302
675,2019-10-14,67,10087,1844,0,11998
675,2019-10-15,90,12751,1249,0,14090
675,2019-10-16,71,22503,1131,1,23706
675,2019-10-17,171,6518,2019,0,8708
675,2019-10-18,136,7442,1536,1,9115
675,2019-10-19,1953,3648,1901,1,7503
675,2019-10-20,1736,773,2208,0,4717
675,2019-10-21,299,16862,1198,0,18359
675,2019-10-22,939,8244,2490,1,11674
675,2019-10-23,52,6411,1398,0,7861
675,2019-10-24,238,12131,1324,2,13695
675,2019-10-25,671,14275,1063,2,16011
675,2019-10-26,76,23837,1614,1,25528
675,2019-10-27,119,29045,1471,0,30635
675,2019-10-28,950,15020,1373,0,17343
675,2019-10-29,805,14174,1749,4,16732
675,2019-10-30,85,14211,1435,2,15733
675,2019-10-31,1117,10700,1384,0,13201
675,2019-11-01,76,24452,1687,0,26215
675,2019-11-02,53,15224,1591,1,16869
675,2019-11-03,81,21010,1233,3,22327
675,2019-11-04,105,6179,1154,0,7438
675,2019-11-05,131,1190,2012,0,3333
675,2019-11-06,462,13443,1502,1,15408
675,2019-11-07,1093,15634,1250,2,17979
675,2019-11-08,72,8844,1110,0,10026
675,2019-11-09,339,7467,2150,0,9956
675,2019-11-10,102,11677,2066,0,13845
675,2019-11-11,260,7614,1778,0,9652
675,2019-11-12,198,9068,2504,0,11770
675,2019-11-13,76,18568,1657,0,20301
675,2019-11-14,91,8672,2536,0,11299
675,2019-11-15,144,2198,1864,0,4206
675,2019-11-16,94,696,2213,0,3003
675,2019-11-17,458,1656,2631,0,4745
675,2019-11-18,115,1834,2179,0,4128
675,2019-11-19,112,2712,2551,0,5375
675,2019-11-20,81,819,2023,0,2923
675,2019-11-21,102,2836,1563,0,4501
675,2019-11-22,71,1820,1890,2,3783
675,2019-11-23,90,4585,1806,3,6484
675,2019-11-24,163,7665,1808,2,9638
675,2019-11-25,82,9670,1435,0,11187
675,2019-11-26,677,7566,1959,0,10202
675,2019-11-27,330,4840,1665,2,6837
676,2019-08-08,6,0,161,0,167
676,2019-08-09,6999,223,155,0,7377
676,2019-08-10,10666,209,301,0,11176
676,2019-08-11,6380,199,17,1,6597
676,2019-08-12,3344,304,192,0,3840
676,2019-08-13,6481,483,504,0,7468
676,2019-08-14,7503,350,81,0,7934
676,2019-08-15,6469,601,23,0,7093
676,2019-08-16,7622,680,22,0,8324
676,2019-08-17,1022,2247,907,0,4176
676,2019-08-18,1678,683,1494,1,3856
676,2019-08-19,1014,7823,555,1,9393
676,2019-08-20,1056,13450,1001,1,15508
676,2019-08-21,1697,12621,538,1,14857
676,2019-08-22,1596,14544,986,1,17127
676,2019-08-23,2206,23824,979,1,27010
676,2019-08-24,1498,9755,1440,0,12693
676,2019-08-25,2164,14861,1923,2,18950
676,2019-08-26,1636,6527,2092,1,10256
676,2019-08-27,1985,2813,2080,2,6880
676,2019-08-28,3548,6677,1170,0,11395
676,2019-08-29,2013,8282,1536,0,11831
676,2019-08-30,1734,3365,468,1,5568
676,2019-08-31,1055,150,2,0,1207
676,2019-09-01,2022,402,156,0,2580
676,2019-09-02,4413,871,10,0,5294
676,2019-09-03,1494,3270,845,0,5609
676,2019-09-04,2800,12408,2646,0,17854
676,2019-09-05,2755,7653,2280,1,12689
676,2019-09-06,2309,11636,1999,0,15944
676,2019-09-07,1347,12100,1352,2,14801
676,2019-09-08,2881,5028,1996,0,9905
676,2019-09-09,2976,7866,2690,0,13532
676,2019-09-10,1471,12073,2483,0,16027
676,2019-09-11,2978,9780,1378,1,14137
676,2019-09-12,2404,8423,2315,2,13144
676,2019-09-13,2438,3571,1324,0,7333
676,2019-09-14,907,6513,1741,1,9162
676,2019-09-15,964,9788,2596,4,13352
676,2019-09-16,1116,16292,1974,2,19384
676,2019-09-17,1057,13041,1930,1,16029
676,2019-09-18,976,10773,1645,2,13396
676,2019-09-19,908,4741,540,0,6189
676,2019-09-20,418,8666,1261,1,10346
676,2019-09-21,305,7743,2112,4,10164
676,2019-09-22,1924,10074,1973,0,13971
676,2019-09-23,1299,9337,1442,0,12078
676,2019-09-24,1467,14259,2056,3,17785
676,2019-09-25,955,14203,1591,0,16749
676,2019-09-26,441,11287,1923,3,13654
676,2019-09-27,1606,8488,2172,1,12267
676,2019-09-28,805,15351,2007,3,18166
676,2019-09-29,686,17583,1830,0,20099
676,2019-09-30,1531,27609,2286,1,31427
676,2019-10-01,638,22649,1713,3,25003
676,2019-10-02,1546,18147,1598,0,21291
676,2019-10-03,991,23180,1665,0,25836
676,2019-10-04,811,21116,1614,1,23542
676,2019-10-05,852,23346,1505,2,25705
676,2019-10-06,794,17135,1372,3,19304
676,2019-10-07,725,6938,2055,1,9719
676,2019-10-08,811,18523,1818,2,21154
676,2019-10-09,1228,17626,1249,1,20104
676,2019-10-10,2022,17026,1572,2,20622
676,2019-10-11,657,12085,1399,4,14145
676,2019-10-12,2426,8374,1821,2,12623
676,2019-10-13,899,12199,2181,1,15280
676,2019-10-14,2311,6448,1441,1,10201
676,2019-10-15,641,15224,1505,1,17371
676,2019-10-16,1440,24359,1275,2,27076
676,2019-10-17,1067,8675,1981,1,11724
676,2019-10-18,1623,15019,1717,1,18360
676,2019-10-19,765,8576,1323,1,10665
676,2019-10-20,800,3142,2058,1,6001
676,2019-10-21,1486,10539,1562,3,13590
676,2019-10-22,995,6584,1626,1,9206
676,2019-10-23,923,14879,1458,3,17263
676,2019-10-24,929,19182,1537,2,21650
676,2019-10-25,1573,16191,1794,1,19559
676,2019-10-26,801,25363,1926,0,28090
676,2019-10-27,2125,31082,882,1,34090
676,2019-10-28,6108,24904,1305,0,32317
676,2019-10-29,1165,29234,1292,1,31692
676,2019-10-30,1223,20679,1455,2,23359
676,2019-10-31,5890,20299,1886,2,28077
676,2019-11-01,2890,27278,1724,0,31892
676,2019-11-02,3506,16770,1275,1,21552
676,2019-11-03,2599,36902,1599,502,41602
676,2019-11-04,2884,10820,1998,0,15702
676,2019-11-05,3800,3867,1565,0,9232
676,2019-11-06,4069,8789,958,1,13817
676,2019-11-07,2658,22747,1254,2,26661
676,2019-11-08,3125,12427,1653,0,17205
676,2019-11-09,3612,9056,1904,1,14573
676,2019-11-10,5063,14269,2433,2,21767
676,2019-11-11,6941,10062,1391,2,18396
676,2019-11-12,4208,11139,2287,0,17634
676,2019-11-13,500,14842,1628,4,16974
676,2019-11-14,680,8604,2076,1,11361
676,2019-11-15,531,3864,1823,2,6220
676,2019-11-16,713,2796,3034,1,6544
676,2019-11-17,884,3769,2410,0,7063
676,2019-11-18,600,2484,2928,0,6012
676,2019-11-19,1356,3482,2374,0,7212
676,2019-11-20,507,1405,1566,1,3479
676,2019-11-21,957,3549,1580,0,6086
676,2019-11-22,450,6150,1044,0,7644
676,2019-11-23,357,9900,2825,0,13082
676,2019-11-24,507,8429,1614,0,10550
676,2019-11-25,749,11990,2128,0,14867
676,2019-11-26,362,6321,2221,0,8904
676,2019-11-27,1258,11233,1163,0,13654
676,2019-11-28,434,9226,468,0,10128
676,2019-11-29,155,558,92,0,805
676,2019-08-09,6999,223,155,0,7377
676,2019-08-10,10666,209,301,0,11176
676,2019-08-11,6380,199,17,1,6597
676,2019-08-12,3344,304,192,0,3840
676,2019-08-13,6481,483,504,0,7468
676,2019-08-14,7503,350,81,0,7934
676,2019-08-15,6469,601,23,0,7093
676,2019-08-16,7622,680,22,0,8324
676,2019-08-17,1022,2247,907,0,4176
676,2019-08-18,1678,683,1494,1,3856
676,2019-08-19,1014,7823,555,1,9393
676,2019-08-20,1056,13450,1001,1,15508
676,2019-08-21,1697,12621,538,1,14857
676,2019-08-22,1596,14544,986,1,17127
676,2019-08-23,2206,23824,979,1,27010
676,2019-08-24,1498,9755,1440,0,12693
676,2019-08-25,2164,14861,1923,2,18950
676,2019-08-26,1636,6527,2092,1,10256
676,2019-08-27,1985,2813,2080,2,6880
676,2019-08-28,3548,6677,1170,0,11395
676,2019-08-29,2013,8282,1536,0,11831
676,2019-08-30,1734,3365,468,1,5568
676,2019-08-31,1055,150,2,0,1207
676,2019-09-01,2022,402,156,0,2580
676,2019-09-02,4413,871,10,0,5294
676,2019-09-03,1494,3270,845,0,5609
676,2019-09-04,2800,12408,2646,0,17854
676,2019-09-05,2755,7653,2280,1,12689
676,2019-09-06,2309,11636,1999,0,15944
676,2019-09-07,1347,12100,1352,2,14801
676,2019-09-08,2881,5028,1996,0,9905
676,2019-09-09,2976,7866,2690,0,13532
676,2019-09-10,1471,12073,2483,0,16027
676,2019-09-11,2978,9780,1378,1,14137
676,2019-09-12,2404,8423,2315,2,13144
676,2019-09-13,2438,3571,1324,0,7333
676,2019-09-14,907,6513,1741,1,9162
676,2019-09-15,964,9788,2596,4,13352
676,2019-09-16,1116,16292,1974,2,19384
676,2019-09-17,1057,13041,1930,1,16029
676,2019-09-18,976,10773,1645,2,13396
676,2019-09-19,908,4741,540,0,6189
676,2019-09-20,418,8666,1261,1,10346
676,2019-09-21,305,7743,2112,4,10164
676,2019-09-22,1924,10074,1973,0,13971
676,2019-09-23,1299,9337,1442,0,12078
676,2019-09-24,1467,14259,2056,3,17785
676,2019-09-25,955,14203,1591,0,16749
676,2019-09-26,441,11287,1923,3,13654
676,2019-09-27,1606,8488,2172,1,12267
676,2019-09-28,805,15351,2007,3,18166
676,2019-09-29,686,17583,1830,0,20099
676,2019-09-30,1531,27609,2286,1,31427
676,2019-10-01,638,22649,1713,3,25003
676,2019-10-02,1546,18147,1598,0,21291
676,2019-10-03,991,23180,1665,0,25836
676,2019-10-04,811,21116,1614,1,23542
676,2019-10-05,852,23346,1505,2,25705
676,2019-10-06,794,17135,1372,3,19304
676,2019-10-07,725,6938,2055,1,9719
676,2019-10-08,811,18523,1818,2,21154
676,2019-10-09,1228,17626,1249,1,20104
676,2019-10-10,2022,17026,1572,2,20622
676,2019-10-11,657,12085,1399,4,14145
676,2019-10-12,2426,8374,1821,2,12623
676,2019-10-13,899,12199,2181,1,15280
676,2019-10-14,2311,6448,1441,1,10201
676,2019-10-15,641,15224,1505,1,17371
676,2019-10-16,1440,24359,1275,2,27076
676,2019-10-17,1067,8675,1981,1,11724
676,2019-10-18,1623,15019,1717,1,18360
676,2019-10-19,765,8576,1323,1,10665
676,2019-10-20,800,3142,2058,1,6001
676,2019-10-21,1486,10539,1562,3,13590
676,2019-10-22,995,6584,1626,1,9206
676,2019-10-23,923,14879,1458,3,17263
676,2019-10-24,929,19182,1537,2,21650
676,2019-10-25,1573,16191,1794,1,19559
676,2019-10-26,801,25363,1926,0,28090
676,2019-10-27,2125,31082,882,1,34090
676,2019-10-28,6108,24904,1305,0,32317
676,2019-10-29,1165,29234,1292,1,31692
676,2019-10-30,1223,20679,1455,2,23359
676,2019-10-31,5890,20299,1886,2,28077
676,2019-11-01,2890,27278,1724,0,31892
676,2019-11-02,3506,16770,1275,1,21552
676,2019-11-03,2599,36902,1599,502,41602
676,2019-11-04,2884,10820,1998,0,15702
676,2019-11-05,3800,3867,1565,0,9232
676,2019-11-06,4069,8789,958,1,13817
676,2019-11-07,2658,22747,1254,2,26661
676,2019-11-08,3125,12427,1653,0,17205
676,2019-11-09,3612,9056,1904,1,14573
676,2019-11-10,5063,14269,2433,2,21767
676,2019-11-11,6941,10062,1391,2,18396
676,2019-11-12,4208,11139,2287,0,17634
676,2019-11-13,500,14842,1628,4,16974
676,2019-11-14,680,8604,2076,1,11361
676,2019-11-15,531,3864,1823,2,6220
676,2019-11-16,713,2796,3034,1,6544
676,2019-11-17,884,3769,2410,0,7063
676,2019-11-18,600,2484,2928,0,6012
676,2019-11-19,1356,3482,2374,0,7212
676,2019-11-20,507,1405,1566,1,3479
676,2019-11-21,957,3549,1580,0,6086
676,2019-11-22,450,6150,1044,0,7644
676,2019-11-23,357,9900,2825,0,13082
676,2019-11-24,507,8429,1614,0,10550
676,2019-11-25,749,11990,2128,0,14867
676,2019-11-26,362,6321,2221,0,8904
676,2019-11-27,1258,11233,1163,0,13654
676,2019-11-28,434,9226,468,0,10128
676,2019-11-29,155,558,92,0,805
676,2019-08-08,6,0,161,0,167
676,2019-08-09,6999,223,155,0,7377
676,2019-08-10,10666,209,301,0,11176
676,2019-08-11,6380,199,17,1,6597
676,2019-08-12,3344,304,192,0,3840
676,2019-08-13,6481,483,504,0,7468
676,2019-08-14,7503,350,81,0,7934
676,2019-08-15,6469,601,23,0,7093
676,2019-08-16,7622,680,22,0,8324
676,2019-08-17,1022,2247,907,0,4176
676,2019-08-18,1678,683,1494,1,3856
676,2019-08-19,1014,7823,555,1,9393
676,2019-08-20,1056,13450,1001,1,15508
676,2019-08-21,1697,12621,538,1,14857
676,2019-08-22,1596,14544,986,1,17127
676,2019-08-23,2206,23824,979,1,27010
676,2019-08-24,1498,9755,1440,0,12693
676,2019-08-25,2164,14861,1923,2,18950
676,2019-08-26,1636,6527,2092,1,10256
676,2019-08-27,1985,2813,2080,2,6880
676,2019-08-28,3548,6677,1170,0,11395
676,2019-08-29,2013,8282,1536,0,11831
676,2019-08-30,1734,3365,468,1,5568
676,2019-08-31,1055,150,2,0,1207
676,2019-09-01,2022,402,156,0,2580
676,2019-09-02,4413,871,10,0,5294
676,2019-09-03,1494,3270,845,0,5609
676,2019-09-04,2800,12408,2646,0,17854
676,2019-09-05,2755,7653,2280,1,12689
676,2019-09-06,2309,11636,1999,0,15944
676,2019-09-07,1347,12100,1352,2,14801
676,2019-09-08,2881,5028,1996,0,9905
676,2019-09-09,2976,7866,2690,0,13532
676,2019-09-10,1471,12073,2483,0,16027
676,2019-09-11,2978,9780,1378,1,14137
676,2019-09-12,2404,8423,2315,2,13144
676,2019-09-13,2438,3571,1324,0,7333
676,2019-09-14,907,6513,1741,1,9162
676,2019-09-15,964,9788,2596,4,13352
676,2019-09-16,1116,16292,1974,2,19384
676,2019-09-17,1057,13041,1930,1,16029
676,2019-09-18,976,10773,1645,2,13396
676,2019-09-19,908,4741,540,0,6189
676,2019-09-20,418,8666,1261,1,10346
676,2019-09-21,305,7743,2112,4,10164
676,2019-09-22,1924,10074,1973,0,13971
676,2019-09-23,1299,9337,1442,0,12078
676,2019-09-24,1467,14259,2056,3,17785
676,2019-09-25,955,14203,1591,0,16749
676,2019-09-26,441,11287,1923,3,13654
676,2019-09-27,1606,8488,2172,1,12267
676,2019-09-28,805,15351,2007,3,18166
676,2019-09-29,686,17583,1830,0,20099
676,2019-09-30,1531,27609,2286,1,31427
676,2019-10-01,638,22649,1713,3,25003
676,2019-10-02,1546,18147,1598,0,21291
676,2019-10-03,991,23180,1665,0,25836
676,2019-10-04,811,21116,1614,1,23542
676,2019-10-05,852,23346,1505,2,25705
676,2019-10-06,794,17135,1372,3,19304
676,2019-10-07,725,6938,2055,1,9719
676,2019-10-08,811,18523,1818,2,21154
676,2019-10-09,1228,17626,1249,1,20104
676,2019-10-10,2022,17026,1572,2,20622
676,2019-10-11,657,12085,1399,4,14145
676,2019-10-12,2426,8374,1821,2,12623
676,2019-10-13,899,12199,2181,1,15280
676,2019-10-14,2311,6448,1441,1,10201
676,2019-10-15,641,15224,1505,1,17371
676,2019-10-16,1440,24359,1275,2,27076
676,2019-10-17,1067,8675,1981,1,11724
676,2019-10-18,1623,15019,1717,1,18360
676,2019-10-19,765,8576,1323,1,10665
676,2019-10-20,800,3142,2058,1,6001
676,2019-10-21,1486,10539,1562,3,13590
676,2019-10-22,995,6584,1626,1,9206
676,2019-10-23,923,14879,1458,3,17263
676,2019-10-24,929,19182,1537,2,21650
676,2019-10-25,1573,16191,1794,1,19559
676,2019-10-26,801,25363,1926,0,28090
676,2019-10-27,2125,31082,882,1,34090
676,2019-10-28,6108,24904,1305,0,32317
676,2019-10-29,1165,29234,1292,1,31692
676,2019-10-30,1223,20679,1455,2,23359
676,2019-10-31,5890,20299,1886,2,28077
676,2019-11-01,2890,27278,1724,0,31892
676,2019-11-02,3506,16770,1275,1,21552
676,2019-11-03,2599,36902,1599,502,41602
676,2019-11-04,2884,10820,1998,0,15702
676,2019-11-05,3800,3867,1565,0,9232
676,2019-11-06,4069,8789,958,1,13817
676,2019-11-07,2658,22747,1254,2,26661
676,2019-11-08,3125,12427,1653,0,17205
676,2019-11-09,3612,9056,1904,1,14573
676,2019-11-10,5063,14269,2433,2,21767
676,2019-11-11,6941,10062,1391,2,18396
676,2019-11-12,4208,11139,2287,0,17634
676,2019-11-13,500,14842,1628,4,16974
676,2019-11-14,680,8604,2076,1,11361
676,2019-11-15,531,3864,1823,2,6220
676,2019-11-16,713,2796,3034,1,6544
676,2019-11-17,884,3769,2410,0,7063
676,2019-11-18,600,2484,2928,0,6012
676,2019-11-19,1356,3482,2374,0,7212
676,2019-11-20,507,1405,1566,1,3479
676,2019-11-21,957,3549,1580,0,6086
676,2019-11-22,450,6150,1044,0,7644
676,2019-11-23,357,9900,2825,0,13082
676,2019-11-24,507,8429,1614,0,10550
676,2019-11-25,749,11990,2128,0,14867
676,2019-11-26,362,6321,2221,0,8904
676,2019-11-27,1258,11233,1163,0,13654
676,2019-11-28,434,9226,468,0,10128
676,2019-11-29,155,558,92,0,805
676,2019-08-11,6380,199,17,1,6597
676,2019-08-12,3344,304,192,0,3840
676,2019-08-13,6481,483,504,0,7468
676,2019-08-14,7503,350,81,0,7934
676,2019-08-15,6469,601,23,0,7093
676,2019-08-16,7622,680,22,0,8324
676,2019-08-17,1022,2247,907,0,4176
676,2019-08-18,1678,683,1494,1,3856
676,2019-08-19,1014,7823,555,1,9393
676,2019-08-20,1056,13450,1001,1,15508
676,2019-08-21,1697,12621,538,1,14857
676,2019-08-22,1596,14544,986,1,17127
676,2019-08-23,2206,23824,979,1,27010
676,2019-08-24,1498,9755,1440,0,12693
676,2019-08-25,2164,14861,1923,2,18950
676,2019-08-26,1636,6527,2092,1,10256
676,2019-08-27,1985,2813,2080,2,6880
676,2019-08-28,3548,6677,1170,0,11395
676,2019-08-29,2013,8282,1536,0,11831
676,2019-08-30,1734,3365,468,1,5568
676,2019-08-31,1055,150,2,0,1207
676,2019-09-01,2022,402,156,0,2580
676,2019-09-02,4413,871,10,0,5294
676,2019-09-03,1494,3270,845,0,5609
676,2019-09-04,2800,12408,2646,0,17854
676,2019-09-05,2755,7653,2280,1,12689
676,2019-09-06,2309,11636,1999,0,15944
676,2019-09-07,1347,12100,1352,2,14801
676,2019-09-08,2881,5028,1996,0,9905
676,2019-09-09,2976,7866,2690,0,13532
676,2019-09-10,1471,12073,2483,0,16027
676,2019-09-11,2978,9780,1378,1,14137
676,2019-09-12,2404,8423,2315,2,13144
676,2019-09-13,2438,3571,1324,0,7333
676,2019-09-14,907,6513,1741,1,9162
676,2019-09-15,964,9788,2596,4,13352
676,2019-09-16,1116,16292,1974,2,19384
676,2019-09-17,1057,13041,1930,1,16029
676,2019-09-18,976,10773,1645,2,13396
676,2019-09-19,908,4741,540,0,6189
676,2019-09-20,418,8666,1261,1,10346
676,2019-09-21,305,7743,2112,4,10164
676,2019-09-22,1924,10074,1973,0,13971
676,2019-09-23,1299,9337,1442,0,12078
676,2019-09-24,1467,14259,2056,3,17785
676,2019-09-25,955,14203,1591,0,16749
676,2019-09-26,441,11287,1923,3,13654
676,2019-09-27,1606,8488,2172,1,12267
676,2019-09-28,805,15351,2007,3,18166
676,2019-09-29,686,17583,1830,0,20099
676,2019-09-30,1531,27609,2286,1,31427
676,2019-10-01,638,22649,1713,3,25003
676,2019-10-02,1546,18147,1598,0,21291
676,2019-10-03,991,23180,1665,0,25836
676,2019-10-04,811,21116,1614,1,23542
676,2019-10-05,852,23346,1505,2,25705
676,2019-10-06,794,17135,1372,3,19304
676,2019-10-07,725,6938,2055,1,9719
676,2019-10-08,811,18523,1818,2,21154
676,2019-10-09,1228,17626,1249,1,20104
676,2019-10-10,2022,17026,1572,2,20622
676,2019-10-11,657,12085,1399,4,14145
676,2019-10-12,2426,8374,1821,2,12623
676,2019-10-13,899,12199,2181,1,15280
676,2019-10-14,2311,6448,1441,1,10201
676,2019-10-15,641,15224,1505,1,17371
676,2019-10-16,1440,24359,1275,2,27076
676,2019-10-17,1067,8675,1981,1,11724
676,2019-10-18,1623,15019,1717,1,18360
676,2019-10-19,765,8576,1323,1,10665
676,2019-10-20,800,3142,2058,1,6001
676,2019-10-21,1486,10539,1562,3,13590
676,2019-10-22,995,6584,1626,1,9206
676,2019-10-23,923,14879,1458,3,17263
676,2019-10-24,929,19182,1537,2,21650
676,2019-10-25,1573,16191,1794,1,19559
676,2019-10-26,801,25363,1926,0,28090
676,2019-10-27,2125,31082,882,1,34090
676,2019-10-28,6108,24904,1305,0,32317
676,2019-10-29,1165,29234,1292,1,31692
676,2019-10-30,1223,20679,1455,2,23359
676,2019-10-31,5890,20299,1886,2,28077
676,2019-11-01,2890,27278,1724,0,31892
676,2019-11-02,3506,16770,1275,1,21552
676,2019-11-03,2599,36902,1599,502,41602
676,2019-11-04,2884,10820,1998,0,15702
676,2019-11-05,3800,3867,1565,0,9232
676,2019-11-06,4069,8789,958,1,13817
676,2019-11-07,2658,22747,1254,2,26661
676,2019-11-08,3125,12427,1653,0,17205
676,2019-11-09,3612,9056,1904,1,14573
676,2019-11-10,5063,14269,2433,2,21767
676,2019-11-11,6941,10062,1391,2,18396
676,2019-11-12,4208,11139,2287,0,17634
676,2019-11-13,500,14842,1628,4,16974
676,2019-11-14,680,8604,2076,1,11361
676,2019-11-15,531,3864,1823,2,6220
676,2019-11-16,713,2796,3034,1,6544
676,2019-11-17,884,3769,2410,0,7063
676,2019-11-18,600,2484,2928,0,6012
676,2019-11-19,1356,3482,2374,0,7212
676,2019-11-20,507,1405,1566,1,3479
677,2019-08-08,2,2,307,0,311
677,2019-08-09,57,256,361,1,675
677,2019-08-10,94,418,141,0,653
677,2019-08-11,235,188,197,4,624
677,2019-08-12,99,412,432,0,943
677,2019-08-13,275,610,70,0,955
677,2019-08-14,102,219,117,0,438
677,2019-08-15,93,33,49,0,175
677,2019-08-16,348,466,37,0,851
677,2019-08-17,116,1647,338,0,2101
677,2019-08-18,943,2187,898,0,4028
677,2019-08-19,74,4809,1159,0,6042
677,2019-08-20,1058,1939,826,0,3823
677,2019-08-21,87,1225,1847,0,3159
677,2019-08-22,100,14477,1173,0,15750
677,2019-08-23,57,5978,1676,0,7711
677,2019-08-24,95,4523,2158,0,6776
677,2019-08-25,97,13513,1995,2,15607
677,2019-08-26,1786,24404,1530,1,27721
677,2019-08-27,116,7017,1910,0,9043
677,2019-08-28,917,14077,1516,0,16510
677,2019-08-29,134,13163,2161,0,15458
677,2019-08-30,73,3090,994,1,4158
677,2019-08-31,59,164,0,0,223
677,2019-09-01,424,945,456,0,1825
677,2019-09-02,18,140,46,0,204
677,2019-09-03,112,7946,1822,1,9881
677,2019-09-04,914,13449,1857,0,16220
677,2019-09-05,109,6494,2860,0,9463
677,2019-09-06,779,15092,2985,0,18856
677,2019-09-07,181,18063,1817,0,20061
677,2019-09-08,183,4969,2321,0,7473
677,2019-09-09,110,7441,1937,1,9489
677,2019-09-10,64,9335,1871,1,11271
677,2019-09-11,227,6496,1753,5,8481
677,2019-09-12,200,6843,2260,3,9306
677,2019-09-13,93,5745,1934,2,7774
677,2019-09-14,67,7767,2522,1,10357
677,2019-09-15,1041,7463,1749,2,10255
677,2019-09-16,1733,14092,2044,6,17875
677,2019-09-17,76,12604,2093,6,14779
677,2019-09-18,88,11492,1440,12,13032
677,2019-09-19,246,3409,1620,9,5284
677,2019-09-20,196,11230,2185,9,13620
677,2019-09-21,185,5521,1304,10,7020
677,2019-09-22,68,10027,1250,6,11351
677,2019-09-23,207,8717,1423,3,10350
677,2019-09-24,123,9948,1625,2,11698
677,2019-09-25,1015,9826,1299,2,12142
677,2019-09-26,124,10352,1789,0,12265
677,2019-09-27,165,10534,1954,2,12655
677,2019-09-28,125,15527,1343,5,17000
677,2019-09-29,95,17356,1711,0,19162
677,2019-09-30,916,18614,1584,0,21114
677,2019-10-01,951,17216,1410,1,19578
677,2019-10-02,142,13132,1807,0,15081
677,2019-10-03,133,14743,1280,0,16156
677,2019-10-04,482,13013,1796,3,15294
677,2019-10-05,802,15095,2141,1,18039
677,2019-10-06,994,13472,1675,0,16141
677,2019-10-07,93,8186,1463,1,9743
677,2019-10-08,632,14247,1437,3,16319
677,2019-10-09,673,16706,1522,1,18902
677,2019-10-10,1018,16753,2267,1,20039
677,2019-10-11,981,11583,1770,2,14336
677,2019-10-12,947,7649,2000,3574,14170
677,2019-10-13,376,9533,1397,4,11310
677,2019-10-14,1439,11404,2089,0,14932
677,2019-10-15,1794,8733,1371,0,11898
677,2019-10-16,1000,18944,966,1,20911
677,2019-10-17,71,8619,2116,2,10808
677,2019-10-18,908,9224,1073,3,11208
677,2019-10-19,84,5833,2482,1,8400
677,2019-10-20,1279,3086,1526,0,5891
677,2019-10-21,1520,18808,1707,2,22037
677,2019-10-22,82,11971,2587,2,14642
677,2019-10-23,119,14822,1345,4,16290
677,2019-10-24,208,25992,1895,1,28096
677,2019-10-25,111,15151,2182,1,17445
677,2019-10-26,75,13619,2616,0,16310
677,2019-10-27,714,17296,2337,0,20347
677,2019-10-28,51,22777,2676,1,25505
677,2019-10-29,214,29204,2197,2,31617
677,2019-10-30,69,29814,1125,1,31009
677,2019-10-31,52,15075,1018,2,16147
677,2019-11-01,156,26267,1464,0,27887
677,2019-11-02,41,17323,1594,4,18962
677,2019-11-03,422,36538,1028,0,37988
677,2019-11-04,87,11169,1829,1,13086
677,2019-11-05,917,4427,2268,0,7612
677,2019-11-06,113,15359,2312,1,17785
677,2019-11-07,169,24637,1678,4,26488
677,2019-11-08,80,18053,971,0,19104
677,2019-11-09,1076,16244,1567,1,18888
677,2019-11-10,869,15694,1216,0,17779
677,2019-11-11,87,14591,1401,0,16079
677,2019-11-12,461,19175,3156,2,22794
677,2019-11-13,1072,14646,1303,3,17024
677,2019-11-14,81,8778,2523,2,11384
677,2019-11-15,74,3869,2103,1,6047
677,2019-11-16,176,2916,2111,1,5204
677,2019-11-17,113,3975,4254,4,8346
677,2019-11-18,1688,3401,3319,1,8409
677,2019-11-19,152,3320,2620,0,6092
677,2019-11-20,69,1607,2276,0,3952
677,2019-11-21,95,5852,1459,1,7407
677,2019-11-22,96,9419,1698,0,11213
677,2019-11-23,2895,6727,2689,0,12311
677,2019-11-24,302,5963,1994,0,8259
677,2019-11-25,68,6938,2519,0,9525
677,2019-11-26,346,9490,1930,0,11766
677,2019-11-27,46,6944,1443,0,8433
677,2019-11-28,66,12781,970,0,13817
677,2019-11-29,9,1229,2,0,1240
677,2019-08-08,2,2,307,0,311
677,2019-08-09,57,256,361,1,675
677,2019-08-10,94,418,141,0,653
677,2019-08-11,235,188,197,4,624
677,2019-08-12,99,412,432,0,943
677,2019-08-13,275,610,70,0,955
677,2019-08-14,102,219,117,0,438
677,2019-08-15,93,33,49,0,175
677,2019-08-16,348,466,37,0,851
677,2019-08-17,116,1647,338,0,2101
677,2019-08-18,943,2187,898,0,4028
677,2019-08-19,74,4809,1159,0,6042
677,2019-08-20,1058,1939,826,0,3823
677,2019-08-21,87,1225,1847,0,3159
677,2019-08-22,100,14477,1173,0,15750
677,2019-08-23,57,5978,1676,0,7711
677,2019-08-24,95,4523,2158,0,6776
677,2019-08-25,97,13513,1995,2,15607
677,2019-08-26,1786,24404,1530,1,27721
677,2019-08-27,116,7017,1910,0,9043
677,2019-08-28,917,14077,1516,0,16510
677,2019-08-29,134,13163,2161,0,15458
677,2019-08-30,73,3090,994,1,4158
677,2019-08-31,59,164,0,0,223
677,2019-09-01,424,945,456,0,1825
677,2019-09-02,18,140,46,0,204
677,2019-09-03,112,7946,1822,1,9881
677,2019-09-04,914,13449,1857,0,16220
677,2019-09-05,109,6494,2860,0,9463
677,2019-09-06,779,15092,2985,0,18856
677,2019-09-07,181,18063,1817,0,20061
677,2019-09-08,183,4969,2321,0,7473
677,2019-09-09,110,7441,1937,1,9489
677,2019-09-10,64,9335,1871,1,11271
677,2019-09-11,227,6496,1753,5,8481
677,2019-09-12,200,6843,2260,3,9306
677,2019-09-13,93,5745,1934,2,7774
677,2019-09-14,67,7767,2522,1,10357
677,2019-09-15,1041,7463,1749,2,10255
677,2019-09-16,1733,14092,2044,6,17875
677,2019-09-17,76,12604,2093,6,14779
677,2019-09-18,88,11492,1440,12,13032
677,2019-09-19,246,3409,1620,9,5284
677,2019-09-20,196,11230,2185,9,13620
677,2019-09-21,185,5521,1304,10,7020
677,2019-09-22,68,10027,1250,6,11351
677,2019-09-23,207,8717,1423,3,10350
677,2019-09-24,123,9948,1625,2,11698
677,2019-09-25,1015,9826,1299,2,12142
677,2019-09-26,124,10352,1789,0,12265
677,2019-09-27,165,10534,1954,2,12655
677,2019-09-28,125,15527,1343,5,17000
677,2019-09-29,95,17356,1711,0,19162
677,2019-09-30,916,18614,1584,0,21114
677,2019-10-01,951,17216,1410,1,19578
677,2019-10-02,142,13132,1807,0,15081
677,2019-10-03,133,14743,1280,0,16156
677,2019-10-04,482,13013,1796,3,15294
677,2019-10-05,802,15095,2141,1,18039
677,2019-10-06,994,13472,1675,0,16141
677,2019-10-07,93,8186,1463,1,9743
677,2019-10-08,632,14247,1437,3,16319
677,2019-10-09,673,16706,1522,1,18902
677,2019-10-10,1018,16753,2267,1,20039
677,2019-10-11,981,11583,1770,2,14336
677,2019-10-12,947,7649,2000,3574,14170
677,2019-10-13,376,9533,1397,4,11310
677,2019-10-14,1439,11404,2089,0,14932
677,2019-10-15,1794,8733,1371,0,11898
677,2019-10-16,1000,18944,966,1,20911
677,2019-10-17,71,8619,2116,2,10808
677,2019-10-18,908,9224,1073,3,11208
677,2019-10-19,84,5833,2482,1,8400
677,2019-10-20,1279,3086,1526,0,5891
677,2019-10-21,1520,18808,1707,2,22037
677,2019-10-22,82,11971,2587,2,14642
677,2019-10-23,119,14822,1345,4,16290
677,2019-10-24,208,25992,1895,1,28096
677,2019-10-25,111,15151,2182,1,17445
677,2019-10-26,75,13619,2616,0,16310
677,2019-10-27,714,17296,2337,0,20347
677,2019-10-28,51,22777,2676,1,25505
677,2019-10-29,214,29204,2197,2,31617
677,2019-10-30,69,29814,1125,1,31009
677,2019-10-31,52,15075,1018,2,16147
677,2019-11-01,156,26267,1464,0,27887
677,2019-11-02,41,17323,1594,4,18962
677,2019-11-03,422,36538,1028,0,37988
677,2019-11-04,87,11169,1829,1,13086
677,2019-11-05,917,4427,2268,0,7612
677,2019-11-06,113,15359,2312,1,17785
677,2019-11-07,169,24637,1678,4,26488
677,2019-11-08,80,18053,971,0,19104
677,2019-11-09,1076,16244,1567,1,18888
677,2019-11-10,869,15694,1216,0,17779
677,2019-11-11,87,14591,1401,0,16079
677,2019-11-12,461,19175,3156,2,22794
677,2019-11-13,1072,14646,1303,3,17024
677,2019-11-14,81,8778,2523,2,11384
677,2019-11-15,74,3869,2103,1,6047
677,2019-11-16,176,2916,2111,1,5204
677,2019-11-17,113,3975,4254,4,8346
677,2019-11-18,1688,3401,3319,1,8409
677,2019-11-19,152,3320,2620,0,6092
677,2019-11-20,69,1607,2276,0,3952
677,2019-11-21,95,5852,1459,1,7407
677,2019-11-22,96,9419,1698,0,11213
677,2019-11-23,2895,6727,2689,0,12311
677,2019-11-24,302,5963,1994,0,8259
677,2019-11-25,68,6938,2519,0,9525
677,2019-11-26,346,9490,1930,0,11766
677,2019-11-27,46,6944,1443,0,8433
677,2019-11-28,66,12781,970,0,13817
677,2019-11-29,9,1229,2,0,1240
677,2019-08-08,2,2,307,0,311
677,2019-08-09,57,256,361,1,675
677,2019-08-10,94,418,141,0,653
677,2019-08-11,235,188,197,4,624
677,2019-08-12,99,412,432,0,943
677,2019-08-13,275,610,70,0,955
677,2019-08-14,102,219,117,0,438
677,2019-08-15,93,33,49,0,175
677,2019-08-16,348,466,37,0,851
677,2019-08-17,116,1647,338,0,2101
677,2019-08-18,943,2187,898,0,4028
677,2019-08-19,74,4809,1159,0,6042
677,2019-08-20,1058,1939,826,0,3823
677,2019-08-21,87,1225,1847,0,3159
677,2019-08-22,100,14477,1173,0,15750
677,2019-08-23,57,5978,1676,0,7711
677,2019-08-24,95,4523,2158,0,6776
677,2019-08-25,97,13513,1995,2,15607
677,2019-08-26,1786,24404,1530,1,27721
677,2019-08-27,116,7017,1910,0,9043
677,2019-08-28,917,14077,1516,0,16510
677,2019-08-29,134,13163,2161,0,15458
677,2019-08-30,73,3090,994,1,4158
677,2019-08-31,59,164,0,0,223
677,2019-09-01,424,945,456,0,1825
677,2019-09-02,18,140,46,0,204
677,2019-09-03,112,7946,1822,1,9881
677,2019-09-04,914,13449,1857,0,16220
677,2019-09-05,109,6494,2860,0,9463
677,2019-09-06,779,15092,2985,0,18856
677,2019-09-07,181,18063,1817,0,20061
677,2019-09-08,183,4969,2321,0,7473
677,2019-09-09,110,7441,1937,1,9489
677,2019-09-10,64,9335,1871,1,11271
677,2019-09-11,227,6496,1753,5,8481
677,2019-09-12,200,6843,2260,3,9306
677,2019-09-13,93,5745,1934,2,7774
677,2019-09-14,67,7767,2522,1,10357
677,2019-09-15,1041,7463,1749,2,10255
677,2019-09-16,1733,14092,2044,6,17875
677,2019-09-17,76,12604,2093,6,14779
677,2019-09-18,88,11492,1440,12,13032
677,2019-09-19,246,3409,1620,9,5284
677,2019-09-20,196,11230,2185,9,13620
677,2019-09-21,185,5521,1304,10,7020
677,2019-09-22,68,10027,1250,6,11351
677,2019-09-23,207,8717,1423,3,10350
677,2019-09-24,123,9948,1625,2,11698
677,2019-09-25,1015,9826,1299,2,12142
677,2019-09-26,124,10352,1789,0,12265
677,2019-09-27,165,10534,1954,2,12655
677,2019-09-28,125,15527,1343,5,17000
677,2019-09-29,95,17356,1711,0,19162
677,2019-09-30,916,18614,1584,0,21114
677,2019-10-01,951,17216,1410,1,19578
677,2019-10-02,142,13132,1807,0,15081
677,2019-10-03,133,14743,1280,0,16156
677,2019-10-04,482,13013,1796,3,15294
677,2019-10-05,802,15095,2141,1,18039
677,2019-10-06,994,13472,1675,0,16141
677,2019-10-07,93,8186,1463,1,9743
677,2019-10-08,632,14247,1437,3,16319
677,2019-10-09,673,16706,1522,1,18902
677,2019-10-10,1018,16753,2267,1,20039
677,2019-10-11,981,11583,1770,2,14336
677,2019-10-12,947,7649,2000,3574,14170
677,2019-10-13,376,9533,1397,4,11310
677,2019-10-14,1439,11404,2089,0,14932
677,2019-10-15,1794,8733,1371,0,11898
677,2019-10-16,1000,18944,966,1,20911
677,2019-10-17,71,8619,2116,2,10808
677,2019-10-18,908,9224,1073,3,11208
677,2019-10-19,84,5833,2482,1,8400
677,2019-10-20,1279,3086,1526,0,5891
677,2019-10-21,1520,18808,1707,2,22037
677,2019-10-22,82,11971,2587,2,14642
677,2019-10-23,119,14822,1345,4,16290
677,2019-10-24,208,25992,1895,1,28096
677,2019-10-25,111,15151,2182,1,17445
677,2019-10-26,75,13619,2616,0,16310
677,2019-10-27,714,17296,2337,0,20347
677,2019-10-28,51,22777,2676,1,25505
677,2019-10-29,214,29204,2197,2,31617
677,2019-10-30,69,29814,1125,1,31009
677,2019-10-31,52,15075,1018,2,16147
677,2019-11-01,156,26267,1464,0,27887
677,2019-11-02,41,17323,1594,4,18962
677,2019-11-03,422,36538,1028,0,37988
677,2019-11-04,87,11169,1829,1,13086
677,2019-11-05,917,4427,2268,0,7612
677,2019-11-06,113,15359,2312,1,17785
677,2019-11-07,169,24637,1678,4,26488
677,2019-11-08,80,18053,971,0,19104
677,2019-11-09,1076,16244,1567,1,18888
677,2019-11-10,869,15694,1216,0,17779
677,2019-11-11,87,14591,1401,0,16079
677,2019-11-12,461,19175,3156,2,22794
677,2019-11-13,1072,14646,1303,3,17024
677,2019-11-14,81,8778,2523,2,11384
677,2019-11-15,74,3869,2103,1,6047
677,2019-11-16,176,2916,2111,1,5204
677,2019-11-17,113,3975,4254,4,8346
677,2019-11-18,1688,3401,3319,1,8409
677,2019-11-19,152,3320,2620,0,6092
677,2019-11-20,69,1607,2276,0,3952
677,2019-11-21,95,5852,1459,1,7407
677,2019-11-22,96,9419,1698,0,11213
677,2019-11-23,2895,6727,2689,0,12311
677,2019-11-24,302,5963,1994,0,8259
677,2019-11-25,68,6938,2519,0,9525
677,2019-11-26,346,9490,1930,0,11766
677,2019-11-27,46,6944,1443,0,8433
677,2019-11-28,66,12781,970,0,13817
677,2019-11-29,9,1229,2,0,1240
677,2019-08-09,57,256,361,1,675
677,2019-08-10,94,418,141,0,653
677,2019-08-11,235,188,197,4,624
677,2019-08-12,99,412,432,0,943
677,2019-08-13,275,610,70,0,955
677,2019-08-14,102,219,117,0,438
677,2019-08-15,93,33,49,0,175
677,2019-08-16,348,466,37,0,851
677,2019-08-17,116,1647,338,0,2101
677,2019-08-18,943,2187,898,0,4028
677,2019-08-19,74,4809,1159,0,6042
677,2019-08-20,1058,1939,826,0,3823
677,2019-08-21,87,1225,1847,0,3159
677,2019-08-22,100,14477,1173,0,15750
677,2019-08-23,57,5978,1676,0,7711
677,2019-08-24,95,4523,2158,0,6776
677,2019-08-25,97,13513,1995,2,15607
677,2019-08-26,1786,24404,1530,1,27721
677,2019-08-27,116,7017,1910,0,9043
677,2019-08-28,917,14077,1516,0,16510
677,2019-08-29,134,13163,2161,0,15458
677,2019-08-30,73,3090,994,1,4158
677,2019-08-31,59,164,0,0,223
677,2019-09-01,424,945,456,0,1825
677,2019-09-02,18,140,46,0,204
677,2019-09-03,112,7946,1822,1,9881
677,2019-09-04,914,13449,1857,0,16220
677,2019-09-05,109,6494,2860,0,9463
677,2019-09-06,779,15092,2985,0,18856
677,2019-09-07,181,18063,1817,0,20061
677,2019-09-08,183,4969,2321,0,7473
677,2019-09-09,110,7441,1937,1,9489
677,2019-09-10,64,9335,1871,1,11271
677,2019-09-11,227,6496,1753,5,8481
677,2019-09-12,200,6843,2260,3,9306
677,2019-09-13,93,5745,1934,2,7774
677,2019-09-14,67,7767,2522,1,10357
677,2019-09-15,1041,7463,1749,2,10255
677,2019-09-16,1733,14092,2044,6,17875
677,2019-09-17,76,12604,2093,6,14779
677,2019-09-18,88,11492,1440,12,13032
677,2019-09-19,246,3409,1620,9,5284
677,2019-09-20,196,11230,2185,9,13620
677,2019-09-21,185,5521,1304,10,7020
677,2019-09-22,68,10027,1250,6,11351
677,2019-09-23,207,8717,1423,3,10350
677,2019-09-24,123,9948,1625,2,11698
677,2019-09-25,1015,9826,1299,2,12142
677,2019-09-26,124,10352,1789,0,12265
677,2019-09-27,165,10534,1954,2,12655
677,2019-09-28,125,15527,1343,5,17000
677,2019-09-29,95,17356,1711,0,19162
677,2019-09-30,916,18614,1584,0,21114
677,2019-10-01,951,17216,1410,1,19578
677,2019-10-02,142,13132,1807,0,15081
677,2019-10-03,133,14743,1280,0,16156
677,2019-10-04,482,13013,1796,3,15294
677,2019-10-05,802,15095,2141,1,18039
677,2019-10-06,994,13472,1675,0,16141
677,2019-10-07,93,8186,1463,1,9743
677,2019-10-08,632,14247,1437,3,16319
677,2019-10-09,673,16706,1522,1,18902
677,2019-10-10,1018,16753,2267,1,20039
677,2019-10-11,981,11583,1770,2,14336
677,2019-10-12,947,7649,2000,3574,14170
677,2019-10-13,376,9533,1397,4,11310
677,2019-10-14,1439,11404,2089,0,14932
677,2019-10-15,1794,8733,1371,0,11898
677,2019-10-16,1000,18944,966,1,20911
677,2019-10-17,71,8619,2116,2,10808
677,2019-10-18,908,9224,1073,3,11208
677,2019-10-19,84,5833,2482,1,8400
677,2019-10-20,1279,3086,1526,0,5891
677,2019-10-21,1520,18808,1707,2,22037
677,2019-10-22,82,11971,2587,2,14642
677,2019-10-23,119,14822,1345,4,16290
677,2019-10-24,208,25992,1895,1,28096
677,2019-10-25,111,15151,2182,1,17445
677,2019-10-26,75,13619,2616,0,16310
677,2019-10-27,714,17296,2337,0,20347
677,2019-10-28,51,22777,2676,1,25505
677,2019-10-29,214,29204,2197,2,31617
677,2019-10-30,69,29814,1125,1,31009
677,2019-10-31,52,15075,1018,2,16147
677,2019-11-01,156,26267,1464,0,27887
677,2019-11-02,41,17323,1594,4,18962
677,2019-11-03,422,36538,1028,0,37988
677,2019-11-04,87,11169,1829,1,13086
677,2019-11-05,917,4427,2268,0,7612
677,2019-11-06,113,15359,2312,1,17785
677,2019-11-07,169,24637,1678,4,26488
677,2019-11-08,80,18053,971,0,19104
677,2019-11-09,1076,16244,1567,1,18888
677,2019-11-10,869,15694,1216,0,17779
677,2019-11-11,87,14591,1401,0,16079
677,2019-11-12,461,19175,3156,2,22794
677,2019-11-13,1072,14646,1303,3,17024
677,2019-11-14,81,8778,2523,2,11384
677,2019-11-15,74,3869,2103,1,6047
677,2019-11-16,176,2916,2111,1,5204
677,2019-11-17,113,3975,4254,4,8346
677,2019-11-18,1688,3401,3319,1,8409
677,2019-11-19,152,3320,2620,0,6092
677,2019-11-20,69,1607,2276,0,3952
677,2019-11-21,95,5852,1459,1,7407
678,2019-08-08,5,0,185,0,190
678,2019-08-09,391,317,217,0,925
678,2019-08-10,40,756,254,0,1050
678,2019-08-11,191,196,204,0,591
678,2019-08-12,145,369,120,0,634
678,2019-08-13,150,326,425,0,901
678,2019-08-14,135,839,208,0,1182
678,2019-08-15,81,769,135,0,985
678,2019-08-16,84,294,190,1,569
678,2019-08-17,83,1674,1158,1,2916
678,2019-08-18,357,1848,1174,1,3380
678,2019-08-19,289,10228,1517,1,12035
678,2019-08-20,160,13587,443,0,14190
678,2019-08-21,73,11194,1518,0,12785
678,2019-08-22,83,15546,990,2,16621
678,2019-08-23,93,20825,1670,2,22590
678,2019-08-24,99,6350,1043,1,7493
678,2019-08-25,105,15771,1533,3,17412
678,2019-08-26,211,4343,1712,3,6269
678,2019-08-27,101,4519,1534,1,6155
678,2019-08-28,397,6788,2160,0,9345
678,2019-08-29,745,9000,1563,1,11309
678,2019-08-30,432,3309,810,1,4552
678,2019-08-31,71,239,6,0,316
678,2019-09-01,84,1394,210,1,1689
678,2019-09-02,56,607,139,0,802
678,2019-09-03,310,3848,1614,1,5773
678,2019-09-04,1442,9634,2084,1,13161
678,2019-09-05,1318,10608,1924,1,13851
678,2019-09-06,537,14741,2580,3,17861
678,2019-09-07,1359,7783,2384,0,11526
678,2019-09-08,1389,7979,2378,0,11746
678,2019-09-09,1659,12858,2383,0,16900
678,2019-09-10,1961,12291,2180,0,16432
678,2019-09-11,1147,6572,1912,1,9632
678,2019-09-12,877,7347,2480,2,10706
678,2019-09-13,1131,7516,2064,0,10711
678,2019-09-14,2049,7213,2437,1,11700
678,2019-09-15,724,14404,1458,2,16588
678,2019-09-16,1728,11232,2344,1,15305
678,2019-09-17,838,10966,2307,0,14111
678,2019-09-18,658,11033,1819,1,13511
678,2019-09-19,502,9492,1163,0,11157
678,2019-09-20,352,17163,1857,0,19372
678,2019-09-21,219,9961,1890,1,12071
678,2019-09-22,1116,8604,2088,0,11808
678,2019-09-23,355,10492,1724,1,12572
678,2019-09-24,1061,13235,1649,2,15947
678,2019-09-25,1051,11374,1197,1,13623
678,2019-09-26,1017,13445,1721,5,16188
678,2019-09-27,132,9361,1682,4,11179
678,2019-09-28,176,26623,2567,1,29367
678,2019-09-29,160,29174,1635,0,30969
678,2019-09-30,949,20739,1618,2,23308
678,2019-10-01,126,17753,1644,3,19526
678,2019-10-02,167,13074,1756,0,14997
678,2019-10-03,196,14651,1625,1,16473
678,2019-10-04,123,12619,1611,17,14370
678,2019-10-05,129,21758,1697,0,23584
678,2019-10-06,2766,15487,1653,4,19910
678,2019-10-07,114,7895,1493,0,9502
678,2019-10-08,934,19517,2259,0,22710
678,2019-10-09,176,19028,2323,0,21527
678,2019-10-10,159,12164,2360,24,14707
678,2019-10-11,1086,16724,2072,5,19887
678,2019-10-12,178,9608,1891,1,11678
678,2019-10-13,1162,11059,1783,0,14004
678,2019-10-14,513,6730,1819,1,9063
678,2019-10-15,292,9182,1342,2,10818
678,2019-10-16,998,18805,1261,2,21066
678,2019-10-17,1582,9491,2096,1,13170
678,2019-10-18,1431,9278,2182,0,12891
678,2019-10-19,180,5822,2004,1,8007
678,2019-10-20,608,3102,2764,0,6474
678,2019-10-21,1573,18680,1807,6,22066
678,2019-10-22,2294,10410,1883,1,14588
678,2019-10-23,658,9775,1897,1,12331
678,2019-10-24,977,13998,1736,1,16712
678,2019-10-25,488,18058,720,1,19267
678,2019-10-26,320,17106,1391,1,18818
678,2019-10-27,1588,16570,949,0,19107
678,2019-10-28,378,24130,1614,0,26122
678,2019-10-29,355,19882,1392,797,22426
678,2019-10-30,390,15860,1167,1,17418
678,2019-10-31,339,12839,2247,918,16343
678,2019-11-01,108,26547,1835,2,28492
678,2019-11-02,98,17497,1071,0,18666
678,2019-11-03,98,23071,1822,0,24991
678,2019-11-04,1037,10881,1708,0,13626
678,2019-11-05,150,3454,1837,0,5441
678,2019-11-06,108,14951,1152,0,16211
678,2019-11-07,913,17359,900,4,19176
678,2019-11-08,1578,10553,1665,1,13797
678,2019-11-09,111,9302,1602,1,11016
678,2019-11-10,919,14473,1508,3,16903
678,2019-11-11,138,9685,3073,1,12897
678,2019-11-12,156,10622,4003,0,14781
678,2019-11-13,166,12689,2056,3,14914
678,2019-11-14,143,8553,2197,1,10894
678,2019-11-15,126,4477,1623,2,6228
678,2019-11-16,185,2526,1931,0,4642
678,2019-11-17,786,3773,2752,0,7311
678,2019-11-18,235,2589,3101,0,5925
678,2019-11-19,333,5344,1933,0,7610
678,2019-11-20,254,1415,1619,0,3288
678,2019-11-21,949,3794,1037,0,5780
678,2019-11-22,690,8981,2049,0,11720
678,2019-11-23,407,7462,2171,0,10040
678,2019-11-24,613,7402,2233,0,10248
678,2019-11-25,343,6924,1864,0,9131
678,2019-11-26,455,10633,2209,0,13297
678,2019-11-27,527,6942,1864,0,9333
678,2019-11-28,661,9155,611,0,10427
678,2019-11-29,110,717,21,0,848
678,2019-08-09,391,317,217,0,925
678,2019-08-10,40,756,254,0,1050
678,2019-08-11,191,196,204,0,591
678,2019-08-12,145,369,120,0,634
678,2019-08-13,150,326,425,0,901
678,2019-08-14,135,839,208,0,1182
678,2019-08-15,81,769,135,0,985
678,2019-08-16,84,294,190,1,569
678,2019-08-17,83,1674,1158,1,2916
678,2019-08-18,357,1848,1174,1,3380
678,2019-08-19,289,10228,1517,1,12035
678,2019-08-20,160,13587,443,0,14190
678,2019-08-21,73,11194,1518,0,12785
678,2019-08-22,83,15546,990,2,16621
678,2019-08-23,93,20825,1670,2,22590
678,2019-08-24,99,6350,1043,1,7493
678,2019-08-25,105,15771,1533,3,17412
678,2019-08-26,211,4343,1712,3,6269
678,2019-08-27,101,4519,1534,1,6155
678,2019-08-28,397,6788,2160,0,9345
678,2019-08-29,745,9000,1563,1,11309
678,2019-08-30,432,3309,810,1,4552
678,2019-08-31,71,239,6,0,316
678,2019-09-01,84,1394,210,1,1689
678,2019-09-02,56,607,139,0,802
678,2019-09-03,310,3848,1614,1,5773
678,2019-09-04,1442,9634,2084,1,13161
678,2019-09-05,1318,10608,1924,1,13851
678,2019-09-06,537,14741,2580,3,17861
678,2019-09-07,1359,7783,2384,0,11526
678,2019-09-08,1389,7979,2378,0,11746
678,2019-09-09,1659,12858,2383,0,16900
678,2019-09-10,1961,12291,2180,0,16432
678,2019-09-11,1147,6572,1912,1,9632
678,2019-09-12,877,7347,2480,2,10706
678,2019-09-13,1131,7516,2064,0,10711
678,2019-09-14,2049,7213,2437,1,11700
678,2019-09-15,724,14404,1458,2,16588
678,2019-09-16,1728,11232,2344,1,15305
678,2019-09-17,838,10966,2307,0,14111
678,2019-09-18,658,11033,1819,1,13511
678,2019-09-19,502,9492,1163,0,11157
678,2019-09-20,352,17163,1857,0,19372
678,2019-09-21,219,9961,1890,1,12071
678,2019-09-22,1116,8604,2088,0,11808
678,2019-09-23,355,10492,1724,1,12572
678,2019-09-24,1061,13235,1649,2,15947
678,2019-09-25,1051,11374,1197,1,13623
678,2019-09-26,1017,13445,1721,5,16188
678,2019-09-27,132,9361,1682,4,11179
678,2019-09-28,176,26623,2567,1,29367
678,2019-09-29,160,29174,1635,0,30969
678,2019-09-30,949,20739,1618,2,23308
678,2019-10-01,126,17753,1644,3,19526
678,2019-10-02,167,13074,1756,0,14997
678,2019-10-03,196,14651,1625,1,16473
678,2019-10-04,123,12619,1611,17,14370
678,2019-10-05,129,21758,1697,0,23584
678,2019-10-06,2766,15487,1653,4,19910
678,2019-10-07,114,7895,1493,0,9502
678,2019-10-08,934,19517,2259,0,22710
678,2019-10-09,176,19028,2323,0,21527
678,2019-10-10,159,12164,2360,24,14707
678,2019-10-11,1086,16724,2072,5,19887
678,2019-10-12,178,9608,1891,1,11678
678,2019-10-13,1162,11059,1783,0,14004
678,2019-10-14,513,6730,1819,1,9063
678,2019-10-15,292,9182,1342,2,10818
678,2019-10-16,998,18805,1261,2,21066
678,2019-10-17,1582,9491,2096,1,13170
678,2019-10-18,1431,9278,2182,0,12891
678,2019-10-19,180,5822,2004,1,8007
678,2019-10-20,608,3102,2764,0,6474
678,2019-10-21,1573,18680,1807,6,22066
678,2019-10-22,2294,10410,1883,1,14588
678,2019-10-23,658,9775,1897,1,12331
678,2019-10-24,977,13998,1736,1,16712
678,2019-10-25,488,18058,720,1,19267
678,2019-10-26,320,17106,1391,1,18818
678,2019-10-27,1588,16570,949,0,19107
678,2019-10-28,378,24130,1614,0,26122
678,2019-10-29,355,19882,1392,797,22426
678,2019-10-30,390,15860,1167,1,17418
678,2019-10-31,339,12839,2247,918,16343
678,2019-11-01,108,26547,1835,2,28492
678,2019-11-02,98,17497,1071,0,18666
678,2019-11-03,98,23071,1822,0,24991
678,2019-11-04,1037,10881,1708,0,13626
678,2019-11-05,150,3454,1837,0,5441
678,2019-11-06,108,14951,1152,0,16211
678,2019-11-07,913,17359,900,4,19176
678,2019-11-08,1578,10553,1665,1,13797
678,2019-11-09,111,9302,1602,1,11016
678,2019-11-10,919,14473,1508,3,16903
678,2019-11-11,138,9685,3073,1,12897
678,2019-11-12,156,10622,4003,0,14781
678,2019-11-13,166,12689,2056,3,14914
678,2019-11-14,143,8553,2197,1,10894
678,2019-11-15,126,4477,1623,2,6228
678,2019-11-16,185,2526,1931,0,4642
678,2019-11-17,786,3773,2752,0,7311
678,2019-11-18,235,2589,3101,0,5925
678,2019-11-19,333,5344,1933,0,7610
678,2019-11-20,254,1415,1619,0,3288
678,2019-11-21,949,3794,1037,0,5780
678,2019-11-22,690,8981,2049,0,11720
678,2019-11-23,407,7462,2171,0,10040
678,2019-11-24,613,7402,2233,0,10248
678,2019-11-25,343,6924,1864,0,9131
678,2019-11-26,455,10633,2209,0,13297
678,2019-11-27,527,6942,1864,0,9333
678,2019-11-28,661,9155,611,0,10427
678,2019-11-29,110,717,21,0,848
678,2019-08-08,5,0,185,0,190
678,2019-08-09,391,317,217,0,925
678,2019-08-10,40,756,254,0,1050
678,2019-08-11,191,196,204,0,591
678,2019-08-12,145,369,120,0,634
678,2019-08-13,150,326,425,0,901
678,2019-08-14,135,839,208,0,1182
678,2019-08-15,81,769,135,0,985
678,2019-08-16,84,294,190,1,569
678,2019-08-17,83,1674,1158,1,2916
678,2019-08-18,357,1848,1174,1,3380
678,2019-08-19,289,10228,1517,1,12035
678,2019-08-20,160,13587,443,0,14190
678,2019-08-21,73,11194,1518,0,12785
678,2019-08-22,83,15546,990,2,16621
678,2019-08-23,93,20825,1670,2,22590
678,2019-08-24,99,6350,1043,1,7493
678,2019-08-25,105,15771,1533,3,17412
678,2019-08-26,211,4343,1712,3,6269
678,2019-08-27,101,4519,1534,1,6155
678,2019-08-28,397,6788,2160,0,9345
678,2019-08-29,745,9000,1563,1,11309
678,2019-08-30,432,3309,810,1,4552
678,2019-08-31,71,239,6,0,316
678,2019-09-01,84,1394,210,1,1689
678,2019-09-02,56,607,139,0,802
678,2019-09-03,310,3848,1614,1,5773
678,2019-09-04,1442,9634,2084,1,13161
678,2019-09-05,1318,10608,1924,1,13851
678,2019-09-06,537,14741,2580,3,17861
678,2019-09-07,1359,7783,2384,0,11526
678,2019-09-08,1389,7979,2378,0,11746
678,2019-09-09,1659,12858,2383,0,16900
678,2019-09-10,1961,12291,2180,0,16432
678,2019-09-11,1147,6572,1912,1,9632
678,2019-09-12,877,7347,2480,2,10706
678,2019-09-13,1131,7516,2064,0,10711
678,2019-09-14,2049,7213,2437,1,11700
678,2019-09-15,724,14404,1458,2,16588
678,2019-09-16,1728,11232,2344,1,15305
678,2019-09-17,838,10966,2307,0,14111
678,2019-09-18,658,11033,1819,1,13511
678,2019-09-19,502,9492,1163,0,11157
678,2019-09-20,352,17163,1857,0,19372
678,2019-09-21,219,9961,1890,1,12071
678,2019-09-22,1116,8604,2088,0,11808
678,2019-09-23,355,10492,1724,1,12572
678,2019-09-24,1061,13235,1649,2,15947
678,2019-09-25,1051,11374,1197,1,13623
678,2019-09-26,1017,13445,1721,5,16188
678,2019-09-27,132,9361,1682,4,11179
678,2019-09-28,176,26623,2567,1,29367
678,2019-09-29,160,29174,1635,0,30969
678,2019-09-30,949,20739,1618,2,23308
678,2019-10-01,126,17753,1644,3,19526
678,2019-10-02,167,13074,1756,0,14997
678,2019-10-03,196,14651,1625,1,16473
678,2019-10-04,123,12619,1611,17,14370
678,2019-10-05,129,21758,1697,0,23584
678,2019-10-06,2766,15487,1653,4,19910
678,2019-10-07,114,7895,1493,0,9502
678,2019-10-08,934,19517,2259,0,22710
678,2019-10-09,176,19028,2323,0,21527
678,2019-10-10,159,12164,2360,24,14707
678,2019-10-11,1086,16724,2072,5,19887
678,2019-10-12,178,9608,1891,1,11678
678,2019-10-13,1162,11059,1783,0,14004
678,2019-10-14,513,6730,1819,1,9063
678,2019-10-15,292,9182,1342,2,10818
678,2019-10-16,998,18805,1261,2,21066
678,2019-10-17,1582,9491,2096,1,13170
678,2019-10-18,1431,9278,2182,0,12891
678,2019-10-19,180,5822,2004,1,8007
678,2019-10-20,608,3102,2764,0,6474
678,2019-10-21,1573,18680,1807,6,22066
678,2019-10-22,2294,10410,1883,1,14588
678,2019-10-23,658,9775,1897,1,12331
678,2019-10-24,977,13998,1736,1,16712
678,2019-10-25,488,18058,720,1,19267
678,2019-10-26,320,17106,1391,1,18818
678,2019-10-27,1588,16570,949,0,19107
678,2019-10-28,378,24130,1614,0,26122
678,2019-10-29,355,19882,1392,797,22426
678,2019-10-30,390,15860,1167,1,17418
678,2019-10-31,339,12839,2247,918,16343
678,2019-11-01,108,26547,1835,2,28492
678,2019-11-02,98,17497,1071,0,18666
678,2019-11-03,98,23071,1822,0,24991
678,2019-11-04,1037,10881,1708,0,13626
678,2019-11-05,150,3454,1837,0,5441
678,2019-11-06,108,14951,1152,0,16211
678,2019-11-07,913,17359,900,4,19176
678,2019-11-08,1578,10553,1665,1,13797
678,2019-11-09,111,9302,1602,1,11016
678,2019-11-10,919,14473,1508,3,16903
678,2019-11-11,138,9685,3073,1,12897
678,2019-11-12,156,10622,4003,0,14781
678,2019-11-13,166,12689,2056,3,14914
678,2019-11-14,143,8553,2197,1,10894
678,2019-11-15,126,4477,1623,2,6228
678,2019-11-16,185,2526,1931,0,4642
678,2019-11-17,786,3773,2752,0,7311
678,2019-11-18,235,2589,3101,0,5925
678,2019-11-19,333,5344,1933,0,7610
678,2019-11-20,254,1415,1619,0,3288
678,2019-11-21,949,3794,1037,0,5780
678,2019-11-22,690,8981,2049,0,11720
678,2019-11-23,407,7462,2171,0,10040
678,2019-11-24,613,7402,2233,0,10248
678,2019-11-25,343,6924,1864,0,9131
678,2019-11-26,455,10633,2209,0,13297
678,2019-11-27,527,6942,1864,0,9333
678,2019-11-28,661,9155,611,0,10427
678,2019-11-29,110,717,21,0,848
678,2019-08-16,84,294,190,1,569
678,2019-08-17,83,1674,1158,1,2916
678,2019-08-18,357,1848,1174,1,3380
678,2019-08-19,289,10228,1517,1,12035
678,2019-08-20,160,13587,443,0,14190
678,2019-08-21,73,11194,1518,0,12785
678,2019-08-22,83,15546,990,2,16621
678,2019-08-23,93,20825,1670,2,22590
678,2019-08-24,99,6350,1043,1,7493
678,2019-08-25,105,15771,1533,3,17412
678,2019-08-26,211,4343,1712,3,6269
678,2019-08-27,101,4519,1534,1,6155
678,2019-08-28,397,6788,2160,0,9345
678,2019-08-29,745,9000,1563,1,11309
678,2019-08-30,432,3309,810,1,4552
678,2019-08-31,71,239,6,0,316
678,2019-09-01,84,1394,210,1,1689
678,2019-09-02,56,607,139,0,802
678,2019-09-03,310,3848,1614,1,5773
678,2019-09-04,1442,9634,2084,1,13161
678,2019-09-05,1318,10608,1924,1,13851
678,2019-09-06,537,14741,2580,3,17861
678,2019-09-07,1359,7783,2384,0,11526
678,2019-09-08,1389,7979,2378,0,11746
678,2019-09-09,1659,12858,2383,0,16900
678,2019-09-10,1961,12291,2180,0,16432
678,2019-09-11,1147,6572,1912,1,9632
678,2019-09-12,877,7347,2480,2,10706
678,2019-09-13,1131,7516,2064,0,10711
678,2019-09-14,2049,7213,2437,1,11700
678,2019-09-15,724,14404,1458,2,16588
678,2019-09-16,1728,11232,2344,1,15305
678,2019-09-17,838,10966,2307,0,14111
678,2019-09-18,658,11033,1819,1,13511
678,2019-09-19,502,9492,1163,0,11157
678,2019-09-20,352,17163,1857,0,19372
678,2019-09-21,219,9961,1890,1,12071
678,2019-09-22,1116,8604,2088,0,11808
678,2019-09-23,355,10492,1724,1,12572
678,2019-09-24,1061,13235,1649,2,15947
678,2019-09-25,1051,11374,1197,1,13623
678,2019-09-26,1017,13445,1721,5,16188
678,2019-09-27,132,9361,1682,4,11179
678,2019-09-28,176,26623,2567,1,29367
678,2019-09-29,160,29174,1635,0,30969
678,2019-09-30,949,20739,1618,2,23308
678,2019-10-01,126,17753,1644,3,19526
678,2019-10-02,167,13074,1756,0,14997
678,2019-10-03,196,14651,1625,1,16473
678,2019-10-04,123,12619,1611,17,14370
678,2019-10-05,129,21758,1697,0,23584
678,2019-10-06,2766,15487,1653,4,19910
678,2019-10-07,114,7895,1493,0,9502
678,2019-10-08,934,19517,2259,0,22710
678,2019-10-09,176,19028,2323,0,21527
678,2019-10-10,159,12164,2360,24,14707
678,2019-10-11,1086,16724,2072,5,19887
678,2019-10-12,178,9608,1891,1,11678
678,2019-10-13,1162,11059,1783,0,14004
678,2019-10-14,513,6730,1819,1,9063
678,2019-10-15,292,9182,1342,2,10818
678,2019-10-16,998,18805,1261,2,21066
678,2019-10-17,1582,9491,2096,1,13170
678,2019-10-18,1431,9278,2182,0,12891
678,2019-10-19,180,5822,2004,1,8007
678,2019-10-20,608,3102,2764,0,6474
678,2019-10-21,1573,18680,1807,6,22066
678,2019-10-22,2294,10410,1883,1,14588
678,2019-10-23,658,9775,1897,1,12331
678,2019-10-24,977,13998,1736,1,16712
678,2019-10-25,488,18058,720,1,19267
678,2019-10-26,320,17106,1391,1,18818
678,2019-10-27,1588,16570,949,0,19107
678,2019-10-28,378,24130,1614,0,26122
678,2019-10-29,355,19882,1392,797,22426
678,2019-10-30,390,15860,1167,1,17418
678,2019-10-31,339,12839,2247,918,16343
678,2019-11-01,108,26547,1835,2,28492
678,2019-11-02,98,17497,1071,0,18666
678,2019-11-03,98,23071,1822,0,24991
678,2019-11-04,1037,10881,1708,0,13626
678,2019-11-05,150,3454,1837,0,5441
678,2019-11-06,108,14951,1152,0,16211
678,2019-11-07,913,17359,900,4,19176
678,2019-11-08,1578,10553,1665,1,13797
678,2019-11-09,111,9302,1602,1,11016
678,2019-11-10,919,14473,1508,3,16903
678,2019-11-11,138,9685,3073,1,12897
678,2019-11-12,156,10622,4003,0,14781
678,2019-11-13,166,12689,2056,3,14914
678,2019-11-14,143,8553,2197,1,10894
678,2019-11-15,126,4477,1623,2,6228
679,2019-08-09,9,275,151,0,435
679,2019-08-10,180,443,180,2,805
679,2019-08-11,196,483,22,0,701
679,2019-08-12,277,286,264,1,828
679,2019-08-13,41,217,252,0,510
679,2019-08-14,75,837,6,1,919
679,2019-08-15,45,709,58,0,812
679,2019-08-16,39,263,100,0,402
679,2019-08-17,64,897,575,1,1537
679,2019-08-18,58,275,1150,0,1483
679,2019-08-19,43,14125,2047,4,16219
679,2019-08-20,47,16985,916,3,17951
679,2019-08-21,97,11010,990,1,12098
679,2019-08-22,1358,17138,1554,1,20051
679,2019-08-23,33,21367,1674,1,23075
679,2019-08-24,44,13064,1826,0,14934
679,2019-08-25,896,3675,1530,2,6103
679,2019-08-26,930,3837,1985,3,6755
679,2019-08-27,72,3255,2276,1,5604
679,2019-08-28,64,2923,1712,0,4699
679,2019-08-29,77,8564,2071,0,10712
679,2019-08-30,40,2404,633,1,3078
679,2019-08-31,9,13578,19,0,13606
679,2019-09-01,29,4107,183,0,4319
679,2019-09-02,9,1501,10,0,1520
679,2019-09-03,72,3467,566,0,4105
679,2019-09-04,73,11572,1909,2,13556
679,2019-09-05,87,7862,2008,1,9958
679,2019-09-06,91,16815,1105,51,18062
679,2019-09-07,192,11931,1935,1,14059
679,2019-09-08,1953,8983,1893,0,12829
679,2019-09-09,66,5947,2104,0,8117
679,2019-09-10,63,3181,1380,2,4626
679,2019-09-11,911,7965,1241,2,10119
679,2019-09-12,58,5833,2304,1,8196
679,2019-09-13,84,7475,1910,1,9470
679,2019-09-14,84,7295,1919,0,9298
679,2019-09-15,899,6406,2180,1,9486
679,2019-09-16,182,8880,2838,1,11901
679,2019-09-17,909,9455,2343,1,12708
679,2019-09-18,153,18384,1099,1,19637
679,2019-09-19,195,8536,991,0,9722
679,2019-09-20,420,12291,1297,3,14011
679,2019-09-21,84,6992,2048,2,9126
679,2019-09-22,150,8720,1040,0,9910
679,2019-09-23,150,8134,3007,0,11291
679,2019-09-24,141,9185,1937,2,11265
679,2019-09-25,193,8009,1499,1,9702
679,2019-09-26,117,10474,2089,654,13334
679,2019-09-27,1051,8053,1668,1,10773
679,2019-09-28,112,15135,1471,1,16719
679,2019-09-29,74,17591,1260,1,18926
679,2019-09-30,707,17246,1915,0,19868
679,2019-10-01,932,16438,1714,4,19088
679,2019-10-02,635,13108,1850,3,15596
679,2019-10-03,947,13920,1305,0,16172
679,2019-10-04,901,11815,1812,2,14530
679,2019-10-05,924,14721,1303,1,16949
679,2019-10-06,70,9584,1780,3,11437
679,2019-10-07,54,7066,1908,1,9029
679,2019-10-08,695,12182,1350,0,14227
679,2019-10-09,148,15713,1065,0,16926
679,2019-10-10,659,11160,1699,0,13518
679,2019-10-11,70,10636,1823,5,12534
679,2019-10-12,959,7755,2762,1,11477
679,2019-10-13,84,7276,1993,0,9353
679,2019-10-14,66,6104,1480,1,7651
679,2019-10-15,260,8430,2029,0,10719
679,2019-10-16,960,12804,1584,4,15352
679,2019-10-17,918,6004,2315,0,9237
679,2019-10-18,1069,9095,1336,1,11501
679,2019-10-19,401,5389,1798,0,7588
679,2019-10-20,58,2871,1525,0,4454
679,2019-10-21,102,10145,1276,4,11527
679,2019-10-22,81,6526,2402,1,9010
679,2019-10-23,936,8420,2386,1,11743
679,2019-10-24,115,13326,1691,2,15134
679,2019-10-25,101,11266,1798,1,13166
679,2019-10-26,72,13565,967,0,14604
679,2019-10-27,102,16421,1001,0,17524
679,2019-10-28,79,24443,1156,0,25678
679,2019-10-29,1629,29111,2064,1,32805
679,2019-10-30,354,20867,1791,1,23013
679,2019-10-31,701,12224,1345,2,14272
679,2019-11-01,56,14937,1369,0,16362
679,2019-11-02,53,15781,1177,0,17011
679,2019-11-03,157,37438,1531,0,39126
679,2019-11-04,77,11019,1956,1,13053
679,2019-11-05,136,3112,1896,0,5144
679,2019-11-06,156,8650,1266,2,10074
679,2019-11-07,190,13321,899,2,14412
679,2019-11-08,197,9811,1368,0,11376
679,2019-11-09,78,8907,1157,480,10622
679,2019-11-10,361,14581,2290,3,17235
679,2019-11-11,87,9560,1686,1,11334
679,2019-11-12,126,10745,3510,1,14382
679,2019-11-13,159,14253,1784,3,16199
679,2019-11-14,104,9833,2524,3,12464
679,2019-11-15,1857,4074,1786,0,7717
679,2019-11-16,94,2434,2942,1,5471
679,2019-11-17,1067,3431,2905,0,7403
679,2019-11-18,518,2319,3175,1,6013
679,2019-11-19,67,3124,2819,1,6011
679,2019-11-20,969,1365,2237,3,4574
679,2019-11-21,75,5228,1704,0,7007
679,2019-11-22,83,5792,1644,1,7520
679,2019-11-23,70,8959,2173,687,11889
679,2019-11-24,163,8214,1676,2,10055
679,2019-11-25,94,10789,1621,1,12505
679,2019-11-26,855,9258,1259,1,11373
679,2019-11-27,518,6244,1481,0,8243
679,2019-11-28,68,11598,548,0,12214
679,2019-11-29,9,598,0,0,607
679,2019-08-09,9,275,151,0,435
679,2019-08-10,180,443,180,2,805
679,2019-08-11,196,483,22,0,701
679,2019-08-12,277,286,264,1,828
679,2019-08-13,41,217,252,0,510
679,2019-08-14,75,837,6,1,919
679,2019-08-15,45,709,58,0,812
679,2019-08-16,39,263,100,0,402
679,2019-08-17,64,897,575,1,1537
679,2019-08-18,58,275,1150,0,1483
679,2019-08-19,43,14125,2047,4,16219
679,2019-08-20,47,16985,916,3,17951
679,2019-08-21,97,11010,990,1,12098
679,2019-08-22,1358,17138,1554,1,20051
679,2019-08-23,33,21367,1674,1,23075
679,2019-08-24,44,13064,1826,0,14934
679,2019-08-25,896,3675,1530,2,6103
679,2019-08-26,930,3837,1985,3,6755
679,2019-08-27,72,3255,2276,1,5604
679,2019-08-28,64,2923,1712,0,4699
679,2019-08-29,77,8564,2071,0,10712
679,2019-08-30,40,2404,633,1,3078
679,2019-08-31,9,13578,19,0,13606
679,2019-09-01,29,4107,183,0,4319
679,2019-09-02,9,1501,10,0,1520
679,2019-09-03,72,3467,566,0,4105
679,2019-09-04,73,11572,1909,2,13556
679,2019-09-05,87,7862,2008,1,9958
679,2019-09-06,91,16815,1105,51,18062
679,2019-09-07,192,11931,1935,1,14059
679,2019-09-08,1953,8983,1893,0,12829
679,2019-09-09,66,5947,2104,0,8117
679,2019-09-10,63,3181,1380,2,4626
679,2019-09-11,911,7965,1241,2,10119
679,2019-09-12,58,5833,2304,1,8196
679,2019-09-13,84,7475,1910,1,9470
679,2019-09-14,84,7295,1919,0,9298
679,2019-09-15,899,6406,2180,1,9486
679,2019-09-16,182,8880,2838,1,11901
679,2019-09-17,909,9455,2343,1,12708
679,2019-09-18,153,18384,1099,1,19637
679,2019-09-19,195,8536,991,0,9722
679,2019-09-20,420,12291,1297,3,14011
679,2019-09-21,84,6992,2048,2,9126
679,2019-09-22,150,8720,1040,0,9910
679,2019-09-23,150,8134,3007,0,11291
679,2019-09-24,141,9185,1937,2,11265
679,2019-09-25,193,8009,1499,1,9702
679,2019-09-26,117,10474,2089,654,13334
679,2019-09-27,1051,8053,1668,1,10773
679,2019-09-28,112,15135,1471,1,16719
679,2019-09-29,74,17591,1260,1,18926
679,2019-09-30,707,17246,1915,0,19868
679,2019-10-01,932,16438,1714,4,19088
679,2019-10-02,635,13108,1850,3,15596
679,2019-10-03,947,13920,1305,0,16172
679,2019-10-04,901,11815,1812,2,14530
679,2019-10-05,924,14721,1303,1,16949
679,2019-10-06,70,9584,1780,3,11437
679,2019-10-07,54,7066,1908,1,9029
679,2019-10-08,695,12182,1350,0,14227
679,2019-10-09,148,15713,1065,0,16926
679,2019-10-10,659,11160,1699,0,13518
679,2019-10-11,70,10636,1823,5,12534
679,2019-10-12,959,7755,2762,1,11477
679,2019-10-13,84,7276,1993,0,9353
679,2019-10-14,66,6104,1480,1,7651
679,2019-10-15,260,8430,2029,0,10719
679,2019-10-16,960,12804,1584,4,15352
679,2019-10-17,918,6004,2315,0,9237
679,2019-10-18,1069,9095,1336,1,11501
679,2019-10-19,401,5389,1798,0,7588
679,2019-10-20,58,2871,1525,0,4454
679,2019-10-21,102,10145,1276,4,11527
679,2019-10-22,81,6526,2402,1,9010
679,2019-10-23,936,8420,2386,1,11743
679,2019-10-24,115,13326,1691,2,15134
679,2019-10-25,101,11266,1798,1,13166
679,2019-10-26,72,13565,967,0,14604
679,2019-10-27,102,16421,1001,0,17524
679,2019-10-28,79,24443,1156,0,25678
679,2019-10-29,1629,29111,2064,1,32805
679,2019-10-30,354,20867,1791,1,23013
679,2019-10-31,701,12224,1345,2,14272
679,2019-11-01,56,14937,1369,0,16362
679,2019-11-02,53,15781,1177,0,17011
679,2019-11-03,157,37438,1531,0,39126
679,2019-11-04,77,11019,1956,1,13053
679,2019-11-05,136,3112,1896,0,5144
679,2019-11-06,156,8650,1266,2,10074
679,2019-11-07,190,13321,899,2,14412
679,2019-11-08,197,9811,1368,0,11376
679,2019-11-09,78,8907,1157,480,10622
679,2019-11-10,361,14581,2290,3,17235
679,2019-11-11,87,9560,1686,1,11334
679,2019-11-12,126,10745,3510,1,14382
679,2019-11-13,159,14253,1784,3,16199
679,2019-11-14,104,9833,2524,3,12464
679,2019-11-15,1857,4074,1786,0,7717
679,2019-11-16,94,2434,2942,1,5471
679,2019-11-17,1067,3431,2905,0,7403
679,2019-11-18,518,2319,3175,1,6013
679,2019-11-19,67,3124,2819,1,6011
679,2019-11-20,969,1365,2237,3,4574
679,2019-11-21,75,5228,1704,0,7007
679,2019-11-22,83,5792,1644,1,7520
679,2019-11-23,70,8959,2173,687,11889
679,2019-11-24,163,8214,1676,2,10055
679,2019-11-25,94,10789,1621,1,12505
679,2019-11-26,855,9258,1259,1,11373
679,2019-11-27,518,6244,1481,0,8243
679,2019-11-28,68,11598,548,0,12214
679,2019-11-29,9,598,0,0,607
679,2019-08-08,0,0,8,0,8
679,2019-08-09,9,275,151,0,435
679,2019-08-10,180,443,180,2,805
679,2019-08-11,196,483,22,0,701
679,2019-08-12,277,286,264,1,828
679,2019-08-13,41,217,252,0,510
679,2019-08-14,75,837,6,1,919
679,2019-08-15,45,709,58,0,812
679,2019-08-16,39,263,100,0,402
679,2019-08-17,64,897,575,1,1537
679,2019-08-18,58,275,1150,0,1483
679,2019-08-19,43,14125,2047,4,16219
679,2019-08-20,47,16985,916,3,17951
679,2019-08-21,97,11010,990,1,12098
679,2019-08-22,1358,17138,1554,1,20051
679,2019-08-23,33,21367,1674,1,23075
679,2019-08-24,44,13064,1826,0,14934
679,2019-08-25,896,3675,1530,2,6103
679,2019-08-26,930,3837,1985,3,6755
679,2019-08-27,72,3255,2276,1,5604
679,2019-08-28,64,2923,1712,0,4699
679,2019-08-29,77,8564,2071,0,10712
679,2019-08-30,40,2404,633,1,3078
679,2019-08-31,9,13578,19,0,13606
679,2019-09-01,29,4107,183,0,4319
679,2019-09-02,9,1501,10,0,1520
679,2019-09-03,72,3467,566,0,4105
679,2019-09-04,73,11572,1909,2,13556
679,2019-09-05,87,7862,2008,1,9958
679,2019-09-06,91,16815,1105,51,18062
679,2019-09-07,192,11931,1935,1,14059
679,2019-09-08,1953,8983,1893,0,12829
679,2019-09-09,66,5947,2104,0,8117
679,2019-09-10,63,3181,1380,2,4626
679,2019-09-11,911,7965,1241,2,10119
679,2019-09-12,58,5833,2304,1,8196
679,2019-09-13,84,7475,1910,1,9470
679,2019-09-14,84,7295,1919,0,9298
679,2019-09-15,899,6406,2180,1,9486
679,2019-09-16,182,8880,2838,1,11901
679,2019-09-17,909,9455,2343,1,12708
679,2019-09-18,153,18384,1099,1,19637
679,2019-09-19,195,8536,991,0,9722
679,2019-09-20,420,12291,1297,3,14011
679,2019-09-21,84,6992,2048,2,9126
679,2019-09-22,150,8720,1040,0,9910
679,2019-09-23,150,8134,3007,0,11291
679,2019-09-24,141,9185,1937,2,11265
679,2019-09-25,193,8009,1499,1,9702
679,2019-09-26,117,10474,2089,654,13334
679,2019-09-27,1051,8053,1668,1,10773
679,2019-09-28,112,15135,1471,1,16719
679,2019-09-29,74,17591,1260,1,18926
679,2019-09-30,707,17246,1915,0,19868
679,2019-10-01,932,16438,1714,4,19088
679,2019-10-02,635,13108,1850,3,15596
679,2019-10-03,947,13920,1305,0,16172
679,2019-10-04,901,11815,1812,2,14530
679,2019-10-05,924,14721,1303,1,16949
679,2019-10-06,70,9584,1780,3,11437
679,2019-10-07,54,7066,1908,1,9029
679,2019-10-08,695,12182,1350,0,14227
679,2019-10-09,148,15713,1065,0,16926
679,2019-10-10,659,11160,1699,0,13518
679,2019-10-11,70,10636,1823,5,12534
679,2019-10-12,959,7755,2762,1,11477
679,2019-10-13,84,7276,1993,0,9353
679,2019-10-14,66,6104,1480,1,7651
679,2019-10-15,260,8430,2029,0,10719
679,2019-10-16,960,12804,1584,4,15352
679,2019-10-17,918,6004,2315,0,9237
679,2019-10-18,1069,9095,1336,1,11501
679,2019-10-19,401,5389,1798,0,7588
679,2019-10-20,58,2871,1525,0,4454
679,2019-10-21,102,10145,1276,4,11527
679,2019-10-22,81,6526,2402,1,9010
679,2019-10-23,936,8420,2386,1,11743
679,2019-10-24,115,13326,1691,2,15134
679,2019-10-25,101,11266,1798,1,13166
679,2019-10-26,72,13565,967,0,14604
679,2019-10-27,102,16421,1001,0,17524
679,2019-10-28,79,24443,1156,0,25678
679,2019-10-29,1629,29111,2064,1,32805
679,2019-10-30,354,20867,1791,1,23013
679,2019-10-31,701,12224,1345,2,14272
679,2019-11-01,56,14937,1369,0,16362
679,2019-11-02,53,15781,1177,0,17011
679,2019-11-03,157,37438,1531,0,39126
679,2019-11-04,77,11019,1956,1,13053
679,2019-11-05,136,3112,1896,0,5144
679,2019-11-06,156,8650,1266,2,10074
679,2019-11-07,190,13321,899,2,14412
679,2019-11-08,197,9811,1368,0,11376
679,2019-11-09,78,8907,1157,480,10622
679,2019-11-10,361,14581,2290,3,17235
679,2019-11-11,87,9560,1686,1,11334
679,2019-11-12,126,10745,3510,1,14382
679,2019-11-13,159,14253,1784,3,16199
679,2019-11-14,104,9833,2524,3,12464
679,2019-11-15,1857,4074,1786,0,7717
679,2019-11-16,94,2434,2942,1,5471
679,2019-11-17,1067,3431,2905,0,7403
679,2019-11-18,518,2319,3175,1,6013
679,2019-11-19,67,3124,2819,1,6011
679,2019-11-20,969,1365,2237,3,4574
679,2019-11-21,75,5228,1704,0,7007
679,2019-11-22,83,5792,1644,1,7520
679,2019-11-23,70,8959,2173,687,11889
679,2019-11-24,163,8214,1676,2,10055
679,2019-11-25,94,10789,1621,1,12505
679,2019-11-26,855,9258,1259,1,11373
679,2019-11-27,518,6244,1481,0,8243
679,2019-11-28,68,11598,548,0,12214
679,2019-08-10,180,443,180,2,805
679,2019-08-11,196,483,22,0,701
679,2019-08-12,277,286,264,1,828
679,2019-08-13,41,217,252,0,510
679,2019-08-14,75,837,6,1,919
679,2019-08-15,45,709,58,0,812
679,2019-08-16,39,263,100,0,402
679,2019-08-17,64,897,575,1,1537
679,2019-08-18,58,275,1150,0,1483
679,2019-08-19,43,14125,2047,4,16219
679,2019-08-20,47,16985,916,3,17951
679,2019-08-21,97,11010,990,1,12098
679,2019-08-22,1358,17138,1554,1,20051
679,2019-08-23,33,21367,1674,1,23075
679,2019-08-24,44,13064,1826,0,14934
679,2019-08-25,896,3675,1530,2,6103
679,2019-08-26,930,3837,1985,3,6755
679,2019-08-27,72,3255,2276,1,5604
679,2019-08-28,64,2923,1712,0,4699
679,2019-08-29,77,8564,2071,0,10712
679,2019-08-30,40,2404,633,1,3078
679,2019-08-31,9,13578,19,0,13606
679,2019-09-01,29,4107,183,0,4319
679,2019-09-02,9,1501,10,0,1520
679,2019-09-03,72,3467,566,0,4105
679,2019-09-04,73,11572,1909,2,13556
679,2019-09-05,87,7862,2008,1,9958
679,2019-09-06,91,16815,1105,51,18062
679,2019-09-07,192,11931,1935,1,14059
679,2019-09-08,1953,8983,1893,0,12829
679,2019-09-09,66,5947,2104,0,8117
679,2019-09-10,63,3181,1380,2,4626
679,2019-09-11,911,7965,1241,2,10119
679,2019-09-12,58,5833,2304,1,8196
679,2019-09-13,84,7475,1910,1,9470
679,2019-09-14,84,7295,1919,0,9298
679,2019-09-15,899,6406,2180,1,9486
679,2019-09-16,182,8880,2838,1,11901
679,2019-09-17,909,9455,2343,1,12708
679,2019-09-18,153,18384,1099,1,19637
679,2019-09-19,195,8536,991,0,9722
679,2019-09-20,420,12291,1297,3,14011
679,2019-09-21,84,6992,2048,2,9126
679,2019-09-22,150,8720,1040,0,9910
679,2019-09-23,150,8134,3007,0,11291
679,2019-09-24,141,9185,1937,2,11265
679,2019-09-25,193,8009,1499,1,9702
679,2019-09-26,117,10474,2089,654,13334
679,2019-09-27,1051,8053,1668,1,10773
679,2019-09-28,112,15135,1471,1,16719
679,2019-09-29,74,17591,1260,1,18926
679,2019-09-30,707,17246,1915,0,19868
679,2019-10-01,932,16438,1714,4,19088
679,2019-10-02,635,13108,1850,3,15596
679,2019-10-03,947,13920,1305,0,16172
679,2019-10-04,901,11815,1812,2,14530
679,2019-10-05,924,14721,1303,1,16949
679,2019-10-06,70,9584,1780,3,11437
679,2019-10-07,54,7066,1908,1,9029
679,2019-10-08,695,12182,1350,0,14227
679,2019-10-09,148,15713,1065,0,16926
679,2019-10-10,659,11160,1699,0,13518
679,2019-10-11,70,10636,1823,5,12534
679,2019-10-12,959,7755,2762,1,11477
679,2019-10-13,84,7276,1993,0,9353
679,2019-10-14,66,6104,1480,1,7651
679,2019-10-15,260,8430,2029,0,10719
679,2019-10-16,960,12804,1584,4,15352
679,2019-10-17,918,6004,2315,0,9237
679,2019-10-18,1069,9095,1336,1,11501
679,2019-10-19,401,5389,1798,0,7588
679,2019-10-20,58,2871,1525,0,4454
679,2019-10-21,102,10145,1276,4,11527
679,2019-10-22,81,6526,2402,1,9010
679,2019-10-23,936,8420,2386,1,11743
679,2019-10-24,115,13326,1691,2,15134
679,2019-10-25,101,11266,1798,1,13166
679,2019-10-26,72,13565,967,0,14604
679,2019-10-27,102,16421,1001,0,17524
679,2019-10-28,79,24443,1156,0,25678
679,2019-10-29,1629,29111,2064,1,32805
679,2019-10-30,354,20867,1791,1,23013
679,2019-10-31,701,12224,1345,2,14272
679,2019-11-01,56,14937,1369,0,16362
679,2019-11-02,53,15781,1177,0,17011
679,2019-11-03,157,37438,1531,0,39126
679,2019-11-04,77,11019,1956,1,13053
679,2019-11-05,136,3112,1896,0,5144
679,2019-11-06,156,8650,1266,2,10074
679,2019-11-07,190,13321,899,2,14412
679,2019-11-08,197,9811,1368,0,11376
679,2019-11-09,78,8907,1157,480,10622
679,2019-11-10,361,14581,2290,3,17235
679,2019-11-11,87,9560,1686,1,11334
679,2019-11-12,126,10745,3510,1,14382
679,2019-11-13,159,14253,1784,3,16199
679,2019-11-14,104,9833,2524,3,12464
679,2019-11-15,1857,4074,1786,0,7717
679,2019-11-16,94,2434,2942,1,5471
679,2019-11-17,1067,3431,2905,0,7403
679,2019-11-18,518,2319,3175,1,6013
679,2019-11-19,67,3124,2819,1,6011
679,2019-11-20,969,1365,2237,3,4574
679,2019-11-21,75,5228,1704,0,7007
679,2019-11-22,83,5792,1644,1,7520
679,2019-11-23,70,8959,2173,687,11889
679,2019-11-24,163,8214,1676,2,10055
679,2019-11-25,94,10789,1621,1,12505
679,2019-11-26,855,9258,1259,1,11373
681,2019-08-09,3,0,212,0,215
681,2019-08-10,313,467,180,0,960
681,2019-08-11,373,353,157,0,883
681,2019-08-12,360,287,136,1,784
681,2019-08-13,219,463,262,0,944
681,2019-08-14,193,502,52,0,747
681,2019-08-15,165,305,232,0,702
681,2019-08-16,139,214,20,0,373
681,2019-08-17,246,2211,350,0,2807
681,2019-08-18,298,2031,1521,1,3851
681,2019-08-19,328,15888,567,1,16784
681,2019-08-20,322,25166,1025,0,26513
681,2019-08-21,256,14410,985,1,15652
681,2019-08-22,1108,16202,928,1,18239
681,2019-08-23,378,21759,1314,1,23452
681,2019-08-24,298,16973,1260,0,18531
681,2019-08-25,329,29153,1529,1,31012
681,2019-08-26,336,25859,1896,3,28094
681,2019-08-27,259,14238,1352,0,15849
681,2019-08-28,282,34630,2320,0,37232
681,2019-08-29,347,19368,1017,0,20732
681,2019-08-30,999,3042,1097,0,5138
681,2019-08-31,55,7525,5,1,7586
681,2019-09-01,57,5543,273,0,5873
681,2019-09-02,31,139,65,0,235
681,2019-09-03,136,844,1160,1,2141
681,2019-09-04,1372,9970,1244,4,12590
681,2019-09-05,257,8083,2287,1,10628
681,2019-09-06,343,15520,2273,0,18136
681,2019-09-07,1256,13317,1452,0,16025
681,2019-09-08,369,6674,1845,0,8888
681,2019-09-09,321,25651,2752,1,28725
681,2019-09-10,247,10135,1507,0,11889
681,2019-09-11,280,7426,2272,4,9982
681,2019-09-12,180,7662,2071,1,9914
681,2019-09-13,1358,5179,1881,1,8419
681,2019-09-14,292,7361,1865,1,9519
681,2019-09-15,281,7950,1796,2,10029
681,2019-09-16,229,19045,2108,1,21383
681,2019-09-17,234,13776,1726,2,15738
681,2019-09-18,345,19857,743,1,20946
681,2019-09-19,1259,9989,1800,1,13049
681,2019-09-20,393,13003,1955,1,15352
681,2019-09-21,294,6353,2445,0,9092
681,2019-09-22,871,8177,1784,0,10832
681,2019-09-23,405,8724,2135,2,11266
681,2019-09-24,1246,10105,1947,5,13303
681,2019-09-25,181,8408,1574,3,10166
681,2019-09-26,149,16546,1918,3,18616
681,2019-09-27,120,8553,2192,2,10867
681,2019-09-28,209,16411,1822,2,18444
681,2019-09-29,754,17560,1580,0,19894
681,2019-09-30,131,16053,1311,4,17499
681,2019-10-01,135,24648,2001,0,26784
681,2019-10-02,662,21931,1820,1,24414
681,2019-10-03,170,21634,975,1,22780
681,2019-10-04,137,23224,1988,1,25350
681,2019-10-05,230,14901,1593,3,16727
681,2019-10-06,1355,10070,1259,0,12684
681,2019-10-07,432,7034,1513,0,8979
681,2019-10-08,188,12315,1445,2,13950
681,2019-10-09,1323,29788,1702,1,32814
681,2019-10-10,275,42894,1224,4,44397
681,2019-10-11,316,17622,1433,1,19372
681,2019-10-12,350,8444,1810,0,10604
681,2019-10-13,1090,8089,2387,1,11567
681,2019-10-14,1135,6017,1459,2,8613
681,2019-10-15,222,8814,1755,3,10794
681,2019-10-16,243,12814,1359,2,14418
681,2019-10-17,265,6382,1376,1,8024
681,2019-10-18,535,9821,1522,0,11878
681,2019-10-19,1751,6951,1890,0,10592
681,2019-10-20,318,3142,2214,2,5676
681,2019-10-21,239,26889,1858,2,28988
681,2019-10-22,262,14225,2319,2,16808
681,2019-10-23,1150,17282,1213,0,19645
681,2019-10-24,632,25758,1106,3,27499
681,2019-10-25,371,20083,1216,3,21673
681,2019-10-26,216,17143,1665,0,19024
681,2019-10-27,1385,28924,1298,0,31607
681,2019-10-28,884,16735,1312,0,18931
681,2019-10-29,283,27204,1706,1,29194
681,2019-10-30,246,23847,1758,3,25854
681,2019-10-31,257,20721,1367,0,22345
681,2019-11-01,1068,27469,1024,1,29562
681,2019-11-02,213,17689,1156,0,19058
681,2019-11-03,234,37701,1137,1,39073
681,2019-11-04,276,11123,1857,3,13259
681,2019-11-05,694,3448,1918,1,6061
681,2019-11-06,368,14648,1450,1,16467
681,2019-11-07,346,25810,804,2,26962
681,2019-11-08,238,17990,856,0,19084
681,2019-11-09,255,16099,1592,2,17948
681,2019-11-10,237,14727,1690,0,16654
681,2019-11-11,253,10007,2319,1,12580
681,2019-11-12,248,10427,3570,1,14246
681,2019-11-13,1199,15588,1918,1,18706
681,2019-11-14,233,8926,1833,0,10992
681,2019-11-15,1173,3655,1567,0,6395
681,2019-11-16,1175,2931,2103,0,6209
681,2019-11-17,1227,4458,2674,0,8359
681,2019-11-18,1189,2625,2669,0,6483
681,2019-11-19,325,3502,2740,0,6567
681,2019-11-20,295,1576,2443,0,4314
681,2019-11-21,1201,5337,1601,0,8139
681,2019-11-22,333,5653,1614,0,7600
681,2019-11-23,1165,6251,2022,0,9438
681,2019-11-24,364,7313,2066,0,9743
681,2019-11-25,1267,6808,1472,0,9547
681,2019-11-26,365,10610,1539,0,12514
681,2019-11-27,243,6569,1941,0,8753
681,2019-11-28,251,12713,753,0,13717
681,2019-11-29,95,526,6,0,627
681,2019-08-10,313,467,180,0,960
681,2019-08-11,373,353,157,0,883
681,2019-08-12,360,287,136,1,784
681,2019-08-13,219,463,262,0,944
681,2019-08-14,193,502,52,0,747
681,2019-08-15,165,305,232,0,702
681,2019-08-16,139,214,20,0,373
681,2019-08-17,246,2211,350,0,2807
681,2019-08-18,298,2031,1521,1,3851
681,2019-08-19,328,15888,567,1,16784
681,2019-08-20,322,25166,1025,0,26513
681,2019-08-21,256,14410,985,1,15652
681,2019-08-22,1108,16202,928,1,18239
681,2019-08-23,378,21759,1314,1,23452
681,2019-08-24,298,16973,1260,0,18531
681,2019-08-25,329,29153,1529,1,31012
681,2019-08-26,336,25859,1896,3,28094
681,2019-08-27,259,14238,1352,0,15849
681,2019-08-28,282,34630,2320,0,37232
681,2019-08-29,347,19368,1017,0,20732
681,2019-08-30,999,3042,1097,0,5138
681,2019-08-31,55,7525,5,1,7586
681,2019-09-01,57,5543,273,0,5873
681,2019-09-02,31,139,65,0,235
681,2019-09-03,136,844,1160,1,2141
681,2019-09-04,1372,9970,1244,4,12590
681,2019-09-05,257,8083,2287,1,10628
681,2019-09-06,343,15520,2273,0,18136
681,2019-09-07,1256,13317,1452,0,16025
681,2019-09-08,369,6674,1845,0,8888
681,2019-09-09,321,25651,2752,1,28725
681,2019-09-10,247,10135,1507,0,11889
681,2019-09-11,280,7426,2272,4,9982
681,2019-09-12,180,7662,2071,1,9914
681,2019-09-13,1358,5179,1881,1,8419
681,2019-09-14,292,7361,1865,1,9519
681,2019-09-15,281,7950,1796,2,10029
681,2019-09-16,229,19045,2108,1,21383
681,2019-09-17,234,13776,1726,2,15738
681,2019-09-18,345,19857,743,1,20946
681,2019-09-19,1259,9989,1800,1,13049
681,2019-09-20,393,13003,1955,1,15352
681,2019-09-21,294,6353,2445,0,9092
681,2019-09-22,871,8177,1784,0,10832
681,2019-09-23,405,8724,2135,2,11266
681,2019-09-24,1246,10105,1947,5,13303
681,2019-09-25,181,8408,1574,3,10166
681,2019-09-26,149,16546,1918,3,18616
681,2019-09-27,120,8553,2192,2,10867
681,2019-09-28,209,16411,1822,2,18444
681,2019-09-29,754,17560,1580,0,19894
681,2019-09-30,131,16053,1311,4,17499
681,2019-10-01,135,24648,2001,0,26784
681,2019-10-02,662,21931,1820,1,24414
681,2019-10-03,170,21634,975,1,22780
681,2019-10-04,137,23224,1988,1,25350
681,2019-10-05,230,14901,1593,3,16727
681,2019-10-06,1355,10070,1259,0,12684
681,2019-10-07,432,7034,1513,0,8979
681,2019-10-08,188,12315,1445,2,13950
681,2019-10-09,1323,29788,1702,1,32814
681,2019-10-10,275,42894,1224,4,44397
681,2019-10-11,316,17622,1433,1,19372
681,2019-10-12,350,8444,1810,0,10604
681,2019-10-13,1090,8089,2387,1,11567
681,2019-10-14,1135,6017,1459,2,8613
681,2019-10-15,222,8814,1755,3,10794
681,2019-10-16,243,12814,1359,2,14418
681,2019-10-17,265,6382,1376,1,8024
681,2019-10-18,535,9821,1522,0,11878
681,2019-10-19,1751,6951,1890,0,10592
681,2019-10-20,318,3142,2214,2,5676
681,2019-10-21,239,26889,1858,2,28988
681,2019-10-22,262,14225,2319,2,16808
681,2019-10-23,1150,17282,1213,0,19645
681,2019-10-24,632,25758,1106,3,27499
681,2019-10-25,371,20083,1216,3,21673
681,2019-10-26,216,17143,1665,0,19024
681,2019-10-27,1385,28924,1298,0,31607
681,2019-10-28,884,16735,1312,0,18931
681,2019-10-29,283,27204,1706,1,29194
681,2019-10-30,246,23847,1758,3,25854
681,2019-10-31,257,20721,1367,0,22345
681,2019-11-01,1068,27469,1024,1,29562
681,2019-11-02,213,17689,1156,0,19058
681,2019-11-03,234,37701,1137,1,39073
681,2019-11-04,276,11123,1857,3,13259
681,2019-11-05,694,3448,1918,1,6061
681,2019-11-06,368,14648,1450,1,16467
681,2019-11-07,346,25810,804,2,26962
681,2019-11-08,238,17990,856,0,19084
681,2019-11-09,255,16099,1592,2,17948
681,2019-11-10,237,14727,1690,0,16654
681,2019-11-11,253,10007,2319,1,12580
681,2019-11-12,248,10427,3570,1,14246
681,2019-11-13,1199,15588,1918,1,18706
681,2019-11-14,233,8926,1833,0,10992
681,2019-11-15,1173,3655,1567,0,6395
681,2019-11-16,1175,2931,2103,0,6209
681,2019-11-17,1227,4458,2674,0,8359
681,2019-11-18,1189,2625,2669,0,6483
681,2019-11-19,325,3502,2740,0,6567
681,2019-11-20,295,1576,2443,0,4314
681,2019-11-21,1201,5337,1601,0,8139
681,2019-11-22,333,5653,1614,0,7600
681,2019-11-23,1165,6251,2022,0,9438
681,2019-11-24,364,7313,2066,0,9743
681,2019-11-25,1267,6808,1472,0,9547
681,2019-11-26,365,10610,1539,0,12514
681,2019-11-27,243,6569,1941,0,8753
681,2019-11-28,251,12713,753,0,13717
681,2019-11-29,95,526,6,0,627
681,2019-08-09,3,0,212,0,215
681,2019-08-10,313,467,180,0,960
681,2019-08-11,373,353,157,0,883
681,2019-08-12,360,287,136,1,784
681,2019-08-13,219,463,262,0,944
681,2019-08-14,193,502,52,0,747
681,2019-08-15,165,305,232,0,702
681,2019-08-16,139,214,20,0,373
681,2019-08-17,246,2211,350,0,2807
681,2019-08-18,298,2031,1521,1,3851
681,2019-08-19,328,15888,567,1,16784
681,2019-08-20,322,25166,1025,0,26513
681,2019-08-21,256,14410,985,1,15652
681,2019-08-22,1108,16202,928,1,18239
681,2019-08-23,378,21759,1314,1,23452
681,2019-08-24,298,16973,1260,0,18531
681,2019-08-25,329,29153,1529,1,31012
681,2019-08-26,336,25859,1896,3,28094
681,2019-08-27,259,14238,1352,0,15849
681,2019-08-28,282,34630,2320,0,37232
681,2019-08-29,347,19368,1017,0,20732
681,2019-08-30,999,3042,1097,0,5138
681,2019-08-31,55,7525,5,1,7586
681,2019-09-01,57,5543,273,0,5873
681,2019-09-02,31,139,65,0,235
681,2019-09-03,136,844,1160,1,2141
681,2019-09-04,1372,9970,1244,4,12590
681,2019-09-05,257,8083,2287,1,10628
681,2019-09-06,343,15520,2273,0,18136
681,2019-09-07,1256,13317,1452,0,16025
681,2019-09-08,369,6674,1845,0,8888
681,2019-09-09,321,25651,2752,1,28725
681,2019-09-10,247,10135,1507,0,11889
681,2019-09-11,280,7426,2272,4,9982
681,2019-09-12,180,7662,2071,1,9914
681,2019-09-13,1358,5179,1881,1,8419
681,2019-09-14,292,7361,1865,1,9519
681,2019-09-15,281,7950,1796,2,10029
681,2019-09-16,229,19045,2108,1,21383
681,2019-09-17,234,13776,1726,2,15738
681,2019-09-18,345,19857,743,1,20946
681,2019-09-19,1259,9989,1800,1,13049
681,2019-09-20,393,13003,1955,1,15352
681,2019-09-21,294,6353,2445,0,9092
681,2019-09-22,871,8177,1784,0,10832
681,2019-09-23,405,8724,2135,2,11266
681,2019-09-24,1246,10105,1947,5,13303
681,2019-09-25,181,8408,1574,3,10166
681,2019-09-26,149,16546,1918,3,18616
681,2019-09-27,120,8553,2192,2,10867
681,2019-09-28,209,16411,1822,2,18444
681,2019-09-29,754,17560,1580,0,19894
681,2019-09-30,131,16053,1311,4,17499
681,2019-10-01,135,24648,2001,0,26784
681,2019-10-02,662,21931,1820,1,24414
681,2019-10-03,170,21634,975,1,22780
681,2019-10-04,137,23224,1988,1,25350
681,2019-10-05,230,14901,1593,3,16727
681,2019-10-06,1355,10070,1259,0,12684
681,2019-10-07,432,7034,1513,0,8979
681,2019-10-08,188,12315,1445,2,13950
681,2019-10-09,1323,29788,1702,1,32814
681,2019-10-10,275,42894,1224,4,44397
681,2019-10-11,316,17622,1433,1,19372
681,2019-10-12,350,8444,1810,0,10604
681,2019-10-13,1090,8089,2387,1,11567
681,2019-10-14,1135,6017,1459,2,8613
681,2019-10-15,222,8814,1755,3,10794
681,2019-10-16,243,12814,1359,2,14418
681,2019-10-17,265,6382,1376,1,8024
681,2019-10-18,535,9821,1522,0,11878
681,2019-10-19,1751,6951,1890,0,10592
681,2019-10-20,318,3142,2214,2,5676
681,2019-10-21,239,26889,1858,2,28988
681,2019-10-22,262,14225,2319,2,16808
681,2019-10-23,1150,17282,1213,0,19645
681,2019-10-24,632,25758,1106,3,27499
681,2019-10-25,371,20083,1216,3,21673
681,2019-10-26,216,17143,1665,0,19024
681,2019-10-27,1385,28924,1298,0,31607
681,2019-10-28,884,16735,1312,0,18931
681,2019-10-29,283,27204,1706,1,29194
681,2019-10-30,246,23847,1758,3,25854
681,2019-10-31,257,20721,1367,0,22345
681,2019-11-01,1068,27469,1024,1,29562
681,2019-11-02,213,17689,1156,0,19058
681,2019-11-03,234,37701,1137,1,39073
681,2019-11-04,276,11123,1857,3,13259
681,2019-11-05,694,3448,1918,1,6061
681,2019-11-06,368,14648,1450,1,16467
681,2019-11-07,346,25810,804,2,26962
681,2019-11-08,238,17990,856,0,19084
681,2019-11-09,255,16099,1592,2,17948
681,2019-11-10,237,14727,1690,0,16654
681,2019-11-11,253,10007,2319,1,12580
681,2019-11-12,248,10427,3570,1,14246
681,2019-11-13,1199,15588,1918,1,18706
681,2019-11-14,233,8926,1833,0,10992
681,2019-11-15,1173,3655,1567,0,6395
681,2019-11-16,1175,2931,2103,0,6209
681,2019-11-17,1227,4458,2674,0,8359
681,2019-11-18,1189,2625,2669,0,6483
681,2019-11-19,325,3502,2740,0,6567
681,2019-11-20,295,1576,2443,0,4314
681,2019-11-21,1201,5337,1601,0,8139
681,2019-11-22,333,5653,1614,0,7600
681,2019-11-23,1165,6251,2022,0,9438
681,2019-11-24,364,7313,2066,0,9743
681,2019-11-25,1267,6808,1472,0,9547
681,2019-11-26,365,10610,1539,0,12514
681,2019-11-27,243,6569,1941,0,8753
681,2019-11-28,251,12713,753,0,13717
681,2019-11-29,95,526,6,0,627
681,2019-08-12,360,287,136,1,784
681,2019-08-13,219,463,262,0,944
681,2019-08-14,193,502,52,0,747
681,2019-08-15,165,305,232,0,702
681,2019-08-16,139,214,20,0,373
681,2019-08-17,246,2211,350,0,2807
681,2019-08-18,298,2031,1521,1,3851
681,2019-08-19,328,15888,567,1,16784
681,2019-08-20,322,25166,1025,0,26513
681,2019-08-21,256,14410,985,1,15652
681,2019-08-22,1108,16202,928,1,18239
681,2019-08-23,378,21759,1314,1,23452
681,2019-08-24,298,16973,1260,0,18531
681,2019-08-25,329,29153,1529,1,31012
681,2019-08-26,336,25859,1896,3,28094
681,2019-08-27,259,14238,1352,0,15849
681,2019-08-28,282,34630,2320,0,37232
681,2019-08-29,347,19368,1017,0,20732
681,2019-08-30,999,3042,1097,0,5138
681,2019-08-31,55,7525,5,1,7586
681,2019-09-01,57,5543,273,0,5873
681,2019-09-02,31,139,65,0,235
681,2019-09-03,136,844,1160,1,2141
681,2019-09-04,1372,9970,1244,4,12590
681,2019-09-05,257,8083,2287,1,10628
681,2019-09-06,343,15520,2273,0,18136
681,2019-09-07,1256,13317,1452,0,16025
681,2019-09-08,369,6674,1845,0,8888
681,2019-09-09,321,25651,2752,1,28725
681,2019-09-10,247,10135,1507,0,11889
681,2019-09-11,280,7426,2272,4,9982
681,2019-09-12,180,7662,2071,1,9914
681,2019-09-13,1358,5179,1881,1,8419
681,2019-09-14,292,7361,1865,1,9519
681,2019-09-15,281,7950,1796,2,10029
681,2019-09-16,229,19045,2108,1,21383
681,2019-09-17,234,13776,1726,2,15738
681,2019-09-18,345,19857,743,1,20946
681,2019-09-19,1259,9989,1800,1,13049
681,2019-09-20,393,13003,1955,1,15352
681,2019-09-21,294,6353,2445,0,9092
681,2019-09-22,871,8177,1784,0,10832
681,2019-09-23,405,8724,2135,2,11266
681,2019-09-24,1246,10105,1947,5,13303
681,2019-09-25,181,8408,1574,3,10166
681,2019-09-26,149,16546,1918,3,18616
681,2019-09-27,120,8553,2192,2,10867
681,2019-09-28,209,16411,1822,2,18444
681,2019-09-29,754,17560,1580,0,19894
681,2019-09-30,131,16053,1311,4,17499
681,2019-10-01,135,24648,2001,0,26784
681,2019-10-02,662,21931,1820,1,24414
681,2019-10-03,170,21634,975,1,22780
681,2019-10-04,137,23224,1988,1,25350
681,2019-10-05,230,14901,1593,3,16727
681,2019-10-06,1355,10070,1259,0,12684
681,2019-10-07,432,7034,1513,0,8979
681,2019-10-08,188,12315,1445,2,13950
681,2019-10-09,1323,29788,1702,1,32814
681,2019-10-10,275,42894,1224,4,44397
681,2019-10-11,316,17622,1433,1,19372
681,2019-10-12,350,8444,1810,0,10604
681,2019-10-13,1090,8089,2387,1,11567
681,2019-10-14,1135,6017,1459,2,8613
681,2019-10-15,222,8814,1755,3,10794
681,2019-10-16,243,12814,1359,2,14418
681,2019-10-17,265,6382,1376,1,8024
681,2019-10-18,535,9821,1522,0,11878
681,2019-10-19,1751,6951,1890,0,10592
681,2019-10-20,318,3142,2214,2,5676
681,2019-10-21,239,26889,1858,2,28988
681,2019-10-22,262,14225,2319,2,16808
681,2019-10-23,1150,17282,1213,0,19645
681,2019-10-24,632,25758,1106,3,27499
681,2019-10-25,371,20083,1216,3,21673
681,2019-10-26,216,17143,1665,0,19024
681,2019-10-27,1385,28924,1298,0,31607
681,2019-10-28,884,16735,1312,0,18931
681,2019-10-29,283,27204,1706,1,29194
681,2019-10-30,246,23847,1758,3,25854
681,2019-10-31,257,20721,1367,0,22345
681,2019-11-01,1068,27469,1024,1,29562
681,2019-11-02,213,17689,1156,0,19058
681,2019-11-03,234,37701,1137,1,39073
681,2019-11-04,276,11123,1857,3,13259
681,2019-11-05,694,3448,1918,1,6061
681,2019-11-06,368,14648,1450,1,16467
681,2019-11-07,346,25810,804,2,26962
681,2019-11-08,238,17990,856,0,19084
681,2019-11-09,255,16099,1592,2,17948
681,2019-11-10,237,14727,1690,0,16654
681,2019-11-11,253,10007,2319,1,12580
681,2019-11-12,248,10427,3570,1,14246
681,2019-11-13,1199,15588,1918,1,18706
682,2019-08-09,1,0,46,0,47
682,2019-08-10,419,623,212,0,1254
682,2019-08-11,231,215,43,0,489
682,2019-08-12,249,4939,139,0,5327
682,2019-08-13,559,4579,243,0,5381
682,2019-08-14,202,225,27,0,454
682,2019-08-15,162,374,20,0,556
682,2019-08-16,118,586,123,0,827
682,2019-08-17,170,1424,753,0,2347
682,2019-08-18,300,1829,900,1,3030
682,2019-08-19,325,3516,989,2,4832
682,2019-08-20,1013,3017,1624,0,5654
682,2019-08-21,323,1130,922,0,2375
682,2019-08-22,618,3299,1385,1,5303
682,2019-08-23,263,2178,1500,1,3942
682,2019-08-24,262,2154,2430,0,4846
682,2019-08-25,310,3744,2271,2,6327
682,2019-08-26,258,2462,1539,1,4260
682,2019-08-27,1195,2626,1799,0,5620
682,2019-08-28,296,13913,1440,2,15651
682,2019-08-29,293,12054,1666,0,14013
682,2019-08-30,213,2982,462,3,3660
682,2019-08-31,60,13496,1,0,13557
682,2019-09-01,235,4866,200,0,5301
682,2019-09-02,33,51,16,0,100
682,2019-09-03,114,580,1042,2,1738
682,2019-09-04,1119,12547,1676,3,15345
682,2019-09-05,1147,8995,2214,1,12357
682,2019-09-06,328,14636,2169,0,17133
682,2019-09-07,481,11524,2060,0,14065
682,2019-09-08,398,7452,1424,2,9276
682,2019-09-09,354,8217,1864,0,10435
682,2019-09-10,1075,8985,2248,1,12309
682,2019-09-11,151,6251,1572,2,7976
682,2019-09-12,263,7048,2723,0,10034
682,2019-09-13,430,6544,1441,0,8415
682,2019-09-14,271,6647,1859,1,8778
682,2019-09-15,258,10766,2070,2,13096
682,2019-09-16,1066,12281,2325,3,15675
682,2019-09-17,237,20449,2464,0,23150
682,2019-09-18,341,11319,1451,1,13112
682,2019-09-19,488,3369,1623,3,5483
682,2019-09-20,1147,8284,1785,0,11216
682,2019-09-21,313,9307,1883,0,11503
682,2019-09-22,237,13849,1501,0,15587
682,2019-09-23,345,11266,2117,2,13730
682,2019-09-24,402,9870,1988,2,12262
682,2019-09-25,170,11731,2635,2,14538
682,2019-09-26,159,12144,1561,0,13864
682,2019-09-27,1862,8876,2087,3,12828
682,2019-09-28,999,15975,1122,5,18101
682,2019-09-29,658,17802,1793,1,20254
682,2019-09-30,144,27152,2076,0,29372
682,2019-10-01,135,23124,2280,0,25539
682,2019-10-02,129,17298,2070,0,19497
682,2019-10-03,154,15101,1957,1,17213
682,2019-10-04,112,12670,751,1,13534
682,2019-10-05,118,16305,1496,1,17920
682,2019-10-06,621,10191,2088,0,12900
682,2019-10-07,133,7333,1474,0,8940
682,2019-10-08,974,12578,1475,4,15031
682,2019-10-09,146,16102,1439,0,17687
682,2019-10-10,623,11649,1758,1,14031
682,2019-10-11,686,11646,1599,1,13932
682,2019-10-12,273,7946,1688,2,9909
682,2019-10-13,744,8664,1959,2,11369
682,2019-10-14,277,6519,1998,1,8795
682,2019-10-15,342,9202,2317,0,11861
682,2019-10-16,282,13455,1967,0,15704
682,2019-10-17,276,6291,1877,2,8446
682,2019-10-18,608,9285,2236,1,12130
682,2019-10-19,392,6214,1671,1,8278
682,2019-10-20,305,3055,2403,1,5764
682,2019-10-21,263,11089,1414,0,12766
682,2019-10-22,365,6801,1700,2,8868
682,2019-10-23,232,9187,1548,2,10969
682,2019-10-24,348,14022,1543,3,15916
682,2019-10-25,309,11582,2110,1,14002
682,2019-10-26,1360,13836,1800,0,16996
682,2019-10-27,284,16674,1551,0,18509
682,2019-10-28,268,23606,1247,1,25122
682,2019-10-29,313,18486,1649,1,20449
682,2019-10-30,301,24453,1336,0,26090
682,2019-10-31,263,14843,1226,1,16333
682,2019-11-01,235,26652,1669,1,28557
682,2019-11-02,244,17313,1476,2,19035
682,2019-11-03,267,38788,1281,0,40336
682,2019-11-04,257,13928,1879,0,16064
682,2019-11-05,303,3493,1085,0,4881
682,2019-11-06,278,8549,940,0,9767
682,2019-11-07,387,14022,1064,4,15477
682,2019-11-08,397,9943,1647,1,11988
682,2019-11-09,1853,8924,1657,0,12434
682,2019-11-10,700,25537,2197,1,28435
682,2019-11-11,398,16552,1617,0,18567
682,2019-11-12,296,17970,2900,0,21166
682,2019-11-13,301,13875,1575,0,15751
682,2019-11-14,315,8745,2846,0,11906
682,2019-11-15,290,4236,2279,0,6805
682,2019-11-16,273,2886,2160,0,5319
682,2019-11-17,1213,3949,3394,0,8556
682,2019-11-18,303,2487,3115,0,5905
682,2019-11-19,299,5269,2722,0,8290
682,2019-11-20,312,1305,1863,0,3480
682,2019-11-21,1202,3619,1324,0,6145
682,2019-11-22,342,5531,1549,0,7422
682,2019-11-23,376,6112,2530,0,9018
682,2019-11-24,1311,6966,1588,0,9865
682,2019-11-25,246,7493,1884,0,9623
682,2019-11-26,288,6567,2218,0,9073
682,2019-11-27,263,6693,1306,0,8262
682,2019-11-28,278,8408,707,0,9393
682,2019-08-10,419,623,212,0,1254
682,2019-08-11,231,215,43,0,489
682,2019-08-12,249,4939,139,0,5327
682,2019-08-13,559,4579,243,0,5381
682,2019-08-14,202,225,27,0,454
682,2019-08-15,162,374,20,0,556
682,2019-08-16,118,586,123,0,827
682,2019-08-17,170,1424,753,0,2347
682,2019-08-18,300,1829,900,1,3030
682,2019-08-19,325,3516,989,2,4832
682,2019-08-20,1013,3017,1624,0,5654
682,2019-08-21,323,1130,922,0,2375
682,2019-08-22,618,3299,1385,1,5303
682,2019-08-23,263,2178,1500,1,3942
682,2019-08-24,262,2154,2430,0,4846
682,2019-08-25,310,3744,2271,2,6327
682,2019-08-26,258,2462,1539,1,4260
682,2019-08-27,1195,2626,1799,0,5620
682,2019-08-28,296,13913,1440,2,15651
682,2019-08-29,293,12054,1666,0,14013
682,2019-08-30,213,2982,462,3,3660
682,2019-08-31,60,13496,1,0,13557
682,2019-09-01,235,4866,200,0,5301
682,2019-09-02,33,51,16,0,100
682,2019-09-03,114,580,1042,2,1738
682,2019-09-04,1119,12547,1676,3,15345
682,2019-09-05,1147,8995,2214,1,12357
682,2019-09-06,328,14636,2169,0,17133
682,2019-09-07,481,11524,2060,0,14065
682,2019-09-08,398,7452,1424,2,9276
682,2019-09-09,354,8217,1864,0,10435
682,2019-09-10,1075,8985,2248,1,12309
682,2019-09-11,151,6251,1572,2,7976
682,2019-09-12,263,7048,2723,0,10034
682,2019-09-13,430,6544,1441,0,8415
682,2019-09-14,271,6647,1859,1,8778
682,2019-09-15,258,10766,2070,2,13096
682,2019-09-16,1066,12281,2325,3,15675
682,2019-09-17,237,20449,2464,0,23150
682,2019-09-18,341,11319,1451,1,13112
682,2019-09-19,488,3369,1623,3,5483
682,2019-09-20,1147,8284,1785,0,11216
682,2019-09-21,313,9307,1883,0,11503
682,2019-09-22,237,13849,1501,0,15587
682,2019-09-23,345,11266,2117,2,13730
682,2019-09-24,402,9870,1988,2,12262
682,2019-09-25,170,11731,2635,2,14538
682,2019-09-26,159,12144,1561,0,13864
682,2019-09-27,1862,8876,2087,3,12828
682,2019-09-28,999,15975,1122,5,18101
682,2019-09-29,658,17802,1793,1,20254
682,2019-09-30,144,27152,2076,0,29372
682,2019-10-01,135,23124,2280,0,25539
682,2019-10-02,129,17298,2070,0,19497
682,2019-10-03,154,15101,1957,1,17213
682,2019-10-04,112,12670,751,1,13534
682,2019-10-05,118,16305,1496,1,17920
682,2019-10-06,621,10191,2088,0,12900
682,2019-10-07,133,7333,1474,0,8940
682,2019-10-08,974,12578,1475,4,15031
682,2019-10-09,146,16102,1439,0,17687
682,2019-10-10,623,11649,1758,1,14031
682,2019-10-11,686,11646,1599,1,13932
682,2019-10-12,273,7946,1688,2,9909
682,2019-10-13,744,8664,1959,2,11369
682,2019-10-14,277,6519,1998,1,8795
682,2019-10-15,342,9202,2317,0,11861
682,2019-10-16,282,13455,1967,0,15704
682,2019-10-17,276,6291,1877,2,8446
682,2019-10-18,608,9285,2236,1,12130
682,2019-10-19,392,6214,1671,1,8278
682,2019-10-20,305,3055,2403,1,5764
682,2019-10-21,263,11089,1414,0,12766
682,2019-10-22,365,6801,1700,2,8868
682,2019-10-23,232,9187,1548,2,10969
682,2019-10-24,348,14022,1543,3,15916
682,2019-10-25,309,11582,2110,1,14002
682,2019-10-26,1360,13836,1800,0,16996
682,2019-10-27,284,16674,1551,0,18509
682,2019-10-28,268,23606,1247,1,25122
682,2019-10-29,313,18486,1649,1,20449
682,2019-10-30,301,24453,1336,0,26090
682,2019-10-31,263,14843,1226,1,16333
682,2019-11-01,235,26652,1669,1,28557
682,2019-11-02,244,17313,1476,2,19035
682,2019-11-03,267,38788,1281,0,40336
682,2019-11-04,257,13928,1879,0,16064
682,2019-11-05,303,3493,1085,0,4881
682,2019-11-06,278,8549,940,0,9767
682,2019-11-07,387,14022,1064,4,15477
682,2019-11-08,397,9943,1647,1,11988
682,2019-11-09,1853,8924,1657,0,12434
682,2019-11-10,700,25537,2197,1,28435
682,2019-11-11,398,16552,1617,0,18567
682,2019-11-12,296,17970,2900,0,21166
682,2019-11-13,301,13875,1575,0,15751
682,2019-11-14,315,8745,2846,0,11906
682,2019-11-15,290,4236,2279,0,6805
682,2019-11-16,273,2886,2160,0,5319
682,2019-11-17,1213,3949,3394,0,8556
682,2019-11-18,303,2487,3115,0,5905
682,2019-11-19,299,5269,2722,0,8290
682,2019-11-20,312,1305,1863,0,3480
682,2019-11-21,1202,3619,1324,0,6145
682,2019-11-22,342,5531,1549,0,7422
682,2019-11-23,376,6112,2530,0,9018
682,2019-11-24,1311,6966,1588,0,9865
682,2019-11-25,246,7493,1884,0,9623
682,2019-11-26,288,6567,2218,0,9073
682,2019-11-27,263,6693,1306,0,8262
682,2019-11-28,278,8408,707,0,9393
682,2019-11-29,0,754,0,0,754
682,2019-08-09,1,0,46,0,47
682,2019-08-10,419,623,212,0,1254
682,2019-08-11,231,215,43,0,489
682,2019-08-12,249,4939,139,0,5327
682,2019-08-13,559,4579,243,0,5381
682,2019-08-14,202,225,27,0,454
682,2019-08-15,162,374,20,0,556
682,2019-08-16,118,586,123,0,827
682,2019-08-17,170,1424,753,0,2347
682,2019-08-18,300,1829,900,1,3030
682,2019-08-19,325,3516,989,2,4832
682,2019-08-20,1013,3017,1624,0,5654
682,2019-08-21,323,1130,922,0,2375
682,2019-08-22,618,3299,1385,1,5303
682,2019-08-23,263,2178,1500,1,3942
682,2019-08-24,262,2154,2430,0,4846
682,2019-08-25,310,3744,2271,2,6327
682,2019-08-26,258,2462,1539,1,4260
682,2019-08-27,1195,2626,1799,0,5620
682,2019-08-28,296,13913,1440,2,15651
682,2019-08-29,293,12054,1666,0,14013
682,2019-08-30,213,2982,462,3,3660
682,2019-08-31,60,13496,1,0,13557
682,2019-09-01,235,4866,200,0,5301
682,2019-09-02,33,51,16,0,100
682,2019-09-03,114,580,1042,2,1738
682,2019-09-04,1119,12547,1676,3,15345
682,2019-09-05,1147,8995,2214,1,12357
682,2019-09-06,328,14636,2169,0,17133
682,2019-09-07,481,11524,2060,0,14065
682,2019-09-08,398,7452,1424,2,9276
682,2019-09-09,354,8217,1864,0,10435
682,2019-09-10,1075,8985,2248,1,12309
682,2019-09-11,151,6251,1572,2,7976
682,2019-09-12,263,7048,2723,0,10034
682,2019-09-13,430,6544,1441,0,8415
682,2019-09-14,271,6647,1859,1,8778
682,2019-09-15,258,10766,2070,2,13096
682,2019-09-16,1066,12281,2325,3,15675
682,2019-09-17,237,20449,2464,0,23150
682,2019-09-18,341,11319,1451,1,13112
682,2019-09-19,488,3369,1623,3,5483
682,2019-09-20,1147,8284,1785,0,11216
682,2019-09-21,313,9307,1883,0,11503
682,2019-09-22,237,13849,1501,0,15587
682,2019-09-23,345,11266,2117,2,13730
682,2019-09-24,402,9870,1988,2,12262
682,2019-09-25,170,11731,2635,2,14538
682,2019-09-26,159,12144,1561,0,13864
682,2019-09-27,1862,8876,2087,3,12828
682,2019-09-28,999,15975,1122,5,18101
682,2019-09-29,658,17802,1793,1,20254
682,2019-09-30,144,27152,2076,0,29372
682,2019-10-01,135,23124,2280,0,25539
682,2019-10-02,129,17298,2070,0,19497
682,2019-10-03,154,15101,1957,1,17213
682,2019-10-04,112,12670,751,1,13534
682,2019-10-05,118,16305,1496,1,17920
682,2019-10-06,621,10191,2088,0,12900
682,2019-10-07,133,7333,1474,0,8940
682,2019-10-08,974,12578,1475,4,15031
682,2019-10-09,146,16102,1439,0,17687
682,2019-10-10,623,11649,1758,1,14031
682,2019-10-11,686,11646,1599,1,13932
682,2019-10-12,273,7946,1688,2,9909
682,2019-10-13,744,8664,1959,2,11369
682,2019-10-14,277,6519,1998,1,8795
682,2019-10-15,342,9202,2317,0,11861
682,2019-10-16,282,13455,1967,0,15704
682,2019-10-17,276,6291,1877,2,8446
682,2019-10-18,608,9285,2236,1,12130
682,2019-10-19,392,6214,1671,1,8278
682,2019-10-20,305,3055,2403,1,5764
682,2019-10-21,263,11089,1414,0,12766
682,2019-10-22,365,6801,1700,2,8868
682,2019-10-23,232,9187,1548,2,10969
682,2019-10-24,348,14022,1543,3,15916
682,2019-10-25,309,11582,2110,1,14002
682,2019-10-26,1360,13836,1800,0,16996
682,2019-10-27,284,16674,1551,0,18509
682,2019-10-28,268,23606,1247,1,25122
682,2019-10-29,313,18486,1649,1,20449
682,2019-10-30,301,24453,1336,0,26090
682,2019-10-31,263,14843,1226,1,16333
682,2019-11-01,235,26652,1669,1,28557
682,2019-11-02,244,17313,1476,2,19035
682,2019-11-03,267,38788,1281,0,40336
682,2019-11-04,257,13928,1879,0,16064
682,2019-11-05,303,3493,1085,0,4881
682,2019-11-06,278,8549,940,0,9767
682,2019-11-07,387,14022,1064,4,15477
682,2019-11-08,397,9943,1647,1,11988
682,2019-11-09,1853,8924,1657,0,12434
682,2019-11-10,700,25537,2197,1,28435
682,2019-11-11,398,16552,1617,0,18567
682,2019-11-12,296,17970,2900,0,21166
682,2019-11-13,301,13875,1575,0,15751
682,2019-11-14,315,8745,2846,0,11906
682,2019-11-15,290,4236,2279,0,6805
682,2019-11-16,273,2886,2160,0,5319
682,2019-11-17,1213,3949,3394,0,8556
682,2019-11-18,303,2487,3115,0,5905
682,2019-11-19,299,5269,2722,0,8290
682,2019-11-20,312,1305,1863,0,3480
682,2019-11-21,1202,3619,1324,0,6145
682,2019-11-22,342,5531,1549,0,7422
682,2019-11-23,376,6112,2530,0,9018
682,2019-11-24,1311,6966,1588,0,9865
682,2019-11-25,246,7493,1884,0,9623
682,2019-11-26,288,6567,2218,0,9073
682,2019-11-27,263,6693,1306,0,8262
682,2019-11-28,278,8408,707,0,9393
682,2019-08-18,300,1829,900,1,3030
682,2019-08-19,325,3516,989,2,4832
682,2019-08-20,1013,3017,1624,0,5654
682,2019-08-21,323,1130,922,0,2375
682,2019-08-22,618,3299,1385,1,5303
682,2019-08-23,263,2178,1500,1,3942
682,2019-08-24,262,2154,2430,0,4846
682,2019-08-25,310,3744,2271,2,6327
682,2019-08-26,258,2462,1539,1,4260
682,2019-08-27,1195,2626,1799,0,5620
682,2019-08-28,296,13913,1440,2,15651
682,2019-08-29,293,12054,1666,0,14013
682,2019-08-30,213,2982,462,3,3660
682,2019-08-31,60,13496,1,0,13557
682,2019-09-01,235,4866,200,0,5301
682,2019-09-02,33,51,16,0,100
682,2019-09-03,114,580,1042,2,1738
682,2019-09-04,1119,12547,1676,3,15345
682,2019-09-05,1147,8995,2214,1,12357
682,2019-09-06,328,14636,2169,0,17133
682,2019-09-07,481,11524,2060,0,14065
682,2019-09-08,398,7452,1424,2,9276
682,2019-09-09,354,8217,1864,0,10435
682,2019-09-10,1075,8985,2248,1,12309
682,2019-09-11,151,6251,1572,2,7976
682,2019-09-12,263,7048,2723,0,10034
682,2019-09-13,430,6544,1441,0,8415
682,2019-09-14,271,6647,1859,1,8778
682,2019-09-15,258,10766,2070,2,13096
682,2019-09-16,1066,12281,2325,3,15675
682,2019-09-17,237,20449,2464,0,23150
682,2019-09-18,341,11319,1451,1,13112
682,2019-09-19,488,3369,1623,3,5483
682,2019-09-20,1147,8284,1785,0,11216
682,2019-09-21,313,9307,1883,0,11503
682,2019-09-22,237,13849,1501,0,15587
682,2019-09-23,345,11266,2117,2,13730
682,2019-09-24,402,9870,1988,2,12262
682,2019-09-25,170,11731,2635,2,14538
682,2019-09-26,159,12144,1561,0,13864
682,2019-09-27,1862,8876,2087,3,12828
682,2019-09-28,999,15975,1122,5,18101
682,2019-09-29,658,17802,1793,1,20254
682,2019-09-30,144,27152,2076,0,29372
682,2019-10-01,135,23124,2280,0,25539
682,2019-10-02,129,17298,2070,0,19497
682,2019-10-03,154,15101,1957,1,17213
682,2019-10-04,112,12670,751,1,13534
682,2019-10-05,118,16305,1496,1,17920
682,2019-10-06,621,10191,2088,0,12900
682,2019-10-07,133,7333,1474,0,8940
682,2019-10-08,974,12578,1475,4,15031
682,2019-10-09,146,16102,1439,0,17687
682,2019-10-10,623,11649,1758,1,14031
682,2019-10-11,686,11646,1599,1,13932
682,2019-10-12,273,7946,1688,2,9909
682,2019-10-13,744,8664,1959,2,11369
682,2019-10-14,277,6519,1998,1,8795
682,2019-10-15,342,9202,2317,0,11861
682,2019-10-16,282,13455,1967,0,15704
682,2019-10-17,276,6291,1877,2,8446
682,2019-10-18,608,9285,2236,1,12130
682,2019-10-19,392,6214,1671,1,8278
682,2019-10-20,305,3055,2403,1,5764
682,2019-10-21,263,11089,1414,0,12766
682,2019-10-22,365,6801,1700,2,8868
682,2019-10-23,232,9187,1548,2,10969
682,2019-10-24,348,14022,1543,3,15916
682,2019-10-25,309,11582,2110,1,14002
682,2019-10-26,1360,13836,1800,0,16996
682,2019-10-27,284,16674,1551,0,18509
682,2019-10-28,268,23606,1247,1,25122
682,2019-10-29,313,18486,1649,1,20449
682,2019-10-30,301,24453,1336,0,26090
682,2019-10-31,263,14843,1226,1,16333
682,2019-11-01,235,26652,1669,1,28557
682,2019-11-02,244,17313,1476,2,19035
682,2019-11-03,267,38788,1281,0,40336
682,2019-11-04,257,13928,1879,0,16064
682,2019-11-05,303,3493,1085,0,4881
682,2019-11-06,278,8549,940,0,9767
682,2019-11-07,387,14022,1064,4,15477
682,2019-11-08,397,9943,1647,1,11988
682,2019-11-09,1853,8924,1657,0,12434
682,2019-11-10,700,25537,2197,1,28435
683,2019-08-09,2,0,264,0,266
683,2019-08-10,437,320,383,0,1140
683,2019-08-11,234,239,109,1,583
683,2019-08-12,477,345,345,0,1167
683,2019-08-13,207,351,138,0,696
683,2019-08-14,225,573,127,0,925
683,2019-08-15,188,43,8,0,239
683,2019-08-16,172,189,166,0,527
683,2019-08-17,217,2065,530,0,2812
683,2019-08-18,393,186,1239,0,1818
683,2019-08-19,313,1194,1084,0,2591
683,2019-08-20,420,1895,799,0,3114
683,2019-08-21,1290,764,990,0,3044
683,2019-08-22,296,2469,1270,2,4037
683,2019-08-23,695,1631,1845,1,4172
683,2019-08-24,280,11148,1621,2,13051
683,2019-08-25,276,23761,1572,4,25613
683,2019-08-26,278,27727,1980,2,29987
683,2019-08-27,286,6452,1689,1,8428
683,2019-08-28,270,13092,2430,0,15792
683,2019-08-29,337,12091,1365,2,13795
683,2019-08-30,241,2981,951,2,4175
683,2019-08-31,44,61,1,0,106
683,2019-09-01,80,490,298,1,869
683,2019-09-02,29,255,10,0,294
683,2019-09-03,106,3182,1802,0,5090
683,2019-09-04,1127,9653,2208,1,12989
683,2019-09-05,1236,11661,2321,2,15220
683,2019-09-06,1128,15009,2028,2,18167
683,2019-09-07,393,8513,1621,1,10528
683,2019-09-08,493,6535,1765,0,8793
683,2019-09-09,341,7107,1466,0,8914
683,2019-09-10,2745,7767,1915,0,12427
683,2019-09-11,189,9367,1865,2,11423
683,2019-09-12,1878,7267,2563,1,11709
683,2019-09-13,546,5226,1809,0,7581
683,2019-09-14,1085,8511,1947,0,11543
683,2019-09-15,332,7688,2999,2,11021
683,2019-09-16,327,6415,2226,1,8969
683,2019-09-17,478,10977,1950,0,13405
683,2019-09-18,288,11254,1845,1,13388
683,2019-09-19,514,10019,1260,0,11793
683,2019-09-20,444,10250,2533,2,13229
683,2019-09-21,2190,9160,1998,2,13350
683,2019-09-22,1301,8540,2214,1,12056
683,2019-09-23,327,11505,1644,1,13477
683,2019-09-24,488,12409,1731,2,14630
683,2019-09-25,1058,12487,1937,4,15486
683,2019-09-26,205,21452,1477,0,23134
683,2019-09-27,147,10902,1288,1,12338
683,2019-09-28,419,25389,2437,3,28248
683,2019-09-29,915,27689,1779,0,30383
683,2019-09-30,1029,20912,1917,4,23862
683,2019-10-01,158,16979,2137,0,19274
683,2019-10-02,261,13702,1981,1,15945
683,2019-10-03,176,14640,1419,3,16238
683,2019-10-04,553,15054,1179,2,16788
683,2019-10-05,318,15414,1564,2,17298
683,2019-10-06,196,10197,1545,1,11939
683,2019-10-07,1655,6845,1952,1,10453
683,2019-10-08,1016,18859,1874,0,21749
683,2019-10-09,507,26465,1908,2,28882
683,2019-10-10,295,12396,1790,2,14483
683,2019-10-11,356,12961,1651,6,14974
683,2019-10-12,2032,7604,2291,0,11927
683,2019-10-13,878,7480,1289,1,9648
683,2019-10-14,265,9510,1997,1,11773
683,2019-10-15,1438,17014,1873,2,20327
683,2019-10-16,1018,18441,1313,1,20773
683,2019-10-17,263,7583,2406,2,10254
683,2019-10-18,332,9552,1683,2,11569
683,2019-10-19,323,6051,1254,0,7628
683,2019-10-20,361,4419,2767,1,7548
683,2019-10-21,407,12257,1337,1,14002
683,2019-10-22,324,11523,2291,0,14138
683,2019-10-23,259,15553,1813,0,17625
683,2019-10-24,405,19003,1557,1,20966
683,2019-10-25,291,16103,943,2,17339
683,2019-10-26,1966,17299,1784,0,21049
683,2019-10-27,1186,28772,945,0,30903
683,2019-10-28,243,20736,1596,0,22575
683,2019-10-29,1454,31396,1984,2,34836
683,2019-10-30,283,22025,1170,2,23480
683,2019-10-31,1178,12820,920,0,14918
683,2019-11-01,2122,15105,1145,1,18373
683,2019-11-02,1287,14366,1422,0,17075
683,2019-11-03,562,22564,1716,0,24842
683,2019-11-04,1172,10959,1445,0,13576
683,2019-11-05,276,4131,2052,0,6459
683,2019-11-06,294,8829,1552,0,10675
683,2019-11-07,359,14297,1117,0,15773
683,2019-11-08,661,10143,1611,0,12415
683,2019-11-09,563,9526,1578,0,11667
683,2019-11-10,256,14290,1794,0,16340
683,2019-11-11,307,10160,1674,0,12141
683,2019-11-12,778,10886,3305,0,14969
683,2019-11-13,315,14884,2353,0,17552
683,2019-11-14,284,8516,1788,0,10588
683,2019-11-15,1197,7274,2450,0,10921
683,2019-11-16,301,4641,2815,0,7757
683,2019-11-17,485,8046,3162,0,11693
683,2019-11-18,1073,3296,3145,1,7515
683,2019-11-19,331,3419,3025,3,6778
683,2019-11-20,349,1442,1760,0,3551
683,2019-11-21,380,3608,1336,1,5325
683,2019-11-22,347,9570,1152,2,11071
683,2019-11-23,362,6761,2168,1,9292
683,2019-11-24,373,8482,1741,1,10597
683,2019-11-25,260,6945,2088,2,9295
683,2019-11-26,284,6660,2070,0,9014
683,2019-11-27,277,6671,1523,0,8471
683,2019-11-28,248,8721,795,0,9764
683,2019-11-29,118,367,4,0,489
683,2019-08-10,437,320,383,0,1140
683,2019-08-11,234,239,109,1,583
683,2019-08-12,477,345,345,0,1167
683,2019-08-13,207,351,138,0,696
683,2019-08-14,225,573,127,0,925
683,2019-08-15,188,43,8,0,239
683,2019-08-16,172,189,166,0,527
683,2019-08-17,217,2065,530,0,2812
683,2019-08-18,393,186,1239,0,1818
683,2019-08-19,313,1194,1084,0,2591
683,2019-08-20,420,1895,799,0,3114
683,2019-08-21,1290,764,990,0,3044
683,2019-08-22,296,2469,1270,2,4037
683,2019-08-23,695,1631,1845,1,4172
683,2019-08-24,280,11148,1621,2,13051
683,2019-08-25,276,23761,1572,4,25613
683,2019-08-26,278,27727,1980,2,29987
683,2019-08-27,286,6452,1689,1,8428
683,2019-08-28,270,13092,2430,0,15792
683,2019-08-29,337,12091,1365,2,13795
683,2019-08-30,241,2981,951,2,4175
683,2019-08-31,44,61,1,0,106
683,2019-09-01,80,490,298,1,869
683,2019-09-02,29,255,10,0,294
683,2019-09-03,106,3182,1802,0,5090
683,2019-09-04,1127,9653,2208,1,12989
683,2019-09-05,1236,11661,2321,2,15220
683,2019-09-06,1128,15009,2028,2,18167
683,2019-09-07,393,8513,1621,1,10528
683,2019-09-08,493,6535,1765,0,8793
683,2019-09-09,341,7107,1466,0,8914
683,2019-09-10,2745,7767,1915,0,12427
683,2019-09-11,189,9367,1865,2,11423
683,2019-09-12,1878,7267,2563,1,11709
683,2019-09-13,546,5226,1809,0,7581
683,2019-09-14,1085,8511,1947,0,11543
683,2019-09-15,332,7688,2999,2,11021
683,2019-09-16,327,6415,2226,1,8969
683,2019-09-17,478,10977,1950,0,13405
683,2019-09-18,288,11254,1845,1,13388
683,2019-09-19,514,10019,1260,0,11793
683,2019-09-20,444,10250,2533,2,13229
683,2019-09-21,2190,9160,1998,2,13350
683,2019-09-22,1301,8540,2214,1,12056
683,2019-09-23,327,11505,1644,1,13477
683,2019-09-24,488,12409,1731,2,14630
683,2019-09-25,1058,12487,1937,4,15486
683,2019-09-26,205,21452,1477,0,23134
683,2019-09-27,147,10902,1288,1,12338
683,2019-09-28,419,25389,2437,3,28248
683,2019-09-29,915,27689,1779,0,30383
683,2019-09-30,1029,20912,1917,4,23862
683,2019-10-01,158,16979,2137,0,19274
683,2019-10-02,261,13702,1981,1,15945
683,2019-10-03,176,14640,1419,3,16238
683,2019-10-04,553,15054,1179,2,16788
683,2019-10-05,318,15414,1564,2,17298
683,2019-10-06,196,10197,1545,1,11939
683,2019-10-07,1655,6845,1952,1,10453
683,2019-10-08,1016,18859,1874,0,21749
683,2019-10-09,507,26465,1908,2,28882
683,2019-10-10,295,12396,1790,2,14483
683,2019-10-11,356,12961,1651,6,14974
683,2019-10-12,2032,7604,2291,0,11927
683,2019-10-13,878,7480,1289,1,9648
683,2019-10-14,265,9510,1997,1,11773
683,2019-10-15,1438,17014,1873,2,20327
683,2019-10-16,1018,18441,1313,1,20773
683,2019-10-17,263,7583,2406,2,10254
683,2019-10-18,332,9552,1683,2,11569
683,2019-10-19,323,6051,1254,0,7628
683,2019-10-20,361,4419,2767,1,7548
683,2019-10-21,407,12257,1337,1,14002
683,2019-10-22,324,11523,2291,0,14138
683,2019-10-23,259,15553,1813,0,17625
683,2019-10-24,405,19003,1557,1,20966
683,2019-10-25,291,16103,943,2,17339
683,2019-10-26,1966,17299,1784,0,21049
683,2019-10-27,1186,28772,945,0,30903
683,2019-10-28,243,20736,1596,0,22575
683,2019-10-29,1454,31396,1984,2,34836
683,2019-10-30,283,22025,1170,2,23480
683,2019-10-31,1178,12820,920,0,14918
683,2019-11-01,2122,15105,1145,1,18373
683,2019-11-02,1287,14366,1422,0,17075
683,2019-11-03,562,22564,1716,0,24842
683,2019-11-04,1172,10959,1445,0,13576
683,2019-11-05,276,4131,2052,0,6459
683,2019-11-06,294,8829,1552,0,10675
683,2019-11-07,359,14297,1117,0,15773
683,2019-11-08,661,10143,1611,0,12415
683,2019-11-09,563,9526,1578,0,11667
683,2019-11-10,256,14290,1794,0,16340
683,2019-11-11,307,10160,1674,0,12141
683,2019-11-12,778,10886,3305,0,14969
683,2019-11-13,315,14884,2353,0,17552
683,2019-11-14,284,8516,1788,0,10588
683,2019-11-15,1197,7274,2450,0,10921
683,2019-11-16,301,4641,2815,0,7757
683,2019-11-17,485,8046,3162,0,11693
683,2019-11-18,1073,3296,3145,1,7515
683,2019-11-19,331,3419,3025,3,6778
683,2019-11-20,349,1442,1760,0,3551
683,2019-11-21,380,3608,1336,1,5325
683,2019-11-22,347,9570,1152,2,11071
683,2019-11-23,362,6761,2168,1,9292
683,2019-11-24,373,8482,1741,1,10597
683,2019-11-25,260,6945,2088,2,9295
683,2019-11-26,284,6660,2070,0,9014
683,2019-11-27,277,6671,1523,0,8471
683,2019-11-28,248,8721,795,0,9764
683,2019-11-29,118,367,4,0,489
683,2019-08-09,2,0,264,0,266
683,2019-08-10,437,320,383,0,1140
683,2019-08-11,234,239,109,1,583
683,2019-08-12,477,345,345,0,1167
683,2019-08-13,207,351,138,0,696
683,2019-08-14,225,573,127,0,925
683,2019-08-15,188,43,8,0,239
683,2019-08-16,172,189,166,0,527
683,2019-08-17,217,2065,530,0,2812
683,2019-08-18,393,186,1239,0,1818
683,2019-08-19,313,1194,1084,0,2591
683,2019-08-20,420,1895,799,0,3114
683,2019-08-21,1290,764,990,0,3044
683,2019-08-22,296,2469,1270,2,4037
683,2019-08-23,695,1631,1845,1,4172
683,2019-08-24,280,11148,1621,2,13051
683,2019-08-25,276,23761,1572,4,25613
683,2019-08-26,278,27727,1980,2,29987
683,2019-08-27,286,6452,1689,1,8428
683,2019-08-28,270,13092,2430,0,15792
683,2019-08-29,337,12091,1365,2,13795
683,2019-08-30,241,2981,951,2,4175
683,2019-08-31,44,61,1,0,106
683,2019-09-01,80,490,298,1,869
683,2019-09-02,29,255,10,0,294
683,2019-09-03,106,3182,1802,0,5090
683,2019-09-04,1127,9653,2208,1,12989
683,2019-09-05,1236,11661,2321,2,15220
683,2019-09-06,1128,15009,2028,2,18167
683,2019-09-07,393,8513,1621,1,10528
683,2019-09-08,493,6535,1765,0,8793
683,2019-09-09,341,7107,1466,0,8914
683,2019-09-10,2745,7767,1915,0,12427
683,2019-09-11,189,9367,1865,2,11423
683,2019-09-12,1878,7267,2563,1,11709
683,2019-09-13,546,5226,1809,0,7581
683,2019-09-14,1085,8511,1947,0,11543
683,2019-09-15,332,7688,2999,2,11021
683,2019-09-16,327,6415,2226,1,8969
683,2019-09-17,478,10977,1950,0,13405
683,2019-09-18,288,11254,1845,1,13388
683,2019-09-19,514,10019,1260,0,11793
683,2019-09-20,444,10250,2533,2,13229
683,2019-09-21,2190,9160,1998,2,13350
683,2019-09-22,1301,8540,2214,1,12056
683,2019-09-23,327,11505,1644,1,13477
683,2019-09-24,488,12409,1731,2,14630
683,2019-09-25,1058,12487,1937,4,15486
683,2019-09-26,205,21452,1477,0,23134
683,2019-09-27,147,10902,1288,1,12338
683,2019-09-28,419,25389,2437,3,28248
683,2019-09-29,915,27689,1779,0,30383
683,2019-09-30,1029,20912,1917,4,23862
683,2019-10-01,158,16979,2137,0,19274
683,2019-10-02,261,13702,1981,1,15945
683,2019-10-03,176,14640,1419,3,16238
683,2019-10-04,553,15054,1179,2,16788
683,2019-10-05,318,15414,1564,2,17298
683,2019-10-06,196,10197,1545,1,11939
683,2019-10-07,1655,6845,1952,1,10453
683,2019-10-08,1016,18859,1874,0,21749
683,2019-10-09,507,26465,1908,2,28882
683,2019-10-10,295,12396,1790,2,14483
683,2019-10-11,356,12961,1651,6,14974
683,2019-10-12,2032,7604,2291,0,11927
683,2019-10-13,878,7480,1289,1,9648
683,2019-10-14,265,9510,1997,1,11773
683,2019-10-15,1438,17014,1873,2,20327
683,2019-10-16,1018,18441,1313,1,20773
683,2019-10-17,263,7583,2406,2,10254
683,2019-10-18,332,9552,1683,2,11569
683,2019-10-19,323,6051,1254,0,7628
683,2019-10-20,361,4419,2767,1,7548
683,2019-10-21,407,12257,1337,1,14002
683,2019-10-22,324,11523,2291,0,14138
683,2019-10-23,259,15553,1813,0,17625
683,2019-10-24,405,19003,1557,1,20966
683,2019-10-25,291,16103,943,2,17339
683,2019-10-26,1966,17299,1784,0,21049
683,2019-10-27,1186,28772,945,0,30903
683,2019-10-28,243,20736,1596,0,22575
683,2019-10-29,1454,31396,1984,2,34836
683,2019-10-30,283,22025,1170,2,23480
683,2019-10-31,1178,12820,920,0,14918
683,2019-11-01,2122,15105,1145,1,18373
683,2019-11-02,1287,14366,1422,0,17075
683,2019-11-03,562,22564,1716,0,24842
683,2019-11-04,1172,10959,1445,0,13576
683,2019-11-05,276,4131,2052,0,6459
683,2019-11-06,294,8829,1552,0,10675
683,2019-11-07,359,14297,1117,0,15773
683,2019-11-08,661,10143,1611,0,12415
683,2019-11-09,563,9526,1578,0,11667
683,2019-11-10,256,14290,1794,0,16340
683,2019-11-11,307,10160,1674,0,12141
683,2019-11-12,778,10886,3305,0,14969
683,2019-11-13,315,14884,2353,0,17552
683,2019-11-14,284,8516,1788,0,10588
683,2019-11-15,1197,7274,2450,0,10921
683,2019-11-16,301,4641,2815,0,7757
683,2019-11-17,485,8046,3162,0,11693
683,2019-11-18,1073,3296,3145,1,7515
683,2019-11-19,331,3419,3025,3,6778
683,2019-11-20,349,1442,1760,0,3551
683,2019-11-21,380,3608,1336,1,5325
683,2019-11-22,347,9570,1152,2,11071
683,2019-11-23,362,6761,2168,1,9292
683,2019-11-24,373,8482,1741,1,10597
683,2019-11-25,260,6945,2088,2,9295
683,2019-11-26,284,6660,2070,0,9014
683,2019-11-27,277,6671,1523,0,8471
683,2019-11-28,248,8721,795,0,9764
683,2019-11-29,118,367,4,0,489
683,2019-08-11,234,239,109,1,583
683,2019-08-12,477,345,345,0,1167
683,2019-08-13,207,351,138,0,696
683,2019-08-14,225,573,127,0,925
683,2019-08-15,188,43,8,0,239
683,2019-08-16,172,189,166,0,527
683,2019-08-17,217,2065,530,0,2812
683,2019-08-18,393,186,1239,0,1818
683,2019-08-19,313,1194,1084,0,2591
683,2019-08-20,420,1895,799,0,3114
683,2019-08-21,1290,764,990,0,3044
683,2019-08-22,296,2469,1270,2,4037
683,2019-08-23,695,1631,1845,1,4172
683,2019-08-24,280,11148,1621,2,13051
683,2019-08-25,276,23761,1572,4,25613
683,2019-08-26,278,27727,1980,2,29987
683,2019-08-27,286,6452,1689,1,8428
683,2019-08-28,270,13092,2430,0,15792
683,2019-08-29,337,12091,1365,2,13795
683,2019-08-30,241,2981,951,2,4175
683,2019-08-31,44,61,1,0,106
683,2019-09-01,80,490,298,1,869
683,2019-09-02,29,255,10,0,294
683,2019-09-03,106,3182,1802,0,5090
683,2019-09-04,1127,9653,2208,1,12989
683,2019-09-05,1236,11661,2321,2,15220
683,2019-09-06,1128,15009,2028,2,18167
683,2019-09-07,393,8513,1621,1,10528
683,2019-09-08,493,6535,1765,0,8793
683,2019-09-09,341,7107,1466,0,8914
683,2019-09-10,2745,7767,1915,0,12427
683,2019-09-11,189,9367,1865,2,11423
683,2019-09-12,1878,7267,2563,1,11709
683,2019-09-13,546,5226,1809,0,7581
683,2019-09-14,1085,8511,1947,0,11543
683,2019-09-15,332,7688,2999,2,11021
683,2019-09-16,327,6415,2226,1,8969
683,2019-09-17,478,10977,1950,0,13405
683,2019-09-18,288,11254,1845,1,13388
683,2019-09-19,514,10019,1260,0,11793
683,2019-09-20,444,10250,2533,2,13229
683,2019-09-21,2190,9160,1998,2,13350
683,2019-09-22,1301,8540,2214,1,12056
683,2019-09-23,327,11505,1644,1,13477
683,2019-09-24,488,12409,1731,2,14630
683,2019-09-25,1058,12487,1937,4,15486
683,2019-09-26,205,21452,1477,0,23134
683,2019-09-27,147,10902,1288,1,12338
683,2019-09-28,419,25389,2437,3,28248
683,2019-09-29,915,27689,1779,0,30383
683,2019-09-30,1029,20912,1917,4,23862
683,2019-10-01,158,16979,2137,0,19274
683,2019-10-02,261,13702,1981,1,15945
683,2019-10-03,176,14640,1419,3,16238
683,2019-10-04,553,15054,1179,2,16788
683,2019-10-05,318,15414,1564,2,17298
683,2019-10-06,196,10197,1545,1,11939
683,2019-10-07,1655,6845,1952,1,10453
683,2019-10-08,1016,18859,1874,0,21749
683,2019-10-09,507,26465,1908,2,28882
683,2019-10-10,295,12396,1790,2,14483
683,2019-10-11,356,12961,1651,6,14974
683,2019-10-12,2032,7604,2291,0,11927
683,2019-10-13,878,7480,1289,1,9648
683,2019-10-14,265,9510,1997,1,11773
683,2019-10-15,1438,17014,1873,2,20327
683,2019-10-16,1018,18441,1313,1,20773
683,2019-10-17,263,7583,2406,2,10254
683,2019-10-18,332,9552,1683,2,11569
683,2019-10-19,323,6051,1254,0,7628
683,2019-10-20,361,4419,2767,1,7548
683,2019-10-21,407,12257,1337,1,14002
683,2019-10-22,324,11523,2291,0,14138
683,2019-10-23,259,15553,1813,0,17625
683,2019-10-24,405,19003,1557,1,20966
683,2019-10-25,291,16103,943,2,17339
683,2019-10-26,1966,17299,1784,0,21049
683,2019-10-27,1186,28772,945,0,30903
683,2019-10-28,243,20736,1596,0,22575
683,2019-10-29,1454,31396,1984,2,34836
683,2019-10-30,283,22025,1170,2,23480
683,2019-10-31,1178,12820,920,0,14918
683,2019-11-01,2122,15105,1145,1,18373
683,2019-11-02,1287,14366,1422,0,17075
683,2019-11-03,562,22564,1716,0,24842
683,2019-11-04,1172,10959,1445,0,13576
683,2019-11-05,276,4131,2052,0,6459
683,2019-11-06,294,8829,1552,0,10675
683,2019-11-07,359,14297,1117,0,15773
683,2019-11-08,661,10143,1611,0,12415
683,2019-11-09,563,9526,1578,0,11667
683,2019-11-10,256,14290,1794,0,16340
683,2019-11-11,307,10160,1674,0,12141
683,2019-11-12,778,10886,3305,0,14969
683,2019-11-13,315,14884,2353,0,17552
683,2019-11-14,284,8516,1788,0,10588
683,2019-11-15,1197,7274,2450,0,10921
683,2019-11-16,301,4641,2815,0,7757
683,2019-11-17,485,8046,3162,0,11693
683,2019-11-18,1073,3296,3145,1,7515
683,2019-11-19,331,3419,3025,3,6778
683,2019-11-20,349,1442,1760,0,3551
683,2019-11-21,380,3608,1336,1,5325
683,2019-11-22,347,9570,1152,2,11071
683,2019-11-23,362,6761,2168,1,9292
683,2019-11-24,373,8482,1741,1,10597
683,2019-11-25,260,6945,2088,2,9295
684,2019-08-09,3,0,0,0,3
684,2019-08-10,87,418,365,4,874
684,2019-08-11,137,350,229,0,716
684,2019-08-12,248,222,103,1,574
684,2019-08-13,79,10720,142,0,10941
684,2019-08-14,223,8374,172,0,8769
684,2019-08-15,103,555,58,0,716
684,2019-08-16,99,285,24,0,408
684,2019-08-17,448,1993,383,1,2825
684,2019-08-18,466,2641,1252,0,4359
684,2019-08-19,537,3954,1372,1,5864
684,2019-08-20,98,1869,1241,0,3208
684,2019-08-21,114,1188,1563,1,2866
684,2019-08-22,107,1644,850,2,2603
684,2019-08-23,240,2773,1868,1,4882
684,2019-08-24,957,3303,2649,1,6910
684,2019-08-25,959,6772,1260,2,8993
684,2019-08-26,103,1677,1800,1,3581
684,2019-08-27,128,1990,1016,0,3134
684,2019-08-28,101,4075,1340,0,5516
684,2019-08-29,210,8765,1719,1,10695
684,2019-08-30,70,2974,726,1,3771
684,2019-08-31,33,225,10,0,268
684,2019-09-01,109,651,183,0,943
684,2019-09-02,31,516,9,0,556
684,2019-09-03,97,3720,1220,2,5039
684,2019-09-04,100,10190,2689,4,12983
684,2019-09-05,109,11660,3056,0,14825
684,2019-09-06,124,14167,1689,0,15980
684,2019-09-07,1674,9105,1722,0,12501
684,2019-09-08,200,7151,2315,0,9666
684,2019-09-09,312,9651,2032,3,11998
684,2019-09-10,1122,8591,1797,0,11510
684,2019-09-11,315,6318,1447,3,8083
684,2019-09-12,951,8392,1565,2,10910
684,2019-09-13,127,7215,1713,3,9058
684,2019-09-14,945,7671,2088,1,10705
684,2019-09-15,97,6627,1986,2,8712
684,2019-09-16,1628,14753,2833,7,19221
684,2019-09-17,124,9676,1710,7,11517
684,2019-09-18,105,11668,1161,9,12943
684,2019-09-19,225,3394,1620,9,5248
684,2019-09-20,1060,9001,2137,9,12207
684,2019-09-21,121,6328,1530,9,7988
684,2019-09-22,962,9852,1460,12,12286
684,2019-09-23,136,9067,1500,11,10714
684,2019-09-24,1000,9771,1441,11,12223
684,2019-09-25,158,11113,1212,12,12495
684,2019-09-26,124,10313,2186,11,12634
684,2019-09-27,983,9683,2448,5,13119
684,2019-09-28,153,15672,1527,3,17355
684,2019-09-29,135,15227,1987,0,17349
684,2019-09-30,106,18524,1595,2,20227
684,2019-10-01,98,17301,1627,0,19026
684,2019-10-02,139,12772,1263,7,14181
684,2019-10-03,121,21339,2127,11,23598
684,2019-10-04,332,31203,1778,12,33325
684,2019-10-05,112,25048,1975,11,27146
684,2019-10-06,1126,17618,1446,11,20201
684,2019-10-07,960,6566,1370,13,8909
684,2019-10-08,1121,13005,1454,12,15592
684,2019-10-09,725,17059,1997,10,19791
684,2019-10-10,964,11784,2549,4899,20196
684,2019-10-11,943,12551,1443,10,14947
684,2019-10-12,419,8468,2689,2,11578
684,2019-10-13,107,17805,2165,0,20077
684,2019-10-14,91,6926,2503,1,9521
684,2019-10-15,115,9572,2425,1,12113
684,2019-10-16,233,24442,1701,1,26377
684,2019-10-17,118,12409,2636,1,15164
684,2019-10-18,193,9131,1864,2,11190
684,2019-10-19,1879,6703,2266,0,10848
684,2019-10-20,1115,3082,1996,0,6193
684,2019-10-21,102,20163,1967,0,22232
684,2019-10-22,324,11784,1372,3,13483
684,2019-10-23,366,16028,1044,0,17438
684,2019-10-24,177,26068,1765,2,28012
684,2019-10-25,143,15968,917,3,17031
684,2019-10-26,1007,14585,1408,0,17000
684,2019-10-27,139,16793,1337,1,18270
684,2019-10-28,115,19815,1239,2,21171
684,2019-10-29,1199,32068,1628,1,34896
684,2019-10-30,89,21208,1274,1,22572
684,2019-10-31,90,12973,1468,1,14532
684,2019-11-01,65,25947,1175,2,27189
684,2019-11-02,589,17301,2129,0,20019
684,2019-11-03,614,23359,1709,0,25682
684,2019-11-04,1003,11487,2257,1,14748
684,2019-11-05,284,3776,2229,0,6289
684,2019-11-06,135,16960,922,4,18021
684,2019-11-07,180,17353,1112,2,18647
684,2019-11-08,1016,10469,1630,0,13115
684,2019-11-09,132,13738,1141,0,15011
684,2019-11-10,136,14617,2087,1,16841
684,2019-11-11,152,9947,2291,4,12394
684,2019-11-12,107,10875,3296,1,14279
684,2019-11-13,829,20220,1488,0,22537
684,2019-11-14,159,15333,2246,1,17739
684,2019-11-15,157,4949,2855,1,7962
684,2019-11-16,600,2530,3178,2,6310
684,2019-11-17,333,7323,2803,1,10460
684,2019-11-18,167,2581,3424,0,6172
684,2019-11-19,1931,3380,2441,0,7752
684,2019-11-20,1076,1530,1519,0,4125
684,2019-11-21,176,3696,1794,0,5666
684,2019-11-22,195,9440,1633,0,11268
684,2019-11-23,130,9116,2084,0,11330
684,2019-11-24,1096,7502,1722,0,10320
684,2019-11-25,454,11017,1375,0,12846
684,2019-11-26,817,6517,2156,0,9490
684,2019-11-27,124,6650,2113,0,8887
684,2019-11-28,245,9241,653,0,10139
684,2019-11-29,16,685,1,0,702
684,2019-08-10,87,418,365,4,874
684,2019-08-11,137,350,229,0,716
684,2019-08-12,248,222,103,1,574
684,2019-08-13,79,10720,142,0,10941
684,2019-08-14,223,8374,172,0,8769
684,2019-08-15,103,555,58,0,716
684,2019-08-16,99,285,24,0,408
684,2019-08-17,448,1993,383,1,2825
684,2019-08-18,466,2641,1252,0,4359
684,2019-08-19,537,3954,1372,1,5864
684,2019-08-20,98,1869,1241,0,3208
684,2019-08-21,114,1188,1563,1,2866
684,2019-08-22,107,1644,850,2,2603
684,2019-08-23,240,2773,1868,1,4882
684,2019-08-24,957,3303,2649,1,6910
684,2019-08-25,959,6772,1260,2,8993
684,2019-08-26,103,1677,1800,1,3581
684,2019-08-27,128,1990,1016,0,3134
684,2019-08-28,101,4075,1340,0,5516
684,2019-08-29,210,8765,1719,1,10695
684,2019-08-30,70,2974,726,1,3771
684,2019-08-31,33,225,10,0,268
684,2019-09-01,109,651,183,0,943
684,2019-09-02,31,516,9,0,556
684,2019-09-03,97,3720,1220,2,5039
684,2019-09-04,100,10190,2689,4,12983
684,2019-09-05,109,11660,3056,0,14825
684,2019-09-06,124,14167,1689,0,15980
684,2019-09-07,1674,9105,1722,0,12501
684,2019-09-08,200,7151,2315,0,9666
684,2019-09-09,312,9651,2032,3,11998
684,2019-09-10,1122,8591,1797,0,11510
684,2019-09-11,315,6318,1447,3,8083
684,2019-09-12,951,8392,1565,2,10910
684,2019-09-13,127,7215,1713,3,9058
684,2019-09-14,945,7671,2088,1,10705
684,2019-09-15,97,6627,1986,2,8712
684,2019-09-16,1628,14753,2833,7,19221
684,2019-09-17,124,9676,1710,7,11517
684,2019-09-18,105,11668,1161,9,12943
684,2019-09-19,225,3394,1620,9,5248
684,2019-09-20,1060,9001,2137,9,12207
684,2019-09-21,121,6328,1530,9,7988
684,2019-09-22,962,9852,1460,12,12286
684,2019-09-23,136,9067,1500,11,10714
684,2019-09-24,1000,9771,1441,11,12223
684,2019-09-25,158,11113,1212,12,12495
684,2019-09-26,124,10313,2186,11,12634
684,2019-09-27,983,9683,2448,5,13119
684,2019-09-28,153,15672,1527,3,17355
684,2019-09-29,135,15227,1987,0,17349
684,2019-09-30,106,18524,1595,2,20227
684,2019-10-01,98,17301,1627,0,19026
684,2019-10-02,139,12772,1263,7,14181
684,2019-10-03,121,21339,2127,11,23598
684,2019-10-04,332,31203,1778,12,33325
684,2019-10-05,112,25048,1975,11,27146
684,2019-10-06,1126,17618,1446,11,20201
684,2019-10-07,960,6566,1370,13,8909
684,2019-10-08,1121,13005,1454,12,15592
684,2019-10-09,725,17059,1997,10,19791
684,2019-10-10,964,11784,2549,4899,20196
684,2019-10-11,943,12551,1443,10,14947
684,2019-10-12,419,8468,2689,2,11578
684,2019-10-13,107,17805,2165,0,20077
684,2019-10-14,91,6926,2503,1,9521
684,2019-10-15,115,9572,2425,1,12113
684,2019-10-16,233,24442,1701,1,26377
684,2019-10-17,118,12409,2636,1,15164
684,2019-10-18,193,9131,1864,2,11190
684,2019-10-19,1879,6703,2266,0,10848
684,2019-10-20,1115,3082,1996,0,6193
684,2019-10-21,102,20163,1967,0,22232
684,2019-10-22,324,11784,1372,3,13483
684,2019-10-23,366,16028,1044,0,17438
684,2019-10-24,177,26068,1765,2,28012
684,2019-10-25,143,15968,917,3,17031
684,2019-10-26,1007,14585,1408,0,17000
684,2019-10-27,139,16793,1337,1,18270
684,2019-10-28,115,19815,1239,2,21171
684,2019-10-29,1199,32068,1628,1,34896
684,2019-10-30,89,21208,1274,1,22572
684,2019-10-31,90,12973,1468,1,14532
684,2019-11-01,65,25947,1175,2,27189
684,2019-11-02,589,17301,2129,0,20019
684,2019-11-03,614,23359,1709,0,25682
684,2019-11-04,1003,11487,2257,1,14748
684,2019-11-05,284,3776,2229,0,6289
684,2019-11-06,135,16960,922,4,18021
684,2019-11-07,180,17353,1112,2,18647
684,2019-11-08,1016,10469,1630,0,13115
684,2019-11-09,132,13738,1141,0,15011
684,2019-11-10,136,14617,2087,1,16841
684,2019-11-11,152,9947,2291,4,12394
684,2019-11-12,107,10875,3296,1,14279
684,2019-11-13,829,20220,1488,0,22537
684,2019-11-14,159,15333,2246,1,17739
684,2019-11-15,157,4949,2855,1,7962
684,2019-11-16,600,2530,3178,2,6310
684,2019-11-17,333,7323,2803,1,10460
684,2019-11-18,167,2581,3424,0,6172
684,2019-11-19,1931,3380,2441,0,7752
684,2019-11-20,1076,1530,1519,0,4125
684,2019-11-21,176,3696,1794,0,5666
684,2019-11-22,195,9440,1633,0,11268
684,2019-11-23,130,9116,2084,0,11330
684,2019-11-24,1096,7502,1722,0,10320
684,2019-11-25,454,11017,1375,0,12846
684,2019-11-26,817,6517,2156,0,9490
684,2019-11-27,124,6650,2113,0,8887
684,2019-11-28,245,9241,653,0,10139
684,2019-11-29,16,685,1,0,702
684,2019-08-10,87,418,365,4,874
684,2019-08-11,137,350,229,0,716
684,2019-08-12,248,222,103,1,574
684,2019-08-13,79,10720,142,0,10941
684,2019-08-14,223,8374,172,0,8769
684,2019-08-15,103,555,58,0,716
684,2019-08-16,99,285,24,0,408
684,2019-08-17,448,1993,383,1,2825
684,2019-08-18,466,2641,1252,0,4359
684,2019-08-19,537,3954,1372,1,5864
684,2019-08-20,98,1869,1241,0,3208
684,2019-08-21,114,1188,1563,1,2866
684,2019-08-22,107,1644,850,2,2603
684,2019-08-23,240,2773,1868,1,4882
684,2019-08-24,957,3303,2649,1,6910
684,2019-08-25,959,6772,1260,2,8993
684,2019-08-26,103,1677,1800,1,3581
684,2019-08-27,128,1990,1016,0,3134
684,2019-08-28,101,4075,1340,0,5516
684,2019-08-29,210,8765,1719,1,10695
684,2019-08-30,70,2974,726,1,3771
684,2019-08-31,33,225,10,0,268
684,2019-09-01,109,651,183,0,943
684,2019-09-02,31,516,9,0,556
684,2019-09-03,97,3720,1220,2,5039
684,2019-09-04,100,10190,2689,4,12983
684,2019-09-05,109,11660,3056,0,14825
684,2019-09-06,124,14167,1689,0,15980
684,2019-09-07,1674,9105,1722,0,12501
684,2019-09-08,200,7151,2315,0,9666
684,2019-09-09,312,9651,2032,3,11998
684,2019-09-10,1122,8591,1797,0,11510
684,2019-09-11,315,6318,1447,3,8083
684,2019-09-12,951,8392,1565,2,10910
684,2019-09-13,127,7215,1713,3,9058
684,2019-09-14,945,7671,2088,1,10705
684,2019-09-15,97,6627,1986,2,8712
684,2019-09-16,1628,14753,2833,7,19221
684,2019-09-17,124,9676,1710,7,11517
684,2019-09-18,105,11668,1161,9,12943
684,2019-09-19,225,3394,1620,9,5248
684,2019-09-20,1060,9001,2137,9,12207
684,2019-09-21,121,6328,1530,9,7988
684,2019-09-22,962,9852,1460,12,12286
684,2019-09-23,136,9067,1500,11,10714
684,2019-09-24,1000,9771,1441,11,12223
684,2019-09-25,158,11113,1212,12,12495
684,2019-09-26,124,10313,2186,11,12634
684,2019-09-27,983,9683,2448,5,13119
684,2019-09-28,153,15672,1527,3,17355
684,2019-09-29,135,15227,1987,0,17349
684,2019-09-30,106,18524,1595,2,20227
684,2019-10-01,98,17301,1627,0,19026
684,2019-10-02,139,12772,1263,7,14181
684,2019-10-03,121,21339,2127,11,23598
684,2019-10-04,332,31203,1778,12,33325
684,2019-10-05,112,25048,1975,11,27146
684,2019-10-06,1126,17618,1446,11,20201
684,2019-10-07,960,6566,1370,13,8909
684,2019-10-08,1121,13005,1454,12,15592
684,2019-10-09,725,17059,1997,10,19791
684,2019-10-10,964,11784,2549,4899,20196
684,2019-10-11,943,12551,1443,10,14947
684,2019-10-12,419,8468,2689,2,11578
684,2019-10-13,107,17805,2165,0,20077
684,2019-10-14,91,6926,2503,1,9521
684,2019-10-15,115,9572,2425,1,12113
684,2019-10-16,233,24442,1701,1,26377
684,2019-10-17,118,12409,2636,1,15164
684,2019-10-18,193,9131,1864,2,11190
684,2019-10-19,1879,6703,2266,0,10848
684,2019-10-20,1115,3082,1996,0,6193
684,2019-10-21,102,20163,1967,0,22232
684,2019-10-22,324,11784,1372,3,13483
684,2019-10-23,366,16028,1044,0,17438
684,2019-10-24,177,26068,1765,2,28012
684,2019-10-25,143,15968,917,3,17031
684,2019-10-26,1007,14585,1408,0,17000
684,2019-10-27,139,16793,1337,1,18270
684,2019-10-28,115,19815,1239,2,21171
684,2019-10-29,1199,32068,1628,1,34896
684,2019-10-30,89,21208,1274,1,22572
684,2019-10-31,90,12973,1468,1,14532
684,2019-11-01,65,25947,1175,2,27189
684,2019-11-02,589,17301,2129,0,20019
684,2019-11-03,614,23359,1709,0,25682
684,2019-11-04,1003,11487,2257,1,14748
684,2019-11-05,284,3776,2229,0,6289
684,2019-11-06,135,16960,922,4,18021
684,2019-11-07,180,17353,1112,2,18647
684,2019-11-08,1016,10469,1630,0,13115
684,2019-11-09,132,13738,1141,0,15011
684,2019-11-10,136,14617,2087,1,16841
684,2019-11-11,152,9947,2291,4,12394
684,2019-11-12,107,10875,3296,1,14279
684,2019-11-13,829,20220,1488,0,22537
684,2019-11-14,159,15333,2246,1,17739
684,2019-11-15,157,4949,2855,1,7962
684,2019-11-16,600,2530,3178,2,6310
684,2019-11-17,333,7323,2803,1,10460
684,2019-11-18,167,2581,3424,0,6172
684,2019-11-19,1931,3380,2441,0,7752
684,2019-11-20,1076,1530,1519,0,4125
684,2019-11-21,176,3696,1794,0,5666
684,2019-11-22,195,9440,1633,0,11268
684,2019-11-23,130,9116,2084,0,11330
684,2019-11-24,1096,7502,1722,0,10320
684,2019-11-25,454,11017,1375,0,12846
684,2019-11-26,817,6517,2156,0,9490
684,2019-11-27,124,6650,2113,0,8887
684,2019-11-28,245,9241,653,0,10139
684,2019-11-29,16,685,1,0,702
684,2019-08-10,87,418,365,4,874
684,2019-08-11,137,350,229,0,716
684,2019-08-12,248,222,103,1,574
684,2019-08-13,79,10720,142,0,10941
684,2019-08-14,223,8374,172,0,8769
684,2019-08-15,103,555,58,0,716
684,2019-08-16,99,285,24,0,408
684,2019-08-17,448,1993,383,1,2825
684,2019-08-18,466,2641,1252,0,4359
684,2019-08-19,537,3954,1372,1,5864
684,2019-08-20,98,1869,1241,0,3208
684,2019-08-21,114,1188,1563,1,2866
684,2019-08-22,107,1644,850,2,2603
684,2019-08-23,240,2773,1868,1,4882
684,2019-08-24,957,3303,2649,1,6910
684,2019-08-25,959,6772,1260,2,8993
684,2019-08-26,103,1677,1800,1,3581
684,2019-08-27,128,1990,1016,0,3134
684,2019-08-28,101,4075,1340,0,5516
684,2019-08-29,210,8765,1719,1,10695
684,2019-08-30,70,2974,726,1,3771
684,2019-08-31,33,225,10,0,268
684,2019-09-01,109,651,183,0,943
684,2019-09-02,31,516,9,0,556
684,2019-09-03,97,3720,1220,2,5039
684,2019-09-04,100,10190,2689,4,12983
684,2019-09-05,109,11660,3056,0,14825
684,2019-09-06,124,14167,1689,0,15980
684,2019-09-07,1674,9105,1722,0,12501
684,2019-09-08,200,7151,2315,0,9666
684,2019-09-09,312,9651,2032,3,11998
684,2019-09-10,1122,8591,1797,0,11510
684,2019-09-11,315,6318,1447,3,8083
684,2019-09-12,951,8392,1565,2,10910
684,2019-09-13,127,7215,1713,3,9058
684,2019-09-14,945,7671,2088,1,10705
684,2019-09-15,97,6627,1986,2,8712
684,2019-09-16,1628,14753,2833,7,19221
684,2019-09-17,124,9676,1710,7,11517
684,2019-09-18,105,11668,1161,9,12943
684,2019-09-19,225,3394,1620,9,5248
684,2019-09-20,1060,9001,2137,9,12207
684,2019-09-21,121,6328,1530,9,7988
684,2019-09-22,962,9852,1460,12,12286
684,2019-09-23,136,9067,1500,11,10714
684,2019-09-24,1000,9771,1441,11,12223
684,2019-09-25,158,11113,1212,12,12495
684,2019-09-26,124,10313,2186,11,12634
684,2019-09-27,983,9683,2448,5,13119
684,2019-09-28,153,15672,1527,3,17355
684,2019-09-29,135,15227,1987,0,17349
684,2019-09-30,106,18524,1595,2,20227
684,2019-10-01,98,17301,1627,0,19026
684,2019-10-02,139,12772,1263,7,14181
684,2019-10-03,121,21339,2127,11,23598
684,2019-10-04,332,31203,1778,12,33325
684,2019-10-05,112,25048,1975,11,27146
684,2019-10-06,1126,17618,1446,11,20201
684,2019-10-07,960,6566,1370,13,8909
684,2019-10-08,1121,13005,1454,12,15592
684,2019-10-09,725,17059,1997,10,19791
684,2019-10-10,964,11784,2549,4899,20196
684,2019-10-11,943,12551,1443,10,14947
684,2019-10-12,419,8468,2689,2,11578
684,2019-10-13,107,17805,2165,0,20077
684,2019-10-14,91,6926,2503,1,9521
684,2019-10-15,115,9572,2425,1,12113
684,2019-10-16,233,24442,1701,1,26377
684,2019-10-17,118,12409,2636,1,15164
684,2019-10-18,193,9131,1864,2,11190
684,2019-10-19,1879,6703,2266,0,10848
684,2019-10-20,1115,3082,1996,0,6193
684,2019-10-21,102,20163,1967,0,22232
684,2019-10-22,324,11784,1372,3,13483
684,2019-10-23,366,16028,1044,0,17438
684,2019-10-24,177,26068,1765,2,28012
684,2019-10-25,143,15968,917,3,17031
684,2019-10-26,1007,14585,1408,0,17000
684,2019-10-27,139,16793,1337,1,18270
684,2019-10-28,115,19815,1239,2,21171
684,2019-10-29,1199,32068,1628,1,34896
684,2019-10-30,89,21208,1274,1,22572
684,2019-10-31,90,12973,1468,1,14532
684,2019-11-01,65,25947,1175,2,27189
684,2019-11-02,589,17301,2129,0,20019
684,2019-11-03,614,23359,1709,0,25682
684,2019-11-04,1003,11487,2257,1,14748
684,2019-11-05,284,3776,2229,0,6289
684,2019-11-06,135,16960,922,4,18021
684,2019-11-07,180,17353,1112,2,18647
684,2019-11-08,1016,10469,1630,0,13115
684,2019-11-09,132,13738,1141,0,15011
684,2019-11-10,136,14617,2087,1,16841
684,2019-11-11,152,9947,2291,4,12394
684,2019-11-12,107,10875,3296,1,14279
684,2019-11-13,829,20220,1488,0,22537
684,2019-11-14,159,15333,2246,1,17739
684,2019-11-15,157,4949,2855,1,7962
684,2019-11-16,600,2530,3178,2,6310
684,2019-11-17,333,7323,2803,1,10460
685,2019-08-09,2,0,38,0,40
685,2019-08-10,409,336,269,0,1014
685,2019-08-11,380,517,254,1,1152
685,2019-08-12,323,429,54,0,806
685,2019-08-13,289,227,280,0,796
685,2019-08-14,352,634,291,0,1277
685,2019-08-15,289,535,44,0,868
685,2019-08-16,223,457,35,0,715
685,2019-08-17,300,1938,648,1,2887
685,2019-08-18,1065,2758,1470,0,5293
685,2019-08-19,681,3255,974,0,4910
685,2019-08-20,308,1875,899,0,3082
685,2019-08-21,314,1463,1088,1,2866
685,2019-08-22,991,15181,1185,0,17357
685,2019-08-23,326,9108,1718,1,11153
685,2019-08-24,297,3778,1531,0,5606
685,2019-08-25,309,18095,1605,4,20013
685,2019-08-26,1116,24931,1174,2,27223
685,2019-08-27,329,8988,2170,2,11489
685,2019-08-28,372,25299,1896,0,27567
685,2019-08-29,1518,16050,2673,1,20242
685,2019-08-30,249,4709,490,0,5448
685,2019-08-31,57,213,0,1,271
685,2019-09-01,81,575,93,1,750
685,2019-09-02,49,940,3,1,993
685,2019-09-03,137,3721,1349,0,5207
685,2019-09-04,293,11940,1956,1,14190
685,2019-09-05,289,9235,2013,1,11538
685,2019-09-06,1161,12132,1730,0,15023
685,2019-09-07,352,7580,1530,0,9462
685,2019-09-08,410,7168,2474,0,10052
685,2019-09-09,451,22648,1794,1,24894
685,2019-09-10,410,9303,1726,1,11440
685,2019-09-11,228,7013,2984,3,10228
685,2019-09-12,359,16211,1881,2,18453
685,2019-09-13,425,4139,2080,3,6647
685,2019-09-14,313,7045,2373,1,9732
685,2019-09-15,2123,11594,2379,2,16098
685,2019-09-16,257,12565,2360,4,15186
685,2019-09-17,255,12382,2160,6,14803
685,2019-09-18,473,19491,1295,9,21268
685,2019-09-19,1529,10183,1712,8,13432
685,2019-09-20,546,16656,1896,9,19107
685,2019-09-21,315,7344,2240,9,9908
685,2019-09-22,275,9683,1526,10,11494
685,2019-09-23,354,9508,2783,9,12654
685,2019-09-24,1366,9508,1950,11,12835
685,2019-09-25,204,10586,1650,11,12451
685,2019-09-26,211,11609,1272,10,13102
685,2019-09-27,223,8851,1877,1,10952
685,2019-09-28,228,15666,2211,3,18108
685,2019-09-29,156,15227,1843,1,17227
685,2019-09-30,138,16708,2139,3,18988
685,2019-10-01,1022,16652,2003,0,19677
685,2019-10-02,228,12610,1971,7,14816
685,2019-10-03,194,14820,1694,10,16718
685,2019-10-04,138,12667,1521,13,14339
685,2019-10-05,954,15110,1036,13,17113
685,2019-10-06,126,10282,2275,10,12693
685,2019-10-07,1081,7721,1565,11,10378
685,2019-10-08,178,13087,1415,10,14690
685,2019-10-09,727,23775,1391,10,25903
685,2019-10-10,271,12592,987,12,13862
685,2019-10-11,338,10378,1973,9,12698
685,2019-10-12,234,7849,1962,1,10046
685,2019-10-13,1119,8982,2046,0,12147
685,2019-10-14,225,6358,1711,2,8296
685,2019-10-15,1212,8632,1717,4,11565
685,2019-10-16,343,13749,937,2,15031
685,2019-10-17,1150,5582,2352,0,9084
685,2019-10-18,1123,9088,1709,1,11921
685,2019-10-19,350,6143,1875,0,8368
685,2019-10-20,370,2899,1111,3,4383
685,2019-10-21,305,11292,1501,2,13100
685,2019-10-22,284,6679,1532,0,8495
685,2019-10-23,244,8616,1740,0,10600
685,2019-10-24,280,13779,1789,0,15848
685,2019-10-25,274,15959,1449,2,17684
685,2019-10-26,374,16740,2930,1,20045
685,2019-10-27,1568,28015,2307,2,31892
685,2019-10-28,288,24554,1948,0,26790
685,2019-10-29,1252,29087,1365,3,31707
685,2019-10-30,262,21153,1940,3,23358
685,2019-10-31,357,12852,1813,0,15022
685,2019-11-01,228,26302,1529,1,28060
685,2019-11-02,220,19090,1653,0,20963
685,2019-11-03,641,24718,1157,0,26516
685,2019-11-04,1177,8216,1184,2,10579
685,2019-11-05,577,3341,2653,0,6571
685,2019-11-06,245,8034,1693,0,9972
685,2019-11-07,353,21286,2484,0,24123
685,2019-11-08,279,11923,2413,0,14615
685,2019-11-09,1162,8908,2747,0,12817
685,2019-11-10,258,14861,2089,0,17208
685,2019-11-11,269,9697,1766,0,11732
685,2019-11-12,262,13832,2984,0,17078
685,2019-11-13,277,12222,2063,0,14562
685,2019-11-14,303,9002,2136,0,11441
685,2019-11-15,245,4172,1992,0,6409
685,2019-11-16,288,2607,2414,0,5309
685,2019-11-17,377,4123,3978,0,8478
685,2019-11-18,274,3269,3248,0,6791
685,2019-11-19,352,5182,2476,2,8012
685,2019-11-20,279,1475,1973,0,3727
685,2019-11-21,1788,6098,2054,0,9940
685,2019-11-22,267,5538,1617,3,7425
685,2019-11-23,305,6139,1759,1,8204
685,2019-11-24,1190,6106,1215,2,8513
685,2019-11-25,801,10940,1676,0,13417
685,2019-11-26,1886,10614,1632,1,14133
685,2019-11-27,252,6769,1610,0,8631
685,2019-11-28,246,13383,660,0,14289
685,2019-11-29,152,901,6,0,1059
685,2019-08-10,409,336,269,0,1014
685,2019-08-11,380,517,254,1,1152
685,2019-08-12,323,429,54,0,806
685,2019-08-13,289,227,280,0,796
685,2019-08-14,352,634,291,0,1277
685,2019-08-15,289,535,44,0,868
685,2019-08-16,223,457,35,0,715
685,2019-08-17,300,1938,648,1,2887
685,2019-08-18,1065,2758,1470,0,5293
685,2019-08-19,681,3255,974,0,4910
685,2019-08-20,308,1875,899,0,3082
685,2019-08-21,314,1463,1088,1,2866
685,2019-08-22,991,15181,1185,0,17357
685,2019-08-23,326,9108,1718,1,11153
685,2019-08-24,297,3778,1531,0,5606
685,2019-08-25,309,18095,1605,4,20013
685,2019-08-26,1116,24931,1174,2,27223
685,2019-08-27,329,8988,2170,2,11489
685,2019-08-28,372,25299,1896,0,27567
685,2019-08-29,1518,16050,2673,1,20242
685,2019-08-30,249,4709,490,0,5448
685,2019-08-31,57,213,0,1,271
685,2019-09-01,81,575,93,1,750
685,2019-09-02,49,940,3,1,993
685,2019-09-03,137,3721,1349,0,5207
685,2019-09-04,293,11940,1956,1,14190
685,2019-09-05,289,9235,2013,1,11538
685,2019-09-06,1161,12132,1730,0,15023
685,2019-09-07,352,7580,1530,0,9462
685,2019-09-08,410,7168,2474,0,10052
685,2019-09-09,451,22648,1794,1,24894
685,2019-09-10,410,9303,1726,1,11440
685,2019-09-11,228,7013,2984,3,10228
685,2019-09-12,359,16211,1881,2,18453
685,2019-09-13,425,4139,2080,3,6647
685,2019-09-14,313,7045,2373,1,9732
685,2019-09-15,2123,11594,2379,2,16098
685,2019-09-16,257,12565,2360,4,15186
685,2019-09-17,255,12382,2160,6,14803
685,2019-09-18,473,19491,1295,9,21268
685,2019-09-19,1529,10183,1712,8,13432
685,2019-09-20,546,16656,1896,9,19107
685,2019-09-21,315,7344,2240,9,9908
685,2019-09-22,275,9683,1526,10,11494
685,2019-09-23,354,9508,2783,9,12654
685,2019-09-24,1366,9508,1950,11,12835
685,2019-09-25,204,10586,1650,11,12451
685,2019-09-26,211,11609,1272,10,13102
685,2019-09-27,223,8851,1877,1,10952
685,2019-09-28,228,15666,2211,3,18108
685,2019-09-29,156,15227,1843,1,17227
685,2019-09-30,138,16708,2139,3,18988
685,2019-10-01,1022,16652,2003,0,19677
685,2019-10-02,228,12610,1971,7,14816
685,2019-10-03,194,14820,1694,10,16718
685,2019-10-04,138,12667,1521,13,14339
685,2019-10-05,954,15110,1036,13,17113
685,2019-10-06,126,10282,2275,10,12693
685,2019-10-07,1081,7721,1565,11,10378
685,2019-10-08,178,13087,1415,10,14690
685,2019-10-09,727,23775,1391,10,25903
685,2019-10-10,271,12592,987,12,13862
685,2019-10-11,338,10378,1973,9,12698
685,2019-10-12,234,7849,1962,1,10046
685,2019-10-13,1119,8982,2046,0,12147
685,2019-10-14,225,6358,1711,2,8296
685,2019-10-15,1212,8632,1717,4,11565
685,2019-10-16,343,13749,937,2,15031
685,2019-10-17,1150,5582,2352,0,9084
685,2019-10-18,1123,9088,1709,1,11921
685,2019-10-19,350,6143,1875,0,8368
685,2019-10-20,370,2899,1111,3,4383
685,2019-10-21,305,11292,1501,2,13100
685,2019-10-22,284,6679,1532,0,8495
685,2019-10-23,244,8616,1740,0,10600
685,2019-10-24,280,13779,1789,0,15848
685,2019-10-25,274,15959,1449,2,17684
685,2019-10-26,374,16740,2930,1,20045
685,2019-10-27,1568,28015,2307,2,31892
685,2019-10-28,288,24554,1948,0,26790
685,2019-10-29,1252,29087,1365,3,31707
685,2019-10-30,262,21153,1940,3,23358
685,2019-10-31,357,12852,1813,0,15022
685,2019-11-01,228,26302,1529,1,28060
685,2019-11-02,220,19090,1653,0,20963
685,2019-11-03,641,24718,1157,0,26516
685,2019-11-04,1177,8216,1184,2,10579
685,2019-11-05,577,3341,2653,0,6571
685,2019-11-06,245,8034,1693,0,9972
685,2019-11-07,353,21286,2484,0,24123
685,2019-11-08,279,11923,2413,0,14615
685,2019-11-09,1162,8908,2747,0,12817
685,2019-11-10,258,14861,2089,0,17208
685,2019-11-11,269,9697,1766,0,11732
685,2019-11-12,262,13832,2984,0,17078
685,2019-11-13,277,12222,2063,0,14562
685,2019-11-14,303,9002,2136,0,11441
685,2019-11-15,245,4172,1992,0,6409
685,2019-11-16,288,2607,2414,0,5309
685,2019-11-17,377,4123,3978,0,8478
685,2019-11-18,274,3269,3248,0,6791
685,2019-11-19,352,5182,2476,2,8012
685,2019-11-20,279,1475,1973,0,3727
685,2019-11-21,1788,6098,2054,0,9940
685,2019-11-22,267,5538,1617,3,7425
685,2019-11-23,305,6139,1759,1,8204
685,2019-11-24,1190,6106,1215,2,8513
685,2019-11-25,801,10940,1676,0,13417
685,2019-11-26,1886,10614,1632,1,14133
685,2019-11-27,252,6769,1610,0,8631
685,2019-11-28,246,13383,660,0,14289
685,2019-11-29,152,901,6,0,1059
685,2019-08-09,2,0,38,0,40
685,2019-08-10,409,336,269,0,1014
685,2019-08-11,380,517,254,1,1152
685,2019-08-12,323,429,54,0,806
685,2019-08-13,289,227,280,0,796
685,2019-08-14,352,634,291,0,1277
685,2019-08-15,289,535,44,0,868
685,2019-08-16,223,457,35,0,715
685,2019-08-17,300,1938,648,1,2887
685,2019-08-18,1065,2758,1470,0,5293
685,2019-08-19,681,3255,974,0,4910
685,2019-08-20,308,1875,899,0,3082
685,2019-08-21,314,1463,1088,1,2866
685,2019-08-22,991,15181,1185,0,17357
685,2019-08-23,326,9108,1718,1,11153
685,2019-08-24,297,3778,1531,0,5606
685,2019-08-25,309,18095,1605,4,20013
685,2019-08-26,1116,24931,1174,2,27223
685,2019-08-27,329,8988,2170,2,11489
685,2019-08-28,372,25299,1896,0,27567
685,2019-08-29,1518,16050,2673,1,20242
685,2019-08-30,249,4709,490,0,5448
685,2019-08-31,57,213,0,1,271
685,2019-09-01,81,575,93,1,750
685,2019-09-02,49,940,3,1,993
685,2019-09-03,137,3721,1349,0,5207
685,2019-09-04,293,11940,1956,1,14190
685,2019-09-05,289,9235,2013,1,11538
685,2019-09-06,1161,12132,1730,0,15023
685,2019-09-07,352,7580,1530,0,9462
685,2019-09-08,410,7168,2474,0,10052
685,2019-09-09,451,22648,1794,1,24894
685,2019-09-10,410,9303,1726,1,11440
685,2019-09-11,228,7013,2984,3,10228
685,2019-09-12,359,16211,1881,2,18453
685,2019-09-13,425,4139,2080,3,6647
685,2019-09-14,313,7045,2373,1,9732
685,2019-09-15,2123,11594,2379,2,16098
685,2019-09-16,257,12565,2360,4,15186
685,2019-09-17,255,12382,2160,6,14803
685,2019-09-18,473,19491,1295,9,21268
685,2019-09-19,1529,10183,1712,8,13432
685,2019-09-20,546,16656,1896,9,19107
685,2019-09-21,315,7344,2240,9,9908
685,2019-09-22,275,9683,1526,10,11494
685,2019-09-23,354,9508,2783,9,12654
685,2019-09-24,1366,9508,1950,11,12835
685,2019-09-25,204,10586,1650,11,12451
685,2019-09-26,211,11609,1272,10,13102
685,2019-09-27,223,8851,1877,1,10952
685,2019-09-28,228,15666,2211,3,18108
685,2019-09-29,156,15227,1843,1,17227
685,2019-09-30,138,16708,2139,3,18988
685,2019-10-01,1022,16652,2003,0,19677
685,2019-10-02,228,12610,1971,7,14816
685,2019-10-03,194,14820,1694,10,16718
685,2019-10-04,138,12667,1521,13,14339
685,2019-10-05,954,15110,1036,13,17113
685,2019-10-06,126,10282,2275,10,12693
685,2019-10-07,1081,7721,1565,11,10378
685,2019-10-08,178,13087,1415,10,14690
685,2019-10-09,727,23775,1391,10,25903
685,2019-10-10,271,12592,987,12,13862
685,2019-10-11,338,10378,1973,9,12698
685,2019-10-12,234,7849,1962,1,10046
685,2019-10-13,1119,8982,2046,0,12147
685,2019-10-14,225,6358,1711,2,8296
685,2019-10-15,1212,8632,1717,4,11565
685,2019-10-16,343,13749,937,2,15031
685,2019-10-17,1150,5582,2352,0,9084
685,2019-10-18,1123,9088,1709,1,11921
685,2019-10-19,350,6143,1875,0,8368
685,2019-10-20,370,2899,1111,3,4383
685,2019-10-21,305,11292,1501,2,13100
685,2019-10-22,284,6679,1532,0,8495
685,2019-10-23,244,8616,1740,0,10600
685,2019-10-24,280,13779,1789,0,15848
685,2019-10-25,274,15959,1449,2,17684
685,2019-10-26,374,16740,2930,1,20045
685,2019-10-27,1568,28015,2307,2,31892
685,2019-10-28,288,24554,1948,0,26790
685,2019-10-29,1252,29087,1365,3,31707
685,2019-10-30,262,21153,1940,3,23358
685,2019-10-31,357,12852,1813,0,15022
685,2019-11-01,228,26302,1529,1,28060
685,2019-11-02,220,19090,1653,0,20963
685,2019-11-03,641,24718,1157,0,26516
685,2019-11-04,1177,8216,1184,2,10579
685,2019-11-05,577,3341,2653,0,6571
685,2019-11-06,245,8034,1693,0,9972
685,2019-11-07,353,21286,2484,0,24123
685,2019-11-08,279,11923,2413,0,14615
685,2019-11-09,1162,8908,2747,0,12817
685,2019-11-10,258,14861,2089,0,17208
685,2019-11-11,269,9697,1766,0,11732
685,2019-11-12,262,13832,2984,0,17078
685,2019-11-13,277,12222,2063,0,14562
685,2019-11-14,303,9002,2136,0,11441
685,2019-11-15,245,4172,1992,0,6409
685,2019-11-16,288,2607,2414,0,5309
685,2019-11-17,377,4123,3978,0,8478
685,2019-11-18,274,3269,3248,0,6791
685,2019-11-19,352,5182,2476,2,8012
685,2019-11-20,279,1475,1973,0,3727
685,2019-11-21,1788,6098,2054,0,9940
685,2019-11-22,267,5538,1617,3,7425
685,2019-11-23,305,6139,1759,1,8204
685,2019-11-24,1190,6106,1215,2,8513
685,2019-11-25,801,10940,1676,0,13417
685,2019-11-26,1886,10614,1632,1,14133
685,2019-11-27,252,6769,1610,0,8631
685,2019-11-28,246,13383,660,0,14289
685,2019-11-29,152,901,6,0,1059
685,2019-08-11,380,517,254,1,1152
685,2019-08-12,323,429,54,0,806
685,2019-08-13,289,227,280,0,796
685,2019-08-14,352,634,291,0,1277
685,2019-08-15,289,535,44,0,868
685,2019-08-16,223,457,35,0,715
685,2019-08-17,300,1938,648,1,2887
685,2019-08-18,1065,2758,1470,0,5293
685,2019-08-19,681,3255,974,0,4910
685,2019-08-20,308,1875,899,0,3082
685,2019-08-21,314,1463,1088,1,2866
685,2019-08-22,991,15181,1185,0,17357
685,2019-08-23,326,9108,1718,1,11153
685,2019-08-24,297,3778,1531,0,5606
685,2019-08-25,309,18095,1605,4,20013
685,2019-08-26,1116,24931,1174,2,27223
685,2019-08-27,329,8988,2170,2,11489
685,2019-08-28,372,25299,1896,0,27567
685,2019-08-29,1518,16050,2673,1,20242
685,2019-08-30,249,4709,490,0,5448
685,2019-08-31,57,213,0,1,271
685,2019-09-01,81,575,93,1,750
685,2019-09-02,49,940,3,1,993
685,2019-09-03,137,3721,1349,0,5207
685,2019-09-04,293,11940,1956,1,14190
685,2019-09-05,289,9235,2013,1,11538
685,2019-09-06,1161,12132,1730,0,15023
685,2019-09-07,352,7580,1530,0,9462
685,2019-09-08,410,7168,2474,0,10052
685,2019-09-09,451,22648,1794,1,24894
685,2019-09-10,410,9303,1726,1,11440
685,2019-09-11,228,7013,2984,3,10228
685,2019-09-12,359,16211,1881,2,18453
685,2019-09-13,425,4139,2080,3,6647
685,2019-09-14,313,7045,2373,1,9732
685,2019-09-15,2123,11594,2379,2,16098
685,2019-09-16,257,12565,2360,4,15186
685,2019-09-17,255,12382,2160,6,14803
685,2019-09-18,473,19491,1295,9,21268
685,2019-09-19,1529,10183,1712,8,13432
685,2019-09-20,546,16656,1896,9,19107
685,2019-09-21,315,7344,2240,9,9908
685,2019-09-22,275,9683,1526,10,11494
685,2019-09-23,354,9508,2783,9,12654
685,2019-09-24,1366,9508,1950,11,12835
685,2019-09-25,204,10586,1650,11,12451
685,2019-09-26,211,11609,1272,10,13102
685,2019-09-27,223,8851,1877,1,10952
685,2019-09-28,228,15666,2211,3,18108
685,2019-09-29,156,15227,1843,1,17227
685,2019-09-30,138,16708,2139,3,18988
685,2019-10-01,1022,16652,2003,0,19677
685,2019-10-02,228,12610,1971,7,14816
685,2019-10-03,194,14820,1694,10,16718
685,2019-10-04,138,12667,1521,13,14339
685,2019-10-05,954,15110,1036,13,17113
685,2019-10-06,126,10282,2275,10,12693
685,2019-10-07,1081,7721,1565,11,10378
685,2019-10-08,178,13087,1415,10,14690
685,2019-10-09,727,23775,1391,10,25903
685,2019-10-10,271,12592,987,12,13862
685,2019-10-11,338,10378,1973,9,12698
685,2019-10-12,234,7849,1962,1,10046
685,2019-10-13,1119,8982,2046,0,12147
685,2019-10-14,225,6358,1711,2,8296
685,2019-10-15,1212,8632,1717,4,11565
685,2019-10-16,343,13749,937,2,15031
685,2019-10-17,1150,5582,2352,0,9084
685,2019-10-18,1123,9088,1709,1,11921
685,2019-10-19,350,6143,1875,0,8368
685,2019-10-20,370,2899,1111,3,4383
685,2019-10-21,305,11292,1501,2,13100
685,2019-10-22,284,6679,1532,0,8495
685,2019-10-23,244,8616,1740,0,10600
685,2019-10-24,280,13779,1789,0,15848
685,2019-10-25,274,15959,1449,2,17684
685,2019-10-26,374,16740,2930,1,20045
685,2019-10-27,1568,28015,2307,2,31892
685,2019-10-28,288,24554,1948,0,26790
685,2019-10-29,1252,29087,1365,3,31707
685,2019-10-30,262,21153,1940,3,23358
685,2019-10-31,357,12852,1813,0,15022
685,2019-11-01,228,26302,1529,1,28060
685,2019-11-02,220,19090,1653,0,20963
685,2019-11-03,641,24718,1157,0,26516
685,2019-11-04,1177,8216,1184,2,10579
685,2019-11-05,577,3341,2653,0,6571
685,2019-11-06,245,8034,1693,0,9972
685,2019-11-07,353,21286,2484,0,24123
685,2019-11-08,279,11923,2413,0,14615
685,2019-11-09,1162,8908,2747,0,12817
685,2019-11-10,258,14861,2089,0,17208
685,2019-11-11,269,9697,1766,0,11732
685,2019-11-12,262,13832,2984,0,17078
685,2019-11-13,277,12222,2063,0,14562
685,2019-11-14,303,9002,2136,0,11441
685,2019-11-15,245,4172,1992,0,6409
685,2019-11-16,288,2607,2414,0,5309
685,2019-11-17,377,4123,3978,0,8478
685,2019-11-18,274,3269,3248,0,6791
685,2019-11-19,352,5182,2476,2,8012
685,2019-11-20,279,1475,1973,0,3727
685,2019-11-21,1788,6098,2054,0,9940
685,2019-11-22,267,5538,1617,3,7425
685,2019-11-23,305,6139,1759,1,8204
685,2019-11-24,1190,6106,1215,2,8513
685,2019-11-25,801,10940,1676,0,13417
685,2019-11-26,1886,10614,1632,1,14133
686,2019-08-11,2840,155,166,0,3161
686,2019-08-12,3795,285,47,0,4127
686,2019-08-13,3739,283,91,0,4113
686,2019-08-14,5160,466,24,0,5650
686,2019-08-15,6117,589,88,1,6795
686,2019-08-16,4572,352,384,0,5308
686,2019-08-17,5312,1725,881,0,7918
686,2019-08-18,6878,1840,1625,0,10343
686,2019-08-19,5801,3498,989,1,10289
686,2019-08-20,6129,1544,1158,0,8831
686,2019-08-21,6064,751,1152,2,7969
686,2019-08-22,6465,3441,1425,0,11331
686,2019-08-23,5251,1559,904,1,7715
686,2019-08-24,6446,11770,2372,0,20588
686,2019-08-25,6259,18011,1776,3,26049
686,2019-08-26,5458,24859,2403,0,32720
686,2019-08-27,6250,15860,2011,3,24124
686,2019-08-28,5665,17093,1968,0,24726
686,2019-08-29,7008,12347,1576,0,20931
686,2019-08-30,5306,3371,311,3,8991
686,2019-08-31,1131,49,9,3,1192
686,2019-09-01,1439,230,291,3,1963
686,2019-09-02,1224,887,145,3,2259
686,2019-09-03,2004,4222,1030,1,7257
686,2019-09-04,3011,9091,2537,1,14640
686,2019-09-05,4716,6740,2207,1,13664
686,2019-09-06,4034,15935,2226,0,22195
686,2019-09-07,3595,13226,2107,0,18928
686,2019-09-08,3074,6626,1474,0,11174
686,2019-09-09,4099,6304,1798,0,12201
686,2019-09-10,4117,10928,2151,1,17197
686,2019-09-11,5000,6578,1299,1,12878
686,2019-09-12,3248,9231,2573,3,15055
686,2019-09-13,3195,6229,1718,0,11142
686,2019-09-14,3421,6513,2365,1,12300
686,2019-09-15,3223,10335,2565,1,16124
686,2019-09-16,7205,9385,1689,1,18280
686,2019-09-17,5261,11200,2177,24,18662
686,2019-09-18,3879,11781,1143,1,16804
686,2019-09-19,3924,4839,1700,1,10464
686,2019-09-20,4272,9479,1276,0,15027
686,2019-09-21,4111,6691,2036,3,12841
686,2019-09-22,3646,9320,1622,0,14588
686,2019-09-23,4921,9254,1732,0,15907
686,2019-09-24,4104,9349,1169,2,14624
686,2019-09-25,4069,10273,1613,1,15956
686,2019-09-26,4974,9056,1243,3,15276
686,2019-09-27,4455,11614,1586,1,17656
686,2019-09-28,3889,16299,1685,953,22826
686,2019-09-29,3833,14742,2088,2,20665
686,2019-09-30,2893,17755,1297,1,21946
686,2019-10-01,4189,16629,2148,1,22967
686,2019-10-02,3183,12826,1632,0,17641
686,2019-10-03,3367,14441,1475,0,19283
686,2019-10-04,3384,12038,1669,8,17099
686,2019-10-05,4175,14851,1263,1,20290
686,2019-10-06,3680,9821,2621,1,16123
686,2019-10-07,2773,6405,1904,1,11083
686,2019-10-08,2887,12616,1523,1,17027
686,2019-10-09,2690,31877,1807,0,36374
686,2019-10-10,2654,13616,1854,3,18127
686,2019-10-11,3311,10411,1775,3,15500
686,2019-10-12,4020,7984,1453,0,13457
686,2019-10-13,3855,8966,1696,1,14518
686,2019-10-14,3719,14228,1516,0,19463
686,2019-10-15,4691,14605,1465,0,20761
686,2019-10-16,4583,18266,1295,2,24146
686,2019-10-17,3320,8498,1554,2,13374
686,2019-10-18,4425,8543,1610,2,14580
686,2019-10-19,3520,6369,1787,1,11677
686,2019-10-20,3382,4270,1719,0,9371
686,2019-10-21,3379,10612,1350,4,15345
686,2019-10-22,2933,6351,1702,1,10987
686,2019-10-23,2994,14360,1344,0,18698
686,2019-10-24,3020,25757,1554,0,30331
686,2019-10-25,2744,14902,2155,3,19804
686,2019-10-26,3243,13821,1196,0,18260
686,2019-10-27,2790,16275,1587,0,20652
686,2019-10-28,3476,14306,1521,1,19304
686,2019-10-29,2974,15540,855,1,19370
686,2019-10-30,4545,15656,1577,1,21779
686,2019-10-31,7043,19748,1552,2,28345
686,2019-11-01,6463,26927,883,0,34273
686,2019-11-02,5743,16726,1121,0,23590
686,2019-11-03,6268,36742,1218,0,44228
686,2019-11-04,6245,10887,1331,1,18464
686,2019-11-05,6176,3028,1657,0,10861
686,2019-11-06,5980,14567,721,2,21270
686,2019-11-07,6477,16428,1339,2,24246
686,2019-11-08,5471,15186,865,0,21522
686,2019-11-09,5335,15868,1458,1,22662
686,2019-11-10,4933,24829,2332,2,32096
686,2019-11-11,5023,16116,3268,2,24409
686,2019-11-12,4487,17791,3152,0,25430
686,2019-11-13,3551,13770,1732,3,19056
686,2019-11-14,3824,12875,1805,2,18506
686,2019-11-15,3744,4840,2296,3848,14728
686,2019-11-16,3279,4029,1999,0,9307
686,2019-11-17,3773,3823,2814,0,10410
686,2019-11-18,5730,3122,2893,0,11745
686,2019-11-19,7206,5220,2112,0,14538
686,2019-11-20,6196,1712,1809,0,9717
686,2019-11-21,4541,5443,1403,0,11387
686,2019-11-22,3869,8846,1240,0,13955
686,2019-11-23,3711,6667,1700,0,12078
686,2019-11-24,4025,7081,1467,0,12573
686,2019-11-25,4686,9795,1475,0,15956
686,2019-11-26,3669,5546,1299,0,10514
686,2019-11-27,3092,6149,1331,0,10572
686,2019-11-28,2878,8596,714,0,12188
686,2019-11-29,510,375,2,0,887
686,2019-08-11,2840,155,166,0,3161
686,2019-08-12,3795,285,47,0,4127
686,2019-08-13,3739,283,91,0,4113
686,2019-08-14,5160,466,24,0,5650
686,2019-08-15,6117,589,88,1,6795
686,2019-08-16,4572,352,384,0,5308
686,2019-08-17,5312,1725,881,0,7918
686,2019-08-18,6878,1840,1625,0,10343
686,2019-08-19,5801,3498,989,1,10289
686,2019-08-20,6129,1544,1158,0,8831
686,2019-08-21,6064,751,1152,2,7969
686,2019-08-22,6465,3441,1425,0,11331
686,2019-08-23,5251,1559,904,1,7715
686,2019-08-24,6446,11770,2372,0,20588
686,2019-08-25,6259,18011,1776,3,26049
686,2019-08-26,5458,24859,2403,0,32720
686,2019-08-27,6250,15860,2011,3,24124
686,2019-08-28,5665,17093,1968,0,24726
686,2019-08-29,7008,12347,1576,0,20931
686,2019-08-30,5306,3371,311,3,8991
686,2019-08-31,1131,49,9,3,1192
686,2019-09-01,1439,230,291,3,1963
686,2019-09-02,1224,887,145,3,2259
686,2019-09-03,2004,4222,1030,1,7257
686,2019-09-04,3011,9091,2537,1,14640
686,2019-09-05,4716,6740,2207,1,13664
686,2019-09-06,4034,15935,2226,0,22195
686,2019-09-07,3595,13226,2107,0,18928
686,2019-09-08,3074,6626,1474,0,11174
686,2019-09-09,4099,6304,1798,0,12201
686,2019-09-10,4117,10928,2151,1,17197
686,2019-09-11,5000,6578,1299,1,12878
686,2019-09-12,3248,9231,2573,3,15055
686,2019-09-13,3195,6229,1718,0,11142
686,2019-09-14,3421,6513,2365,1,12300
686,2019-09-15,3223,10335,2565,1,16124
686,2019-09-16,7205,9385,1689,1,18280
686,2019-09-17,5261,11200,2177,24,18662
686,2019-09-18,3879,11781,1143,1,16804
686,2019-09-19,3924,4839,1700,1,10464
686,2019-09-20,4272,9479,1276,0,15027
686,2019-09-21,4111,6691,2036,3,12841
686,2019-09-22,3646,9320,1622,0,14588
686,2019-09-23,4921,9254,1732,0,15907
686,2019-09-24,4104,9349,1169,2,14624
686,2019-09-25,4069,10273,1613,1,15956
686,2019-09-26,4974,9056,1243,3,15276
686,2019-09-27,4455,11614,1586,1,17656
686,2019-09-28,3889,16299,1685,953,22826
686,2019-09-29,3833,14742,2088,2,20665
686,2019-09-30,2893,17755,1297,1,21946
686,2019-10-01,4189,16629,2148,1,22967
686,2019-10-02,3183,12826,1632,0,17641
686,2019-10-03,3367,14441,1475,0,19283
686,2019-10-04,3384,12038,1669,8,17099
686,2019-10-05,4175,14851,1263,1,20290
686,2019-10-06,3680,9821,2621,1,16123
686,2019-10-07,2773,6405,1904,1,11083
686,2019-10-08,2887,12616,1523,1,17027
686,2019-10-09,2690,31877,1807,0,36374
686,2019-10-10,2654,13616,1854,3,18127
686,2019-10-11,3311,10411,1775,3,15500
686,2019-10-12,4020,7984,1453,0,13457
686,2019-10-13,3855,8966,1696,1,14518
686,2019-10-14,3719,14228,1516,0,19463
686,2019-10-15,4691,14605,1465,0,20761
686,2019-10-16,4583,18266,1295,2,24146
686,2019-10-17,3320,8498,1554,2,13374
686,2019-10-18,4425,8543,1610,2,14580
686,2019-10-19,3520,6369,1787,1,11677
686,2019-10-20,3382,4270,1719,0,9371
686,2019-10-21,3379,10612,1350,4,15345
686,2019-10-22,2933,6351,1702,1,10987
686,2019-10-23,2994,14360,1344,0,18698
686,2019-10-24,3020,25757,1554,0,30331
686,2019-10-25,2744,14902,2155,3,19804
686,2019-10-26,3243,13821,1196,0,18260
686,2019-10-27,2790,16275,1587,0,20652
686,2019-10-28,3476,14306,1521,1,19304
686,2019-10-29,2974,15540,855,1,19370
686,2019-10-30,4545,15656,1577,1,21779
686,2019-10-31,7043,19748,1552,2,28345
686,2019-11-01,6463,26927,883,0,34273
686,2019-11-02,5743,16726,1121,0,23590
686,2019-11-03,6268,36742,1218,0,44228
686,2019-11-04,6245,10887,1331,1,18464
686,2019-11-05,6176,3028,1657,0,10861
686,2019-11-06,5980,14567,721,2,21270
686,2019-11-07,6477,16428,1339,2,24246
686,2019-11-08,5471,15186,865,0,21522
686,2019-11-09,5335,15868,1458,1,22662
686,2019-11-10,4933,24829,2332,2,32096
686,2019-11-11,5023,16116,3268,2,24409
686,2019-11-12,4487,17791,3152,0,25430
686,2019-11-13,3551,13770,1732,3,19056
686,2019-11-14,3824,12875,1805,2,18506
686,2019-11-15,3744,4840,2296,3848,14728
686,2019-11-16,3279,4029,1999,0,9307
686,2019-11-17,3773,3823,2814,0,10410
686,2019-11-18,5730,3122,2893,0,11745
686,2019-11-19,7206,5220,2112,0,14538
686,2019-11-20,6196,1712,1809,0,9717
686,2019-11-21,4541,5443,1403,0,11387
686,2019-11-22,3869,8846,1240,0,13955
686,2019-11-23,3711,6667,1700,0,12078
686,2019-11-24,4025,7081,1467,0,12573
686,2019-11-25,4686,9795,1475,0,15956
686,2019-11-26,3669,5546,1299,0,10514
686,2019-11-27,3092,6149,1331,0,10572
686,2019-11-28,2878,8596,714,0,12188
686,2019-11-29,510,375,2,0,887
686,2019-08-10,0,0,40,0,40
686,2019-08-11,2840,155,166,0,3161
686,2019-08-12,3795,285,47,0,4127
686,2019-08-13,3739,283,91,0,4113
686,2019-08-14,5160,466,24,0,5650
686,2019-08-15,6117,589,88,1,6795
686,2019-08-16,4572,352,384,0,5308
686,2019-08-17,5312,1725,881,0,7918
686,2019-08-18,6878,1840,1625,0,10343
686,2019-08-19,5801,3498,989,1,10289
686,2019-08-20,6129,1544,1158,0,8831
686,2019-08-21,6064,751,1152,2,7969
686,2019-08-22,6465,3441,1425,0,11331
686,2019-08-23,5251,1559,904,1,7715
686,2019-08-24,6446,11770,2372,0,20588
686,2019-08-25,6259,18011,1776,3,26049
686,2019-08-26,5458,24859,2403,0,32720
686,2019-08-27,6250,15860,2011,3,24124
686,2019-08-28,5665,17093,1968,0,24726
686,2019-08-29,7008,12347,1576,0,20931
686,2019-08-30,5306,3371,311,3,8991
686,2019-08-31,1131,49,9,3,1192
686,2019-09-01,1439,230,291,3,1963
686,2019-09-02,1224,887,145,3,2259
686,2019-09-03,2004,4222,1030,1,7257
686,2019-09-04,3011,9091,2537,1,14640
686,2019-09-05,4716,6740,2207,1,13664
686,2019-09-06,4034,15935,2226,0,22195
686,2019-09-07,3595,13226,2107,0,18928
686,2019-09-08,3074,6626,1474,0,11174
686,2019-09-09,4099,6304,1798,0,12201
686,2019-09-10,4117,10928,2151,1,17197
686,2019-09-11,5000,6578,1299,1,12878
686,2019-09-12,3248,9231,2573,3,15055
686,2019-09-13,3195,6229,1718,0,11142
686,2019-09-14,3421,6513,2365,1,12300
686,2019-09-15,3223,10335,2565,1,16124
686,2019-09-16,7205,9385,1689,1,18280
686,2019-09-17,5261,11200,2177,24,18662
686,2019-09-18,3879,11781,1143,1,16804
686,2019-09-19,3924,4839,1700,1,10464
686,2019-09-20,4272,9479,1276,0,15027
686,2019-09-21,4111,6691,2036,3,12841
686,2019-09-22,3646,9320,1622,0,14588
686,2019-09-23,4921,9254,1732,0,15907
686,2019-09-24,4104,9349,1169,2,14624
686,2019-09-25,4069,10273,1613,1,15956
686,2019-09-26,4974,9056,1243,3,15276
686,2019-09-27,4455,11614,1586,1,17656
686,2019-09-28,3889,16299,1685,953,22826
686,2019-09-29,3833,14742,2088,2,20665
686,2019-09-30,2893,17755,1297,1,21946
686,2019-10-01,4189,16629,2148,1,22967
686,2019-10-02,3183,12826,1632,0,17641
686,2019-10-03,3367,14441,1475,0,19283
686,2019-10-04,3384,12038,1669,8,17099
686,2019-10-05,4175,14851,1263,1,20290
686,2019-10-06,3680,9821,2621,1,16123
686,2019-10-07,2773,6405,1904,1,11083
686,2019-10-08,2887,12616,1523,1,17027
686,2019-10-09,2690,31877,1807,0,36374
686,2019-10-10,2654,13616,1854,3,18127
686,2019-10-11,3311,10411,1775,3,15500
686,2019-10-12,4020,7984,1453,0,13457
686,2019-10-13,3855,8966,1696,1,14518
686,2019-10-14,3719,14228,1516,0,19463
686,2019-10-15,4691,14605,1465,0,20761
686,2019-10-16,4583,18266,1295,2,24146
686,2019-10-17,3320,8498,1554,2,13374
686,2019-10-18,4425,8543,1610,2,14580
686,2019-10-19,3520,6369,1787,1,11677
686,2019-10-20,3382,4270,1719,0,9371
686,2019-10-21,3379,10612,1350,4,15345
686,2019-10-22,2933,6351,1702,1,10987
686,2019-10-23,2994,14360,1344,0,18698
686,2019-10-24,3020,25757,1554,0,30331
686,2019-10-25,2744,14902,2155,3,19804
686,2019-10-26,3243,13821,1196,0,18260
686,2019-10-27,2790,16275,1587,0,20652
686,2019-10-28,3476,14306,1521,1,19304
686,2019-10-29,2974,15540,855,1,19370
686,2019-10-30,4545,15656,1577,1,21779
686,2019-10-31,7043,19748,1552,2,28345
686,2019-11-01,6463,26927,883,0,34273
686,2019-11-02,5743,16726,1121,0,23590
686,2019-11-03,6268,36742,1218,0,44228
686,2019-11-04,6245,10887,1331,1,18464
686,2019-11-05,6176,3028,1657,0,10861
686,2019-11-06,5980,14567,721,2,21270
686,2019-11-07,6477,16428,1339,2,24246
686,2019-11-08,5471,15186,865,0,21522
686,2019-11-09,5335,15868,1458,1,22662
686,2019-11-10,4933,24829,2332,2,32096
686,2019-11-11,5023,16116,3268,2,24409
686,2019-11-12,4487,17791,3152,0,25430
686,2019-11-13,3551,13770,1732,3,19056
686,2019-11-14,3824,12875,1805,2,18506
686,2019-11-15,3744,4840,2296,3848,14728
686,2019-11-16,3279,4029,1999,0,9307
686,2019-11-17,3773,3823,2814,0,10410
686,2019-11-18,5730,3122,2893,0,11745
686,2019-11-19,7206,5220,2112,0,14538
686,2019-11-20,6196,1712,1809,0,9717
686,2019-11-21,4541,5443,1403,0,11387
686,2019-11-22,3869,8846,1240,0,13955
686,2019-11-23,3711,6667,1700,0,12078
686,2019-11-24,4025,7081,1467,0,12573
686,2019-11-25,4686,9795,1475,0,15956
686,2019-11-26,3669,5546,1299,0,10514
686,2019-11-27,3092,6149,1331,0,10572
686,2019-11-28,2878,8596,714,0,12188
686,2019-11-29,510,375,2,0,887
686,2019-08-15,6117,589,88,1,6795
686,2019-08-16,4572,352,384,0,5308
686,2019-08-17,5312,1725,881,0,7918
686,2019-08-18,6878,1840,1625,0,10343
686,2019-08-19,5801,3498,989,1,10289
686,2019-08-20,6129,1544,1158,0,8831
686,2019-08-21,6064,751,1152,2,7969
686,2019-08-22,6465,3441,1425,0,11331
686,2019-08-23,5251,1559,904,1,7715
686,2019-08-24,6446,11770,2372,0,20588
686,2019-08-25,6259,18011,1776,3,26049
686,2019-08-26,5458,24859,2403,0,32720
686,2019-08-27,6250,15860,2011,3,24124
686,2019-08-28,5665,17093,1968,0,24726
686,2019-08-29,7008,12347,1576,0,20931
686,2019-08-30,5306,3371,311,3,8991
686,2019-08-31,1131,49,9,3,1192
686,2019-09-01,1439,230,291,3,1963
686,2019-09-02,1224,887,145,3,2259
686,2019-09-03,2004,4222,1030,1,7257
686,2019-09-04,3011,9091,2537,1,14640
686,2019-09-05,4716,6740,2207,1,13664
686,2019-09-06,4034,15935,2226,0,22195
686,2019-09-07,3595,13226,2107,0,18928
686,2019-09-08,3074,6626,1474,0,11174
686,2019-09-09,4099,6304,1798,0,12201
686,2019-09-10,4117,10928,2151,1,17197
686,2019-09-11,5000,6578,1299,1,12878
686,2019-09-12,3248,9231,2573,3,15055
686,2019-09-13,3195,6229,1718,0,11142
686,2019-09-14,3421,6513,2365,1,12300
686,2019-09-15,3223,10335,2565,1,16124
686,2019-09-16,7205,9385,1689,1,18280
686,2019-09-17,5261,11200,2177,24,18662
686,2019-09-18,3879,11781,1143,1,16804
686,2019-09-19,3924,4839,1700,1,10464
686,2019-09-20,4272,9479,1276,0,15027
686,2019-09-21,4111,6691,2036,3,12841
686,2019-09-22,3646,9320,1622,0,14588
686,2019-09-23,4921,9254,1732,0,15907
686,2019-09-24,4104,9349,1169,2,14624
686,2019-09-25,4069,10273,1613,1,15956
686,2019-09-26,4974,9056,1243,3,15276
686,2019-09-27,4455,11614,1586,1,17656
686,2019-09-28,3889,16299,1685,953,22826
686,2019-09-29,3833,14742,2088,2,20665
686,2019-09-30,2893,17755,1297,1,21946
686,2019-10-01,4189,16629,2148,1,22967
686,2019-10-02,3183,12826,1632,0,17641
686,2019-10-03,3367,14441,1475,0,19283
686,2019-10-04,3384,12038,1669,8,17099
686,2019-10-05,4175,14851,1263,1,20290
686,2019-10-06,3680,9821,2621,1,16123
686,2019-10-07,2773,6405,1904,1,11083
686,2019-10-08,2887,12616,1523,1,17027
686,2019-10-09,2690,31877,1807,0,36374
686,2019-10-10,2654,13616,1854,3,18127
686,2019-10-11,3311,10411,1775,3,15500
686,2019-10-12,4020,7984,1453,0,13457
686,2019-10-13,3855,8966,1696,1,14518
686,2019-10-14,3719,14228,1516,0,19463
686,2019-10-15,4691,14605,1465,0,20761
686,2019-10-16,4583,18266,1295,2,24146
686,2019-10-17,3320,8498,1554,2,13374
686,2019-10-18,4425,8543,1610,2,14580
686,2019-10-19,3520,6369,1787,1,11677
686,2019-10-20,3382,4270,1719,0,9371
686,2019-10-21,3379,10612,1350,4,15345
686,2019-10-22,2933,6351,1702,1,10987
686,2019-10-23,2994,14360,1344,0,18698
686,2019-10-24,3020,25757,1554,0,30331
686,2019-10-25,2744,14902,2155,3,19804
686,2019-10-26,3243,13821,1196,0,18260
686,2019-10-27,2790,16275,1587,0,20652
686,2019-10-28,3476,14306,1521,1,19304
686,2019-10-29,2974,15540,855,1,19370
686,2019-10-30,4545,15656,1577,1,21779
686,2019-10-31,7043,19748,1552,2,28345
686,2019-11-01,6463,26927,883,0,34273
686,2019-11-02,5743,16726,1121,0,23590
686,2019-11-03,6268,36742,1218,0,44228
686,2019-11-04,6245,10887,1331,1,18464
686,2019-11-05,6176,3028,1657,0,10861
686,2019-11-06,5980,14567,721,2,21270
686,2019-11-07,6477,16428,1339,2,24246
686,2019-11-08,5471,15186,865,0,21522
686,2019-11-09,5335,15868,1458,1,22662
686,2019-11-10,4933,24829,2332,2,32096
686,2019-11-11,5023,16116,3268,2,24409
686,2019-11-12,4487,17791,3152,0,25430
686,2019-11-13,3551,13770,1732,3,19056
686,2019-11-14,3824,12875,1805,2,18506
686,2019-11-15,3744,4840,2296,3848,14728
687,2019-08-11,413,240,108,0,761
687,2019-08-12,251,364,212,1,828
687,2019-08-13,228,520,130,0,878
687,2019-08-14,168,543,32,0,743
687,2019-08-15,133,326,29,0,488
687,2019-08-16,225,247,88,1,561
687,2019-08-17,115,1367,554,0,2036
687,2019-08-18,346,1723,1097,426,3592
687,2019-08-19,339,8791,1835,1,10966
687,2019-08-20,185,4809,708,0,5702
687,2019-08-21,121,8041,1518,0,9680
687,2019-08-22,1004,16358,1405,2,18769
687,2019-08-23,121,14333,1164,462,16080
687,2019-08-24,264,13533,1274,1,15072
687,2019-08-25,940,28453,1788,1,31182
687,2019-08-26,219,37406,1465,1,39091
687,2019-08-27,183,16125,1712,2,18022
687,2019-08-28,454,18385,1618,2,20459
687,2019-08-29,602,12601,1621,1,14825
687,2019-08-30,542,2786,738,89,4155
687,2019-08-31,317,9287,4,0,9608
687,2019-09-01,478,3050,271,0,3799
687,2019-09-02,301,153,6,0,460
687,2019-09-03,410,3663,1188,0,5261
687,2019-09-04,2077,10263,2561,2,14903
687,2019-09-05,483,7334,2459,0,10276
687,2019-09-06,822,13175,2231,0,16228
687,2019-09-07,328,6609,1803,0,8740
687,2019-09-08,1371,5147,1995,77,8590
687,2019-09-09,1236,11014,1643,1,13894
687,2019-09-10,256,6838,1680,0,8774
687,2019-09-11,421,6602,1736,2,8761
687,2019-09-12,580,6382,1533,2,8497
687,2019-09-13,477,3024,2286,2,5789
687,2019-09-14,468,6269,2561,0,9298
687,2019-09-15,402,7800,2691,1,10894
687,2019-09-16,339,18510,1650,1,20500
687,2019-09-17,1283,6460,2187,1,9931
687,2019-09-18,312,11489,1163,0,12964
687,2019-09-19,599,3691,2188,1,6479
687,2019-09-20,279,7519,2328,1,10127
687,2019-09-21,1890,5479,2228,1,9598
687,2019-09-22,135,8951,1801,62,10949
687,2019-09-23,258,7524,1705,2,9489
687,2019-09-24,260,6705,2391,2,9358
687,2019-09-25,1227,6560,1846,0,9633
687,2019-09-26,204,8800,1982,0,10986
687,2019-09-27,268,8348,2096,4,10716
687,2019-09-28,178,14276,1124,2,15580
687,2019-09-29,142,12872,2198,0,15212
687,2019-09-30,1269,15203,1341,1,17814
687,2019-10-01,1045,16118,831,2,17996
687,2019-10-02,428,11770,2635,0,14833
687,2019-10-03,150,12761,1689,0,14600
687,2019-10-04,189,11004,1273,81,12547
687,2019-10-05,1502,14497,1485,46,17530
687,2019-10-06,137,8532,2054,73,10796
687,2019-10-07,100,4395,1898,4,6397
687,2019-10-08,7002,10951,1194,1,19148
687,2019-10-09,14063,12780,1305,1,28149
687,2019-10-10,1051,8893,2082,58,12084
687,2019-10-11,1843,18213,1048,0,21104
687,2019-10-12,242,7949,2537,103,10831
687,2019-10-13,291,9217,2515,2,12025
687,2019-10-14,1090,4266,2828,0,8184
687,2019-10-15,2749,7009,1735,0,11493
687,2019-10-16,1858,17482,1641,1,20982
687,2019-10-17,428,6851,1040,3,8322
687,2019-10-18,431,6732,1451,2,8616
687,2019-10-19,295,3815,2330,0,6440
687,2019-10-20,257,831,1656,2,2746
687,2019-10-21,767,9108,1694,1,11570
687,2019-10-22,443,4759,1744,2,6948
687,2019-10-23,838,6706,1496,1,9041
687,2019-10-24,832,12559,938,0,14329
687,2019-10-25,424,9778,1375,316,11893
687,2019-10-26,560,20273,1311,0,22144
687,2019-10-27,198,17669,1184,452,19503
687,2019-10-28,330,15545,1832,2,17709
687,2019-10-29,502,14603,1450,1,16556
687,2019-10-30,399,14475,1807,437,17118
687,2019-10-31,243,10930,1681,1,12855
687,2019-11-01,282,24673,889,3,25847
687,2019-11-02,373,24705,1188,0,26266
687,2019-11-03,1296,36878,821,1,38996
687,2019-11-04,220,9208,1536,1,10965
687,2019-11-05,431,1551,1861,0,3843
687,2019-11-06,433,13281,1288,1,15003
687,2019-11-07,975,24759,559,4,26297
687,2019-11-08,392,10920,948,1,12261
687,2019-11-09,262,12038,1939,1,14240
687,2019-11-10,165,12789,1591,2,14547
687,2019-11-11,344,8112,1777,3,10236
687,2019-11-12,547,8969,2682,28,12226
687,2019-11-13,207,12471,1703,2,14383
687,2019-11-14,171,12104,1567,0,13842
687,2019-11-15,185,2973,3022,3,6183
687,2019-11-16,1040,876,1608,2,3526
687,2019-11-17,252,1991,2987,1064,6294
687,2019-11-18,157,1968,2213,880,5218
687,2019-11-19,236,2583,2170,0,4989
687,2019-11-20,1016,804,2188,1,4009
687,2019-11-21,253,4617,1749,3,6622
687,2019-11-22,232,4966,1371,29,6598
687,2019-11-23,263,8744,2681,0,11688
687,2019-11-24,292,7529,1712,0,9533
687,2019-11-25,230,9198,1260,0,10688
687,2019-11-26,388,3615,1151,3,5157
687,2019-11-27,532,8749,1844,5,11130
687,2019-11-28,382,8272,535,19,9208
687,2019-11-29,106,176,1,0,283
687,2019-08-11,413,240,108,0,761
687,2019-08-12,251,364,212,1,828
687,2019-08-13,228,520,130,0,878
687,2019-08-14,168,543,32,0,743
687,2019-08-15,133,326,29,0,488
687,2019-08-16,225,247,88,1,561
687,2019-08-17,115,1367,554,0,2036
687,2019-08-18,346,1723,1097,426,3592
687,2019-08-19,339,8791,1835,1,10966
687,2019-08-20,185,4809,708,0,5702
687,2019-08-21,121,8041,1518,0,9680
687,2019-08-22,1004,16358,1405,2,18769
687,2019-08-23,121,14333,1164,462,16080
687,2019-08-24,264,13533,1274,1,15072
687,2019-08-25,940,28453,1788,1,31182
687,2019-08-26,219,37406,1465,1,39091
687,2019-08-27,183,16125,1712,2,18022
687,2019-08-28,454,18385,1618,2,20459
687,2019-08-29,602,12601,1621,1,14825
687,2019-08-30,542,2786,738,89,4155
687,2019-08-31,317,9287,4,0,9608
687,2019-09-01,478,3050,271,0,3799
687,2019-09-02,301,153,6,0,460
687,2019-09-03,410,3663,1188,0,5261
687,2019-09-04,2077,10263,2561,2,14903
687,2019-09-05,483,7334,2459,0,10276
687,2019-09-06,822,13175,2231,0,16228
687,2019-09-07,328,6609,1803,0,8740
687,2019-09-08,1371,5147,1995,77,8590
687,2019-09-09,1236,11014,1643,1,13894
687,2019-09-10,256,6838,1680,0,8774
687,2019-09-11,421,6602,1736,2,8761
687,2019-09-12,580,6382,1533,2,8497
687,2019-09-13,477,3024,2286,2,5789
687,2019-09-14,468,6269,2561,0,9298
687,2019-09-15,402,7800,2691,1,10894
687,2019-09-16,339,18510,1650,1,20500
687,2019-09-17,1283,6460,2187,1,9931
687,2019-09-18,312,11489,1163,0,12964
687,2019-09-19,599,3691,2188,1,6479
687,2019-09-20,279,7519,2328,1,10127
687,2019-09-21,1890,5479,2228,1,9598
687,2019-09-22,135,8951,1801,62,10949
687,2019-09-23,258,7524,1705,2,9489
687,2019-09-24,260,6705,2391,2,9358
687,2019-09-25,1227,6560,1846,0,9633
687,2019-09-26,204,8800,1982,0,10986
687,2019-09-27,268,8348,2096,4,10716
687,2019-09-28,178,14276,1124,2,15580
687,2019-09-29,142,12872,2198,0,15212
687,2019-09-30,1269,15203,1341,1,17814
687,2019-10-01,1045,16118,831,2,17996
687,2019-10-02,428,11770,2635,0,14833
687,2019-10-03,150,12761,1689,0,14600
687,2019-10-04,189,11004,1273,81,12547
687,2019-10-05,1502,14497,1485,46,17530
687,2019-10-06,137,8532,2054,73,10796
687,2019-10-07,100,4395,1898,4,6397
687,2019-10-08,7002,10951,1194,1,19148
687,2019-10-09,14063,12780,1305,1,28149
687,2019-10-10,1051,8893,2082,58,12084
687,2019-10-11,1843,18213,1048,0,21104
687,2019-10-12,242,7949,2537,103,10831
687,2019-10-13,291,9217,2515,2,12025
687,2019-10-14,1090,4266,2828,0,8184
687,2019-10-15,2749,7009,1735,0,11493
687,2019-10-16,1858,17482,1641,1,20982
687,2019-10-17,428,6851,1040,3,8322
687,2019-10-18,431,6732,1451,2,8616
687,2019-10-19,295,3815,2330,0,6440
687,2019-10-20,257,831,1656,2,2746
687,2019-10-21,767,9108,1694,1,11570
687,2019-10-22,443,4759,1744,2,6948
687,2019-10-23,838,6706,1496,1,9041
687,2019-10-24,832,12559,938,0,14329
687,2019-10-25,424,9778,1375,316,11893
687,2019-10-26,560,20273,1311,0,22144
687,2019-10-27,198,17669,1184,452,19503
687,2019-10-28,330,15545,1832,2,17709
687,2019-10-29,502,14603,1450,1,16556
687,2019-10-30,399,14475,1807,437,17118
687,2019-10-31,243,10930,1681,1,12855
687,2019-11-01,282,24673,889,3,25847
687,2019-11-02,373,24705,1188,0,26266
687,2019-11-03,1296,36878,821,1,38996
687,2019-11-04,220,9208,1536,1,10965
687,2019-11-05,431,1551,1861,0,3843
687,2019-11-06,433,13281,1288,1,15003
687,2019-11-07,975,24759,559,4,26297
687,2019-11-08,392,10920,948,1,12261
687,2019-11-09,262,12038,1939,1,14240
687,2019-11-10,165,12789,1591,2,14547
687,2019-11-11,344,8112,1777,3,10236
687,2019-11-12,547,8969,2682,28,12226
687,2019-11-13,207,12471,1703,2,14383
687,2019-11-14,171,12104,1567,0,13842
687,2019-11-15,185,2973,3022,3,6183
687,2019-11-16,1040,876,1608,2,3526
687,2019-11-17,252,1991,2987,1064,6294
687,2019-11-18,157,1968,2213,880,5218
687,2019-11-19,236,2583,2170,0,4989
687,2019-11-20,1016,804,2188,1,4009
687,2019-11-21,253,4617,1749,3,6622
687,2019-11-22,232,4966,1371,29,6598
687,2019-11-23,263,8744,2681,0,11688
687,2019-11-24,292,7529,1712,0,9533
687,2019-11-25,230,9198,1260,0,10688
687,2019-11-26,388,3615,1151,3,5157
687,2019-11-27,532,8749,1844,5,11130
687,2019-11-28,382,8272,535,19,9208
687,2019-11-29,106,176,1,0,283
687,2019-08-10,0,0,33,0,33
687,2019-08-11,413,240,108,0,761
687,2019-08-12,251,364,212,1,828
687,2019-08-13,228,520,130,0,878
687,2019-08-14,168,543,32,0,743
687,2019-08-15,133,326,29,0,488
687,2019-08-16,225,247,88,1,561
687,2019-08-17,115,1367,554,0,2036
687,2019-08-18,346,1723,1097,426,3592
687,2019-08-19,339,8791,1835,1,10966
687,2019-08-20,185,4809,708,0,5702
687,2019-08-21,121,8041,1518,0,9680
687,2019-08-22,1004,16358,1405,2,18769
687,2019-08-23,121,14333,1164,462,16080
687,2019-08-24,264,13533,1274,1,15072
687,2019-08-25,940,28453,1788,1,31182
687,2019-08-26,219,37406,1465,1,39091
687,2019-08-27,183,16125,1712,2,18022
687,2019-08-28,454,18385,1618,2,20459
687,2019-08-29,602,12601,1621,1,14825
687,2019-08-30,542,2786,738,89,4155
687,2019-08-31,317,9287,4,0,9608
687,2019-09-01,478,3050,271,0,3799
687,2019-09-02,301,153,6,0,460
687,2019-09-03,410,3663,1188,0,5261
687,2019-09-04,2077,10263,2561,2,14903
687,2019-09-05,483,7334,2459,0,10276
687,2019-09-06,822,13175,2231,0,16228
687,2019-09-07,328,6609,1803,0,8740
687,2019-09-08,1371,5147,1995,77,8590
687,2019-09-09,1236,11014,1643,1,13894
687,2019-09-10,256,6838,1680,0,8774
687,2019-09-11,421,6602,1736,2,8761
687,2019-09-12,580,6382,1533,2,8497
687,2019-09-13,477,3024,2286,2,5789
687,2019-09-14,468,6269,2561,0,9298
687,2019-09-15,402,7800,2691,1,10894
687,2019-09-16,339,18510,1650,1,20500
687,2019-09-17,1283,6460,2187,1,9931
687,2019-09-18,312,11489,1163,0,12964
687,2019-09-19,599,3691,2188,1,6479
687,2019-09-20,279,7519,2328,1,10127
687,2019-09-21,1890,5479,2228,1,9598
687,2019-09-22,135,8951,1801,62,10949
687,2019-09-23,258,7524,1705,2,9489
687,2019-09-24,260,6705,2391,2,9358
687,2019-09-25,1227,6560,1846,0,9633
687,2019-09-26,204,8800,1982,0,10986
687,2019-09-27,268,8348,2096,4,10716
687,2019-09-28,178,14276,1124,2,15580
687,2019-09-29,142,12872,2198,0,15212
687,2019-09-30,1269,15203,1341,1,17814
687,2019-10-01,1045,16118,831,2,17996
687,2019-10-02,428,11770,2635,0,14833
687,2019-10-03,150,12761,1689,0,14600
687,2019-10-04,189,11004,1273,81,12547
687,2019-10-05,1502,14497,1485,46,17530
687,2019-10-06,137,8532,2054,73,10796
687,2019-10-07,100,4395,1898,4,6397
687,2019-10-08,7002,10951,1194,1,19148
687,2019-10-09,14063,12780,1305,1,28149
687,2019-10-10,1051,8893,2082,58,12084
687,2019-10-11,1843,18213,1048,0,21104
687,2019-10-12,242,7949,2537,103,10831
687,2019-10-13,291,9217,2515,2,12025
687,2019-10-14,1090,4266,2828,0,8184
687,2019-10-15,2749,7009,1735,0,11493
687,2019-10-16,1858,17482,1641,1,20982
687,2019-10-17,428,6851,1040,3,8322
687,2019-10-18,431,6732,1451,2,8616
687,2019-10-19,295,3815,2330,0,6440
687,2019-10-20,257,831,1656,2,2746
687,2019-10-21,767,9108,1694,1,11570
687,2019-10-22,443,4759,1744,2,6948
687,2019-10-23,838,6706,1496,1,9041
687,2019-10-24,832,12559,938,0,14329
687,2019-10-25,424,9778,1375,316,11893
687,2019-10-26,560,20273,1311,0,22144
687,2019-10-27,198,17669,1184,452,19503
687,2019-10-28,330,15545,1832,2,17709
687,2019-10-29,502,14603,1450,1,16556
687,2019-10-30,399,14475,1807,437,17118
687,2019-10-31,243,10930,1681,1,12855
687,2019-11-01,282,24673,889,3,25847
687,2019-11-02,373,24705,1188,0,26266
687,2019-11-03,1296,36878,821,1,38996
687,2019-11-04,220,9208,1536,1,10965
687,2019-11-05,431,1551,1861,0,3843
687,2019-11-06,433,13281,1288,1,15003
687,2019-11-07,975,24759,559,4,26297
687,2019-11-08,392,10920,948,1,12261
687,2019-11-09,262,12038,1939,1,14240
687,2019-11-10,165,12789,1591,2,14547
687,2019-11-11,344,8112,1777,3,10236
687,2019-11-12,547,8969,2682,28,12226
687,2019-11-13,207,12471,1703,2,14383
687,2019-11-14,171,12104,1567,0,13842
687,2019-11-15,185,2973,3022,3,6183
687,2019-11-16,1040,876,1608,2,3526
687,2019-11-17,252,1991,2987,1064,6294
687,2019-11-18,157,1968,2213,880,5218
687,2019-11-19,236,2583,2170,0,4989
687,2019-11-20,1016,804,2188,1,4009
687,2019-11-21,253,4617,1749,3,6622
687,2019-11-22,232,4966,1371,29,6598
687,2019-11-23,263,8744,2681,0,11688
687,2019-11-24,292,7529,1712,0,9533
687,2019-11-25,230,9198,1260,0,10688
687,2019-11-26,388,3615,1151,3,5157
687,2019-11-27,532,8749,1844,5,11130
687,2019-11-28,382,8272,535,19,9208
687,2019-11-29,106,176,1,0,283
687,2019-08-12,251,364,212,1,828
687,2019-08-13,228,520,130,0,878
687,2019-08-14,168,543,32,0,743
687,2019-08-15,133,326,29,0,488
687,2019-08-16,225,247,88,1,561
687,2019-08-17,115,1367,554,0,2036
687,2019-08-18,346,1723,1097,426,3592
687,2019-08-19,339,8791,1835,1,10966
687,2019-08-20,185,4809,708,0,5702
687,2019-08-21,121,8041,1518,0,9680
687,2019-08-22,1004,16358,1405,2,18769
687,2019-08-23,121,14333,1164,462,16080
687,2019-08-24,264,13533,1274,1,15072
687,2019-08-25,940,28453,1788,1,31182
687,2019-08-26,219,37406,1465,1,39091
687,2019-08-27,183,16125,1712,2,18022
687,2019-08-28,454,18385,1618,2,20459
687,2019-08-29,602,12601,1621,1,14825
687,2019-08-30,542,2786,738,89,4155
687,2019-08-31,317,9287,4,0,9608
687,2019-09-01,478,3050,271,0,3799
687,2019-09-02,301,153,6,0,460
687,2019-09-03,410,3663,1188,0,5261
687,2019-09-04,2077,10263,2561,2,14903
687,2019-09-05,483,7334,2459,0,10276
687,2019-09-06,822,13175,2231,0,16228
687,2019-09-07,328,6609,1803,0,8740
687,2019-09-08,1371,5147,1995,77,8590
687,2019-09-09,1236,11014,1643,1,13894
687,2019-09-10,256,6838,1680,0,8774
687,2019-09-11,421,6602,1736,2,8761
687,2019-09-12,580,6382,1533,2,8497
687,2019-09-13,477,3024,2286,2,5789
687,2019-09-14,468,6269,2561,0,9298
687,2019-09-15,402,7800,2691,1,10894
687,2019-09-16,339,18510,1650,1,20500
687,2019-09-17,1283,6460,2187,1,9931
687,2019-09-18,312,11489,1163,0,12964
687,2019-09-19,599,3691,2188,1,6479
687,2019-09-20,279,7519,2328,1,10127
687,2019-09-21,1890,5479,2228,1,9598
687,2019-09-22,135,8951,1801,62,10949
687,2019-09-23,258,7524,1705,2,9489
687,2019-09-24,260,6705,2391,2,9358
687,2019-09-25,1227,6560,1846,0,9633
687,2019-09-26,204,8800,1982,0,10986
687,2019-09-27,268,8348,2096,4,10716
687,2019-09-28,178,14276,1124,2,15580
687,2019-09-29,142,12872,2198,0,15212
687,2019-09-30,1269,15203,1341,1,17814
687,2019-10-01,1045,16118,831,2,17996
687,2019-10-02,428,11770,2635,0,14833
687,2019-10-03,150,12761,1689,0,14600
687,2019-10-04,189,11004,1273,81,12547
687,2019-10-05,1502,14497,1485,46,17530
687,2019-10-06,137,8532,2054,73,10796
687,2019-10-07,100,4395,1898,4,6397
687,2019-10-08,7002,10951,1194,1,19148
687,2019-10-09,14063,12780,1305,1,28149
687,2019-10-10,1051,8893,2082,58,12084
687,2019-10-11,1843,18213,1048,0,21104
687,2019-10-12,242,7949,2537,103,10831
687,2019-10-13,291,9217,2515,2,12025
687,2019-10-14,1090,4266,2828,0,8184
687,2019-10-15,2749,7009,1735,0,11493
687,2019-10-16,1858,17482,1641,1,20982
687,2019-10-17,428,6851,1040,3,8322
687,2019-10-18,431,6732,1451,2,8616
687,2019-10-19,295,3815,2330,0,6440
687,2019-10-20,257,831,1656,2,2746
687,2019-10-21,767,9108,1694,1,11570
687,2019-10-22,443,4759,1744,2,6948
687,2019-10-23,838,6706,1496,1,9041
687,2019-10-24,832,12559,938,0,14329
687,2019-10-25,424,9778,1375,316,11893
687,2019-10-26,560,20273,1311,0,22144
687,2019-10-27,198,17669,1184,452,19503
687,2019-10-28,330,15545,1832,2,17709
687,2019-10-29,502,14603,1450,1,16556
687,2019-10-30,399,14475,1807,437,17118
687,2019-10-31,243,10930,1681,1,12855
687,2019-11-01,282,24673,889,3,25847
687,2019-11-02,373,24705,1188,0,26266
687,2019-11-03,1296,36878,821,1,38996
687,2019-11-04,220,9208,1536,1,10965
687,2019-11-05,431,1551,1861,0,3843
687,2019-11-06,433,13281,1288,1,15003
687,2019-11-07,975,24759,559,4,26297
687,2019-11-08,392,10920,948,1,12261
687,2019-11-09,262,12038,1939,1,14240
687,2019-11-10,165,12789,1591,2,14547
687,2019-11-11,344,8112,1777,3,10236
687,2019-11-12,547,8969,2682,28,12226
687,2019-11-13,207,12471,1703,2,14383
687,2019-11-14,171,12104,1567,0,13842
687,2019-11-15,185,2973,3022,3,6183
687,2019-11-16,1040,876,1608,2,3526
687,2019-11-17,252,1991,2987,1064,6294
687,2019-11-18,157,1968,2213,880,5218
687,2019-11-19,236,2583,2170,0,4989
687,2019-11-20,1016,804,2188,1,4009
687,2019-11-21,253,4617,1749,3,6622
687,2019-11-22,232,4966,1371,29,6598
687,2019-11-23,263,8744,2681,0,11688
687,2019-11-24,292,7529,1712,0,9533
687,2019-11-25,230,9198,1260,0,10688
687,2019-11-26,388,3615,1151,3,5157
687,2019-11-27,532,8749,1844,5,11130
687,2019-11-28,382,8272,535,19,9208
688,2019-08-11,656972,136,46,0,657154
688,2019-08-12,849788,282,22,0,850092
688,2019-08-13,887747,417,12,0,888176
688,2019-08-14,891901,109,23,0,892033
688,2019-08-15,766719,413,0,0,767132
688,2019-08-16,762125,505,0,0,762630
688,2019-08-17,913334,1543,0,42,914919
688,2019-08-18,1155294,636,23,0,1155953
688,2019-08-19,1013213,2070,0,0,1015283
688,2019-08-20,1086463,3704,0,0,1090167
688,2019-08-21,1210164,2049,0,0,1212213
688,2019-08-22,1222695,3582,0,0,1226277
688,2019-08-23,1154046,1649,0,0,1155695
688,2019-08-24,774969,2078,0,0,777047
688,2019-08-25,4323,0,0,0,4323
688,2019-08-26,672,0,0,0,672
688,2019-08-11,656972,136,46,0,657154
688,2019-08-12,849788,282,22,0,850092
688,2019-08-13,887747,417,12,0,888176
688,2019-08-14,891901,109,23,0,892033
688,2019-08-15,766719,413,0,0,767132
688,2019-08-16,762125,505,0,0,762630
688,2019-08-17,913334,1543,0,42,914919
688,2019-08-18,1155294,636,23,0,1155953
688,2019-08-19,1013213,2070,0,0,1015283
688,2019-08-20,1086463,3704,0,0,1090167
688,2019-08-21,1210164,2049,0,0,1212213
688,2019-08-22,1222695,3582,0,0,1226277
688,2019-08-23,1154046,1649,0,0,1155695
688,2019-08-24,774969,2078,0,0,777047
688,2019-08-10,0,0,8,0,8
688,2019-08-11,656972,136,46,0,657154
688,2019-08-12,849788,282,22,0,850092
688,2019-08-13,887747,417,12,0,888176
688,2019-08-14,891901,109,23,0,892033
688,2019-08-15,766719,413,0,0,767132
688,2019-08-16,762125,505,0,0,762630
688,2019-08-17,913334,1543,0,42,914919
688,2019-08-18,1155294,636,23,0,1155953
688,2019-08-17,913334,1543,0,42,914919
689,2019-08-11,205,340,142,0,687
689,2019-08-12,487,347,207,0,1041
689,2019-08-13,294,361,347,1,1003
689,2019-08-14,1104,471,108,0,1683
689,2019-08-15,681,747,124,0,1552
689,2019-08-16,772,127,326,1,1226
689,2019-08-17,238,1984,321,0,2543
689,2019-08-18,336,1854,1006,1,3197
689,2019-08-19,320,9659,1032,1,11012
689,2019-08-20,727,12915,1172,0,14814
689,2019-08-21,810,11705,1635,2,14152
689,2019-08-22,4685,16584,965,1,22235
689,2019-08-23,8944,19700,1265,2,29911
689,2019-08-24,355,16160,866,3,17384
689,2019-08-25,754,30401,984,3,32142
689,2019-08-26,592,26492,2449,0,29533
689,2019-08-27,761,20931,1111,0,22803
689,2019-08-28,1452,19982,1744,3,23181
689,2019-08-29,3376,12263,1262,1,16902
689,2019-08-30,1693,2608,843,0,5144
689,2019-08-31,367,53,6,0,426
689,2019-09-01,179,1634,277,0,2090
689,2019-09-02,101,358,73,0,532
689,2019-09-03,192,1078,1334,2,2606
689,2019-09-04,278,10490,2142,0,12910
689,2019-09-05,1450,6685,1332,1,9468
689,2019-09-06,886,16190,1384,0,18460
689,2019-09-07,353,7707,2131,0,10191
689,2019-09-08,528,7964,2160,0,10652
689,2019-09-09,5449,8464,1434,0,15347
689,2019-09-10,1450,8091,3345,1,12887
689,2019-09-11,414,7276,1881,2,9573
689,2019-09-12,751,7969,2704,2,11426
689,2019-09-13,357,8074,1267,1,9699
689,2019-09-14,1918,7758,1661,0,11337
689,2019-09-15,9221,5915,1603,1,16740
689,2019-09-16,2093,14508,1858,0,18459
689,2019-09-17,1477,7614,1894,0,10985
689,2019-09-18,1054,20051,1331,1,22437
689,2019-09-19,551,10285,2407,2,13245
689,2019-09-20,334,24592,1890,0,26816
689,2019-09-21,435,9313,2217,1,11966
689,2019-09-22,270,13901,2014,0,16185
689,2019-09-23,384,13857,2019,5,16265
689,2019-09-24,226,6030,1713,4,7973
689,2019-09-25,360,12730,2843,2,15935
689,2019-09-26,1084,12419,1316,2,14821
689,2019-09-27,273,9220,2649,2,12144
689,2019-09-28,1161,25870,1514,5,28550
689,2019-09-29,1947,18039,1541,0,21527
689,2019-09-30,1659,19114,1543,1,22317
689,2019-10-01,573,22268,1543,0,24384
689,2019-10-02,1703,14312,1002,0,17017
689,2019-10-03,291,22711,1318,1,24321
689,2019-10-04,2009,14165,1449,1,17624
689,2019-10-05,4288,21032,1746,1,27067
689,2019-10-06,1249,16713,1307,0,19269
689,2019-10-07,516,6428,1520,0,8464
689,2019-10-08,181,17504,1473,3,19161
689,2019-10-09,315,15940,1692,0,17947
689,2019-10-10,780,11399,2569,0,14748
689,2019-10-11,635,12770,1383,0,14788
689,2019-10-12,380,8185,1963,2,10530
689,2019-10-13,275,8392,2061,3,10731
689,2019-10-14,320,9714,2361,1,12396
689,2019-10-15,1149,14547,1382,1,17079
689,2019-10-16,243,24212,1426,1,25882
689,2019-10-17,230,10495,1640,0,12365
689,2019-10-18,1785,17991,1597,5,21378
689,2019-10-19,1201,6101,1855,0,9157
689,2019-10-20,1128,3214,1330,0,5672
689,2019-10-21,1323,10970,1425,0,13718
689,2019-10-22,164,7072,2159,1,9396
689,2019-10-23,249,14322,1959,4,16534
689,2019-10-24,568,19559,1701,3,21831
689,2019-10-25,335,11383,1564,2,13284
689,2019-10-26,9013,13238,979,0,23230
689,2019-10-27,7998,16499,1639,0,26136
689,2019-10-28,936,21494,1450,1,23881
689,2019-10-29,1208,29658,2336,1,33203
689,2019-10-30,697,29747,1456,0,31900
689,2019-10-31,474,14808,2038,0,17320
689,2019-11-01,235,15479,1490,0,17204
689,2019-11-02,541,14989,1390,5,16925
689,2019-11-03,238,37658,1488,0,39384
689,2019-11-04,5552,15247,1453,1,22253
689,2019-11-05,3427,3487,1991,1,8906
689,2019-11-06,1225,8745,1511,1,11482
689,2019-11-07,1179,13993,1202,3,16377
689,2019-11-08,265,10296,1698,0,12259
689,2019-11-09,265,13953,1679,0,15897
689,2019-11-10,265,15074,1618,0,16957
689,2019-11-11,237,9874,1352,0,11463
689,2019-11-12,185,10440,2969,3,13597
689,2019-11-13,278,15747,1907,1,17933
689,2019-11-14,229,8813,2225,1,11268
689,2019-11-15,934,4157,3325,1,8417
689,2019-11-16,1895,2569,3215,2,7681
689,2019-11-17,1978,4109,3669,2,9758
689,2019-11-18,222,2432,3627,1,6282
689,2019-11-19,179,3231,3632,0,7042
689,2019-11-20,220,1370,1985,0,3575
689,2019-11-21,208,3670,2102,0,5980
689,2019-11-22,184,5607,1241,0,7032
689,2019-11-23,1214,10096,2203,0,13513
689,2019-11-24,401,9601,2006,0,12008
689,2019-11-25,1051,7585,2017,0,10653
689,2019-11-26,1108,6548,1744,0,9400
689,2019-11-27,1085,14946,1748,0,17779
689,2019-11-28,502,14897,786,0,16185
689,2019-11-29,21,708,0,0,729
689,2019-08-11,205,340,142,0,687
689,2019-08-12,487,347,207,0,1041
689,2019-08-13,294,361,347,1,1003
689,2019-08-14,1104,471,108,0,1683
689,2019-08-15,681,747,124,0,1552
689,2019-08-16,772,127,326,1,1226
689,2019-08-17,238,1984,321,0,2543
689,2019-08-18,336,1854,1006,1,3197
689,2019-08-19,320,9659,1032,1,11012
689,2019-08-20,727,12915,1172,0,14814
689,2019-08-21,810,11705,1635,2,14152
689,2019-08-22,4685,16584,965,1,22235
689,2019-08-23,8944,19700,1265,2,29911
689,2019-08-24,355,16160,866,3,17384
689,2019-08-25,754,30401,984,3,32142
689,2019-08-26,592,26492,2449,0,29533
689,2019-08-27,761,20931,1111,0,22803
689,2019-08-28,1452,19982,1744,3,23181
689,2019-08-29,3376,12263,1262,1,16902
689,2019-08-30,1693,2608,843,0,5144
689,2019-08-31,367,53,6,0,426
689,2019-09-01,179,1634,277,0,2090
689,2019-09-02,101,358,73,0,532
689,2019-09-03,192,1078,1334,2,2606
689,2019-09-04,278,10490,2142,0,12910
689,2019-09-05,1450,6685,1332,1,9468
689,2019-09-06,886,16190,1384,0,18460
689,2019-09-07,353,7707,2131,0,10191
689,2019-09-08,528,7964,2160,0,10652
689,2019-09-09,5449,8464,1434,0,15347
689,2019-09-10,1450,8091,3345,1,12887
689,2019-09-11,414,7276,1881,2,9573
689,2019-09-12,751,7969,2704,2,11426
689,2019-09-13,357,8074,1267,1,9699
689,2019-09-14,1918,7758,1661,0,11337
689,2019-09-15,9221,5915,1603,1,16740
689,2019-09-16,2093,14508,1858,0,18459
689,2019-09-17,1477,7614,1894,0,10985
689,2019-09-18,1054,20051,1331,1,22437
689,2019-09-19,551,10285,2407,2,13245
689,2019-09-20,334,24592,1890,0,26816
689,2019-09-21,435,9313,2217,1,11966
689,2019-09-22,270,13901,2014,0,16185
689,2019-09-23,384,13857,2019,5,16265
689,2019-09-24,226,6030,1713,4,7973
689,2019-09-25,360,12730,2843,2,15935
689,2019-09-26,1084,12419,1316,2,14821
689,2019-09-27,273,9220,2649,2,12144
689,2019-09-28,1161,25870,1514,5,28550
689,2019-09-29,1947,18039,1541,0,21527
689,2019-09-30,1659,19114,1543,1,22317
689,2019-10-01,573,22268,1543,0,24384
689,2019-10-02,1703,14312,1002,0,17017
689,2019-10-03,291,22711,1318,1,24321
689,2019-10-04,2009,14165,1449,1,17624
689,2019-10-05,4288,21032,1746,1,27067
689,2019-10-06,1249,16713,1307,0,19269
689,2019-10-07,516,6428,1520,0,8464
689,2019-10-08,181,17504,1473,3,19161
689,2019-10-09,315,15940,1692,0,17947
689,2019-10-10,780,11399,2569,0,14748
689,2019-10-11,635,12770,1383,0,14788
689,2019-10-12,380,8185,1963,2,10530
689,2019-10-13,275,8392,2061,3,10731
689,2019-10-14,320,9714,2361,1,12396
689,2019-10-15,1149,14547,1382,1,17079
689,2019-10-16,243,24212,1426,1,25882
689,2019-10-17,230,10495,1640,0,12365
689,2019-10-18,1785,17991,1597,5,21378
689,2019-10-19,1201,6101,1855,0,9157
689,2019-10-20,1128,3214,1330,0,5672
689,2019-10-21,1323,10970,1425,0,13718
689,2019-10-22,164,7072,2159,1,9396
689,2019-10-23,249,14322,1959,4,16534
689,2019-10-24,568,19559,1701,3,21831
689,2019-10-25,335,11383,1564,2,13284
689,2019-10-26,9013,13238,979,0,23230
689,2019-10-27,7998,16499,1639,0,26136
689,2019-10-28,936,21494,1450,1,23881
689,2019-10-29,1208,29658,2336,1,33203
689,2019-10-30,697,29747,1456,0,31900
689,2019-10-31,474,14808,2038,0,17320
689,2019-11-01,235,15479,1490,0,17204
689,2019-11-02,541,14989,1390,5,16925
689,2019-11-03,238,37658,1488,0,39384
689,2019-11-04,5552,15247,1453,1,22253
689,2019-11-05,3427,3487,1991,1,8906
689,2019-11-06,1225,8745,1511,1,11482
689,2019-11-07,1179,13993,1202,3,16377
689,2019-11-08,265,10296,1698,0,12259
689,2019-11-09,265,13953,1679,0,15897
689,2019-11-10,265,15074,1618,0,16957
689,2019-11-11,237,9874,1352,0,11463
689,2019-11-12,185,10440,2969,3,13597
689,2019-11-13,278,15747,1907,1,17933
689,2019-11-14,229,8813,2225,1,11268
689,2019-11-15,934,4157,3325,1,8417
689,2019-11-16,1895,2569,3215,2,7681
689,2019-11-17,1978,4109,3669,2,9758
689,2019-11-18,222,2432,3627,1,6282
689,2019-11-19,179,3231,3632,0,7042
689,2019-11-20,220,1370,1985,0,3575
689,2019-11-21,208,3670,2102,0,5980
689,2019-11-22,184,5607,1241,0,7032
689,2019-11-23,1214,10096,2203,0,13513
689,2019-11-24,401,9601,2006,0,12008
689,2019-11-25,1051,7585,2017,0,10653
689,2019-11-26,1108,6548,1744,0,9400
689,2019-11-27,1085,14946,1748,0,17779
689,2019-11-28,502,14897,786,0,16185
689,2019-11-29,21,708,0,0,729
689,2019-08-10,0,0,1,0,1
689,2019-08-11,205,340,142,0,687
689,2019-08-12,487,347,207,0,1041
689,2019-08-13,294,361,347,1,1003
689,2019-08-14,1104,471,108,0,1683
689,2019-08-15,681,747,124,0,1552
689,2019-08-16,772,127,326,1,1226
689,2019-08-17,238,1984,321,0,2543
689,2019-08-18,336,1854,1006,1,3197
689,2019-08-19,320,9659,1032,1,11012
689,2019-08-20,727,12915,1172,0,14814
689,2019-08-21,810,11705,1635,2,14152
689,2019-08-22,4685,16584,965,1,22235
689,2019-08-23,8944,19700,1265,2,29911
689,2019-08-24,355,16160,866,3,17384
689,2019-08-25,754,30401,984,3,32142
689,2019-08-26,592,26492,2449,0,29533
689,2019-08-27,761,20931,1111,0,22803
689,2019-08-28,1452,19982,1744,3,23181
689,2019-08-29,3376,12263,1262,1,16902
689,2019-08-30,1693,2608,843,0,5144
689,2019-08-31,367,53,6,0,426
689,2019-09-01,179,1634,277,0,2090
689,2019-09-02,101,358,73,0,532
689,2019-09-03,192,1078,1334,2,2606
689,2019-09-04,278,10490,2142,0,12910
689,2019-09-05,1450,6685,1332,1,9468
689,2019-09-06,886,16190,1384,0,18460
689,2019-09-07,353,7707,2131,0,10191
689,2019-09-08,528,7964,2160,0,10652
689,2019-09-09,5449,8464,1434,0,15347
689,2019-09-10,1450,8091,3345,1,12887
689,2019-09-11,414,7276,1881,2,9573
689,2019-09-12,751,7969,2704,2,11426
689,2019-09-13,357,8074,1267,1,9699
689,2019-09-14,1918,7758,1661,0,11337
689,2019-09-15,9221,5915,1603,1,16740
689,2019-09-16,2093,14508,1858,0,18459
689,2019-09-17,1477,7614,1894,0,10985
689,2019-09-18,1054,20051,1331,1,22437
689,2019-09-19,551,10285,2407,2,13245
689,2019-09-20,334,24592,1890,0,26816
689,2019-09-21,435,9313,2217,1,11966
689,2019-09-22,270,13901,2014,0,16185
689,2019-09-23,384,13857,2019,5,16265
689,2019-09-24,226,6030,1713,4,7973
689,2019-09-25,360,12730,2843,2,15935
689,2019-09-26,1084,12419,1316,2,14821
689,2019-09-27,273,9220,2649,2,12144
689,2019-09-28,1161,25870,1514,5,28550
689,2019-09-29,1947,18039,1541,0,21527
689,2019-09-30,1659,19114,1543,1,22317
689,2019-10-01,573,22268,1543,0,24384
689,2019-10-02,1703,14312,1002,0,17017
689,2019-10-03,291,22711,1318,1,24321
689,2019-10-04,2009,14165,1449,1,17624
689,2019-10-05,4288,21032,1746,1,27067
689,2019-10-06,1249,16713,1307,0,19269
689,2019-10-07,516,6428,1520,0,8464
689,2019-10-08,181,17504,1473,3,19161
689,2019-10-09,315,15940,1692,0,17947
689,2019-10-10,780,11399,2569,0,14748
689,2019-10-11,635,12770,1383,0,14788
689,2019-10-12,380,8185,1963,2,10530
689,2019-10-13,275,8392,2061,3,10731
689,2019-10-14,320,9714,2361,1,12396
689,2019-10-15,1149,14547,1382,1,17079
689,2019-10-16,243,24212,1426,1,25882
689,2019-10-17,230,10495,1640,0,12365
689,2019-10-18,1785,17991,1597,5,21378
689,2019-10-19,1201,6101,1855,0,9157
689,2019-10-20,1128,3214,1330,0,5672
689,2019-10-21,1323,10970,1425,0,13718
689,2019-10-22,164,7072,2159,1,9396
689,2019-10-23,249,14322,1959,4,16534
689,2019-10-24,568,19559,1701,3,21831
689,2019-10-25,335,11383,1564,2,13284
689,2019-10-26,9013,13238,979,0,23230
689,2019-10-27,7998,16499,1639,0,26136
689,2019-10-28,936,21494,1450,1,23881
689,2019-10-29,1208,29658,2336,1,33203
689,2019-10-30,697,29747,1456,0,31900
689,2019-10-31,474,14808,2038,0,17320
689,2019-11-01,235,15479,1490,0,17204
689,2019-11-02,541,14989,1390,5,16925
689,2019-11-03,238,37658,1488,0,39384
689,2019-11-04,5552,15247,1453,1,22253
689,2019-11-05,3427,3487,1991,1,8906
689,2019-11-06,1225,8745,1511,1,11482
689,2019-11-07,1179,13993,1202,3,16377
689,2019-11-08,265,10296,1698,0,12259
689,2019-11-09,265,13953,1679,0,15897
689,2019-11-10,265,15074,1618,0,16957
689,2019-11-11,237,9874,1352,0,11463
689,2019-11-12,185,10440,2969,3,13597
689,2019-11-13,278,15747,1907,1,17933
689,2019-11-14,229,8813,2225,1,11268
689,2019-11-15,934,4157,3325,1,8417
689,2019-11-16,1895,2569,3215,2,7681
689,2019-11-17,1978,4109,3669,2,9758
689,2019-11-18,222,2432,3627,1,6282
689,2019-11-19,179,3231,3632,0,7042
689,2019-11-20,220,1370,1985,0,3575
689,2019-11-21,208,3670,2102,0,5980
689,2019-11-22,184,5607,1241,0,7032
689,2019-11-23,1214,10096,2203,0,13513
689,2019-11-24,401,9601,2006,0,12008
689,2019-11-25,1051,7585,2017,0,10653
689,2019-11-26,1108,6548,1744,0,9400
689,2019-11-27,1085,14946,1748,0,17779
689,2019-11-28,502,14897,786,0,16185
689,2019-08-13,294,361,347,1,1003
689,2019-08-14,1104,471,108,0,1683
689,2019-08-15,681,747,124,0,1552
689,2019-08-16,772,127,326,1,1226
689,2019-08-17,238,1984,321,0,2543
689,2019-08-18,336,1854,1006,1,3197
689,2019-08-19,320,9659,1032,1,11012
689,2019-08-20,727,12915,1172,0,14814
689,2019-08-21,810,11705,1635,2,14152
689,2019-08-22,4685,16584,965,1,22235
689,2019-08-23,8944,19700,1265,2,29911
689,2019-08-24,355,16160,866,3,17384
689,2019-08-25,754,30401,984,3,32142
689,2019-08-26,592,26492,2449,0,29533
689,2019-08-27,761,20931,1111,0,22803
689,2019-08-28,1452,19982,1744,3,23181
689,2019-08-29,3376,12263,1262,1,16902
689,2019-08-30,1693,2608,843,0,5144
689,2019-08-31,367,53,6,0,426
689,2019-09-01,179,1634,277,0,2090
689,2019-09-02,101,358,73,0,532
689,2019-09-03,192,1078,1334,2,2606
689,2019-09-04,278,10490,2142,0,12910
689,2019-09-05,1450,6685,1332,1,9468
689,2019-09-06,886,16190,1384,0,18460
689,2019-09-07,353,7707,2131,0,10191
689,2019-09-08,528,7964,2160,0,10652
689,2019-09-09,5449,8464,1434,0,15347
689,2019-09-10,1450,8091,3345,1,12887
689,2019-09-11,414,7276,1881,2,9573
689,2019-09-12,751,7969,2704,2,11426
689,2019-09-13,357,8074,1267,1,9699
689,2019-09-14,1918,7758,1661,0,11337
689,2019-09-15,9221,5915,1603,1,16740
689,2019-09-16,2093,14508,1858,0,18459
689,2019-09-17,1477,7614,1894,0,10985
689,2019-09-18,1054,20051,1331,1,22437
689,2019-09-19,551,10285,2407,2,13245
689,2019-09-20,334,24592,1890,0,26816
689,2019-09-21,435,9313,2217,1,11966
689,2019-09-22,270,13901,2014,0,16185
689,2019-09-23,384,13857,2019,5,16265
689,2019-09-24,226,6030,1713,4,7973
689,2019-09-25,360,12730,2843,2,15935
689,2019-09-26,1084,12419,1316,2,14821
689,2019-09-27,273,9220,2649,2,12144
689,2019-09-28,1161,25870,1514,5,28550
689,2019-09-29,1947,18039,1541,0,21527
689,2019-09-30,1659,19114,1543,1,22317
689,2019-10-01,573,22268,1543,0,24384
689,2019-10-02,1703,14312,1002,0,17017
689,2019-10-03,291,22711,1318,1,24321
689,2019-10-04,2009,14165,1449,1,17624
689,2019-10-05,4288,21032,1746,1,27067
689,2019-10-06,1249,16713,1307,0,19269
689,2019-10-07,516,6428,1520,0,8464
689,2019-10-08,181,17504,1473,3,19161
689,2019-10-09,315,15940,1692,0,17947
689,2019-10-10,780,11399,2569,0,14748
689,2019-10-11,635,12770,1383,0,14788
689,2019-10-12,380,8185,1963,2,10530
689,2019-10-13,275,8392,2061,3,10731
689,2019-10-14,320,9714,2361,1,12396
689,2019-10-15,1149,14547,1382,1,17079
689,2019-10-16,243,24212,1426,1,25882
689,2019-10-17,230,10495,1640,0,12365
689,2019-10-18,1785,17991,1597,5,21378
689,2019-10-19,1201,6101,1855,0,9157
689,2019-10-20,1128,3214,1330,0,5672
689,2019-10-21,1323,10970,1425,0,13718
689,2019-10-22,164,7072,2159,1,9396
689,2019-10-23,249,14322,1959,4,16534
689,2019-10-24,568,19559,1701,3,21831
689,2019-10-25,335,11383,1564,2,13284
689,2019-10-26,9013,13238,979,0,23230
689,2019-10-27,7998,16499,1639,0,26136
689,2019-10-28,936,21494,1450,1,23881
689,2019-10-29,1208,29658,2336,1,33203
689,2019-10-30,697,29747,1456,0,31900
689,2019-10-31,474,14808,2038,0,17320
689,2019-11-01,235,15479,1490,0,17204
689,2019-11-02,541,14989,1390,5,16925
689,2019-11-03,238,37658,1488,0,39384
689,2019-11-04,5552,15247,1453,1,22253
689,2019-11-05,3427,3487,1991,1,8906
689,2019-11-06,1225,8745,1511,1,11482
689,2019-11-07,1179,13993,1202,3,16377
689,2019-11-08,265,10296,1698,0,12259
689,2019-11-09,265,13953,1679,0,15897
689,2019-11-10,265,15074,1618,0,16957
689,2019-11-11,237,9874,1352,0,11463
689,2019-11-12,185,10440,2969,3,13597
689,2019-11-13,278,15747,1907,1,17933
689,2019-11-14,229,8813,2225,1,11268
689,2019-11-15,934,4157,3325,1,8417
689,2019-11-16,1895,2569,3215,2,7681
689,2019-11-17,1978,4109,3669,2,9758
689,2019-11-18,222,2432,3627,1,6282
690,2019-08-11,112,279,178,0,569
690,2019-08-12,108,520,230,0,858
690,2019-08-13,384,475,160,1,1020
690,2019-08-14,183,860,187,0,1230
690,2019-08-15,86,816,172,0,1074
690,2019-08-16,112,354,124,1,591
690,2019-08-17,199,2968,895,2,4064
690,2019-08-18,1004,3197,1268,1,5470
690,2019-08-19,518,3692,1061,1,5272
690,2019-08-20,204,2002,1129,1,3336
690,2019-08-21,135,340,1479,1,1955
690,2019-08-22,345,15440,1091,2,16878
690,2019-08-23,69,4634,1174,1,5878
690,2019-08-24,918,5076,1138,0,7132
690,2019-08-25,962,45187,2071,2,48222
690,2019-08-26,872,32221,1440,0,34533
690,2019-08-27,119,6928,1946,1,8994
690,2019-08-28,102,23475,1178,0,24755
690,2019-08-29,99,15706,2402,1,18208
690,2019-08-30,66,2832,450,1,3349
690,2019-08-31,22,43,12,0,77
690,2019-09-01,61,1115,421,0,1597
690,2019-09-02,18,947,118,0,1083
690,2019-09-03,99,3397,1408,1,4905
690,2019-09-04,925,9600,2504,0,13029
690,2019-09-05,100,6520,1590,1,8211
690,2019-09-06,87,19266,1905,1,21259
690,2019-09-07,1041,7139,1746,0,9926
690,2019-09-08,1966,4621,1580,0,8167
690,2019-09-09,170,8829,1516,0,10515
690,2019-09-10,106,11343,1946,0,13395
690,2019-09-11,1072,6382,1762,3,9219
690,2019-09-12,59,6538,1741,2,8340
690,2019-09-13,170,8820,3059,2,12051
690,2019-09-14,96,7836,2616,2,10550
690,2019-09-15,986,11274,1173,2,13435
690,2019-09-16,85,14930,2686,4,17705
690,2019-09-17,77,8875,2538,7,11497
690,2019-09-18,89,20370,1086,9,21554
690,2019-09-19,383,11253,1350,10,12996
690,2019-09-20,134,15982,1634,10,17760
690,2019-09-21,180,12847,1716,10,14753
690,2019-09-22,81,10004,1757,9,11851
690,2019-09-23,133,9055,2235,10,11433
690,2019-09-24,140,21600,2289,12,24041
690,2019-09-25,186,14427,1269,9,15891
690,2019-09-26,123,10084,2033,11,12251
690,2019-09-27,90,9794,1932,5,11821
690,2019-09-28,109,15734,1912,1,17756
690,2019-09-29,80,16921,1323,0,18324
690,2019-09-30,2381,18035,2204,0,22620
690,2019-10-01,105,17030,1731,1,18867
690,2019-10-02,994,13272,1507,7,15780
690,2019-10-03,805,14463,1219,12,16499
690,2019-10-04,64,12857,728,10,13659
690,2019-10-05,98,15645,1762,10,17515
690,2019-10-06,75,11859,1514,11,13459
690,2019-10-07,68,6712,2152,10,8942
690,2019-10-08,1019,11446,1086,11,13562
690,2019-10-09,85,16338,1857,11,18291
690,2019-10-10,199,11360,1865,11,13435
690,2019-10-11,164,14600,2118,9,16891
690,2019-10-12,398,18965,2963,2,22328
690,2019-10-13,80,14674,2013,1,16768
690,2019-10-14,259,6880,3224,0,10363
690,2019-10-15,69,10000,1184,0,11253
690,2019-10-16,845,13037,1562,2,15446
690,2019-10-17,495,5525,1785,1,7806
690,2019-10-18,119,9745,2061,0,11925
690,2019-10-19,92,5640,2119,1,7852
690,2019-10-20,1875,3189,2080,0,7144
690,2019-10-21,90,11287,1615,4,12996
690,2019-10-22,121,17700,2429,1,20251
690,2019-10-23,54,9056,1588,1,10699
690,2019-10-24,136,14178,1321,3,15638
690,2019-10-25,1009,11551,1073,1,13634
690,2019-10-26,566,14178,1691,0,16435
690,2019-10-27,80,28871,1606,0,30557
690,2019-10-28,78,26070,1176,1,27325
690,2019-10-29,126,29601,1258,1,30986
690,2019-10-30,107,31822,1727,2,33658
690,2019-10-31,57,15110,1734,2,16903
690,2019-11-01,157,26448,1180,1,27786
690,2019-11-02,1297,17204,1467,3,19971
690,2019-11-03,373,22874,1194,0,24441
690,2019-11-04,95,10897,1168,0,12160
690,2019-11-05,131,4185,1630,0,5946
690,2019-11-06,114,9141,971,2,10228
690,2019-11-07,264,14221,1010,1,15496
690,2019-11-08,455,10177,941,2,11575
690,2019-11-09,75,9328,1321,0,10724
690,2019-11-10,1007,25191,1803,3,28004
690,2019-11-11,82,16564,2294,3,18943
690,2019-11-12,89,13126,3081,0,16296
690,2019-11-13,95,13430,2086,2,15613
690,2019-11-14,87,13287,2257,1,15632
690,2019-11-15,76,4951,1877,1,6905
690,2019-11-16,97,2869,2431,0,5397
690,2019-11-17,196,5415,3201,0,8812
690,2019-11-18,113,3346,2803,0,6262
690,2019-11-19,135,5844,2787,2,8768
690,2019-11-20,127,1374,1845,2,3348
690,2019-11-21,111,3749,2248,0,6108
690,2019-11-22,101,5608,2081,2,7792
690,2019-11-23,119,6053,1966,0,8138
690,2019-11-24,111,6136,1505,0,7752
690,2019-11-25,439,7678,2108,0,10225
690,2019-11-26,80,7045,1382,0,8507
690,2019-11-27,105,6814,1187,0,8106
690,2019-11-28,81,8729,645,0,9455
690,2019-11-29,27,1542,216,0,1785
690,2019-08-11,112,279,178,0,569
690,2019-08-12,108,520,230,0,858
690,2019-08-13,384,475,160,1,1020
690,2019-08-14,183,860,187,0,1230
690,2019-08-15,86,816,172,0,1074
690,2019-08-16,112,354,124,1,591
690,2019-08-17,199,2968,895,2,4064
690,2019-08-18,1004,3197,1268,1,5470
690,2019-08-19,518,3692,1061,1,5272
690,2019-08-20,204,2002,1129,1,3336
690,2019-08-21,135,340,1479,1,1955
690,2019-08-22,345,15440,1091,2,16878
690,2019-08-23,69,4634,1174,1,5878
690,2019-08-24,918,5076,1138,0,7132
690,2019-08-25,962,45187,2071,2,48222
690,2019-08-26,872,32221,1440,0,34533
690,2019-08-27,119,6928,1946,1,8994
690,2019-08-28,102,23475,1178,0,24755
690,2019-08-29,99,15706,2402,1,18208
690,2019-08-30,66,2832,450,1,3349
690,2019-08-31,22,43,12,0,77
690,2019-09-01,61,1115,421,0,1597
690,2019-09-02,18,947,118,0,1083
690,2019-09-03,99,3397,1408,1,4905
690,2019-09-04,925,9600,2504,0,13029
690,2019-09-05,100,6520,1590,1,8211
690,2019-09-06,87,19266,1905,1,21259
690,2019-09-07,1041,7139,1746,0,9926
690,2019-09-08,1966,4621,1580,0,8167
690,2019-09-09,170,8829,1516,0,10515
690,2019-09-10,106,11343,1946,0,13395
690,2019-09-11,1072,6382,1762,3,9219
690,2019-09-12,59,6538,1741,2,8340
690,2019-09-13,170,8820,3059,2,12051
690,2019-09-14,96,7836,2616,2,10550
690,2019-09-15,986,11274,1173,2,13435
690,2019-09-16,85,14930,2686,4,17705
690,2019-09-17,77,8875,2538,7,11497
690,2019-09-18,89,20370,1086,9,21554
690,2019-09-19,383,11253,1350,10,12996
690,2019-09-20,134,15982,1634,10,17760
690,2019-09-21,180,12847,1716,10,14753
690,2019-09-22,81,10004,1757,9,11851
690,2019-09-23,133,9055,2235,10,11433
690,2019-09-24,140,21600,2289,12,24041
690,2019-09-25,186,14427,1269,9,15891
690,2019-09-26,123,10084,2033,11,12251
690,2019-09-27,90,9794,1932,5,11821
690,2019-09-28,109,15734,1912,1,17756
690,2019-09-29,80,16921,1323,0,18324
690,2019-09-30,2381,18035,2204,0,22620
690,2019-10-01,105,17030,1731,1,18867
690,2019-10-02,994,13272,1507,7,15780
690,2019-10-03,805,14463,1219,12,16499
690,2019-10-04,64,12857,728,10,13659
690,2019-10-05,98,15645,1762,10,17515
690,2019-10-06,75,11859,1514,11,13459
690,2019-10-07,68,6712,2152,10,8942
690,2019-10-08,1019,11446,1086,11,13562
690,2019-10-09,85,16338,1857,11,18291
690,2019-10-10,199,11360,1865,11,13435
690,2019-10-11,164,14600,2118,9,16891
690,2019-10-12,398,18965,2963,2,22328
690,2019-10-13,80,14674,2013,1,16768
690,2019-10-14,259,6880,3224,0,10363
690,2019-10-15,69,10000,1184,0,11253
690,2019-10-16,845,13037,1562,2,15446
690,2019-10-17,495,5525,1785,1,7806
690,2019-10-18,119,9745,2061,0,11925
690,2019-10-19,92,5640,2119,1,7852
690,2019-10-20,1875,3189,2080,0,7144
690,2019-10-21,90,11287,1615,4,12996
690,2019-10-22,121,17700,2429,1,20251
690,2019-10-23,54,9056,1588,1,10699
690,2019-10-24,136,14178,1321,3,15638
690,2019-10-25,1009,11551,1073,1,13634
690,2019-10-26,566,14178,1691,0,16435
690,2019-10-27,80,28871,1606,0,30557
690,2019-10-28,78,26070,1176,1,27325
690,2019-10-29,126,29601,1258,1,30986
690,2019-10-30,107,31822,1727,2,33658
690,2019-10-31,57,15110,1734,2,16903
690,2019-11-01,157,26448,1180,1,27786
690,2019-11-02,1297,17204,1467,3,19971
690,2019-11-03,373,22874,1194,0,24441
690,2019-11-04,95,10897,1168,0,12160
690,2019-11-05,131,4185,1630,0,5946
690,2019-11-06,114,9141,971,2,10228
690,2019-11-07,264,14221,1010,1,15496
690,2019-11-08,455,10177,941,2,11575
690,2019-11-09,75,9328,1321,0,10724
690,2019-11-10,1007,25191,1803,3,28004
690,2019-11-11,82,16564,2294,3,18943
690,2019-11-12,89,13126,3081,0,16296
690,2019-11-13,95,13430,2086,2,15613
690,2019-11-14,87,13287,2257,1,15632
690,2019-11-15,76,4951,1877,1,6905
690,2019-11-16,97,2869,2431,0,5397
690,2019-11-17,196,5415,3201,0,8812
690,2019-11-18,113,3346,2803,0,6262
690,2019-11-19,135,5844,2787,2,8768
690,2019-11-20,127,1374,1845,2,3348
690,2019-11-21,111,3749,2248,0,6108
690,2019-11-22,101,5608,2081,2,7792
690,2019-11-23,119,6053,1966,0,8138
690,2019-11-24,111,6136,1505,0,7752
690,2019-11-25,439,7678,2108,0,10225
690,2019-11-26,80,7045,1382,0,8507
690,2019-11-27,105,6814,1187,0,8106
690,2019-11-28,81,8729,645,0,9455
690,2019-11-29,27,1542,216,0,1785
690,2019-08-10,0,0,88,0,88
690,2019-08-11,112,279,178,0,569
690,2019-08-12,108,520,230,0,858
690,2019-08-13,384,475,160,1,1020
690,2019-08-14,183,860,187,0,1230
690,2019-08-15,86,816,172,0,1074
690,2019-08-16,112,354,124,1,591
690,2019-08-17,199,2968,895,2,4064
690,2019-08-18,1004,3197,1268,1,5470
690,2019-08-19,518,3692,1061,1,5272
690,2019-08-20,204,2002,1129,1,3336
690,2019-08-21,135,340,1479,1,1955
690,2019-08-22,345,15440,1091,2,16878
690,2019-08-23,69,4634,1174,1,5878
690,2019-08-24,918,5076,1138,0,7132
690,2019-08-25,962,45187,2071,2,48222
690,2019-08-26,872,32221,1440,0,34533
690,2019-08-27,119,6928,1946,1,8994
690,2019-08-28,102,23475,1178,0,24755
690,2019-08-29,99,15706,2402,1,18208
690,2019-08-30,66,2832,450,1,3349
690,2019-08-31,22,43,12,0,77
690,2019-09-01,61,1115,421,0,1597
690,2019-09-02,18,947,118,0,1083
690,2019-09-03,99,3397,1408,1,4905
690,2019-09-04,925,9600,2504,0,13029
690,2019-09-05,100,6520,1590,1,8211
690,2019-09-06,87,19266,1905,1,21259
690,2019-09-07,1041,7139,1746,0,9926
690,2019-09-08,1966,4621,1580,0,8167
690,2019-09-09,170,8829,1516,0,10515
690,2019-09-10,106,11343,1946,0,13395
690,2019-09-11,1072,6382,1762,3,9219
690,2019-09-12,59,6538,1741,2,8340
690,2019-09-13,170,8820,3059,2,12051
690,2019-09-14,96,7836,2616,2,10550
690,2019-09-15,986,11274,1173,2,13435
690,2019-09-16,85,14930,2686,4,17705
690,2019-09-17,77,8875,2538,7,11497
690,2019-09-18,89,20370,1086,9,21554
690,2019-09-19,383,11253,1350,10,12996
690,2019-09-20,134,15982,1634,10,17760
690,2019-09-21,180,12847,1716,10,14753
690,2019-09-22,81,10004,1757,9,11851
690,2019-09-23,133,9055,2235,10,11433
690,2019-09-24,140,21600,2289,12,24041
690,2019-09-25,186,14427,1269,9,15891
690,2019-09-26,123,10084,2033,11,12251
690,2019-09-27,90,9794,1932,5,11821
690,2019-09-28,109,15734,1912,1,17756
690,2019-09-29,80,16921,1323,0,18324
690,2019-09-30,2381,18035,2204,0,22620
690,2019-10-01,105,17030,1731,1,18867
690,2019-10-02,994,13272,1507,7,15780
690,2019-10-03,805,14463,1219,12,16499
690,2019-10-04,64,12857,728,10,13659
690,2019-10-05,98,15645,1762,10,17515
690,2019-10-06,75,11859,1514,11,13459
690,2019-10-07,68,6712,2152,10,8942
690,2019-10-08,1019,11446,1086,11,13562
690,2019-10-09,85,16338,1857,11,18291
690,2019-10-10,199,11360,1865,11,13435
690,2019-10-11,164,14600,2118,9,16891
690,2019-10-12,398,18965,2963,2,22328
690,2019-10-13,80,14674,2013,1,16768
690,2019-10-14,259,6880,3224,0,10363
690,2019-10-15,69,10000,1184,0,11253
690,2019-10-16,845,13037,1562,2,15446
690,2019-10-17,495,5525,1785,1,7806
690,2019-10-18,119,9745,2061,0,11925
690,2019-10-19,92,5640,2119,1,7852
690,2019-10-20,1875,3189,2080,0,7144
690,2019-10-21,90,11287,1615,4,12996
690,2019-10-22,121,17700,2429,1,20251
690,2019-10-23,54,9056,1588,1,10699
690,2019-10-24,136,14178,1321,3,15638
690,2019-10-25,1009,11551,1073,1,13634
690,2019-10-26,566,14178,1691,0,16435
690,2019-10-27,80,28871,1606,0,30557
690,2019-10-28,78,26070,1176,1,27325
690,2019-10-29,126,29601,1258,1,30986
690,2019-10-30,107,31822,1727,2,33658
690,2019-10-31,57,15110,1734,2,16903
690,2019-11-01,157,26448,1180,1,27786
690,2019-11-02,1297,17204,1467,3,19971
690,2019-11-03,373,22874,1194,0,24441
690,2019-11-04,95,10897,1168,0,12160
690,2019-11-05,131,4185,1630,0,5946
690,2019-11-06,114,9141,971,2,10228
690,2019-11-07,264,14221,1010,1,15496
690,2019-11-08,455,10177,941,2,11575
690,2019-11-09,75,9328,1321,0,10724
690,2019-11-10,1007,25191,1803,3,28004
690,2019-11-11,82,16564,2294,3,18943
690,2019-11-12,89,13126,3081,0,16296
690,2019-11-13,95,13430,2086,2,15613
690,2019-11-14,87,13287,2257,1,15632
690,2019-11-15,76,4951,1877,1,6905
690,2019-11-16,97,2869,2431,0,5397
690,2019-11-17,196,5415,3201,0,8812
690,2019-11-18,113,3346,2803,0,6262
690,2019-11-19,135,5844,2787,2,8768
690,2019-11-20,127,1374,1845,2,3348
690,2019-11-21,111,3749,2248,0,6108
690,2019-11-22,101,5608,2081,2,7792
690,2019-11-23,119,6053,1966,0,8138
690,2019-11-24,111,6136,1505,0,7752
690,2019-11-25,439,7678,2108,0,10225
690,2019-11-26,80,7045,1382,0,8507
690,2019-11-27,105,6814,1187,0,8106
690,2019-11-28,81,8729,645,0,9455
690,2019-11-29,27,1542,216,0,1785
690,2019-08-13,384,475,160,1,1020
690,2019-08-14,183,860,187,0,1230
690,2019-08-15,86,816,172,0,1074
690,2019-08-16,112,354,124,1,591
690,2019-08-17,199,2968,895,2,4064
690,2019-08-18,1004,3197,1268,1,5470
690,2019-08-19,518,3692,1061,1,5272
690,2019-08-20,204,2002,1129,1,3336
690,2019-08-21,135,340,1479,1,1955
690,2019-08-22,345,15440,1091,2,16878
690,2019-08-23,69,4634,1174,1,5878
690,2019-08-24,918,5076,1138,0,7132
690,2019-08-25,962,45187,2071,2,48222
690,2019-08-26,872,32221,1440,0,34533
690,2019-08-27,119,6928,1946,1,8994
690,2019-08-28,102,23475,1178,0,24755
690,2019-08-29,99,15706,2402,1,18208
690,2019-08-30,66,2832,450,1,3349
690,2019-08-31,22,43,12,0,77
690,2019-09-01,61,1115,421,0,1597
690,2019-09-02,18,947,118,0,1083
690,2019-09-03,99,3397,1408,1,4905
690,2019-09-04,925,9600,2504,0,13029
690,2019-09-05,100,6520,1590,1,8211
690,2019-09-06,87,19266,1905,1,21259
690,2019-09-07,1041,7139,1746,0,9926
690,2019-09-08,1966,4621,1580,0,8167
690,2019-09-09,170,8829,1516,0,10515
690,2019-09-10,106,11343,1946,0,13395
690,2019-09-11,1072,6382,1762,3,9219
690,2019-09-12,59,6538,1741,2,8340
690,2019-09-13,170,8820,3059,2,12051
690,2019-09-14,96,7836,2616,2,10550
690,2019-09-15,986,11274,1173,2,13435
690,2019-09-16,85,14930,2686,4,17705
690,2019-09-17,77,8875,2538,7,11497
690,2019-09-18,89,20370,1086,9,21554
690,2019-09-19,383,11253,1350,10,12996
690,2019-09-20,134,15982,1634,10,17760
690,2019-09-21,180,12847,1716,10,14753
690,2019-09-22,81,10004,1757,9,11851
690,2019-09-23,133,9055,2235,10,11433
690,2019-09-24,140,21600,2289,12,24041
690,2019-09-25,186,14427,1269,9,15891
690,2019-09-26,123,10084,2033,11,12251
690,2019-09-27,90,9794,1932,5,11821
690,2019-09-28,109,15734,1912,1,17756
690,2019-09-29,80,16921,1323,0,18324
690,2019-09-30,2381,18035,2204,0,22620
690,2019-10-01,105,17030,1731,1,18867
690,2019-10-02,994,13272,1507,7,15780
690,2019-10-03,805,14463,1219,12,16499
690,2019-10-04,64,12857,728,10,13659
690,2019-10-05,98,15645,1762,10,17515
690,2019-10-06,75,11859,1514,11,13459
690,2019-10-07,68,6712,2152,10,8942
690,2019-10-08,1019,11446,1086,11,13562
690,2019-10-09,85,16338,1857,11,18291
690,2019-10-10,199,11360,1865,11,13435
690,2019-10-11,164,14600,2118,9,16891
690,2019-10-12,398,18965,2963,2,22328
690,2019-10-13,80,14674,2013,1,16768
690,2019-10-14,259,6880,3224,0,10363
690,2019-10-15,69,10000,1184,0,11253
690,2019-10-16,845,13037,1562,2,15446
690,2019-10-17,495,5525,1785,1,7806
690,2019-10-18,119,9745,2061,0,11925
690,2019-10-19,92,5640,2119,1,7852
690,2019-10-20,1875,3189,2080,0,7144
690,2019-10-21,90,11287,1615,4,12996
690,2019-10-22,121,17700,2429,1,20251
690,2019-10-23,54,9056,1588,1,10699
690,2019-10-24,136,14178,1321,3,15638
690,2019-10-25,1009,11551,1073,1,13634
690,2019-10-26,566,14178,1691,0,16435
690,2019-10-27,80,28871,1606,0,30557
690,2019-10-28,78,26070,1176,1,27325
690,2019-10-29,126,29601,1258,1,30986
690,2019-10-30,107,31822,1727,2,33658
690,2019-10-31,57,15110,1734,2,16903
690,2019-11-01,157,26448,1180,1,27786
690,2019-11-02,1297,17204,1467,3,19971
690,2019-11-03,373,22874,1194,0,24441
690,2019-11-04,95,10897,1168,0,12160
690,2019-11-05,131,4185,1630,0,5946
690,2019-11-06,114,9141,971,2,10228
690,2019-11-07,264,14221,1010,1,15496
690,2019-11-08,455,10177,941,2,11575
690,2019-11-09,75,9328,1321,0,10724
690,2019-11-10,1007,25191,1803,3,28004
690,2019-11-11,82,16564,2294,3,18943
690,2019-11-12,89,13126,3081,0,16296
690,2019-11-13,95,13430,2086,2,15613
690,2019-11-14,87,13287,2257,1,15632
690,2019-11-15,76,4951,1877,1,6905
690,2019-11-16,97,2869,2431,0,5397
690,2019-11-17,196,5415,3201,0,8812
690,2019-11-18,113,3346,2803,0,6262
690,2019-11-19,135,5844,2787,2,8768
690,2019-11-20,127,1374,1845,2,3348
690,2019-11-21,111,3749,2248,0,6108
690,2019-11-22,101,5608,2081,2,7792
693,2019-08-11,14,5,251,0,270
693,2019-08-12,96,334,104,0,534
693,2019-08-13,136,585,205,0,926
693,2019-08-14,154,1058,77,1,1290
693,2019-08-15,182,536,83,0,801
693,2019-08-16,142,421,112,0,675
693,2019-08-17,91,2251,721,1,3064
693,2019-08-18,982,3229,1202,0,5413
693,2019-08-19,415,3603,950,0,4968
693,2019-08-20,180,2548,2027,0,4755
693,2019-08-21,462,1250,1594,1,3307
693,2019-08-22,126,4194,1659,1,5980
693,2019-08-23,130,1306,1046,2,2484
693,2019-08-24,130,5908,1465,1,7504
693,2019-08-25,986,8550,1775,3,11314
693,2019-08-26,2168,23235,2223,0,27626
693,2019-08-27,195,6342,2178,1,8716
693,2019-08-28,137,21564,1494,1,23196
693,2019-08-29,137,16041,1414,0,17592
693,2019-08-30,113,2750,732,2,3597
693,2019-08-31,46,185,0,0,231
693,2019-09-01,233,498,364,1,1096
693,2019-09-02,225,376,3,0,604
693,2019-09-03,93,1235,1092,0,2420
693,2019-09-04,106,10564,2255,2,12927
693,2019-09-05,994,6154,3061,3,10212
693,2019-09-06,1016,11855,1916,0,14787
693,2019-09-07,298,14749,1286,1,16334
693,2019-09-08,213,30053,1538,0,31804
693,2019-09-09,117,6507,2129,0,8753
693,2019-09-10,236,8446,1885,1,10568
693,2019-09-11,981,7232,2639,4,10856
693,2019-09-12,66,6747,2050,1,8864
693,2019-09-13,155,2773,1980,0,4908
693,2019-09-14,155,6702,2157,1,9015
693,2019-09-15,75,5990,1724,1,7790
693,2019-09-16,98,14617,2097,1,16813
693,2019-09-17,196,10756,1812,0,12764
693,2019-09-18,118,11110,938,2,12168
693,2019-09-19,214,3469,1974,1,5658
693,2019-09-20,221,8549,999,2,9771
693,2019-09-21,117,7846,2520,0,10483
693,2019-09-22,1780,13030,1153,1,15964
693,2019-09-23,231,12400,1720,2,14353
693,2019-09-24,153,12918,1444,4,14519
693,2019-09-25,258,9924,1634,3,11819
693,2019-09-26,142,12856,1401,0,14399
693,2019-09-27,105,9143,1491,2,10741
693,2019-09-28,271,25334,1790,0,27395
693,2019-09-29,155,19064,1302,1,20522
693,2019-09-30,100,18583,2506,3,21192
693,2019-10-01,889,22236,1794,0,24919
693,2019-10-02,106,18113,3015,2,21236
693,2019-10-03,131,13560,1236,0,14927
693,2019-10-04,621,18659,1536,3,20819
693,2019-10-05,181,25433,1891,1,27506
693,2019-10-06,397,17132,1568,1,19098
693,2019-10-07,1011,6687,1738,1,9437
693,2019-10-08,152,19083,2029,2,21266
693,2019-10-09,652,18787,1490,0,20929
693,2019-10-10,1007,17338,1583,4,19932
693,2019-10-11,99,15807,1434,1,17341
693,2019-10-12,951,12236,2362,0,15549
693,2019-10-13,657,11692,1850,0,14199
693,2019-10-14,185,12036,1021,2,13244
693,2019-10-15,754,15561,1243,8,17566
693,2019-10-16,118,25116,1662,1,26897
693,2019-10-17,957,8787,1576,0,11320
693,2019-10-18,846,3840,1932,1,6619
693,2019-10-19,1849,3158,2080,0,7087
693,2019-10-20,176,3160,1838,2,5176
693,2019-10-21,1067,11155,1659,1,13882
693,2019-10-22,98,7051,1440,2,8591
693,2019-10-23,70,9782,2038,0,11890
693,2019-10-24,720,20525,1619,2,22866
693,2019-10-25,182,15362,1789,3,17336
693,2019-10-26,134,24005,1653,0,25792
693,2019-10-27,151,31141,1467,1,32760
693,2019-10-28,529,25259,2008,0,27796
693,2019-10-29,157,29668,1524,0,31349
693,2019-10-30,86,21139,1426,6,22657
693,2019-10-31,856,20715,1809,0,23380
693,2019-11-01,93,27638,1761,0,29492
693,2019-11-02,96,17595,1727,1,19419
693,2019-11-03,85,23397,1420,0,24902
693,2019-11-04,1466,10744,1827,2,14039
693,2019-11-05,145,3513,1390,1,5049
693,2019-11-06,170,12264,1248,0,13682
693,2019-11-07,537,22794,1204,4,24539
693,2019-11-08,85,12686,1620,2,14393
693,2019-11-09,121,18729,1922,1,20773
693,2019-11-10,653,14849,2066,0,17568
693,2019-11-11,343,14503,2090,0,16936
693,2019-11-12,96,18832,2536,0,21464
693,2019-11-13,184,14554,1797,0,16535
693,2019-11-14,175,8869,2116,0,11160
693,2019-11-15,128,3872,2544,0,6544
693,2019-11-16,116,2665,2618,0,5399
693,2019-11-17,205,3610,3731,0,7546
693,2019-11-18,126,2668,2906,0,5700
693,2019-11-19,130,5737,2761,0,8628
693,2019-11-20,151,1296,2076,0,3523
693,2019-11-21,117,5871,2060,0,8048
693,2019-11-22,141,6064,2029,4,8238
693,2019-11-23,111,6427,2962,1,9501
693,2019-11-24,133,6656,1918,1,8708
693,2019-11-25,88,7775,2052,0,9915
693,2019-11-26,72,6377,2140,0,8589
693,2019-11-27,62,6550,2495,0,9107
693,2019-11-28,1030,2037,599,1,3667
693,2019-11-29,30,0,1,0,31
693,2019-08-11,14,5,251,0,270
693,2019-08-12,96,334,104,0,534
693,2019-08-13,136,585,205,0,926
693,2019-08-14,154,1058,77,1,1290
693,2019-08-15,182,536,83,0,801
693,2019-08-16,142,421,112,0,675
693,2019-08-17,91,2251,721,1,3064
693,2019-08-18,982,3229,1202,0,5413
693,2019-08-19,415,3603,950,0,4968
693,2019-08-20,180,2548,2027,0,4755
693,2019-08-21,462,1250,1594,1,3307
693,2019-08-22,126,4194,1659,1,5980
693,2019-08-23,130,1306,1046,2,2484
693,2019-08-24,130,5908,1465,1,7504
693,2019-08-25,986,8550,1775,3,11314
693,2019-08-26,2168,23235,2223,0,27626
693,2019-08-27,195,6342,2178,1,8716
693,2019-08-28,137,21564,1494,1,23196
693,2019-08-29,137,16041,1414,0,17592
693,2019-08-30,113,2750,732,2,3597
693,2019-08-31,46,185,0,0,231
693,2019-09-01,233,498,364,1,1096
693,2019-09-02,225,376,3,0,604
693,2019-09-03,93,1235,1092,0,2420
693,2019-09-04,106,10564,2255,2,12927
693,2019-09-05,994,6154,3061,3,10212
693,2019-09-06,1016,11855,1916,0,14787
693,2019-09-07,298,14749,1286,1,16334
693,2019-09-08,213,30053,1538,0,31804
693,2019-09-09,117,6507,2129,0,8753
693,2019-09-10,236,8446,1885,1,10568
693,2019-09-11,981,7232,2639,4,10856
693,2019-09-12,66,6747,2050,1,8864
693,2019-09-13,155,2773,1980,0,4908
693,2019-09-14,155,6702,2157,1,9015
693,2019-09-15,75,5990,1724,1,7790
693,2019-09-16,98,14617,2097,1,16813
693,2019-09-17,196,10756,1812,0,12764
693,2019-09-18,118,11110,938,2,12168
693,2019-09-19,214,3469,1974,1,5658
693,2019-09-20,221,8549,999,2,9771
693,2019-09-21,117,7846,2520,0,10483
693,2019-09-22,1780,13030,1153,1,15964
693,2019-09-23,231,12400,1720,2,14353
693,2019-09-24,153,12918,1444,4,14519
693,2019-09-25,258,9924,1634,3,11819
693,2019-09-26,142,12856,1401,0,14399
693,2019-09-27,105,9143,1491,2,10741
693,2019-09-28,271,25334,1790,0,27395
693,2019-09-29,155,19064,1302,1,20522
693,2019-09-30,100,18583,2506,3,21192
693,2019-10-01,889,22236,1794,0,24919
693,2019-10-02,106,18113,3015,2,21236
693,2019-10-03,131,13560,1236,0,14927
693,2019-10-04,621,18659,1536,3,20819
693,2019-10-05,181,25433,1891,1,27506
693,2019-10-06,397,17132,1568,1,19098
693,2019-10-07,1011,6687,1738,1,9437
693,2019-10-08,152,19083,2029,2,21266
693,2019-10-09,652,18787,1490,0,20929
693,2019-10-10,1007,17338,1583,4,19932
693,2019-10-11,99,15807,1434,1,17341
693,2019-10-12,951,12236,2362,0,15549
693,2019-10-13,657,11692,1850,0,14199
693,2019-10-14,185,12036,1021,2,13244
693,2019-10-15,754,15561,1243,8,17566
693,2019-10-16,118,25116,1662,1,26897
693,2019-10-17,957,8787,1576,0,11320
693,2019-10-18,846,3840,1932,1,6619
693,2019-10-19,1849,3158,2080,0,7087
693,2019-10-20,176,3160,1838,2,5176
693,2019-10-21,1067,11155,1659,1,13882
693,2019-10-22,98,7051,1440,2,8591
693,2019-10-23,70,9782,2038,0,11890
693,2019-10-24,720,20525,1619,2,22866
693,2019-10-25,182,15362,1789,3,17336
693,2019-10-26,134,24005,1653,0,25792
693,2019-10-27,151,31141,1467,1,32760
693,2019-10-28,529,25259,2008,0,27796
693,2019-10-29,157,29668,1524,0,31349
693,2019-10-30,86,21139,1426,6,22657
693,2019-10-31,856,20715,1809,0,23380
693,2019-11-01,93,27638,1761,0,29492
693,2019-11-02,96,17595,1727,1,19419
693,2019-11-03,85,23397,1420,0,24902
693,2019-11-04,1466,10744,1827,2,14039
693,2019-11-05,145,3513,1390,1,5049
693,2019-11-06,170,12264,1248,0,13682
693,2019-11-07,537,22794,1204,4,24539
693,2019-11-08,85,12686,1620,2,14393
693,2019-11-09,121,18729,1922,1,20773
693,2019-11-10,653,14849,2066,0,17568
693,2019-11-11,343,14503,2090,0,16936
693,2019-11-12,96,18832,2536,0,21464
693,2019-11-13,184,14554,1797,0,16535
693,2019-11-14,175,8869,2116,0,11160
693,2019-11-15,128,3872,2544,0,6544
693,2019-11-16,116,2665,2618,0,5399
693,2019-11-17,205,3610,3731,0,7546
693,2019-11-18,126,2668,2906,0,5700
693,2019-11-19,130,5737,2761,0,8628
693,2019-11-20,151,1296,2076,0,3523
693,2019-11-21,117,5871,2060,0,8048
693,2019-11-22,141,6064,2029,4,8238
693,2019-11-23,111,6427,2962,1,9501
693,2019-11-24,133,6656,1918,1,8708
693,2019-11-25,88,7775,2052,0,9915
693,2019-11-26,72,6377,2140,0,8589
693,2019-11-27,62,6550,2495,0,9107
693,2019-11-28,1030,2037,599,1,3667
693,2019-08-11,14,5,251,0,270
693,2019-08-12,96,334,104,0,534
693,2019-08-13,136,585,205,0,926
693,2019-08-14,154,1058,77,1,1290
693,2019-08-15,182,536,83,0,801
693,2019-08-16,142,421,112,0,675
693,2019-08-17,91,2251,721,1,3064
693,2019-08-18,982,3229,1202,0,5413
693,2019-08-19,415,3603,950,0,4968
693,2019-08-20,180,2548,2027,0,4755
693,2019-08-21,462,1250,1594,1,3307
693,2019-08-22,126,4194,1659,1,5980
693,2019-08-23,130,1306,1046,2,2484
693,2019-08-24,130,5908,1465,1,7504
693,2019-08-25,986,8550,1775,3,11314
693,2019-08-26,2168,23235,2223,0,27626
693,2019-08-27,195,6342,2178,1,8716
693,2019-08-28,137,21564,1494,1,23196
693,2019-08-29,137,16041,1414,0,17592
693,2019-08-30,113,2750,732,2,3597
693,2019-08-31,46,185,0,0,231
693,2019-09-01,233,498,364,1,1096
693,2019-09-02,225,376,3,0,604
693,2019-09-03,93,1235,1092,0,2420
693,2019-09-04,106,10564,2255,2,12927
693,2019-09-05,994,6154,3061,3,10212
693,2019-09-06,1016,11855,1916,0,14787
693,2019-09-07,298,14749,1286,1,16334
693,2019-09-08,213,30053,1538,0,31804
693,2019-09-09,117,6507,2129,0,8753
693,2019-09-10,236,8446,1885,1,10568
693,2019-09-11,981,7232,2639,4,10856
693,2019-09-12,66,6747,2050,1,8864
693,2019-09-13,155,2773,1980,0,4908
693,2019-09-14,155,6702,2157,1,9015
693,2019-09-15,75,5990,1724,1,7790
693,2019-09-16,98,14617,2097,1,16813
693,2019-09-17,196,10756,1812,0,12764
693,2019-09-18,118,11110,938,2,12168
693,2019-09-19,214,3469,1974,1,5658
693,2019-09-20,221,8549,999,2,9771
693,2019-09-21,117,7846,2520,0,10483
693,2019-09-22,1780,13030,1153,1,15964
693,2019-09-23,231,12400,1720,2,14353
693,2019-09-24,153,12918,1444,4,14519
693,2019-09-25,258,9924,1634,3,11819
693,2019-09-26,142,12856,1401,0,14399
693,2019-09-27,105,9143,1491,2,10741
693,2019-09-28,271,25334,1790,0,27395
693,2019-09-29,155,19064,1302,1,20522
693,2019-09-30,100,18583,2506,3,21192
693,2019-10-01,889,22236,1794,0,24919
693,2019-10-02,106,18113,3015,2,21236
693,2019-10-03,131,13560,1236,0,14927
693,2019-10-04,621,18659,1536,3,20819
693,2019-10-05,181,25433,1891,1,27506
693,2019-10-06,397,17132,1568,1,19098
693,2019-10-07,1011,6687,1738,1,9437
693,2019-10-08,152,19083,2029,2,21266
693,2019-10-09,652,18787,1490,0,20929
693,2019-10-10,1007,17338,1583,4,19932
693,2019-10-11,99,15807,1434,1,17341
693,2019-10-12,951,12236,2362,0,15549
693,2019-10-13,657,11692,1850,0,14199
693,2019-10-14,185,12036,1021,2,13244
693,2019-10-15,754,15561,1243,8,17566
693,2019-10-16,118,25116,1662,1,26897
693,2019-10-17,957,8787,1576,0,11320
693,2019-10-18,846,3840,1932,1,6619
693,2019-10-19,1849,3158,2080,0,7087
693,2019-10-20,176,3160,1838,2,5176
693,2019-10-21,1067,11155,1659,1,13882
693,2019-10-22,98,7051,1440,2,8591
693,2019-10-23,70,9782,2038,0,11890
693,2019-10-24,720,20525,1619,2,22866
693,2019-10-25,182,15362,1789,3,17336
693,2019-10-26,134,24005,1653,0,25792
693,2019-10-27,151,31141,1467,1,32760
693,2019-10-28,529,25259,2008,0,27796
693,2019-10-29,157,29668,1524,0,31349
693,2019-10-30,86,21139,1426,6,22657
693,2019-10-31,856,20715,1809,0,23380
693,2019-11-01,93,27638,1761,0,29492
693,2019-11-02,96,17595,1727,1,19419
693,2019-11-03,85,23397,1420,0,24902
693,2019-11-04,1466,10744,1827,2,14039
693,2019-11-05,145,3513,1390,1,5049
693,2019-11-06,170,12264,1248,0,13682
693,2019-11-07,537,22794,1204,4,24539
693,2019-11-08,85,12686,1620,2,14393
693,2019-11-09,121,18729,1922,1,20773
693,2019-11-10,653,14849,2066,0,17568
693,2019-11-11,343,14503,2090,0,16936
693,2019-11-12,96,18832,2536,0,21464
693,2019-11-13,184,14554,1797,0,16535
693,2019-11-14,175,8869,2116,0,11160
693,2019-11-15,128,3872,2544,0,6544
693,2019-11-16,116,2665,2618,0,5399
693,2019-11-17,205,3610,3731,0,7546
693,2019-11-18,126,2668,2906,0,5700
693,2019-11-19,130,5737,2761,0,8628
693,2019-11-20,151,1296,2076,0,3523
693,2019-11-21,117,5871,2060,0,8048
693,2019-11-22,141,6064,2029,4,8238
693,2019-11-23,111,6427,2962,1,9501
693,2019-11-24,133,6656,1918,1,8708
693,2019-11-25,88,7775,2052,0,9915
693,2019-11-26,72,6377,2140,0,8589
693,2019-11-27,62,6550,2495,0,9107
693,2019-11-28,1030,2037,599,1,3667
693,2019-11-29,30,0,1,0,31
693,2019-08-14,154,1058,77,1,1290
693,2019-08-15,182,536,83,0,801
693,2019-08-16,142,421,112,0,675
693,2019-08-17,91,2251,721,1,3064
693,2019-08-18,982,3229,1202,0,5413
693,2019-08-19,415,3603,950,0,4968
693,2019-08-20,180,2548,2027,0,4755
693,2019-08-21,462,1250,1594,1,3307
693,2019-08-22,126,4194,1659,1,5980
693,2019-08-23,130,1306,1046,2,2484
693,2019-08-24,130,5908,1465,1,7504
693,2019-08-25,986,8550,1775,3,11314
693,2019-08-26,2168,23235,2223,0,27626
693,2019-08-27,195,6342,2178,1,8716
693,2019-08-28,137,21564,1494,1,23196
693,2019-08-29,137,16041,1414,0,17592
693,2019-08-30,113,2750,732,2,3597
693,2019-08-31,46,185,0,0,231
693,2019-09-01,233,498,364,1,1096
693,2019-09-02,225,376,3,0,604
693,2019-09-03,93,1235,1092,0,2420
693,2019-09-04,106,10564,2255,2,12927
693,2019-09-05,994,6154,3061,3,10212
693,2019-09-06,1016,11855,1916,0,14787
693,2019-09-07,298,14749,1286,1,16334
693,2019-09-08,213,30053,1538,0,31804
693,2019-09-09,117,6507,2129,0,8753
693,2019-09-10,236,8446,1885,1,10568
693,2019-09-11,981,7232,2639,4,10856
693,2019-09-12,66,6747,2050,1,8864
693,2019-09-13,155,2773,1980,0,4908
693,2019-09-14,155,6702,2157,1,9015
693,2019-09-15,75,5990,1724,1,7790
693,2019-09-16,98,14617,2097,1,16813
693,2019-09-17,196,10756,1812,0,12764
693,2019-09-18,118,11110,938,2,12168
693,2019-09-19,214,3469,1974,1,5658
693,2019-09-20,221,8549,999,2,9771
693,2019-09-21,117,7846,2520,0,10483
693,2019-09-22,1780,13030,1153,1,15964
693,2019-09-23,231,12400,1720,2,14353
693,2019-09-24,153,12918,1444,4,14519
693,2019-09-25,258,9924,1634,3,11819
693,2019-09-26,142,12856,1401,0,14399
693,2019-09-27,105,9143,1491,2,10741
693,2019-09-28,271,25334,1790,0,27395
693,2019-09-29,155,19064,1302,1,20522
693,2019-09-30,100,18583,2506,3,21192
693,2019-10-01,889,22236,1794,0,24919
693,2019-10-02,106,18113,3015,2,21236
693,2019-10-03,131,13560,1236,0,14927
693,2019-10-04,621,18659,1536,3,20819
693,2019-10-05,181,25433,1891,1,27506
693,2019-10-06,397,17132,1568,1,19098
693,2019-10-07,1011,6687,1738,1,9437
693,2019-10-08,152,19083,2029,2,21266
693,2019-10-09,652,18787,1490,0,20929
693,2019-10-10,1007,17338,1583,4,19932
693,2019-10-11,99,15807,1434,1,17341
693,2019-10-12,951,12236,2362,0,15549
693,2019-10-13,657,11692,1850,0,14199
693,2019-10-14,185,12036,1021,2,13244
693,2019-10-15,754,15561,1243,8,17566
693,2019-10-16,118,25116,1662,1,26897
693,2019-10-17,957,8787,1576,0,11320
693,2019-10-18,846,3840,1932,1,6619
693,2019-10-19,1849,3158,2080,0,7087
693,2019-10-20,176,3160,1838,2,5176
693,2019-10-21,1067,11155,1659,1,13882
693,2019-10-22,98,7051,1440,2,8591
693,2019-10-23,70,9782,2038,0,11890
693,2019-10-24,720,20525,1619,2,22866
693,2019-10-25,182,15362,1789,3,17336
693,2019-10-26,134,24005,1653,0,25792
693,2019-10-27,151,31141,1467,1,32760
693,2019-10-28,529,25259,2008,0,27796
693,2019-10-29,157,29668,1524,0,31349
693,2019-10-30,86,21139,1426,6,22657
693,2019-10-31,856,20715,1809,0,23380
693,2019-11-01,93,27638,1761,0,29492
693,2019-11-02,96,17595,1727,1,19419
693,2019-11-03,85,23397,1420,0,24902
693,2019-11-04,1466,10744,1827,2,14039
693,2019-11-05,145,3513,1390,1,5049
693,2019-11-06,170,12264,1248,0,13682
693,2019-11-07,537,22794,1204,4,24539
693,2019-11-08,85,12686,1620,2,14393
693,2019-11-09,121,18729,1922,1,20773
693,2019-11-10,653,14849,2066,0,17568
693,2019-11-11,343,14503,2090,0,16936
693,2019-11-12,96,18832,2536,0,21464
693,2019-11-13,184,14554,1797,0,16535
693,2019-11-14,175,8869,2116,0,11160
693,2019-11-15,128,3872,2544,0,6544
693,2019-11-16,116,2665,2618,0,5399
693,2019-11-17,205,3610,3731,0,7546
693,2019-11-18,126,2668,2906,0,5700
693,2019-11-19,130,5737,2761,0,8628
693,2019-11-20,151,1296,2076,0,3523
693,2019-11-21,117,5871,2060,0,8048
693,2019-11-22,141,6064,2029,4,8238
693,2019-11-23,111,6427,2962,1,9501
693,2019-11-24,133,6656,1918,1,8708
693,2019-11-25,88,7775,2052,0,9915
693,2019-11-26,72,6377,2140,0,8589
693,2019-11-27,62,6550,2495,0,9107
693,2019-11-28,1030,2037,599,1,3667
694,2019-08-11,15,37,218,0,270
694,2019-08-12,132,5095,217,0,5444
694,2019-08-13,488,4802,293,1,5584
694,2019-08-14,214,732,146,1,1093
694,2019-08-15,223,714,152,1,1090
694,2019-08-16,92,233,66,0,391
694,2019-08-17,248,1330,1117,3,2698
694,2019-08-18,935,826,677,0,2438
694,2019-08-19,633,8150,1070,0,9853
694,2019-08-20,149,13199,1224,0,14572
694,2019-08-21,491,11446,1331,0,13268
694,2019-08-22,1745,14209,1068,0,17022
694,2019-08-23,939,13864,1801,2,16606
694,2019-08-24,132,3547,1161,0,4840
694,2019-08-25,166,7782,1820,4,9772
694,2019-08-26,811,1766,1173,3,3753
694,2019-08-27,205,2240,1303,0,3748
694,2019-08-28,1010,12497,1350,1,14858
694,2019-08-29,149,12539,1260,0,13948
694,2019-08-30,136,2511,376,2,3025
694,2019-08-31,76,68,1,0,145
694,2019-09-01,656,335,273,0,1264
694,2019-09-02,35,241,92,1,369
694,2019-09-03,96,2309,1086,0,3491
694,2019-09-04,102,14998,2171,4,17275
694,2019-09-05,963,4993,2121,3,8080
694,2019-09-06,964,17897,1910,4,20775
694,2019-09-07,1074,6885,1521,1,9481
694,2019-09-08,323,6314,1982,1,8620
694,2019-09-09,197,6819,2086,1,9103
694,2019-09-10,182,6730,2666,2,9580
694,2019-09-11,178,5973,2691,1,8843
694,2019-09-12,1735,9140,1594,2,12471
694,2019-09-13,999,4049,2240,1,7289
694,2019-09-14,203,6741,2150,0,9094
694,2019-09-15,95,5590,2526,2,8213
694,2019-09-16,106,8885,1976,0,10967
694,2019-09-17,98,7563,2079,0,9740
694,2019-09-18,734,11116,1015,0,12865
694,2019-09-19,319,4112,1809,0,6240
694,2019-09-20,316,10874,2038,1,13229
694,2019-09-21,94,6810,1859,0,8763
694,2019-09-22,1425,13294,2384,0,17103
694,2019-09-23,193,9543,1617,1,11354
694,2019-09-24,1818,11128,1950,8,14904
694,2019-09-25,203,7840,2345,5,10393
694,2019-09-26,1867,8746,1857,1,12471
694,2019-09-27,827,8133,1431,4,10395
694,2019-09-28,551,15250,2163,3,17967
694,2019-09-29,114,17591,1899,1,19605
694,2019-09-30,477,16840,1658,3,18978
694,2019-10-01,83,15606,1307,0,16996
694,2019-10-02,972,11799,2432,2,15205
694,2019-10-03,115,13312,1072,2,14501
694,2019-10-04,395,17250,2141,0,19786
694,2019-10-05,1726,22507,937,2,25172
694,2019-10-06,745,15687,2028,2,18462
694,2019-10-07,230,4812,1990,1,7033
694,2019-10-08,1535,16895,1076,1,19507
694,2019-10-09,114,16474,1594,6,18188
694,2019-10-10,1123,9499,1886,2,12510
694,2019-10-11,206,9053,2140,1,11400
694,2019-10-12,172,5712,1691,2,7577
694,2019-10-13,93,7171,1837,2,9103
694,2019-10-14,129,5483,2162,2,7776
694,2019-10-15,963,13295,1955,2,16215
694,2019-10-16,117,23883,1220,1,25221
694,2019-10-17,1645,6641,2385,0,10671
694,2019-10-18,286,7606,2237,0,10129
694,2019-10-19,87,3778,1197,2,5064
694,2019-10-20,159,1031,1829,3,3022
694,2019-10-21,254,9488,1598,2,11342
694,2019-10-22,977,6044,1017,1,8039
694,2019-10-23,55,6978,2596,1,9630
694,2019-10-24,1094,13005,2647,2,16748
694,2019-10-25,408,10258,1650,4,12320
694,2019-10-26,104,13051,1480,0,14635
694,2019-10-27,135,13580,2063,1,15779
694,2019-10-28,834,22381,2546,2,25763
694,2019-10-29,161,17485,1579,1,19226
694,2019-10-30,69,15028,1809,3,16909
694,2019-10-31,56,11428,1730,1,13215
694,2019-11-01,748,14107,2464,0,17319
694,2019-11-02,71,12817,1719,0,14607
694,2019-11-03,519,21645,1340,0,23504
694,2019-11-04,109,6363,1473,2,7947
694,2019-11-05,988,1885,2111,1,4985
694,2019-11-06,1022,7406,1055,2,9485
694,2019-11-07,224,21976,1469,1,23670
694,2019-11-08,81,16680,1519,0,18280
694,2019-11-09,177,10514,1698,2,12391
694,2019-11-10,1995,21772,2148,0,25915
694,2019-11-11,124,14747,2365,1,17237
694,2019-11-12,187,11483,3135,1,14806
694,2019-11-13,107,20107,1731,3,21948
694,2019-11-14,75,13922,1471,4,15472
694,2019-11-15,117,3042,2579,0,5738
694,2019-11-16,125,1160,2247,1,3533
694,2019-11-17,217,2287,3501,1,6006
694,2019-11-18,1087,2061,2831,2,5981
694,2019-11-19,148,5027,3011,6,8192
694,2019-11-20,139,889,1685,0,2713
694,2019-11-21,113,5448,1722,2,7285
694,2019-11-22,87,4973,1676,1,6737
694,2019-11-23,1028,5944,2334,2,9308
694,2019-11-24,148,6040,1795,4,7987
694,2019-11-25,454,5809,2314,893,9470
694,2019-11-26,1147,4786,1507,0,7440
694,2019-11-27,103,5178,1240,1,6522
694,2019-11-28,719,7199,621,0,8539
694,2019-11-29,255,650,2,0,907
694,2019-08-11,15,37,218,0,270
694,2019-08-12,132,5095,217,0,5444
694,2019-08-13,488,4802,293,1,5584
694,2019-08-14,214,732,146,1,1093
694,2019-08-15,223,714,152,1,1090
694,2019-08-16,92,233,66,0,391
694,2019-08-17,248,1330,1117,3,2698
694,2019-08-18,935,826,677,0,2438
694,2019-08-19,633,8150,1070,0,9853
694,2019-08-20,149,13199,1224,0,14572
694,2019-08-21,491,11446,1331,0,13268
694,2019-08-22,1745,14209,1068,0,17022
694,2019-08-23,939,13864,1801,2,16606
694,2019-08-24,132,3547,1161,0,4840
694,2019-08-25,166,7782,1820,4,9772
694,2019-08-26,811,1766,1173,3,3753
694,2019-08-27,205,2240,1303,0,3748
694,2019-08-28,1010,12497,1350,1,14858
694,2019-08-29,149,12539,1260,0,13948
694,2019-08-30,136,2511,376,2,3025
694,2019-08-31,76,68,1,0,145
694,2019-09-01,656,335,273,0,1264
694,2019-09-02,35,241,92,1,369
694,2019-09-03,96,2309,1086,0,3491
694,2019-09-04,102,14998,2171,4,17275
694,2019-09-05,963,4993,2121,3,8080
694,2019-09-06,964,17897,1910,4,20775
694,2019-09-07,1074,6885,1521,1,9481
694,2019-09-08,323,6314,1982,1,8620
694,2019-09-09,197,6819,2086,1,9103
694,2019-09-10,182,6730,2666,2,9580
694,2019-09-11,178,5973,2691,1,8843
694,2019-09-12,1735,9140,1594,2,12471
694,2019-09-13,999,4049,2240,1,7289
694,2019-09-14,203,6741,2150,0,9094
694,2019-09-15,95,5590,2526,2,8213
694,2019-09-16,106,8885,1976,0,10967
694,2019-09-17,98,7563,2079,0,9740
694,2019-09-18,734,11116,1015,0,12865
694,2019-09-19,319,4112,1809,0,6240
694,2019-09-20,316,10874,2038,1,13229
694,2019-09-21,94,6810,1859,0,8763
694,2019-09-22,1425,13294,2384,0,17103
694,2019-09-23,193,9543,1617,1,11354
694,2019-09-24,1818,11128,1950,8,14904
694,2019-09-25,203,7840,2345,5,10393
694,2019-09-26,1867,8746,1857,1,12471
694,2019-09-27,827,8133,1431,4,10395
694,2019-09-28,551,15250,2163,3,17967
694,2019-09-29,114,17591,1899,1,19605
694,2019-09-30,477,16840,1658,3,18978
694,2019-10-01,83,15606,1307,0,16996
694,2019-10-02,972,11799,2432,2,15205
694,2019-10-03,115,13312,1072,2,14501
694,2019-10-04,395,17250,2141,0,19786
694,2019-10-05,1726,22507,937,2,25172
694,2019-10-06,745,15687,2028,2,18462
694,2019-10-07,230,4812,1990,1,7033
694,2019-10-08,1535,16895,1076,1,19507
694,2019-10-09,114,16474,1594,6,18188
694,2019-10-10,1123,9499,1886,2,12510
694,2019-10-11,206,9053,2140,1,11400
694,2019-10-12,172,5712,1691,2,7577
694,2019-10-13,93,7171,1837,2,9103
694,2019-10-14,129,5483,2162,2,7776
694,2019-10-15,963,13295,1955,2,16215
694,2019-10-16,117,23883,1220,1,25221
694,2019-10-17,1645,6641,2385,0,10671
694,2019-10-18,286,7606,2237,0,10129
694,2019-10-19,87,3778,1197,2,5064
694,2019-10-20,159,1031,1829,3,3022
694,2019-10-21,254,9488,1598,2,11342
694,2019-10-22,977,6044,1017,1,8039
694,2019-10-23,55,6978,2596,1,9630
694,2019-10-24,1094,13005,2647,2,16748
694,2019-10-25,408,10258,1650,4,12320
694,2019-10-26,104,13051,1480,0,14635
694,2019-10-27,135,13580,2063,1,15779
694,2019-10-28,834,22381,2546,2,25763
694,2019-10-29,161,17485,1579,1,19226
694,2019-10-30,69,15028,1809,3,16909
694,2019-10-31,56,11428,1730,1,13215
694,2019-11-01,748,14107,2464,0,17319
694,2019-11-02,71,12817,1719,0,14607
694,2019-11-03,519,21645,1340,0,23504
694,2019-11-04,109,6363,1473,2,7947
694,2019-11-05,988,1885,2111,1,4985
694,2019-11-06,1022,7406,1055,2,9485
694,2019-11-07,224,21976,1469,1,23670
694,2019-11-08,81,16680,1519,0,18280
694,2019-11-09,177,10514,1698,2,12391
694,2019-11-10,1995,21772,2148,0,25915
694,2019-11-11,124,14747,2365,1,17237
694,2019-11-12,187,11483,3135,1,14806
694,2019-11-13,107,20107,1731,3,21948
694,2019-11-14,75,13922,1471,4,15472
694,2019-11-15,117,3042,2579,0,5738
694,2019-11-16,125,1160,2247,1,3533
694,2019-11-17,217,2287,3501,1,6006
694,2019-11-18,1087,2061,2831,2,5981
694,2019-11-19,148,5027,3011,6,8192
694,2019-11-20,139,889,1685,0,2713
694,2019-11-21,113,5448,1722,2,7285
694,2019-11-22,87,4973,1676,1,6737
694,2019-11-23,1028,5944,2334,2,9308
694,2019-11-24,148,6040,1795,4,7987
694,2019-11-25,454,5809,2314,893,9470
694,2019-11-26,1147,4786,1507,0,7440
694,2019-11-27,103,5178,1240,1,6522
694,2019-11-28,719,7199,621,0,8539
694,2019-11-29,255,650,2,0,907
694,2019-08-11,15,37,218,0,270
694,2019-08-12,132,5095,217,0,5444
694,2019-08-13,488,4802,293,1,5584
694,2019-08-14,214,732,146,1,1093
694,2019-08-15,223,714,152,1,1090
694,2019-08-16,92,233,66,0,391
694,2019-08-17,248,1330,1117,3,2698
694,2019-08-18,935,826,677,0,2438
694,2019-08-19,633,8150,1070,0,9853
694,2019-08-20,149,13199,1224,0,14572
694,2019-08-21,491,11446,1331,0,13268
694,2019-08-22,1745,14209,1068,0,17022
694,2019-08-23,939,13864,1801,2,16606
694,2019-08-24,132,3547,1161,0,4840
694,2019-08-25,166,7782,1820,4,9772
694,2019-08-26,811,1766,1173,3,3753
694,2019-08-27,205,2240,1303,0,3748
694,2019-08-28,1010,12497,1350,1,14858
694,2019-08-29,149,12539,1260,0,13948
694,2019-08-30,136,2511,376,2,3025
694,2019-08-31,76,68,1,0,145
694,2019-09-01,656,335,273,0,1264
694,2019-09-02,35,241,92,1,369
694,2019-09-03,96,2309,1086,0,3491
694,2019-09-04,102,14998,2171,4,17275
694,2019-09-05,963,4993,2121,3,8080
694,2019-09-06,964,17897,1910,4,20775
694,2019-09-07,1074,6885,1521,1,9481
694,2019-09-08,323,6314,1982,1,8620
694,2019-09-09,197,6819,2086,1,9103
694,2019-09-10,182,6730,2666,2,9580
694,2019-09-11,178,5973,2691,1,8843
694,2019-09-12,1735,9140,1594,2,12471
694,2019-09-13,999,4049,2240,1,7289
694,2019-09-14,203,6741,2150,0,9094
694,2019-09-15,95,5590,2526,2,8213
694,2019-09-16,106,8885,1976,0,10967
694,2019-09-17,98,7563,2079,0,9740
694,2019-09-18,734,11116,1015,0,12865
694,2019-09-19,319,4112,1809,0,6240
694,2019-09-20,316,10874,2038,1,13229
694,2019-09-21,94,6810,1859,0,8763
694,2019-09-22,1425,13294,2384,0,17103
694,2019-09-23,193,9543,1617,1,11354
694,2019-09-24,1818,11128,1950,8,14904
694,2019-09-25,203,7840,2345,5,10393
694,2019-09-26,1867,8746,1857,1,12471
694,2019-09-27,827,8133,1431,4,10395
694,2019-09-28,551,15250,2163,3,17967
694,2019-09-29,114,17591,1899,1,19605
694,2019-09-30,477,16840,1658,3,18978
694,2019-10-01,83,15606,1307,0,16996
694,2019-10-02,972,11799,2432,2,15205
694,2019-10-03,115,13312,1072,2,14501
694,2019-10-04,395,17250,2141,0,19786
694,2019-10-05,1726,22507,937,2,25172
694,2019-10-06,745,15687,2028,2,18462
694,2019-10-07,230,4812,1990,1,7033
694,2019-10-08,1535,16895,1076,1,19507
694,2019-10-09,114,16474,1594,6,18188
694,2019-10-10,1123,9499,1886,2,12510
694,2019-10-11,206,9053,2140,1,11400
694,2019-10-12,172,5712,1691,2,7577
694,2019-10-13,93,7171,1837,2,9103
694,2019-10-14,129,5483,2162,2,7776
694,2019-10-15,963,13295,1955,2,16215
694,2019-10-16,117,23883,1220,1,25221
694,2019-10-17,1645,6641,2385,0,10671
694,2019-10-18,286,7606,2237,0,10129
694,2019-10-19,87,3778,1197,2,5064
694,2019-10-20,159,1031,1829,3,3022
694,2019-10-21,254,9488,1598,2,11342
694,2019-10-22,977,6044,1017,1,8039
694,2019-10-23,55,6978,2596,1,9630
694,2019-10-24,1094,13005,2647,2,16748
694,2019-10-25,408,10258,1650,4,12320
694,2019-10-26,104,13051,1480,0,14635
694,2019-10-27,135,13580,2063,1,15779
694,2019-10-28,834,22381,2546,2,25763
694,2019-10-29,161,17485,1579,1,19226
694,2019-10-30,69,15028,1809,3,16909
694,2019-10-31,56,11428,1730,1,13215
694,2019-11-01,748,14107,2464,0,17319
694,2019-11-02,71,12817,1719,0,14607
694,2019-11-03,519,21645,1340,0,23504
694,2019-11-04,109,6363,1473,2,7947
694,2019-11-05,988,1885,2111,1,4985
694,2019-11-06,1022,7406,1055,2,9485
694,2019-11-07,224,21976,1469,1,23670
694,2019-11-08,81,16680,1519,0,18280
694,2019-11-09,177,10514,1698,2,12391
694,2019-11-10,1995,21772,2148,0,25915
694,2019-11-11,124,14747,2365,1,17237
694,2019-11-12,187,11483,3135,1,14806
694,2019-11-13,107,20107,1731,3,21948
694,2019-11-14,75,13922,1471,4,15472
694,2019-11-15,117,3042,2579,0,5738
694,2019-11-16,125,1160,2247,1,3533
694,2019-11-17,217,2287,3501,1,6006
694,2019-11-18,1087,2061,2831,2,5981
694,2019-11-19,148,5027,3011,6,8192
694,2019-11-20,139,889,1685,0,2713
694,2019-11-21,113,5448,1722,2,7285
694,2019-11-22,87,4973,1676,1,6737
694,2019-11-23,1028,5944,2334,2,9308
694,2019-11-24,148,6040,1795,4,7987
694,2019-11-25,454,5809,2314,893,9470
694,2019-11-26,1147,4786,1507,0,7440
694,2019-11-27,103,5178,1240,1,6522
694,2019-11-28,719,7199,621,0,8539
694,2019-11-29,255,650,2,0,907
694,2019-08-13,488,4802,293,1,5584
694,2019-08-14,214,732,146,1,1093
694,2019-08-15,223,714,152,1,1090
694,2019-08-16,92,233,66,0,391
694,2019-08-17,248,1330,1117,3,2698
694,2019-08-18,935,826,677,0,2438
694,2019-08-19,633,8150,1070,0,9853
694,2019-08-20,149,13199,1224,0,14572
694,2019-08-21,491,11446,1331,0,13268
694,2019-08-22,1745,14209,1068,0,17022
694,2019-08-23,939,13864,1801,2,16606
694,2019-08-24,132,3547,1161,0,4840
694,2019-08-25,166,7782,1820,4,9772
694,2019-08-26,811,1766,1173,3,3753
694,2019-08-27,205,2240,1303,0,3748
694,2019-08-28,1010,12497,1350,1,14858
694,2019-08-29,149,12539,1260,0,13948
694,2019-08-30,136,2511,376,2,3025
694,2019-08-31,76,68,1,0,145
694,2019-09-01,656,335,273,0,1264
694,2019-09-02,35,241,92,1,369
694,2019-09-03,96,2309,1086,0,3491
694,2019-09-04,102,14998,2171,4,17275
694,2019-09-05,963,4993,2121,3,8080
694,2019-09-06,964,17897,1910,4,20775
694,2019-09-07,1074,6885,1521,1,9481
694,2019-09-08,323,6314,1982,1,8620
694,2019-09-09,197,6819,2086,1,9103
694,2019-09-10,182,6730,2666,2,9580
694,2019-09-11,178,5973,2691,1,8843
694,2019-09-12,1735,9140,1594,2,12471
694,2019-09-13,999,4049,2240,1,7289
694,2019-09-14,203,6741,2150,0,9094
694,2019-09-15,95,5590,2526,2,8213
694,2019-09-16,106,8885,1976,0,10967
694,2019-09-17,98,7563,2079,0,9740
694,2019-09-18,734,11116,1015,0,12865
694,2019-09-19,319,4112,1809,0,6240
694,2019-09-20,316,10874,2038,1,13229
694,2019-09-21,94,6810,1859,0,8763
694,2019-09-22,1425,13294,2384,0,17103
694,2019-09-23,193,9543,1617,1,11354
694,2019-09-24,1818,11128,1950,8,14904
694,2019-09-25,203,7840,2345,5,10393
694,2019-09-26,1867,8746,1857,1,12471
694,2019-09-27,827,8133,1431,4,10395
694,2019-09-28,551,15250,2163,3,17967
694,2019-09-29,114,17591,1899,1,19605
694,2019-09-30,477,16840,1658,3,18978
694,2019-10-01,83,15606,1307,0,16996
694,2019-10-02,972,11799,2432,2,15205
694,2019-10-03,115,13312,1072,2,14501
694,2019-10-04,395,17250,2141,0,19786
694,2019-10-05,1726,22507,937,2,25172
694,2019-10-06,745,15687,2028,2,18462
694,2019-10-07,230,4812,1990,1,7033
694,2019-10-08,1535,16895,1076,1,19507
694,2019-10-09,114,16474,1594,6,18188
694,2019-10-10,1123,9499,1886,2,12510
694,2019-10-11,206,9053,2140,1,11400
694,2019-10-12,172,5712,1691,2,7577
694,2019-10-13,93,7171,1837,2,9103
694,2019-10-14,129,5483,2162,2,7776
694,2019-10-15,963,13295,1955,2,16215
694,2019-10-16,117,23883,1220,1,25221
694,2019-10-17,1645,6641,2385,0,10671
694,2019-10-18,286,7606,2237,0,10129
694,2019-10-19,87,3778,1197,2,5064
694,2019-10-20,159,1031,1829,3,3022
694,2019-10-21,254,9488,1598,2,11342
694,2019-10-22,977,6044,1017,1,8039
694,2019-10-23,55,6978,2596,1,9630
694,2019-10-24,1094,13005,2647,2,16748
694,2019-10-25,408,10258,1650,4,12320
694,2019-10-26,104,13051,1480,0,14635
694,2019-10-27,135,13580,2063,1,15779
694,2019-10-28,834,22381,2546,2,25763
694,2019-10-29,161,17485,1579,1,19226
694,2019-10-30,69,15028,1809,3,16909
694,2019-10-31,56,11428,1730,1,13215
694,2019-11-01,748,14107,2464,0,17319
694,2019-11-02,71,12817,1719,0,14607
694,2019-11-03,519,21645,1340,0,23504
694,2019-11-04,109,6363,1473,2,7947
694,2019-11-05,988,1885,2111,1,4985
694,2019-11-06,1022,7406,1055,2,9485
694,2019-11-07,224,21976,1469,1,23670
694,2019-11-08,81,16680,1519,0,18280
694,2019-11-09,177,10514,1698,2,12391
694,2019-11-10,1995,21772,2148,0,25915
694,2019-11-11,124,14747,2365,1,17237
694,2019-11-12,187,11483,3135,1,14806
694,2019-11-13,107,20107,1731,3,21948
694,2019-11-14,75,13922,1471,4,15472
694,2019-11-15,117,3042,2579,0,5738
694,2019-11-16,125,1160,2247,1,3533
694,2019-11-17,217,2287,3501,1,6006
694,2019-11-18,1087,2061,2831,2,5981
694,2019-11-19,148,5027,3011,6,8192
694,2019-11-20,139,889,1685,0,2713
694,2019-11-21,113,5448,1722,2,7285
694,2019-11-22,87,4973,1676,1,6737
694,2019-11-23,1028,5944,2334,2,9308
694,2019-11-24,148,6040,1795,4,7987
694,2019-11-25,454,5809,2314,893,9470
694,2019-11-26,1147,4786,1507,0,7440
694,2019-11-27,103,5178,1240,1,6522
696,2019-08-12,5,4,134,0,143
696,2019-08-13,88,83,209,0,380
696,2019-08-14,98,1063,213,1,1375
696,2019-08-15,256,725,196,0,1177
696,2019-08-16,166,251,169,0,586
696,2019-08-17,215,761,809,1,1786
696,2019-08-18,222,3018,866,1,4107
696,2019-08-19,106,9169,850,1,10126
696,2019-08-20,232,14367,902,1,15502
696,2019-08-21,126,12106,1275,0,13507
696,2019-08-22,75,17180,1240,2,18497
696,2019-08-23,95,25544,1285,1,26925
696,2019-08-24,85,16170,1613,1,17869
696,2019-08-25,123,27525,1352,3,29003
696,2019-08-26,942,42036,1440,1,44419
696,2019-08-27,167,16538,1830,6,18541
696,2019-08-28,97,17153,1744,2,18996
696,2019-08-29,181,12406,1536,4,14127
696,2019-08-30,107,2545,276,0,2928
696,2019-08-31,21,92,5,0,118
696,2019-09-01,91,379,122,0,592
696,2019-09-02,16,62,49,0,127
696,2019-09-03,106,485,1131,1,1723
696,2019-09-04,77,13964,1949,2,15992
696,2019-09-05,204,8880,2117,0,11201
696,2019-09-06,151,15373,2169,2,17695
696,2019-09-07,270,14857,1565,0,16692
696,2019-09-08,197,8876,1530,1,10604
696,2019-09-09,80,17141,2096,2,19319
696,2019-09-10,1166,13226,1953,1,16346
696,2019-09-11,264,11118,2170,1,13553
696,2019-09-12,98,9138,1634,3,10873
696,2019-09-13,130,5827,2227,3,8187
696,2019-09-14,128,10468,1211,1,11808
696,2019-09-15,948,19489,2677,3,23117
696,2019-09-16,102,16795,2029,0,18926
696,2019-09-17,1206,12769,2169,0,16144
696,2019-09-18,163,26991,1355,1,28510
696,2019-09-19,194,10266,1890,2,12352
696,2019-09-20,2785,14268,1807,1,18861
696,2019-09-21,94,9203,2611,0,11908
696,2019-09-22,619,14324,1534,0,16477
696,2019-09-23,212,13180,2199,0,15591
696,2019-09-24,121,13391,1918,5,15435
696,2019-09-25,272,25495,1579,1,27347
696,2019-09-26,103,17230,2233,1,19567
696,2019-09-27,591,11003,1784,4,13382
696,2019-09-28,145,15880,1331,3,17359
696,2019-09-29,89,26860,1451,3,28403
696,2019-09-30,949,29825,1057,1,31832
696,2019-10-01,1789,28012,2081,2,31884
696,2019-10-02,993,14710,2707,0,18410
696,2019-10-03,729,14660,877,1,16267
696,2019-10-04,651,32365,898,3,33917
696,2019-10-05,1579,42769,1517,0,45865
696,2019-10-06,522,22036,1434,1,23993
696,2019-10-07,950,6916,2276,1,10143
696,2019-10-08,969,18530,1424,2,20925
696,2019-10-09,896,26633,2771,2,30302
696,2019-10-10,141,18461,2038,0,20640
696,2019-10-11,123,20327,1633,0,22083
696,2019-10-12,75,9757,1496,1,11329
696,2019-10-13,80,8846,1267,1,10194
696,2019-10-14,1872,6547,2526,2,10947
696,2019-10-15,113,8986,1641,0,10740
696,2019-10-16,81,18756,1237,2,20076
696,2019-10-17,83,8544,1909,1,10537
696,2019-10-18,1094,8919,2178,1,12192
696,2019-10-19,90,6149,1763,0,8002
696,2019-10-20,88,3145,1843,1,5077
696,2019-10-21,95,11090,1004,1,12190
696,2019-10-22,85,14745,1844,2,16676
696,2019-10-23,498,21130,1062,1,22691
696,2019-10-24,237,19211,1454,2,20904
696,2019-10-25,568,15967,2042,3,18580
696,2019-10-26,844,17551,1519,1,19915
696,2019-10-27,135,16859,1831,1,18826
696,2019-10-28,482,14335,1320,0,16137
696,2019-10-29,163,27513,1409,4,29089
696,2019-10-30,82,29559,1568,0,31209
696,2019-10-31,778,15300,1298,1,17377
696,2019-11-01,629,26293,986,0,27908
696,2019-11-02,965,26887,1049,0,28901
696,2019-11-03,97,25206,1453,3,26759
696,2019-11-04,177,8394,1807,0,10378
696,2019-11-05,208,3497,1794,0,5499
696,2019-11-06,245,14840,1055,1,16141
696,2019-11-07,200,16893,1681,4,18778
696,2019-11-08,96,10365,1558,1,12020
696,2019-11-09,707,9018,1842,1,11568
696,2019-11-10,1026,14228,1674,1,16929
696,2019-11-11,106,9619,2403,2,12130
696,2019-11-12,66,10516,3737,1,14320
696,2019-11-13,1422,14976,2847,4,19249
696,2019-11-14,72,13151,1710,1,14934
696,2019-11-15,183,5561,2857,1,8602
696,2019-11-16,967,3173,2453,0,6593
696,2019-11-17,86,5571,3158,0,8815
696,2019-11-18,112,2686,2936,2,5736
696,2019-11-19,1488,3236,2063,0,6787
696,2019-11-20,190,1520,2509,0,4219
696,2019-11-21,88,5845,2079,0,8012
696,2019-11-22,79,9295,1625,0,10999
696,2019-11-23,2373,6959,1970,0,11302
696,2019-11-24,122,6493,2733,0,9348
696,2019-11-25,99,7357,1680,0,9136
696,2019-11-26,283,6378,2299,0,8960
696,2019-11-27,73,6891,1660,0,8624
696,2019-11-28,77,9030,944,0,10051
696,2019-11-29,13,248,1,0,262
696,2019-08-12,5,4,134,0,143
696,2019-08-13,88,83,209,0,380
696,2019-08-14,98,1063,213,1,1375
696,2019-08-15,256,725,196,0,1177
696,2019-08-16,166,251,169,0,586
696,2019-08-17,215,761,809,1,1786
696,2019-08-18,222,3018,866,1,4107
696,2019-08-19,106,9169,850,1,10126
696,2019-08-20,232,14367,902,1,15502
696,2019-08-21,126,12106,1275,0,13507
696,2019-08-22,75,17180,1240,2,18497
696,2019-08-23,95,25544,1285,1,26925
696,2019-08-24,85,16170,1613,1,17869
696,2019-08-25,123,27525,1352,3,29003
696,2019-08-26,942,42036,1440,1,44419
696,2019-08-27,167,16538,1830,6,18541
696,2019-08-28,97,17153,1744,2,18996
696,2019-08-29,181,12406,1536,4,14127
696,2019-08-30,107,2545,276,0,2928
696,2019-08-31,21,92,5,0,118
696,2019-09-01,91,379,122,0,592
696,2019-09-02,16,62,49,0,127
696,2019-09-03,106,485,1131,1,1723
696,2019-09-04,77,13964,1949,2,15992
696,2019-09-05,204,8880,2117,0,11201
696,2019-09-06,151,15373,2169,2,17695
696,2019-09-07,270,14857,1565,0,16692
696,2019-09-08,197,8876,1530,1,10604
696,2019-09-09,80,17141,2096,2,19319
696,2019-09-10,1166,13226,1953,1,16346
696,2019-09-11,264,11118,2170,1,13553
696,2019-09-12,98,9138,1634,3,10873
696,2019-09-13,130,5827,2227,3,8187
696,2019-09-14,128,10468,1211,1,11808
696,2019-09-15,948,19489,2677,3,23117
696,2019-09-16,102,16795,2029,0,18926
696,2019-09-17,1206,12769,2169,0,16144
696,2019-09-18,163,26991,1355,1,28510
696,2019-09-19,194,10266,1890,2,12352
696,2019-09-20,2785,14268,1807,1,18861
696,2019-09-21,94,9203,2611,0,11908
696,2019-09-22,619,14324,1534,0,16477
696,2019-09-23,212,13180,2199,0,15591
696,2019-09-24,121,13391,1918,5,15435
696,2019-09-25,272,25495,1579,1,27347
696,2019-09-26,103,17230,2233,1,19567
696,2019-09-27,591,11003,1784,4,13382
696,2019-09-28,145,15880,1331,3,17359
696,2019-09-29,89,26860,1451,3,28403
696,2019-09-30,949,29825,1057,1,31832
696,2019-10-01,1789,28012,2081,2,31884
696,2019-10-02,993,14710,2707,0,18410
696,2019-10-03,729,14660,877,1,16267
696,2019-10-04,651,32365,898,3,33917
696,2019-10-05,1579,42769,1517,0,45865
696,2019-10-06,522,22036,1434,1,23993
696,2019-10-07,950,6916,2276,1,10143
696,2019-10-08,969,18530,1424,2,20925
696,2019-10-09,896,26633,2771,2,30302
696,2019-10-10,141,18461,2038,0,20640
696,2019-10-11,123,20327,1633,0,22083
696,2019-10-12,75,9757,1496,1,11329
696,2019-10-13,80,8846,1267,1,10194
696,2019-10-14,1872,6547,2526,2,10947
696,2019-10-15,113,8986,1641,0,10740
696,2019-10-16,81,18756,1237,2,20076
696,2019-10-17,83,8544,1909,1,10537
696,2019-10-18,1094,8919,2178,1,12192
696,2019-10-19,90,6149,1763,0,8002
696,2019-10-20,88,3145,1843,1,5077
696,2019-10-21,95,11090,1004,1,12190
696,2019-10-22,85,14745,1844,2,16676
696,2019-10-23,498,21130,1062,1,22691
696,2019-10-24,237,19211,1454,2,20904
696,2019-10-25,568,15967,2042,3,18580
696,2019-10-26,844,17551,1519,1,19915
696,2019-10-27,135,16859,1831,1,18826
696,2019-10-28,482,14335,1320,0,16137
696,2019-10-29,163,27513,1409,4,29089
696,2019-10-30,82,29559,1568,0,31209
696,2019-10-31,778,15300,1298,1,17377
696,2019-11-01,629,26293,986,0,27908
696,2019-11-02,965,26887,1049,0,28901
696,2019-11-03,97,25206,1453,3,26759
696,2019-11-04,177,8394,1807,0,10378
696,2019-11-05,208,3497,1794,0,5499
696,2019-11-06,245,14840,1055,1,16141
696,2019-11-07,200,16893,1681,4,18778
696,2019-11-08,96,10365,1558,1,12020
696,2019-11-09,707,9018,1842,1,11568
696,2019-11-10,1026,14228,1674,1,16929
696,2019-11-11,106,9619,2403,2,12130
696,2019-11-12,66,10516,3737,1,14320
696,2019-11-13,1422,14976,2847,4,19249
696,2019-11-14,72,13151,1710,1,14934
696,2019-11-15,183,5561,2857,1,8602
696,2019-11-16,967,3173,2453,0,6593
696,2019-11-17,86,5571,3158,0,8815
696,2019-11-18,112,2686,2936,2,5736
696,2019-11-19,1488,3236,2063,0,6787
696,2019-11-20,190,1520,2509,0,4219
696,2019-11-21,88,5845,2079,0,8012
696,2019-11-22,79,9295,1625,0,10999
696,2019-11-23,2373,6959,1970,0,11302
696,2019-11-24,122,6493,2733,0,9348
696,2019-11-25,99,7357,1680,0,9136
696,2019-11-26,283,6378,2299,0,8960
696,2019-11-27,73,6891,1660,0,8624
696,2019-11-28,77,9030,944,0,10051
696,2019-11-29,13,248,1,0,262
696,2019-08-12,5,4,134,0,143
696,2019-08-13,88,83,209,0,380
696,2019-08-14,98,1063,213,1,1375
696,2019-08-15,256,725,196,0,1177
696,2019-08-16,166,251,169,0,586
696,2019-08-17,215,761,809,1,1786
696,2019-08-18,222,3018,866,1,4107
696,2019-08-19,106,9169,850,1,10126
696,2019-08-20,232,14367,902,1,15502
696,2019-08-21,126,12106,1275,0,13507
696,2019-08-22,75,17180,1240,2,18497
696,2019-08-23,95,25544,1285,1,26925
696,2019-08-24,85,16170,1613,1,17869
696,2019-08-25,123,27525,1352,3,29003
696,2019-08-26,942,42036,1440,1,44419
696,2019-08-27,167,16538,1830,6,18541
696,2019-08-28,97,17153,1744,2,18996
696,2019-08-29,181,12406,1536,4,14127
696,2019-08-30,107,2545,276,0,2928
696,2019-08-31,21,92,5,0,118
696,2019-09-01,91,379,122,0,592
696,2019-09-02,16,62,49,0,127
696,2019-09-03,106,485,1131,1,1723
696,2019-09-04,77,13964,1949,2,15992
696,2019-09-05,204,8880,2117,0,11201
696,2019-09-06,151,15373,2169,2,17695
696,2019-09-07,270,14857,1565,0,16692
696,2019-09-08,197,8876,1530,1,10604
696,2019-09-09,80,17141,2096,2,19319
696,2019-09-10,1166,13226,1953,1,16346
696,2019-09-11,264,11118,2170,1,13553
696,2019-09-12,98,9138,1634,3,10873
696,2019-09-13,130,5827,2227,3,8187
696,2019-09-14,128,10468,1211,1,11808
696,2019-09-15,948,19489,2677,3,23117
696,2019-09-16,102,16795,2029,0,18926
696,2019-09-17,1206,12769,2169,0,16144
696,2019-09-18,163,26991,1355,1,28510
696,2019-09-19,194,10266,1890,2,12352
696,2019-09-20,2785,14268,1807,1,18861
696,2019-09-21,94,9203,2611,0,11908
696,2019-09-22,619,14324,1534,0,16477
696,2019-09-23,212,13180,2199,0,15591
696,2019-09-24,121,13391,1918,5,15435
696,2019-09-25,272,25495,1579,1,27347
696,2019-09-26,103,17230,2233,1,19567
696,2019-09-27,591,11003,1784,4,13382
696,2019-09-28,145,15880,1331,3,17359
696,2019-09-29,89,26860,1451,3,28403
696,2019-09-30,949,29825,1057,1,31832
696,2019-10-01,1789,28012,2081,2,31884
696,2019-10-02,993,14710,2707,0,18410
696,2019-10-03,729,14660,877,1,16267
696,2019-10-04,651,32365,898,3,33917
696,2019-10-05,1579,42769,1517,0,45865
696,2019-10-06,522,22036,1434,1,23993
696,2019-10-07,950,6916,2276,1,10143
696,2019-10-08,969,18530,1424,2,20925
696,2019-10-09,896,26633,2771,2,30302
696,2019-10-10,141,18461,2038,0,20640
696,2019-10-11,123,20327,1633,0,22083
696,2019-10-12,75,9757,1496,1,11329
696,2019-10-13,80,8846,1267,1,10194
696,2019-10-14,1872,6547,2526,2,10947
696,2019-10-15,113,8986,1641,0,10740
696,2019-10-16,81,18756,1237,2,20076
696,2019-10-17,83,8544,1909,1,10537
696,2019-10-18,1094,8919,2178,1,12192
696,2019-10-19,90,6149,1763,0,8002
696,2019-10-20,88,3145,1843,1,5077
696,2019-10-21,95,11090,1004,1,12190
696,2019-10-22,85,14745,1844,2,16676
696,2019-10-23,498,21130,1062,1,22691
696,2019-10-24,237,19211,1454,2,20904
696,2019-10-25,568,15967,2042,3,18580
696,2019-10-26,844,17551,1519,1,19915
696,2019-10-27,135,16859,1831,1,18826
696,2019-10-28,482,14335,1320,0,16137
696,2019-10-29,163,27513,1409,4,29089
696,2019-10-30,82,29559,1568,0,31209
696,2019-10-31,778,15300,1298,1,17377
696,2019-11-01,629,26293,986,0,27908
696,2019-11-02,965,26887,1049,0,28901
696,2019-11-03,97,25206,1453,3,26759
696,2019-11-04,177,8394,1807,0,10378
696,2019-11-05,208,3497,1794,0,5499
696,2019-11-06,245,14840,1055,1,16141
696,2019-11-07,200,16893,1681,4,18778
696,2019-11-08,96,10365,1558,1,12020
696,2019-11-09,707,9018,1842,1,11568
696,2019-11-10,1026,14228,1674,1,16929
696,2019-11-11,106,9619,2403,2,12130
696,2019-11-12,66,10516,3737,1,14320
696,2019-11-13,1422,14976,2847,4,19249
696,2019-11-14,72,13151,1710,1,14934
696,2019-11-15,183,5561,2857,1,8602
696,2019-11-16,967,3173,2453,0,6593
696,2019-11-17,86,5571,3158,0,8815
696,2019-11-18,112,2686,2936,2,5736
696,2019-11-19,1488,3236,2063,0,6787
696,2019-11-20,190,1520,2509,0,4219
696,2019-11-21,88,5845,2079,0,8012
696,2019-11-22,79,9295,1625,0,10999
696,2019-11-23,2373,6959,1970,0,11302
696,2019-11-24,122,6493,2733,0,9348
696,2019-11-25,99,7357,1680,0,9136
696,2019-11-26,283,6378,2299,0,8960
696,2019-11-27,73,6891,1660,0,8624
696,2019-11-28,77,9030,944,0,10051
696,2019-11-29,13,248,1,0,262
696,2019-08-14,98,1063,213,1,1375
696,2019-08-15,256,725,196,0,1177
696,2019-08-16,166,251,169,0,586
696,2019-08-17,215,761,809,1,1786
696,2019-08-18,222,3018,866,1,4107
696,2019-08-19,106,9169,850,1,10126
696,2019-08-20,232,14367,902,1,15502
696,2019-08-21,126,12106,1275,0,13507
696,2019-08-22,75,17180,1240,2,18497
696,2019-08-23,95,25544,1285,1,26925
696,2019-08-24,85,16170,1613,1,17869
696,2019-08-25,123,27525,1352,3,29003
696,2019-08-26,942,42036,1440,1,44419
696,2019-08-27,167,16538,1830,6,18541
696,2019-08-28,97,17153,1744,2,18996
696,2019-08-29,181,12406,1536,4,14127
696,2019-08-30,107,2545,276,0,2928
696,2019-08-31,21,92,5,0,118
696,2019-09-01,91,379,122,0,592
696,2019-09-02,16,62,49,0,127
696,2019-09-03,106,485,1131,1,1723
696,2019-09-04,77,13964,1949,2,15992
696,2019-09-05,204,8880,2117,0,11201
696,2019-09-06,151,15373,2169,2,17695
696,2019-09-07,270,14857,1565,0,16692
696,2019-09-08,197,8876,1530,1,10604
696,2019-09-09,80,17141,2096,2,19319
696,2019-09-10,1166,13226,1953,1,16346
696,2019-09-11,264,11118,2170,1,13553
696,2019-09-12,98,9138,1634,3,10873
696,2019-09-13,130,5827,2227,3,8187
696,2019-09-14,128,10468,1211,1,11808
696,2019-09-15,948,19489,2677,3,23117
696,2019-09-16,102,16795,2029,0,18926
696,2019-09-17,1206,12769,2169,0,16144
696,2019-09-18,163,26991,1355,1,28510
696,2019-09-19,194,10266,1890,2,12352
696,2019-09-20,2785,14268,1807,1,18861
696,2019-09-21,94,9203,2611,0,11908
696,2019-09-22,619,14324,1534,0,16477
696,2019-09-23,212,13180,2199,0,15591
696,2019-09-24,121,13391,1918,5,15435
696,2019-09-25,272,25495,1579,1,27347
696,2019-09-26,103,17230,2233,1,19567
696,2019-09-27,591,11003,1784,4,13382
696,2019-09-28,145,15880,1331,3,17359
696,2019-09-29,89,26860,1451,3,28403
696,2019-09-30,949,29825,1057,1,31832
696,2019-10-01,1789,28012,2081,2,31884
696,2019-10-02,993,14710,2707,0,18410
696,2019-10-03,729,14660,877,1,16267
696,2019-10-04,651,32365,898,3,33917
696,2019-10-05,1579,42769,1517,0,45865
696,2019-10-06,522,22036,1434,1,23993
696,2019-10-07,950,6916,2276,1,10143
696,2019-10-08,969,18530,1424,2,20925
696,2019-10-09,896,26633,2771,2,30302
696,2019-10-10,141,18461,2038,0,20640
696,2019-10-11,123,20327,1633,0,22083
696,2019-10-12,75,9757,1496,1,11329
696,2019-10-13,80,8846,1267,1,10194
696,2019-10-14,1872,6547,2526,2,10947
696,2019-10-15,113,8986,1641,0,10740
696,2019-10-16,81,18756,1237,2,20076
696,2019-10-17,83,8544,1909,1,10537
696,2019-10-18,1094,8919,2178,1,12192
696,2019-10-19,90,6149,1763,0,8002
696,2019-10-20,88,3145,1843,1,5077
696,2019-10-21,95,11090,1004,1,12190
696,2019-10-22,85,14745,1844,2,16676
696,2019-10-23,498,21130,1062,1,22691
696,2019-10-24,237,19211,1454,2,20904
696,2019-10-25,568,15967,2042,3,18580
696,2019-10-26,844,17551,1519,1,19915
696,2019-10-27,135,16859,1831,1,18826
696,2019-10-28,482,14335,1320,0,16137
696,2019-10-29,163,27513,1409,4,29089
696,2019-10-30,82,29559,1568,0,31209
696,2019-10-31,778,15300,1298,1,17377
696,2019-11-01,629,26293,986,0,27908
696,2019-11-02,965,26887,1049,0,28901
696,2019-11-03,97,25206,1453,3,26759
696,2019-11-04,177,8394,1807,0,10378
696,2019-11-05,208,3497,1794,0,5499
696,2019-11-06,245,14840,1055,1,16141
696,2019-11-07,200,16893,1681,4,18778
696,2019-11-08,96,10365,1558,1,12020
696,2019-11-09,707,9018,1842,1,11568
696,2019-11-10,1026,14228,1674,1,16929
696,2019-11-11,106,9619,2403,2,12130
696,2019-11-12,66,10516,3737,1,14320
696,2019-11-13,1422,14976,2847,4,19249
696,2019-11-14,72,13151,1710,1,14934
696,2019-11-15,183,5561,2857,1,8602
696,2019-11-16,967,3173,2453,0,6593
696,2019-11-17,86,5571,3158,0,8815
696,2019-11-18,112,2686,2936,2,5736
697,2019-08-12,4,0,41,0,45
697,2019-08-13,54,148,304,0,506
697,2019-08-14,205,222,80,1,508
697,2019-08-15,322,376,84,1,783
697,2019-08-16,195,234,43,0,472
697,2019-08-17,509,1392,691,0,2592
697,2019-08-18,1566,443,770,0,2779
697,2019-08-19,1034,707,1562,1,3304
697,2019-08-20,1349,1321,745,0,3415
697,2019-08-21,303,1002,1302,1,2608
697,2019-08-22,378,3020,1501,1,4900
697,2019-08-23,583,1611,924,3,3121
697,2019-08-24,308,11470,1992,0,13770
697,2019-08-25,537,18662,1858,4,21061
697,2019-08-26,1148,15100,2015,1,18264
697,2019-08-27,1182,12425,2078,4,15689
697,2019-08-28,310,6437,1533,0,8280
697,2019-08-29,368,10013,1871,0,12252
697,2019-08-30,320,3326,459,0,4105
697,2019-08-31,73,114,8,0,195
697,2019-09-01,214,374,274,0,862
697,2019-09-02,60,975,93,0,1128
697,2019-09-03,188,4166,1517,0,5871
697,2019-09-04,358,16160,2416,1,18935
697,2019-09-05,342,10920,2201,1,13464
697,2019-09-06,384,15198,1616,0,17198
697,2019-09-07,1241,11243,1649,1,14134
697,2019-09-08,1364,5019,1728,0,8111
697,2019-09-09,1158,6109,2105,0,9372
697,2019-09-10,1100,6853,2211,1,10165
697,2019-09-11,1066,6718,2391,2,10177
697,2019-09-12,135,9342,1858,0,11335
697,2019-09-13,423,5938,2443,1,8805
697,2019-09-14,297,6876,1756,0,8929
697,2019-09-15,1143,7009,1262,2,9416
697,2019-09-16,1075,11478,2022,0,14575
697,2019-09-17,1419,10414,2463,0,14296
697,2019-09-18,840,19515,1416,1,21772
697,2019-09-19,1325,4837,2823,1,8986
697,2019-09-20,396,14705,1992,0,17093
697,2019-09-21,307,10110,2195,2,12614
697,2019-09-22,1123,9278,1073,0,11474
697,2019-09-23,375,11406,2008,0,13789
697,2019-09-24,1248,12960,2675,5,16888
697,2019-09-25,225,10496,2351,0,13072
697,2019-09-26,159,13393,1219,4,14775
697,2019-09-27,139,10844,1876,1,12860
697,2019-09-28,368,25861,1697,3,27929
697,2019-09-29,134,29101,2226,0,31461
697,2019-09-30,1240,21176,959,2,23377
697,2019-10-01,411,16519,1460,2,18392
697,2019-10-02,214,12897,1828,1,14940
697,2019-10-03,1016,14649,963,0,16628
697,2019-10-04,111,12764,1767,2,14644
697,2019-10-05,468,14818,1789,1,17076
697,2019-10-06,1083,11933,2406,2,15424
697,2019-10-07,982,6597,2065,1,9645
697,2019-10-08,131,18658,2016,2,20807
697,2019-10-09,634,18231,2188,0,21053
697,2019-10-10,192,11584,3541,1,15318
697,2019-10-11,726,12164,1393,2,14285
697,2019-10-12,1104,7829,3109,2,12044
697,2019-10-13,2790,9010,2196,3,13999
697,2019-10-14,199,14170,2203,0,16572
697,2019-10-15,228,10133,3203,1,13565
697,2019-10-16,551,13494,818,2,14865
697,2019-10-17,232,5501,1663,0,7396
697,2019-10-18,463,8836,1801,0,11100
697,2019-10-19,284,5992,2372,1,8649
697,2019-10-20,1149,3011,2032,1,6193
697,2019-10-21,210,10869,1723,4,12806
697,2019-10-22,1116,6878,1849,1,9844
697,2019-10-23,458,8670,1463,1,10592
697,2019-10-24,962,14297,1233,0,16492
697,2019-10-25,1023,18912,2262,2,22199
697,2019-10-26,352,25767,2176,0,28295
697,2019-10-27,744,31119,1459,1,33323
697,2019-10-28,445,26497,1242,0,28184
697,2019-10-29,348,17842,1554,1,19745
697,2019-10-30,256,15477,1632,1,17366
697,2019-10-31,1138,20939,1568,2,23647
697,2019-11-01,233,27740,1091,0,29064
697,2019-11-02,213,35645,1167,0,37025
697,2019-11-03,434,42151,2278,0,44863
697,2019-11-04,297,11057,1399,1,12754
697,2019-11-05,294,3589,1921,1,5805
697,2019-11-06,296,8795,1233,2,10326
697,2019-11-07,359,24064,1308,2,25733
697,2019-11-08,277,18076,1506,0,19859
697,2019-11-09,250,16137,1491,3,17881
697,2019-11-10,218,14493,1816,0,16527
697,2019-11-11,525,14244,1456,2,16227
697,2019-11-12,840,13073,2581,2,16496
697,2019-11-13,1726,11662,1312,3,14703
697,2019-11-14,1151,13079,1408,2,15640
697,2019-11-15,1166,5874,2620,0,9660
697,2019-11-16,261,2736,2397,2,5396
697,2019-11-17,922,3779,3192,0,7893
697,2019-11-18,1166,2707,3013,1,6887
697,2019-11-19,311,5318,2469,1,8099
697,2019-11-20,285,1535,2080,3,3903
697,2019-11-21,697,3316,1755,0,5768
697,2019-11-22,955,9578,1345,2,11880
697,2019-11-23,263,11228,1969,2,13462
697,2019-11-24,353,10479,1506,2,12340
697,2019-11-25,262,11918,1820,0,14000
697,2019-11-26,247,9279,1535,1,11062
697,2019-11-27,260,6670,1786,0,8716
697,2019-11-28,248,12806,949,1,14004
697,2019-11-29,89,191,1,0,281
697,2019-08-13,54,148,304,0,506
697,2019-08-14,205,222,80,1,508
697,2019-08-15,322,376,84,1,783
697,2019-08-16,195,234,43,0,472
697,2019-08-17,509,1392,691,0,2592
697,2019-08-18,1566,443,770,0,2779
697,2019-08-19,1034,707,1562,1,3304
697,2019-08-20,1349,1321,745,0,3415
697,2019-08-21,303,1002,1302,1,2608
697,2019-08-22,378,3020,1501,1,4900
697,2019-08-23,583,1611,924,3,3121
697,2019-08-24,308,11470,1992,0,13770
697,2019-08-25,537,18662,1858,4,21061
697,2019-08-26,1148,15100,2015,1,18264
697,2019-08-27,1182,12425,2078,4,15689
697,2019-08-28,310,6437,1533,0,8280
697,2019-08-29,368,10013,1871,0,12252
697,2019-08-30,320,3326,459,0,4105
697,2019-08-31,73,114,8,0,195
697,2019-09-01,214,374,274,0,862
697,2019-09-02,60,975,93,0,1128
697,2019-09-03,188,4166,1517,0,5871
697,2019-09-04,358,16160,2416,1,18935
697,2019-09-05,342,10920,2201,1,13464
697,2019-09-06,384,15198,1616,0,17198
697,2019-09-07,1241,11243,1649,1,14134
697,2019-09-08,1364,5019,1728,0,8111
697,2019-09-09,1158,6109,2105,0,9372
697,2019-09-10,1100,6853,2211,1,10165
697,2019-09-11,1066,6718,2391,2,10177
697,2019-09-12,135,9342,1858,0,11335
697,2019-09-13,423,5938,2443,1,8805
697,2019-09-14,297,6876,1756,0,8929
697,2019-09-15,1143,7009,1262,2,9416
697,2019-09-16,1075,11478,2022,0,14575
697,2019-09-17,1419,10414,2463,0,14296
697,2019-09-18,840,19515,1416,1,21772
697,2019-09-19,1325,4837,2823,1,8986
697,2019-09-20,396,14705,1992,0,17093
697,2019-09-21,307,10110,2195,2,12614
697,2019-09-22,1123,9278,1073,0,11474
697,2019-09-23,375,11406,2008,0,13789
697,2019-09-24,1248,12960,2675,5,16888
697,2019-09-25,225,10496,2351,0,13072
697,2019-09-26,159,13393,1219,4,14775
697,2019-09-27,139,10844,1876,1,12860
697,2019-09-28,368,25861,1697,3,27929
697,2019-09-29,134,29101,2226,0,31461
697,2019-09-30,1240,21176,959,2,23377
697,2019-10-01,411,16519,1460,2,18392
697,2019-10-02,214,12897,1828,1,14940
697,2019-10-03,1016,14649,963,0,16628
697,2019-10-04,111,12764,1767,2,14644
697,2019-10-05,468,14818,1789,1,17076
697,2019-10-06,1083,11933,2406,2,15424
697,2019-10-07,982,6597,2065,1,9645
697,2019-10-08,131,18658,2016,2,20807
697,2019-10-09,634,18231,2188,0,21053
697,2019-10-10,192,11584,3541,1,15318
697,2019-10-11,726,12164,1393,2,14285
697,2019-10-12,1104,7829,3109,2,12044
697,2019-10-13,2790,9010,2196,3,13999
697,2019-10-14,199,14170,2203,0,16572
697,2019-10-15,228,10133,3203,1,13565
697,2019-10-16,551,13494,818,2,14865
697,2019-10-17,232,5501,1663,0,7396
697,2019-10-18,463,8836,1801,0,11100
697,2019-10-19,284,5992,2372,1,8649
697,2019-10-20,1149,3011,2032,1,6193
697,2019-10-21,210,10869,1723,4,12806
697,2019-10-22,1116,6878,1849,1,9844
697,2019-10-23,458,8670,1463,1,10592
697,2019-10-24,962,14297,1233,0,16492
697,2019-10-25,1023,18912,2262,2,22199
697,2019-10-26,352,25767,2176,0,28295
697,2019-10-27,744,31119,1459,1,33323
697,2019-10-28,445,26497,1242,0,28184
697,2019-10-29,348,17842,1554,1,19745
697,2019-10-30,256,15477,1632,1,17366
697,2019-10-31,1138,20939,1568,2,23647
697,2019-11-01,233,27740,1091,0,29064
697,2019-11-02,213,35645,1167,0,37025
697,2019-11-03,434,42151,2278,0,44863
697,2019-11-04,297,11057,1399,1,12754
697,2019-11-05,294,3589,1921,1,5805
697,2019-11-06,296,8795,1233,2,10326
697,2019-11-07,359,24064,1308,2,25733
697,2019-11-08,277,18076,1506,0,19859
697,2019-11-09,250,16137,1491,3,17881
697,2019-11-10,218,14493,1816,0,16527
697,2019-11-11,525,14244,1456,2,16227
697,2019-11-12,840,13073,2581,2,16496
697,2019-11-13,1726,11662,1312,3,14703
697,2019-11-14,1151,13079,1408,2,15640
697,2019-11-15,1166,5874,2620,0,9660
697,2019-11-16,261,2736,2397,2,5396
697,2019-11-17,922,3779,3192,0,7893
697,2019-11-18,1166,2707,3013,1,6887
697,2019-11-19,311,5318,2469,1,8099
697,2019-11-20,285,1535,2080,3,3903
697,2019-11-21,697,3316,1755,0,5768
697,2019-11-22,955,9578,1345,2,11880
697,2019-11-23,263,11228,1969,2,13462
697,2019-11-24,353,10479,1506,2,12340
697,2019-11-25,262,11918,1820,0,14000
697,2019-11-26,247,9279,1535,1,11062
697,2019-11-27,260,6670,1786,0,8716
697,2019-11-28,248,12806,949,1,14004
697,2019-11-29,89,191,1,0,281
697,2019-08-12,4,0,41,0,45
697,2019-08-13,54,148,304,0,506
697,2019-08-14,205,222,80,1,508
697,2019-08-15,322,376,84,1,783
697,2019-08-16,195,234,43,0,472
697,2019-08-17,509,1392,691,0,2592
697,2019-08-18,1566,443,770,0,2779
697,2019-08-19,1034,707,1562,1,3304
697,2019-08-20,1349,1321,745,0,3415
697,2019-08-21,303,1002,1302,1,2608
697,2019-08-22,378,3020,1501,1,4900
697,2019-08-23,583,1611,924,3,3121
697,2019-08-24,308,11470,1992,0,13770
697,2019-08-25,537,18662,1858,4,21061
697,2019-08-26,1148,15100,2015,1,18264
697,2019-08-27,1182,12425,2078,4,15689
697,2019-08-28,310,6437,1533,0,8280
697,2019-08-29,368,10013,1871,0,12252
697,2019-08-30,320,3326,459,0,4105
697,2019-08-31,73,114,8,0,195
697,2019-09-01,214,374,274,0,862
697,2019-09-02,60,975,93,0,1128
697,2019-09-03,188,4166,1517,0,5871
697,2019-09-04,358,16160,2416,1,18935
697,2019-09-05,342,10920,2201,1,13464
697,2019-09-06,384,15198,1616,0,17198
697,2019-09-07,1241,11243,1649,1,14134
697,2019-09-08,1364,5019,1728,0,8111
697,2019-09-09,1158,6109,2105,0,9372
697,2019-09-10,1100,6853,2211,1,10165
697,2019-09-11,1066,6718,2391,2,10177
697,2019-09-12,135,9342,1858,0,11335
697,2019-09-13,423,5938,2443,1,8805
697,2019-09-14,297,6876,1756,0,8929
697,2019-09-15,1143,7009,1262,2,9416
697,2019-09-16,1075,11478,2022,0,14575
697,2019-09-17,1419,10414,2463,0,14296
697,2019-09-18,840,19515,1416,1,21772
697,2019-09-19,1325,4837,2823,1,8986
697,2019-09-20,396,14705,1992,0,17093
697,2019-09-21,307,10110,2195,2,12614
697,2019-09-22,1123,9278,1073,0,11474
697,2019-09-23,375,11406,2008,0,13789
697,2019-09-24,1248,12960,2675,5,16888
697,2019-09-25,225,10496,2351,0,13072
697,2019-09-26,159,13393,1219,4,14775
697,2019-09-27,139,10844,1876,1,12860
697,2019-09-28,368,25861,1697,3,27929
697,2019-09-29,134,29101,2226,0,31461
697,2019-09-30,1240,21176,959,2,23377
697,2019-10-01,411,16519,1460,2,18392
697,2019-10-02,214,12897,1828,1,14940
697,2019-10-03,1016,14649,963,0,16628
697,2019-10-04,111,12764,1767,2,14644
697,2019-10-05,468,14818,1789,1,17076
697,2019-10-06,1083,11933,2406,2,15424
697,2019-10-07,982,6597,2065,1,9645
697,2019-10-08,131,18658,2016,2,20807
697,2019-10-09,634,18231,2188,0,21053
697,2019-10-10,192,11584,3541,1,15318
697,2019-10-11,726,12164,1393,2,14285
697,2019-10-12,1104,7829,3109,2,12044
697,2019-10-13,2790,9010,2196,3,13999
697,2019-10-14,199,14170,2203,0,16572
697,2019-10-15,228,10133,3203,1,13565
697,2019-10-16,551,13494,818,2,14865
697,2019-10-17,232,5501,1663,0,7396
697,2019-10-18,463,8836,1801,0,11100
697,2019-10-19,284,5992,2372,1,8649
697,2019-10-20,1149,3011,2032,1,6193
697,2019-10-21,210,10869,1723,4,12806
697,2019-10-22,1116,6878,1849,1,9844
697,2019-10-23,458,8670,1463,1,10592
697,2019-10-24,962,14297,1233,0,16492
697,2019-10-25,1023,18912,2262,2,22199
697,2019-10-26,352,25767,2176,0,28295
697,2019-10-27,744,31119,1459,1,33323
697,2019-10-28,445,26497,1242,0,28184
697,2019-10-29,348,17842,1554,1,19745
697,2019-10-30,256,15477,1632,1,17366
697,2019-10-31,1138,20939,1568,2,23647
697,2019-11-01,233,27740,1091,0,29064
697,2019-11-02,213,35645,1167,0,37025
697,2019-11-03,434,42151,2278,0,44863
697,2019-11-04,297,11057,1399,1,12754
697,2019-11-05,294,3589,1921,1,5805
697,2019-11-06,296,8795,1233,2,10326
697,2019-11-07,359,24064,1308,2,25733
697,2019-11-08,277,18076,1506,0,19859
697,2019-11-09,250,16137,1491,3,17881
697,2019-11-10,218,14493,1816,0,16527
697,2019-11-11,525,14244,1456,2,16227
697,2019-11-12,840,13073,2581,2,16496
697,2019-11-13,1726,11662,1312,3,14703
697,2019-11-14,1151,13079,1408,2,15640
697,2019-11-15,1166,5874,2620,0,9660
697,2019-11-16,261,2736,2397,2,5396
697,2019-11-17,922,3779,3192,0,7893
697,2019-11-18,1166,2707,3013,1,6887
697,2019-11-19,311,5318,2469,1,8099
697,2019-11-20,285,1535,2080,3,3903
697,2019-11-21,697,3316,1755,0,5768
697,2019-11-22,955,9578,1345,2,11880
697,2019-11-23,263,11228,1969,2,13462
697,2019-11-24,353,10479,1506,2,12340
697,2019-11-25,262,11918,1820,0,14000
697,2019-11-26,247,9279,1535,1,11062
697,2019-11-27,260,6670,1786,0,8716
697,2019-11-28,248,12806,949,1,14004
697,2019-11-29,89,191,1,0,281
697,2019-08-14,205,222,80,1,508
697,2019-08-15,322,376,84,1,783
697,2019-08-16,195,234,43,0,472
697,2019-08-17,509,1392,691,0,2592
697,2019-08-18,1566,443,770,0,2779
697,2019-08-19,1034,707,1562,1,3304
697,2019-08-20,1349,1321,745,0,3415
697,2019-08-21,303,1002,1302,1,2608
697,2019-08-22,378,3020,1501,1,4900
697,2019-08-23,583,1611,924,3,3121
697,2019-08-24,308,11470,1992,0,13770
697,2019-08-25,537,18662,1858,4,21061
697,2019-08-26,1148,15100,2015,1,18264
697,2019-08-27,1182,12425,2078,4,15689
697,2019-08-28,310,6437,1533,0,8280
697,2019-08-29,368,10013,1871,0,12252
697,2019-08-30,320,3326,459,0,4105
697,2019-08-31,73,114,8,0,195
697,2019-09-01,214,374,274,0,862
697,2019-09-02,60,975,93,0,1128
697,2019-09-03,188,4166,1517,0,5871
697,2019-09-04,358,16160,2416,1,18935
697,2019-09-05,342,10920,2201,1,13464
697,2019-09-06,384,15198,1616,0,17198
697,2019-09-07,1241,11243,1649,1,14134
697,2019-09-08,1364,5019,1728,0,8111
697,2019-09-09,1158,6109,2105,0,9372
697,2019-09-10,1100,6853,2211,1,10165
697,2019-09-11,1066,6718,2391,2,10177
697,2019-09-12,135,9342,1858,0,11335
697,2019-09-13,423,5938,2443,1,8805
697,2019-09-14,297,6876,1756,0,8929
697,2019-09-15,1143,7009,1262,2,9416
697,2019-09-16,1075,11478,2022,0,14575
697,2019-09-17,1419,10414,2463,0,14296
697,2019-09-18,840,19515,1416,1,21772
697,2019-09-19,1325,4837,2823,1,8986
697,2019-09-20,396,14705,1992,0,17093
697,2019-09-21,307,10110,2195,2,12614
697,2019-09-22,1123,9278,1073,0,11474
697,2019-09-23,375,11406,2008,0,13789
697,2019-09-24,1248,12960,2675,5,16888
697,2019-09-25,225,10496,2351,0,13072
697,2019-09-26,159,13393,1219,4,14775
697,2019-09-27,139,10844,1876,1,12860
697,2019-09-28,368,25861,1697,3,27929
697,2019-09-29,134,29101,2226,0,31461
697,2019-09-30,1240,21176,959,2,23377
697,2019-10-01,411,16519,1460,2,18392
697,2019-10-02,214,12897,1828,1,14940
697,2019-10-03,1016,14649,963,0,16628
697,2019-10-04,111,12764,1767,2,14644
697,2019-10-05,468,14818,1789,1,17076
697,2019-10-06,1083,11933,2406,2,15424
697,2019-10-07,982,6597,2065,1,9645
697,2019-10-08,131,18658,2016,2,20807
697,2019-10-09,634,18231,2188,0,21053
697,2019-10-10,192,11584,3541,1,15318
697,2019-10-11,726,12164,1393,2,14285
697,2019-10-12,1104,7829,3109,2,12044
697,2019-10-13,2790,9010,2196,3,13999
697,2019-10-14,199,14170,2203,0,16572
697,2019-10-15,228,10133,3203,1,13565
697,2019-10-16,551,13494,818,2,14865
697,2019-10-17,232,5501,1663,0,7396
697,2019-10-18,463,8836,1801,0,11100
697,2019-10-19,284,5992,2372,1,8649
697,2019-10-20,1149,3011,2032,1,6193
697,2019-10-21,210,10869,1723,4,12806
697,2019-10-22,1116,6878,1849,1,9844
697,2019-10-23,458,8670,1463,1,10592
697,2019-10-24,962,14297,1233,0,16492
697,2019-10-25,1023,18912,2262,2,22199
697,2019-10-26,352,25767,2176,0,28295
697,2019-10-27,744,31119,1459,1,33323
697,2019-10-28,445,26497,1242,0,28184
697,2019-10-29,348,17842,1554,1,19745
697,2019-10-30,256,15477,1632,1,17366
697,2019-10-31,1138,20939,1568,2,23647
697,2019-11-01,233,27740,1091,0,29064
697,2019-11-02,213,35645,1167,0,37025
697,2019-11-03,434,42151,2278,0,44863
697,2019-11-04,297,11057,1399,1,12754
697,2019-11-05,294,3589,1921,1,5805
697,2019-11-06,296,8795,1233,2,10326
697,2019-11-07,359,24064,1308,2,25733
697,2019-11-08,277,18076,1506,0,19859
697,2019-11-09,250,16137,1491,3,17881
697,2019-11-10,218,14493,1816,0,16527
697,2019-11-11,525,14244,1456,2,16227
697,2019-11-12,840,13073,2581,2,16496
697,2019-11-13,1726,11662,1312,3,14703
697,2019-11-14,1151,13079,1408,2,15640
697,2019-11-15,1166,5874,2620,0,9660
697,2019-11-16,261,2736,2397,2,5396
697,2019-11-17,922,3779,3192,0,7893
697,2019-11-18,1166,2707,3013,1,6887
697,2019-11-19,311,5318,2469,1,8099
697,2019-11-20,285,1535,2080,3,3903
697,2019-11-21,697,3316,1755,0,5768
697,2019-11-22,955,9578,1345,2,11880
697,2019-11-23,263,11228,1969,2,13462
697,2019-11-24,353,10479,1506,2,12340
697,2019-11-25,262,11918,1820,0,14000
697,2019-11-26,247,9279,1535,1,11062
697,2019-11-27,260,6670,1786,0,8716
697,2019-11-28,248,12806,949,1,14004
698,2019-08-13,17,316,30,1,364
698,2019-08-14,103,1143,298,1,1545
698,2019-08-15,194,812,25,0,1031
698,2019-08-16,81,259,109,1,450
698,2019-08-17,446,1645,659,0,2750
698,2019-08-18,1029,2010,1371,2,4412
698,2019-08-19,510,3722,985,1,5218
698,2019-08-20,264,2497,1088,1,3850
698,2019-08-21,125,1692,1080,2,2899
698,2019-08-22,96,3160,1150,0,4406
698,2019-08-23,86,1669,816,0,2571
698,2019-08-24,101,12503,1440,1,14045
698,2019-08-25,91,19098,1260,4,20453
698,2019-08-26,63,15262,1326,0,16651
698,2019-08-27,138,12725,1985,0,14848
698,2019-08-28,111,19046,1859,0,21016
698,2019-08-29,160,12151,1171,2,13484
698,2019-08-30,101,2955,743,1,3800
698,2019-08-31,16,215,11,0,242
698,2019-09-01,118,635,452,0,1205
698,2019-09-02,18,366,21,0,405
698,2019-09-03,78,1146,1015,0,2239
698,2019-09-04,106,10472,3229,2,13809
698,2019-09-05,122,12691,2096,1,14910
698,2019-09-06,95,11693,1922,0,13710
698,2019-09-07,75,17190,2310,0,19575
698,2019-09-08,287,5932,2957,1,9177
698,2019-09-09,139,7168,2727,2,10036
698,2019-09-10,75,9121,2208,0,11404
698,2019-09-11,113,6231,1732,3,8079
698,2019-09-12,914,8218,2290,3,11425
698,2019-09-13,97,7418,1697,0,9212
698,2019-09-14,1761,8144,1917,1,11823
698,2019-09-15,75,6764,2892,1,9732
698,2019-09-16,98,12168,3469,1,15736
698,2019-09-17,110,12799,2170,2,15081
698,2019-09-18,73,19763,1981,0,21817
698,2019-09-19,240,10840,1890,3,12973
698,2019-09-20,166,21168,1717,0,23051
698,2019-09-21,185,11936,1980,0,14101
698,2019-09-22,152,14585,1308,1,16046
698,2019-09-23,98,13938,1701,1,15738
698,2019-09-24,818,12606,2210,5,15639
698,2019-09-25,257,11515,1924,2,13698
698,2019-09-26,550,12713,1373,0,14636
698,2019-09-27,90,11211,1702,3,13006
698,2019-09-28,181,24870,1261,3,26315
698,2019-09-29,63,20602,1412,58,22135
698,2019-09-30,1503,18285,1730,1,21519
698,2019-10-01,716,17359,1668,0,19743
698,2019-10-02,161,12972,1228,0,14361
698,2019-10-03,889,15111,1043,0,17043
698,2019-10-04,86,13006,1630,11,14733
698,2019-10-05,68,14853,1867,1,16789
698,2019-10-06,678,11917,2106,1,14702
698,2019-10-07,82,6595,1784,1,8462
698,2019-10-08,548,19094,2337,1,21980
698,2019-10-09,1049,32793,1659,1,35502
698,2019-10-10,985,19873,1467,3,22328
698,2019-10-11,651,11605,758,1,13015
698,2019-10-12,104,8225,1505,1,9835
698,2019-10-13,81,8882,1763,3,10729
698,2019-10-14,949,7818,2140,0,10907
698,2019-10-15,988,8521,1947,0,11456
698,2019-10-16,89,18960,1292,1,20342
698,2019-10-17,967,9033,2456,0,12456
698,2019-10-18,155,15085,1939,1,17180
698,2019-10-19,135,9100,1812,0,11047
698,2019-10-20,984,3278,1746,0,6008
698,2019-10-21,445,10677,1375,1,12498
698,2019-10-22,631,7466,1812,2,9911
698,2019-10-23,1938,10142,2410,1,14491
698,2019-10-24,337,14273,1772,3,16385
698,2019-10-25,103,12480,1302,3,13888
698,2019-10-26,956,13996,1695,0,16647
698,2019-10-27,449,16507,1297,3,18256
698,2019-10-28,875,14011,1115,0,16001
698,2019-10-29,1023,18356,1593,3,20975
698,2019-10-30,80,16290,735,1,17106
698,2019-10-31,71,12785,1770,0,14626
698,2019-11-01,581,14704,1922,0,17207
698,2019-11-02,956,14176,826,0,15958
698,2019-11-03,77,36592,722,4,37395
698,2019-11-04,81,15198,1647,0,16926
698,2019-11-05,929,5480,2311,1,8721
698,2019-11-06,385,9142,1289,1,10817
698,2019-11-07,602,23119,1128,2,24851
698,2019-11-08,533,18243,1559,1,20336
698,2019-11-09,951,16293,1877,0,19121
698,2019-11-10,115,24869,2085,0,27069
698,2019-11-11,1275,16728,1599,1,19603
698,2019-11-12,1132,18300,2895,2,22329
698,2019-11-13,167,16790,2037,2,18996
698,2019-11-14,68,13451,2743,1,16263
698,2019-11-15,82,5353,3340,1,8776
698,2019-11-16,940,2790,2361,2856,8947
698,2019-11-17,172,3962,3398,0,7532
698,2019-11-18,494,5283,3432,4,9213
698,2019-11-19,105,5974,2226,2,8307
698,2019-11-20,200,1478,2179,1,3858
698,2019-11-21,77,5703,1223,1,7004
698,2019-11-22,997,5435,1389,4,7825
698,2019-11-23,934,6088,1863,2,8887
698,2019-11-24,190,6459,2124,0,8773
698,2019-11-25,1048,7554,1765,0,10367
698,2019-11-26,992,8709,1504,0,11205
698,2019-11-27,72,6713,1661,0,8446
698,2019-11-28,871,13760,473,1,15105
698,2019-11-29,15,508,2,0,525
698,2019-08-13,17,316,30,1,364
698,2019-08-14,103,1143,298,1,1545
698,2019-08-15,194,812,25,0,1031
698,2019-08-16,81,259,109,1,450
698,2019-08-17,446,1645,659,0,2750
698,2019-08-18,1029,2010,1371,2,4412
698,2019-08-19,510,3722,985,1,5218
698,2019-08-20,264,2497,1088,1,3850
698,2019-08-21,125,1692,1080,2,2899
698,2019-08-22,96,3160,1150,0,4406
698,2019-08-23,86,1669,816,0,2571
698,2019-08-24,101,12503,1440,1,14045
698,2019-08-25,91,19098,1260,4,20453
698,2019-08-26,63,15262,1326,0,16651
698,2019-08-27,138,12725,1985,0,14848
698,2019-08-28,111,19046,1859,0,21016
698,2019-08-29,160,12151,1171,2,13484
698,2019-08-30,101,2955,743,1,3800
698,2019-08-31,16,215,11,0,242
698,2019-09-01,118,635,452,0,1205
698,2019-09-02,18,366,21,0,405
698,2019-09-03,78,1146,1015,0,2239
698,2019-09-04,106,10472,3229,2,13809
698,2019-09-05,122,12691,2096,1,14910
698,2019-09-06,95,11693,1922,0,13710
698,2019-09-07,75,17190,2310,0,19575
698,2019-09-08,287,5932,2957,1,9177
698,2019-09-09,139,7168,2727,2,10036
698,2019-09-10,75,9121,2208,0,11404
698,2019-09-11,113,6231,1732,3,8079
698,2019-09-12,914,8218,2290,3,11425
698,2019-09-13,97,7418,1697,0,9212
698,2019-09-14,1761,8144,1917,1,11823
698,2019-09-15,75,6764,2892,1,9732
698,2019-09-16,98,12168,3469,1,15736
698,2019-09-17,110,12799,2170,2,15081
698,2019-09-18,73,19763,1981,0,21817
698,2019-09-19,240,10840,1890,3,12973
698,2019-09-20,166,21168,1717,0,23051
698,2019-09-21,185,11936,1980,0,14101
698,2019-09-22,152,14585,1308,1,16046
698,2019-09-23,98,13938,1701,1,15738
698,2019-09-24,818,12606,2210,5,15639
698,2019-09-25,257,11515,1924,2,13698
698,2019-09-26,550,12713,1373,0,14636
698,2019-09-27,90,11211,1702,3,13006
698,2019-09-28,181,24870,1261,3,26315
698,2019-09-29,63,20602,1412,58,22135
698,2019-09-30,1503,18285,1730,1,21519
698,2019-10-01,716,17359,1668,0,19743
698,2019-10-02,161,12972,1228,0,14361
698,2019-10-03,889,15111,1043,0,17043
698,2019-10-04,86,13006,1630,11,14733
698,2019-10-05,68,14853,1867,1,16789
698,2019-10-06,678,11917,2106,1,14702
698,2019-10-07,82,6595,1784,1,8462
698,2019-10-08,548,19094,2337,1,21980
698,2019-10-09,1049,32793,1659,1,35502
698,2019-10-10,985,19873,1467,3,22328
698,2019-10-11,651,11605,758,1,13015
698,2019-10-12,104,8225,1505,1,9835
698,2019-10-13,81,8882,1763,3,10729
698,2019-10-14,949,7818,2140,0,10907
698,2019-10-15,988,8521,1947,0,11456
698,2019-10-16,89,18960,1292,1,20342
698,2019-10-17,967,9033,2456,0,12456
698,2019-10-18,155,15085,1939,1,17180
698,2019-10-19,135,9100,1812,0,11047
698,2019-10-20,984,3278,1746,0,6008
698,2019-10-21,445,10677,1375,1,12498
698,2019-10-22,631,7466,1812,2,9911
698,2019-10-23,1938,10142,2410,1,14491
698,2019-10-24,337,14273,1772,3,16385
698,2019-10-25,103,12480,1302,3,13888
698,2019-10-26,956,13996,1695,0,16647
698,2019-10-27,449,16507,1297,3,18256
698,2019-10-28,875,14011,1115,0,16001
698,2019-10-29,1023,18356,1593,3,20975
698,2019-10-30,80,16290,735,1,17106
698,2019-10-31,71,12785,1770,0,14626
698,2019-11-01,581,14704,1922,0,17207
698,2019-11-02,956,14176,826,0,15958
698,2019-11-03,77,36592,722,4,37395
698,2019-11-04,81,15198,1647,0,16926
698,2019-11-05,929,5480,2311,1,8721
698,2019-11-06,385,9142,1289,1,10817
698,2019-11-07,602,23119,1128,2,24851
698,2019-11-08,533,18243,1559,1,20336
698,2019-11-09,951,16293,1877,0,19121
698,2019-11-10,115,24869,2085,0,27069
698,2019-11-11,1275,16728,1599,1,19603
698,2019-11-12,1132,18300,2895,2,22329
698,2019-11-13,167,16790,2037,2,18996
698,2019-11-14,68,13451,2743,1,16263
698,2019-11-15,82,5353,3340,1,8776
698,2019-11-16,940,2790,2361,2856,8947
698,2019-11-17,172,3962,3398,0,7532
698,2019-11-18,494,5283,3432,4,9213
698,2019-11-19,105,5974,2226,2,8307
698,2019-11-20,200,1478,2179,1,3858
698,2019-11-21,77,5703,1223,1,7004
698,2019-11-22,997,5435,1389,4,7825
698,2019-11-23,934,6088,1863,2,8887
698,2019-11-24,190,6459,2124,0,8773
698,2019-11-25,1048,7554,1765,0,10367
698,2019-11-26,992,8709,1504,0,11205
698,2019-11-27,72,6713,1661,0,8446
698,2019-11-28,871,13760,473,1,15105
698,2019-11-29,15,508,2,0,525
698,2019-08-12,0,0,49,0,49
698,2019-08-13,17,316,30,1,364
698,2019-08-14,103,1143,298,1,1545
698,2019-08-15,194,812,25,0,1031
698,2019-08-16,81,259,109,1,450
698,2019-08-17,446,1645,659,0,2750
698,2019-08-18,1029,2010,1371,2,4412
698,2019-08-19,510,3722,985,1,5218
698,2019-08-20,264,2497,1088,1,3850
698,2019-08-21,125,1692,1080,2,2899
698,2019-08-22,96,3160,1150,0,4406
698,2019-08-23,86,1669,816,0,2571
698,2019-08-24,101,12503,1440,1,14045
698,2019-08-25,91,19098,1260,4,20453
698,2019-08-26,63,15262,1326,0,16651
698,2019-08-27,138,12725,1985,0,14848
698,2019-08-28,111,19046,1859,0,21016
698,2019-08-29,160,12151,1171,2,13484
698,2019-08-30,101,2955,743,1,3800
698,2019-08-31,16,215,11,0,242
698,2019-09-01,118,635,452,0,1205
698,2019-09-02,18,366,21,0,405
698,2019-09-03,78,1146,1015,0,2239
698,2019-09-04,106,10472,3229,2,13809
698,2019-09-05,122,12691,2096,1,14910
698,2019-09-06,95,11693,1922,0,13710
698,2019-09-07,75,17190,2310,0,19575
698,2019-09-08,287,5932,2957,1,9177
698,2019-09-09,139,7168,2727,2,10036
698,2019-09-10,75,9121,2208,0,11404
698,2019-09-11,113,6231,1732,3,8079
698,2019-09-12,914,8218,2290,3,11425
698,2019-09-13,97,7418,1697,0,9212
698,2019-09-14,1761,8144,1917,1,11823
698,2019-09-15,75,6764,2892,1,9732
698,2019-09-16,98,12168,3469,1,15736
698,2019-09-17,110,12799,2170,2,15081
698,2019-09-18,73,19763,1981,0,21817
698,2019-09-19,240,10840,1890,3,12973
698,2019-09-20,166,21168,1717,0,23051
698,2019-09-21,185,11936,1980,0,14101
698,2019-09-22,152,14585,1308,1,16046
698,2019-09-23,98,13938,1701,1,15738
698,2019-09-24,818,12606,2210,5,15639
698,2019-09-25,257,11515,1924,2,13698
698,2019-09-26,550,12713,1373,0,14636
698,2019-09-27,90,11211,1702,3,13006
698,2019-09-28,181,24870,1261,3,26315
698,2019-09-29,63,20602,1412,58,22135
698,2019-09-30,1503,18285,1730,1,21519
698,2019-10-01,716,17359,1668,0,19743
698,2019-10-02,161,12972,1228,0,14361
698,2019-10-03,889,15111,1043,0,17043
698,2019-10-04,86,13006,1630,11,14733
698,2019-10-05,68,14853,1867,1,16789
698,2019-10-06,678,11917,2106,1,14702
698,2019-10-07,82,6595,1784,1,8462
698,2019-10-08,548,19094,2337,1,21980
698,2019-10-09,1049,32793,1659,1,35502
698,2019-10-10,985,19873,1467,3,22328
698,2019-10-11,651,11605,758,1,13015
698,2019-10-12,104,8225,1505,1,9835
698,2019-10-13,81,8882,1763,3,10729
698,2019-10-14,949,7818,2140,0,10907
698,2019-10-15,988,8521,1947,0,11456
698,2019-10-16,89,18960,1292,1,20342
698,2019-10-17,967,9033,2456,0,12456
698,2019-10-18,155,15085,1939,1,17180
698,2019-10-19,135,9100,1812,0,11047
698,2019-10-20,984,3278,1746,0,6008
698,2019-10-21,445,10677,1375,1,12498
698,2019-10-22,631,7466,1812,2,9911
698,2019-10-23,1938,10142,2410,1,14491
698,2019-10-24,337,14273,1772,3,16385
698,2019-10-25,103,12480,1302,3,13888
698,2019-10-26,956,13996,1695,0,16647
698,2019-10-27,449,16507,1297,3,18256
698,2019-10-28,875,14011,1115,0,16001
698,2019-10-29,1023,18356,1593,3,20975
698,2019-10-30,80,16290,735,1,17106
698,2019-10-31,71,12785,1770,0,14626
698,2019-11-01,581,14704,1922,0,17207
698,2019-11-02,956,14176,826,0,15958
698,2019-11-03,77,36592,722,4,37395
698,2019-11-04,81,15198,1647,0,16926
698,2019-11-05,929,5480,2311,1,8721
698,2019-11-06,385,9142,1289,1,10817
698,2019-11-07,602,23119,1128,2,24851
698,2019-11-08,533,18243,1559,1,20336
698,2019-11-09,951,16293,1877,0,19121
698,2019-11-10,115,24869,2085,0,27069
698,2019-11-11,1275,16728,1599,1,19603
698,2019-11-12,1132,18300,2895,2,22329
698,2019-11-13,167,16790,2037,2,18996
698,2019-11-14,68,13451,2743,1,16263
698,2019-11-15,82,5353,3340,1,8776
698,2019-11-16,940,2790,2361,2856,8947
698,2019-11-17,172,3962,3398,0,7532
698,2019-11-18,494,5283,3432,4,9213
698,2019-11-19,105,5974,2226,2,8307
698,2019-11-20,200,1478,2179,1,3858
698,2019-11-21,77,5703,1223,1,7004
698,2019-11-22,997,5435,1389,4,7825
698,2019-11-23,934,6088,1863,2,8887
698,2019-11-24,190,6459,2124,0,8773
698,2019-11-25,1048,7554,1765,0,10367
698,2019-11-26,992,8709,1504,0,11205
698,2019-11-27,72,6713,1661,0,8446
698,2019-11-28,871,13760,473,1,15105
698,2019-11-29,15,508,2,0,525
698,2019-08-13,17,316,30,1,364
698,2019-08-14,103,1143,298,1,1545
698,2019-08-15,194,812,25,0,1031
698,2019-08-16,81,259,109,1,450
698,2019-08-17,446,1645,659,0,2750
698,2019-08-18,1029,2010,1371,2,4412
698,2019-08-19,510,3722,985,1,5218
698,2019-08-20,264,2497,1088,1,3850
698,2019-08-21,125,1692,1080,2,2899
698,2019-08-22,96,3160,1150,0,4406
698,2019-08-23,86,1669,816,0,2571
698,2019-08-24,101,12503,1440,1,14045
698,2019-08-25,91,19098,1260,4,20453
698,2019-08-26,63,15262,1326,0,16651
698,2019-08-27,138,12725,1985,0,14848
698,2019-08-28,111,19046,1859,0,21016
698,2019-08-29,160,12151,1171,2,13484
698,2019-08-30,101,2955,743,1,3800
698,2019-08-31,16,215,11,0,242
698,2019-09-01,118,635,452,0,1205
698,2019-09-02,18,366,21,0,405
698,2019-09-03,78,1146,1015,0,2239
698,2019-09-04,106,10472,3229,2,13809
698,2019-09-05,122,12691,2096,1,14910
698,2019-09-06,95,11693,1922,0,13710
698,2019-09-07,75,17190,2310,0,19575
698,2019-09-08,287,5932,2957,1,9177
698,2019-09-09,139,7168,2727,2,10036
698,2019-09-10,75,9121,2208,0,11404
698,2019-09-11,113,6231,1732,3,8079
698,2019-09-12,914,8218,2290,3,11425
698,2019-09-13,97,7418,1697,0,9212
698,2019-09-14,1761,8144,1917,1,11823
698,2019-09-15,75,6764,2892,1,9732
698,2019-09-16,98,12168,3469,1,15736
698,2019-09-17,110,12799,2170,2,15081
698,2019-09-18,73,19763,1981,0,21817
698,2019-09-19,240,10840,1890,3,12973
698,2019-09-20,166,21168,1717,0,23051
698,2019-09-21,185,11936,1980,0,14101
698,2019-09-22,152,14585,1308,1,16046
698,2019-09-23,98,13938,1701,1,15738
698,2019-09-24,818,12606,2210,5,15639
698,2019-09-25,257,11515,1924,2,13698
698,2019-09-26,550,12713,1373,0,14636
698,2019-09-27,90,11211,1702,3,13006
698,2019-09-28,181,24870,1261,3,26315
698,2019-09-29,63,20602,1412,58,22135
698,2019-09-30,1503,18285,1730,1,21519
698,2019-10-01,716,17359,1668,0,19743
698,2019-10-02,161,12972,1228,0,14361
698,2019-10-03,889,15111,1043,0,17043
698,2019-10-04,86,13006,1630,11,14733
698,2019-10-05,68,14853,1867,1,16789
698,2019-10-06,678,11917,2106,1,14702
698,2019-10-07,82,6595,1784,1,8462
698,2019-10-08,548,19094,2337,1,21980
698,2019-10-09,1049,32793,1659,1,35502
698,2019-10-10,985,19873,1467,3,22328
698,2019-10-11,651,11605,758,1,13015
698,2019-10-12,104,8225,1505,1,9835
698,2019-10-13,81,8882,1763,3,10729
698,2019-10-14,949,7818,2140,0,10907
698,2019-10-15,988,8521,1947,0,11456
698,2019-10-16,89,18960,1292,1,20342
698,2019-10-17,967,9033,2456,0,12456
698,2019-10-18,155,15085,1939,1,17180
698,2019-10-19,135,9100,1812,0,11047
698,2019-10-20,984,3278,1746,0,6008
698,2019-10-21,445,10677,1375,1,12498
698,2019-10-22,631,7466,1812,2,9911
698,2019-10-23,1938,10142,2410,1,14491
698,2019-10-24,337,14273,1772,3,16385
698,2019-10-25,103,12480,1302,3,13888
698,2019-10-26,956,13996,1695,0,16647
698,2019-10-27,449,16507,1297,3,18256
698,2019-10-28,875,14011,1115,0,16001
698,2019-10-29,1023,18356,1593,3,20975
698,2019-10-30,80,16290,735,1,17106
698,2019-10-31,71,12785,1770,0,14626
698,2019-11-01,581,14704,1922,0,17207
698,2019-11-02,956,14176,826,0,15958
698,2019-11-03,77,36592,722,4,37395
698,2019-11-04,81,15198,1647,0,16926
698,2019-11-05,929,5480,2311,1,8721
698,2019-11-06,385,9142,1289,1,10817
698,2019-11-07,602,23119,1128,2,24851
698,2019-11-08,533,18243,1559,1,20336
698,2019-11-09,951,16293,1877,0,19121
698,2019-11-10,115,24869,2085,0,27069
698,2019-11-11,1275,16728,1599,1,19603
698,2019-11-12,1132,18300,2895,2,22329
698,2019-11-13,167,16790,2037,2,18996
698,2019-11-14,68,13451,2743,1,16263
698,2019-11-15,82,5353,3340,1,8776
698,2019-11-16,940,2790,2361,2856,8947
698,2019-11-17,172,3962,3398,0,7532
698,2019-11-18,494,5283,3432,4,9213
698,2019-11-19,105,5974,2226,2,8307
698,2019-11-20,200,1478,2179,1,3858
698,2019-11-21,77,5703,1223,1,7004
698,2019-11-22,997,5435,1389,4,7825
698,2019-11-23,934,6088,1863,2,8887
698,2019-11-24,190,6459,2124,0,8773
698,2019-11-25,1048,7554,1765,0,10367
698,2019-11-26,992,8709,1504,0,11205
698,2019-11-27,72,6713,1661,0,8446
698,2019-11-28,871,13760,473,1,15105
700,2019-08-13,12,426,103,0,541
700,2019-08-14,86,538,172,0,796
700,2019-08-15,142,204,274,0,620
700,2019-08-16,364,300,38,0,702
700,2019-08-17,494,1292,540,0,2326
700,2019-08-18,219,1762,1339,1,3321
700,2019-08-19,126,2965,1589,0,4680
700,2019-08-20,187,2828,1413,3,4431
700,2019-08-21,822,1379,1252,1,3454
700,2019-08-22,744,3325,2203,1,6273
700,2019-08-23,89,1920,1346,2,3357
700,2019-08-24,111,3368,2049,0,5528
700,2019-08-25,75,6584,1799,1,8459
700,2019-08-26,1780,2542,2176,1,6499
700,2019-08-27,139,2018,1352,0,3509
700,2019-08-28,113,8624,1308,0,10045
700,2019-08-29,128,15501,1743,1,17373
700,2019-08-30,99,5315,542,1,5957
700,2019-08-31,20,275,2,0,297
700,2019-09-01,34,1392,706,1,2133
700,2019-09-02,16,744,124,0,884
700,2019-09-03,93,3409,1149,0,4651
700,2019-09-04,561,9772,1582,0,11915
700,2019-09-05,117,14729,2276,3,17125
700,2019-09-06,98,18163,2217,1,20479
700,2019-09-07,178,8301,2221,1,10701
700,2019-09-08,1327,5895,1801,1,9024
700,2019-09-09,99,7349,1659,2,9109
700,2019-09-10,190,7022,1990,1,9203
700,2019-09-11,136,10936,1511,4,12587
700,2019-09-12,81,9869,2846,1,12797
700,2019-09-13,180,7301,2318,3,9802
700,2019-09-14,2650,7362,1337,0,11349
700,2019-09-15,920,11511,2044,1,14476
700,2019-09-16,1164,17304,2687,7,21162
700,2019-09-17,952,10698,1865,8,13523
700,2019-09-18,921,19223,1048,9,21201
700,2019-09-19,252,11602,1531,8,13393
700,2019-09-20,255,16833,1890,8,18986
700,2019-09-21,75,8497,2078,10,10660
700,2019-09-22,1046,9369,1861,7,12283
700,2019-09-23,188,11598,1894,1,13681
700,2019-09-24,122,12399,2286,2,14809
700,2019-09-25,1028,10732,1631,3,13394
700,2019-09-26,872,11474,2095,1,14442
700,2019-09-27,90,8799,2056,6,10951
700,2019-09-28,192,15670,1749,2,17613
700,2019-09-29,93,26771,1632,1,28497
700,2019-09-30,70,20258,1378,0,21706
700,2019-10-01,109,17139,1794,0,19042
700,2019-10-02,111,13484,1475,908,15978
700,2019-10-03,399,24075,1543,1,26018
700,2019-10-04,652,21603,1522,1,23778
700,2019-10-05,984,22073,1369,1,24427
700,2019-10-06,2681,17975,1025,2,21683
700,2019-10-07,448,8699,1928,4,11079
700,2019-10-08,80,19074,1094,3,20251
700,2019-10-09,288,25330,1907,1,27526
700,2019-10-10,2062,12552,1888,1,16503
700,2019-10-11,76,15879,1471,0,17426
700,2019-10-12,640,8964,1020,3,10627
700,2019-10-13,81,23585,1426,2,25094
700,2019-10-14,48,18767,1989,2,20806
700,2019-10-15,952,19089,1510,0,21551
700,2019-10-16,77,29030,1358,1,30466
700,2019-10-17,940,19431,2102,4,22477
700,2019-10-18,263,25724,1499,1,27487
700,2019-10-19,153,21755,1527,1,23436
700,2019-10-20,3426,14606,1766,0,19798
700,2019-10-21,439,29547,1397,3,31386
700,2019-10-22,97,22114,1448,3,23662
700,2019-10-23,62,19340,1168,1,20571
700,2019-10-24,968,30992,1055,3,33018
700,2019-10-25,106,30370,1411,2,31889
700,2019-10-26,997,35621,1466,0,38084
700,2019-10-27,1111,28792,1562,1,31466
700,2019-10-28,77,24562,1924,1,26564
700,2019-10-29,228,30719,1460,1,32408
700,2019-10-30,73,36500,1507,2,38082
700,2019-10-31,584,32236,1125,2,33947
700,2019-11-01,159,38011,1653,3,39826
700,2019-11-02,48,38111,1696,0,39855
700,2019-11-03,79,35971,1449,2,37501
700,2019-11-04,138,22027,1376,0,23541
700,2019-11-05,163,14480,1675,1,16319
700,2019-11-06,95,25317,702,4,26118
700,2019-11-07,260,27670,1275,2,29207
700,2019-11-08,115,25970,846,0,26931
700,2019-11-09,178,27173,1712,0,29063
700,2019-11-10,1036,27037,1824,0,29897
700,2019-11-11,232,16391,2066,4,18693
700,2019-11-12,1510,18579,3909,0,23998
700,2019-11-13,506,15032,1521,2,17061
700,2019-11-14,864,8981,2385,1,12231
700,2019-11-15,200,7105,1755,0,9060
700,2019-11-16,664,2721,3161,6440,12986
700,2019-11-17,275,4422,3369,0,8066
700,2019-11-18,149,3509,3412,0,7070
700,2019-11-19,2001,5534,3604,0,11139
700,2019-11-20,194,1455,2081,0,3730
700,2019-11-21,456,5410,1432,0,7298
700,2019-11-22,90,5705,953,0,6748
700,2019-11-23,107,6253,2667,0,9027
700,2019-11-24,1031,10224,1815,0,13070
700,2019-11-25,156,12000,1914,0,14070
700,2019-11-26,63,6023,1317,0,7403
700,2019-11-27,78,6597,1699,0,8374
700,2019-11-28,71,8644,644,0,9359
700,2019-11-29,18,1095,3,0,1116
700,2019-08-13,12,426,103,0,541
700,2019-08-14,86,538,172,0,796
700,2019-08-15,142,204,274,0,620
700,2019-08-16,364,300,38,0,702
700,2019-08-17,494,1292,540,0,2326
700,2019-08-18,219,1762,1339,1,3321
700,2019-08-19,126,2965,1589,0,4680
700,2019-08-20,187,2828,1413,3,4431
700,2019-08-21,822,1379,1252,1,3454
700,2019-08-22,744,3325,2203,1,6273
700,2019-08-23,89,1920,1346,2,3357
700,2019-08-24,111,3368,2049,0,5528
700,2019-08-25,75,6584,1799,1,8459
700,2019-08-26,1780,2542,2176,1,6499
700,2019-08-27,139,2018,1352,0,3509
700,2019-08-28,113,8624,1308,0,10045
700,2019-08-29,128,15501,1743,1,17373
700,2019-08-30,99,5315,542,1,5957
700,2019-08-31,20,275,2,0,297
700,2019-09-01,34,1392,706,1,2133
700,2019-09-02,16,744,124,0,884
700,2019-09-03,93,3409,1149,0,4651
700,2019-09-04,561,9772,1582,0,11915
700,2019-09-05,117,14729,2276,3,17125
700,2019-09-06,98,18163,2217,1,20479
700,2019-09-07,178,8301,2221,1,10701
700,2019-09-08,1327,5895,1801,1,9024
700,2019-09-09,99,7349,1659,2,9109
700,2019-09-10,190,7022,1990,1,9203
700,2019-09-11,136,10936,1511,4,12587
700,2019-09-12,81,9869,2846,1,12797
700,2019-09-13,180,7301,2318,3,9802
700,2019-09-14,2650,7362,1337,0,11349
700,2019-09-15,920,11511,2044,1,14476
700,2019-09-16,1164,17304,2687,7,21162
700,2019-09-17,952,10698,1865,8,13523
700,2019-09-18,921,19223,1048,9,21201
700,2019-09-19,252,11602,1531,8,13393
700,2019-09-20,255,16833,1890,8,18986
700,2019-09-21,75,8497,2078,10,10660
700,2019-09-22,1046,9369,1861,7,12283
700,2019-09-23,188,11598,1894,1,13681
700,2019-09-24,122,12399,2286,2,14809
700,2019-09-25,1028,10732,1631,3,13394
700,2019-09-26,872,11474,2095,1,14442
700,2019-09-27,90,8799,2056,6,10951
700,2019-09-28,192,15670,1749,2,17613
700,2019-09-29,93,26771,1632,1,28497
700,2019-09-30,70,20258,1378,0,21706
700,2019-10-01,109,17139,1794,0,19042
700,2019-10-02,111,13484,1475,908,15978
700,2019-10-03,399,24075,1543,1,26018
700,2019-10-04,652,21603,1522,1,23778
700,2019-10-05,984,22073,1369,1,24427
700,2019-10-06,2681,17975,1025,2,21683
700,2019-10-07,448,8699,1928,4,11079
700,2019-10-08,80,19074,1094,3,20251
700,2019-10-09,288,25330,1907,1,27526
700,2019-10-10,2062,12552,1888,1,16503
700,2019-10-11,76,15879,1471,0,17426
700,2019-10-12,640,8964,1020,3,10627
700,2019-10-13,81,23585,1426,2,25094
700,2019-10-14,48,18767,1989,2,20806
700,2019-10-15,952,19089,1510,0,21551
700,2019-10-16,77,29030,1358,1,30466
700,2019-10-17,940,19431,2102,4,22477
700,2019-10-18,263,25724,1499,1,27487
700,2019-10-19,153,21755,1527,1,23436
700,2019-10-20,3426,14606,1766,0,19798
700,2019-10-21,439,29547,1397,3,31386
700,2019-10-22,97,22114,1448,3,23662
700,2019-10-23,62,19340,1168,1,20571
700,2019-10-24,968,30992,1055,3,33018
700,2019-10-25,106,30370,1411,2,31889
700,2019-10-26,997,35621,1466,0,38084
700,2019-10-27,1111,28792,1562,1,31466
700,2019-10-28,77,24562,1924,1,26564
700,2019-10-29,228,30719,1460,1,32408
700,2019-10-30,73,36500,1507,2,38082
700,2019-10-31,584,32236,1125,2,33947
700,2019-11-01,159,38011,1653,3,39826
700,2019-11-02,48,38111,1696,0,39855
700,2019-11-03,79,35971,1449,2,37501
700,2019-11-04,138,22027,1376,0,23541
700,2019-11-05,163,14480,1675,1,16319
700,2019-11-06,95,25317,702,4,26118
700,2019-11-07,260,27670,1275,2,29207
700,2019-11-08,115,25970,846,0,26931
700,2019-11-09,178,27173,1712,0,29063
700,2019-11-10,1036,27037,1824,0,29897
700,2019-11-11,232,16391,2066,4,18693
700,2019-11-12,1510,18579,3909,0,23998
700,2019-11-13,506,15032,1521,2,17061
700,2019-11-14,864,8981,2385,1,12231
700,2019-11-15,200,7105,1755,0,9060
700,2019-11-16,664,2721,3161,6440,12986
700,2019-11-17,275,4422,3369,0,8066
700,2019-11-18,149,3509,3412,0,7070
700,2019-11-19,2001,5534,3604,0,11139
700,2019-11-20,194,1455,2081,0,3730
700,2019-11-21,456,5410,1432,0,7298
700,2019-11-22,90,5705,953,0,6748
700,2019-11-23,107,6253,2667,0,9027
700,2019-11-24,1031,10224,1815,0,13070
700,2019-11-25,156,12000,1914,0,14070
700,2019-11-26,63,6023,1317,0,7403
700,2019-11-27,78,6597,1699,0,8374
700,2019-11-28,71,8644,644,0,9359
700,2019-11-29,18,1095,3,0,1116
700,2019-08-12,0,0,2,0,2
700,2019-08-13,12,426,103,0,541
700,2019-08-14,86,538,172,0,796
700,2019-08-15,142,204,274,0,620
700,2019-08-16,364,300,38,0,702
700,2019-08-17,494,1292,540,0,2326
700,2019-08-18,219,1762,1339,1,3321
700,2019-08-19,126,2965,1589,0,4680
700,2019-08-20,187,2828,1413,3,4431
700,2019-08-21,822,1379,1252,1,3454
700,2019-08-22,744,3325,2203,1,6273
700,2019-08-23,89,1920,1346,2,3357
700,2019-08-24,111,3368,2049,0,5528
700,2019-08-25,75,6584,1799,1,8459
700,2019-08-26,1780,2542,2176,1,6499
700,2019-08-27,139,2018,1352,0,3509
700,2019-08-28,113,8624,1308,0,10045
700,2019-08-29,128,15501,1743,1,17373
700,2019-08-30,99,5315,542,1,5957
700,2019-08-31,20,275,2,0,297
700,2019-09-01,34,1392,706,1,2133
700,2019-09-02,16,744,124,0,884
700,2019-09-03,93,3409,1149,0,4651
700,2019-09-04,561,9772,1582,0,11915
700,2019-09-05,117,14729,2276,3,17125
700,2019-09-06,98,18163,2217,1,20479
700,2019-09-07,178,8301,2221,1,10701
700,2019-09-08,1327,5895,1801,1,9024
700,2019-09-09,99,7349,1659,2,9109
700,2019-09-10,190,7022,1990,1,9203
700,2019-09-11,136,10936,1511,4,12587
700,2019-09-12,81,9869,2846,1,12797
700,2019-09-13,180,7301,2318,3,9802
700,2019-09-14,2650,7362,1337,0,11349
700,2019-09-15,920,11511,2044,1,14476
700,2019-09-16,1164,17304,2687,7,21162
700,2019-09-17,952,10698,1865,8,13523
700,2019-09-18,921,19223,1048,9,21201
700,2019-09-19,252,11602,1531,8,13393
700,2019-09-20,255,16833,1890,8,18986
700,2019-09-21,75,8497,2078,10,10660
700,2019-09-22,1046,9369,1861,7,12283
700,2019-09-23,188,11598,1894,1,13681
700,2019-09-24,122,12399,2286,2,14809
700,2019-09-25,1028,10732,1631,3,13394
700,2019-09-26,872,11474,2095,1,14442
700,2019-09-27,90,8799,2056,6,10951
700,2019-09-28,192,15670,1749,2,17613
700,2019-09-29,93,26771,1632,1,28497
700,2019-09-30,70,20258,1378,0,21706
700,2019-10-01,109,17139,1794,0,19042
700,2019-10-02,111,13484,1475,908,15978
700,2019-10-03,399,24075,1543,1,26018
700,2019-10-04,652,21603,1522,1,23778
700,2019-10-05,984,22073,1369,1,24427
700,2019-10-06,2681,17975,1025,2,21683
700,2019-10-07,448,8699,1928,4,11079
700,2019-10-08,80,19074,1094,3,20251
700,2019-10-09,288,25330,1907,1,27526
700,2019-10-10,2062,12552,1888,1,16503
700,2019-10-11,76,15879,1471,0,17426
700,2019-10-12,640,8964,1020,3,10627
700,2019-10-13,81,23585,1426,2,25094
700,2019-10-14,48,18767,1989,2,20806
700,2019-10-15,952,19089,1510,0,21551
700,2019-10-16,77,29030,1358,1,30466
700,2019-10-17,940,19431,2102,4,22477
700,2019-10-18,263,25724,1499,1,27487
700,2019-10-19,153,21755,1527,1,23436
700,2019-10-20,3426,14606,1766,0,19798
700,2019-10-21,439,29547,1397,3,31386
700,2019-10-22,97,22114,1448,3,23662
700,2019-10-23,62,19340,1168,1,20571
700,2019-10-24,968,30992,1055,3,33018
700,2019-10-25,106,30370,1411,2,31889
700,2019-10-26,997,35621,1466,0,38084
700,2019-10-27,1111,28792,1562,1,31466
700,2019-10-28,77,24562,1924,1,26564
700,2019-10-29,228,30719,1460,1,32408
700,2019-10-30,73,36500,1507,2,38082
700,2019-10-31,584,32236,1125,2,33947
700,2019-11-01,159,38011,1653,3,39826
700,2019-11-02,48,38111,1696,0,39855
700,2019-11-03,79,35971,1449,2,37501
700,2019-11-04,138,22027,1376,0,23541
700,2019-11-05,163,14480,1675,1,16319
700,2019-11-06,95,25317,702,4,26118
700,2019-11-07,260,27670,1275,2,29207
700,2019-11-08,115,25970,846,0,26931
700,2019-11-09,178,27173,1712,0,29063
700,2019-11-10,1036,27037,1824,0,29897
700,2019-11-11,232,16391,2066,4,18693
700,2019-11-12,1510,18579,3909,0,23998
700,2019-11-13,506,15032,1521,2,17061
700,2019-11-14,864,8981,2385,1,12231
700,2019-11-15,200,7105,1755,0,9060
700,2019-11-16,664,2721,3161,6440,12986
700,2019-11-17,275,4422,3369,0,8066
700,2019-11-18,149,3509,3412,0,7070
700,2019-11-19,2001,5534,3604,0,11139
700,2019-11-20,194,1455,2081,0,3730
700,2019-11-21,456,5410,1432,0,7298
700,2019-11-22,90,5705,953,0,6748
700,2019-11-23,107,6253,2667,0,9027
700,2019-11-24,1031,10224,1815,0,13070
700,2019-11-25,156,12000,1914,0,14070
700,2019-11-26,63,6023,1317,0,7403
700,2019-11-27,78,6597,1699,0,8374
700,2019-11-28,71,8644,644,0,9359
700,2019-11-29,18,1095,3,0,1116
700,2019-08-18,219,1762,1339,1,3321
700,2019-08-19,126,2965,1589,0,4680
700,2019-08-20,187,2828,1413,3,4431
700,2019-08-21,822,1379,1252,1,3454
700,2019-08-22,744,3325,2203,1,6273
700,2019-08-23,89,1920,1346,2,3357
700,2019-08-24,111,3368,2049,0,5528
700,2019-08-25,75,6584,1799,1,8459
700,2019-08-26,1780,2542,2176,1,6499
700,2019-08-27,139,2018,1352,0,3509
700,2019-08-28,113,8624,1308,0,10045
700,2019-08-29,128,15501,1743,1,17373
700,2019-08-30,99,5315,542,1,5957
700,2019-08-31,20,275,2,0,297
700,2019-09-01,34,1392,706,1,2133
700,2019-09-02,16,744,124,0,884
700,2019-09-03,93,3409,1149,0,4651
700,2019-09-04,561,9772,1582,0,11915
700,2019-09-05,117,14729,2276,3,17125
700,2019-09-06,98,18163,2217,1,20479
700,2019-09-07,178,8301,2221,1,10701
700,2019-09-08,1327,5895,1801,1,9024
700,2019-09-09,99,7349,1659,2,9109
700,2019-09-10,190,7022,1990,1,9203
700,2019-09-11,136,10936,1511,4,12587
700,2019-09-12,81,9869,2846,1,12797
700,2019-09-13,180,7301,2318,3,9802
700,2019-09-14,2650,7362,1337,0,11349
700,2019-09-15,920,11511,2044,1,14476
700,2019-09-16,1164,17304,2687,7,21162
700,2019-09-17,952,10698,1865,8,13523
700,2019-09-18,921,19223,1048,9,21201
700,2019-09-19,252,11602,1531,8,13393
700,2019-09-20,255,16833,1890,8,18986
700,2019-09-21,75,8497,2078,10,10660
700,2019-09-22,1046,9369,1861,7,12283
700,2019-09-23,188,11598,1894,1,13681
700,2019-09-24,122,12399,2286,2,14809
700,2019-09-25,1028,10732,1631,3,13394
700,2019-09-26,872,11474,2095,1,14442
700,2019-09-27,90,8799,2056,6,10951
700,2019-09-28,192,15670,1749,2,17613
700,2019-09-29,93,26771,1632,1,28497
700,2019-09-30,70,20258,1378,0,21706
700,2019-10-01,109,17139,1794,0,19042
700,2019-10-02,111,13484,1475,908,15978
700,2019-10-03,399,24075,1543,1,26018
700,2019-10-04,652,21603,1522,1,23778
700,2019-10-05,984,22073,1369,1,24427
700,2019-10-06,2681,17975,1025,2,21683
700,2019-10-07,448,8699,1928,4,11079
700,2019-10-08,80,19074,1094,3,20251
700,2019-10-09,288,25330,1907,1,27526
700,2019-10-10,2062,12552,1888,1,16503
700,2019-10-11,76,15879,1471,0,17426
700,2019-10-12,640,8964,1020,3,10627
700,2019-10-13,81,23585,1426,2,25094
700,2019-10-14,48,18767,1989,2,20806
700,2019-10-15,952,19089,1510,0,21551
700,2019-10-16,77,29030,1358,1,30466
700,2019-10-17,940,19431,2102,4,22477
700,2019-10-18,263,25724,1499,1,27487
700,2019-10-19,153,21755,1527,1,23436
700,2019-10-20,3426,14606,1766,0,19798
700,2019-10-21,439,29547,1397,3,31386
700,2019-10-22,97,22114,1448,3,23662
700,2019-10-23,62,19340,1168,1,20571
700,2019-10-24,968,30992,1055,3,33018
700,2019-10-25,106,30370,1411,2,31889
700,2019-10-26,997,35621,1466,0,38084
700,2019-10-27,1111,28792,1562,1,31466
700,2019-10-28,77,24562,1924,1,26564
700,2019-10-29,228,30719,1460,1,32408
700,2019-10-30,73,36500,1507,2,38082
700,2019-10-31,584,32236,1125,2,33947
700,2019-11-01,159,38011,1653,3,39826
700,2019-11-02,48,38111,1696,0,39855
700,2019-11-03,79,35971,1449,2,37501
700,2019-11-04,138,22027,1376,0,23541
700,2019-11-05,163,14480,1675,1,16319
700,2019-11-06,95,25317,702,4,26118
700,2019-11-07,260,27670,1275,2,29207
700,2019-11-08,115,25970,846,0,26931
700,2019-11-09,178,27173,1712,0,29063
700,2019-11-10,1036,27037,1824,0,29897
700,2019-11-11,232,16391,2066,4,18693
700,2019-11-12,1510,18579,3909,0,23998
700,2019-11-13,506,15032,1521,2,17061
700,2019-11-14,864,8981,2385,1,12231
700,2019-11-15,200,7105,1755,0,9060
700,2019-11-16,664,2721,3161,6440,12986
701,2019-08-13,141,354,138,1,634
701,2019-08-14,176,765,62,1,1004
701,2019-08-15,139,400,56,1,596
701,2019-08-16,105,321,76,0,502
701,2019-08-17,243,1158,483,0,1884
701,2019-08-18,159,2158,1202,2,3521
701,2019-08-19,197,2925,1195,1,4318
701,2019-08-20,223,2658,1026,0,3907
701,2019-08-21,84,1626,1195,0,2905
701,2019-08-22,72,5277,1475,2,6826
701,2019-08-23,91,1738,1500,1,3330
701,2019-08-24,717,2669,1705,0,5091
701,2019-08-25,963,17824,1444,3,20234
701,2019-08-26,596,14209,2168,1,16974
701,2019-08-27,1002,6874,1902,2,9780
701,2019-08-28,114,5204,1667,0,6985
701,2019-08-29,120,9430,1870,2,11422
701,2019-08-30,82,2914,1098,0,4094
701,2019-08-31,59,169,1,0,229
701,2019-09-01,43,271,619,0,933
701,2019-09-02,39,344,43,0,426
701,2019-09-03,93,912,1383,0,2388
701,2019-09-04,92,15363,2710,2,18167
701,2019-09-05,100,8648,2762,1,11511
701,2019-09-06,110,10652,2119,0,12881
701,2019-09-07,91,11788,2038,1,13918
701,2019-09-08,1028,6551,1813,0,9392
701,2019-09-09,210,6721,2733,0,9664
701,2019-09-10,96,9223,2135,0,11454
701,2019-09-11,1053,9133,1973,2,12161
701,2019-09-12,71,6207,1843,2,8123
701,2019-09-13,128,5658,1725,0,7511
701,2019-09-14,86,6965,1433,1,8485
701,2019-09-15,81,13096,2005,1,15183
701,2019-09-16,117,16018,3327,1,19463
701,2019-09-17,940,8225,1919,1,11085
701,2019-09-18,115,19770,1142,0,21027
701,2019-09-19,357,9705,2664,2,12728
701,2019-09-20,278,19705,1904,1,21888
701,2019-09-21,79,12098,2321,2,14500
701,2019-09-22,1001,13696,2720,0,17417
701,2019-09-23,967,12359,1385,0,14711
701,2019-09-24,123,10687,1983,2,12795
701,2019-09-25,168,12588,1500,3,14259
701,2019-09-26,110,12383,1580,3,14076
701,2019-09-27,88,8452,1581,2,10123
701,2019-09-28,105,24924,1095,1,26125
701,2019-09-29,364,28179,861,0,29404
701,2019-09-30,66,27998,2402,1,30467
701,2019-10-01,82,21567,1296,2,22947
701,2019-10-02,77,15509,2255,0,17841
701,2019-10-03,971,21498,1307,0,23776
701,2019-10-04,90,13055,1785,2,14932
701,2019-10-05,1442,20633,1247,0,23322
701,2019-10-06,70,15204,1284,3,16561
701,2019-10-07,509,3225,2129,1,5864
701,2019-10-08,962,16968,1713,2,19645
701,2019-10-09,1823,33322,1232,1,36378
701,2019-10-10,1484,11532,1622,2,14640
701,2019-10-11,79,15671,2417,4,18171
701,2019-10-12,211,7930,2258,1,10400
701,2019-10-13,95,7447,1854,1,9397
701,2019-10-14,1430,5527,1389,1,8347
701,2019-10-15,147,12602,1776,2,14527
701,2019-10-16,170,23071,1924,3,25168
701,2019-10-17,85,6938,2174,0,9197
701,2019-10-18,2022,13987,1433,1,17443
701,2019-10-19,1870,7024,1458,0,10352
701,2019-10-20,2350,917,1387,0,4654
701,2019-10-21,1478,9293,1671,5,12447
701,2019-10-22,124,4668,2117,0,6909
701,2019-10-23,1211,12795,1376,0,15382
701,2019-10-24,708,18354,1335,2,20399
701,2019-10-25,129,14846,1218,1,16194
701,2019-10-26,72,24481,1836,1,26390
701,2019-10-27,105,30383,1451,0,31939
701,2019-10-28,154,24732,1629,1,26516
701,2019-10-29,1016,17019,1734,2,19771
701,2019-10-30,447,15065,1379,1,16892
701,2019-10-31,1269,19460,937,2,21668
701,2019-11-01,890,26770,1848,1,29509
701,2019-11-02,81,15797,1373,0,17251
701,2019-11-03,947,36033,1671,0,38651
701,2019-11-04,111,9484,1282,0,10877
701,2019-11-05,999,2912,1744,0,5655
701,2019-11-06,120,7370,1148,0,8638
701,2019-11-07,1018,13222,851,0,15091
701,2019-11-08,101,8835,1580,0,10516
701,2019-11-09,986,7865,1945,0,10796
701,2019-11-10,255,11662,2388,0,14305
701,2019-11-11,581,7774,2496,0,10851
701,2019-11-12,67,9187,3867,0,13121
701,2019-11-13,191,11345,2094,0,13630
701,2019-11-14,61,7397,1742,0,9200
701,2019-11-15,161,2087,3140,0,5388
701,2019-11-16,79,1029,2201,0,3309
701,2019-11-17,433,2593,3438,0,6464
701,2019-11-18,262,2080,3847,0,6189
701,2019-11-19,134,2714,3638,0,6486
701,2019-11-20,134,1352,2188,0,3674
701,2019-11-21,95,5382,1314,0,6791
701,2019-11-22,63,8692,1332,0,10087
701,2019-11-23,140,10517,2906,0,13563
701,2019-11-24,667,8860,1527,0,11054
701,2019-11-25,70,10263,2006,0,12339
701,2019-11-26,97,8968,1605,0,10670
701,2019-11-27,539,10337,1516,0,12392
701,2019-11-28,46,13778,428,0,14252
701,2019-08-13,141,354,138,1,634
701,2019-08-14,176,765,62,1,1004
701,2019-08-15,139,400,56,1,596
701,2019-08-16,105,321,76,0,502
701,2019-08-17,243,1158,483,0,1884
701,2019-08-18,159,2158,1202,2,3521
701,2019-08-19,197,2925,1195,1,4318
701,2019-08-20,223,2658,1026,0,3907
701,2019-08-21,84,1626,1195,0,2905
701,2019-08-22,72,5277,1475,2,6826
701,2019-08-23,91,1738,1500,1,3330
701,2019-08-24,717,2669,1705,0,5091
701,2019-08-25,963,17824,1444,3,20234
701,2019-08-26,596,14209,2168,1,16974
701,2019-08-27,1002,6874,1902,2,9780
701,2019-08-28,114,5204,1667,0,6985
701,2019-08-29,120,9430,1870,2,11422
701,2019-08-30,82,2914,1098,0,4094
701,2019-08-31,59,169,1,0,229
701,2019-09-01,43,271,619,0,933
701,2019-09-02,39,344,43,0,426
701,2019-09-03,93,912,1383,0,2388
701,2019-09-04,92,15363,2710,2,18167
701,2019-09-05,100,8648,2762,1,11511
701,2019-09-06,110,10652,2119,0,12881
701,2019-09-07,91,11788,2038,1,13918
701,2019-09-08,1028,6551,1813,0,9392
701,2019-09-09,210,6721,2733,0,9664
701,2019-09-10,96,9223,2135,0,11454
701,2019-09-11,1053,9133,1973,2,12161
701,2019-09-12,71,6207,1843,2,8123
701,2019-09-13,128,5658,1725,0,7511
701,2019-09-14,86,6965,1433,1,8485
701,2019-09-15,81,13096,2005,1,15183
701,2019-09-16,117,16018,3327,1,19463
701,2019-09-17,940,8225,1919,1,11085
701,2019-09-18,115,19770,1142,0,21027
701,2019-09-19,357,9705,2664,2,12728
701,2019-09-20,278,19705,1904,1,21888
701,2019-09-21,79,12098,2321,2,14500
701,2019-09-22,1001,13696,2720,0,17417
701,2019-09-23,967,12359,1385,0,14711
701,2019-09-24,123,10687,1983,2,12795
701,2019-09-25,168,12588,1500,3,14259
701,2019-09-26,110,12383,1580,3,14076
701,2019-09-27,88,8452,1581,2,10123
701,2019-09-28,105,24924,1095,1,26125
701,2019-09-29,364,28179,861,0,29404
701,2019-09-30,66,27998,2402,1,30467
701,2019-10-01,82,21567,1296,2,22947
701,2019-10-02,77,15509,2255,0,17841
701,2019-10-03,971,21498,1307,0,23776
701,2019-10-04,90,13055,1785,2,14932
701,2019-10-05,1442,20633,1247,0,23322
701,2019-10-06,70,15204,1284,3,16561
701,2019-10-07,509,3225,2129,1,5864
701,2019-10-08,962,16968,1713,2,19645
701,2019-10-09,1823,33322,1232,1,36378
701,2019-10-10,1484,11532,1622,2,14640
701,2019-10-11,79,15671,2417,4,18171
701,2019-10-12,211,7930,2258,1,10400
701,2019-10-13,95,7447,1854,1,9397
701,2019-10-14,1430,5527,1389,1,8347
701,2019-10-15,147,12602,1776,2,14527
701,2019-10-16,170,23071,1924,3,25168
701,2019-10-17,85,6938,2174,0,9197
701,2019-10-18,2022,13987,1433,1,17443
701,2019-10-19,1870,7024,1458,0,10352
701,2019-10-20,2350,917,1387,0,4654
701,2019-10-21,1478,9293,1671,5,12447
701,2019-10-22,124,4668,2117,0,6909
701,2019-10-23,1211,12795,1376,0,15382
701,2019-10-24,708,18354,1335,2,20399
701,2019-10-25,129,14846,1218,1,16194
701,2019-10-26,72,24481,1836,1,26390
701,2019-10-27,105,30383,1451,0,31939
701,2019-10-28,154,24732,1629,1,26516
701,2019-10-29,1016,17019,1734,2,19771
701,2019-10-30,447,15065,1379,1,16892
701,2019-10-31,1269,19460,937,2,21668
701,2019-11-01,890,26770,1848,1,29509
701,2019-11-02,81,15797,1373,0,17251
701,2019-11-03,947,36033,1671,0,38651
701,2019-11-04,111,9484,1282,0,10877
701,2019-11-05,999,2912,1744,0,5655
701,2019-11-06,120,7370,1148,0,8638
701,2019-11-07,1018,13222,851,0,15091
701,2019-11-08,101,8835,1580,0,10516
701,2019-11-09,986,7865,1945,0,10796
701,2019-11-10,255,11662,2388,0,14305
701,2019-11-11,581,7774,2496,0,10851
701,2019-11-12,67,9187,3867,0,13121
701,2019-11-13,191,11345,2094,0,13630
701,2019-11-14,61,7397,1742,0,9200
701,2019-11-15,161,2087,3140,0,5388
701,2019-11-16,79,1029,2201,0,3309
701,2019-11-17,433,2593,3438,0,6464
701,2019-11-18,262,2080,3847,0,6189
701,2019-11-19,134,2714,3638,0,6486
701,2019-11-20,134,1352,2188,0,3674
701,2019-11-21,95,5382,1314,0,6791
701,2019-11-22,63,8692,1332,0,10087
701,2019-11-23,140,10517,2906,0,13563
701,2019-11-24,667,8860,1527,0,11054
701,2019-11-25,70,10263,2006,0,12339
701,2019-11-26,97,8968,1605,0,10670
701,2019-11-27,539,10337,1516,0,12392
701,2019-11-28,46,13778,428,0,14252
701,2019-11-29,0,374,0,0,374
701,2019-08-12,0,0,6,0,6
701,2019-08-13,141,354,138,1,634
701,2019-08-14,176,765,62,1,1004
701,2019-08-15,139,400,56,1,596
701,2019-08-16,105,321,76,0,502
701,2019-08-17,243,1158,483,0,1884
701,2019-08-18,159,2158,1202,2,3521
701,2019-08-19,197,2925,1195,1,4318
701,2019-08-20,223,2658,1026,0,3907
701,2019-08-21,84,1626,1195,0,2905
701,2019-08-22,72,5277,1475,2,6826
701,2019-08-23,91,1738,1500,1,3330
701,2019-08-24,717,2669,1705,0,5091
701,2019-08-25,963,17824,1444,3,20234
701,2019-08-26,596,14209,2168,1,16974
701,2019-08-27,1002,6874,1902,2,9780
701,2019-08-28,114,5204,1667,0,6985
701,2019-08-29,120,9430,1870,2,11422
701,2019-08-30,82,2914,1098,0,4094
701,2019-08-31,59,169,1,0,229
701,2019-09-01,43,271,619,0,933
701,2019-09-02,39,344,43,0,426
701,2019-09-03,93,912,1383,0,2388
701,2019-09-04,92,15363,2710,2,18167
701,2019-09-05,100,8648,2762,1,11511
701,2019-09-06,110,10652,2119,0,12881
701,2019-09-07,91,11788,2038,1,13918
701,2019-09-08,1028,6551,1813,0,9392
701,2019-09-09,210,6721,2733,0,9664
701,2019-09-10,96,9223,2135,0,11454
701,2019-09-11,1053,9133,1973,2,12161
701,2019-09-12,71,6207,1843,2,8123
701,2019-09-13,128,5658,1725,0,7511
701,2019-09-14,86,6965,1433,1,8485
701,2019-09-15,81,13096,2005,1,15183
701,2019-09-16,117,16018,3327,1,19463
701,2019-09-17,940,8225,1919,1,11085
701,2019-09-18,115,19770,1142,0,21027
701,2019-09-19,357,9705,2664,2,12728
701,2019-09-20,278,19705,1904,1,21888
701,2019-09-21,79,12098,2321,2,14500
701,2019-09-22,1001,13696,2720,0,17417
701,2019-09-23,967,12359,1385,0,14711
701,2019-09-24,123,10687,1983,2,12795
701,2019-09-25,168,12588,1500,3,14259
701,2019-09-26,110,12383,1580,3,14076
701,2019-09-27,88,8452,1581,2,10123
701,2019-09-28,105,24924,1095,1,26125
701,2019-09-29,364,28179,861,0,29404
701,2019-09-30,66,27998,2402,1,30467
701,2019-10-01,82,21567,1296,2,22947
701,2019-10-02,77,15509,2255,0,17841
701,2019-10-03,971,21498,1307,0,23776
701,2019-10-04,90,13055,1785,2,14932
701,2019-10-05,1442,20633,1247,0,23322
701,2019-10-06,70,15204,1284,3,16561
701,2019-10-07,509,3225,2129,1,5864
701,2019-10-08,962,16968,1713,2,19645
701,2019-10-09,1823,33322,1232,1,36378
701,2019-10-10,1484,11532,1622,2,14640
701,2019-10-11,79,15671,2417,4,18171
701,2019-10-12,211,7930,2258,1,10400
701,2019-10-13,95,7447,1854,1,9397
701,2019-10-14,1430,5527,1389,1,8347
701,2019-10-15,147,12602,1776,2,14527
701,2019-10-16,170,23071,1924,3,25168
701,2019-10-17,85,6938,2174,0,9197
701,2019-10-18,2022,13987,1433,1,17443
701,2019-10-19,1870,7024,1458,0,10352
701,2019-10-20,2350,917,1387,0,4654
701,2019-10-21,1478,9293,1671,5,12447
701,2019-10-22,124,4668,2117,0,6909
701,2019-10-23,1211,12795,1376,0,15382
701,2019-10-24,708,18354,1335,2,20399
701,2019-10-25,129,14846,1218,1,16194
701,2019-10-26,72,24481,1836,1,26390
701,2019-10-27,105,30383,1451,0,31939
701,2019-10-28,154,24732,1629,1,26516
701,2019-10-29,1016,17019,1734,2,19771
701,2019-10-30,447,15065,1379,1,16892
701,2019-10-31,1269,19460,937,2,21668
701,2019-11-01,890,26770,1848,1,29509
701,2019-11-02,81,15797,1373,0,17251
701,2019-11-03,947,36033,1671,0,38651
701,2019-11-04,111,9484,1282,0,10877
701,2019-11-05,999,2912,1744,0,5655
701,2019-11-06,120,7370,1148,0,8638
701,2019-11-07,1018,13222,851,0,15091
701,2019-11-08,101,8835,1580,0,10516
701,2019-11-09,986,7865,1945,0,10796
701,2019-11-10,255,11662,2388,0,14305
701,2019-11-11,581,7774,2496,0,10851
701,2019-11-12,67,9187,3867,0,13121
701,2019-11-13,191,11345,2094,0,13630
701,2019-11-14,61,7397,1742,0,9200
701,2019-11-15,161,2087,3140,0,5388
701,2019-11-16,79,1029,2201,0,3309
701,2019-11-17,433,2593,3438,0,6464
701,2019-11-18,262,2080,3847,0,6189
701,2019-11-19,134,2714,3638,0,6486
701,2019-11-20,134,1352,2188,0,3674
701,2019-11-21,95,5382,1314,0,6791
701,2019-11-22,63,8692,1332,0,10087
701,2019-11-23,140,10517,2906,0,13563
701,2019-11-24,667,8860,1527,0,11054
701,2019-11-25,70,10263,2006,0,12339
701,2019-11-26,97,8968,1605,0,10670
701,2019-11-27,539,10337,1516,0,12392
701,2019-11-28,46,13778,428,0,14252
701,2019-08-13,141,354,138,1,634
701,2019-08-14,176,765,62,1,1004
701,2019-08-15,139,400,56,1,596
701,2019-08-16,105,321,76,0,502
701,2019-08-17,243,1158,483,0,1884
701,2019-08-18,159,2158,1202,2,3521
701,2019-08-19,197,2925,1195,1,4318
701,2019-08-20,223,2658,1026,0,3907
701,2019-08-21,84,1626,1195,0,2905
701,2019-08-22,72,5277,1475,2,6826
701,2019-08-23,91,1738,1500,1,3330
701,2019-08-24,717,2669,1705,0,5091
701,2019-08-25,963,17824,1444,3,20234
701,2019-08-26,596,14209,2168,1,16974
701,2019-08-27,1002,6874,1902,2,9780
701,2019-08-28,114,5204,1667,0,6985
701,2019-08-29,120,9430,1870,2,11422
701,2019-08-30,82,2914,1098,0,4094
701,2019-08-31,59,169,1,0,229
701,2019-09-01,43,271,619,0,933
701,2019-09-02,39,344,43,0,426
701,2019-09-03,93,912,1383,0,2388
701,2019-09-04,92,15363,2710,2,18167
701,2019-09-05,100,8648,2762,1,11511
701,2019-09-06,110,10652,2119,0,12881
701,2019-09-07,91,11788,2038,1,13918
701,2019-09-08,1028,6551,1813,0,9392
701,2019-09-09,210,6721,2733,0,9664
701,2019-09-10,96,9223,2135,0,11454
701,2019-09-11,1053,9133,1973,2,12161
701,2019-09-12,71,6207,1843,2,8123
701,2019-09-13,128,5658,1725,0,7511
701,2019-09-14,86,6965,1433,1,8485
701,2019-09-15,81,13096,2005,1,15183
701,2019-09-16,117,16018,3327,1,19463
701,2019-09-17,940,8225,1919,1,11085
701,2019-09-18,115,19770,1142,0,21027
701,2019-09-19,357,9705,2664,2,12728
701,2019-09-20,278,19705,1904,1,21888
701,2019-09-21,79,12098,2321,2,14500
701,2019-09-22,1001,13696,2720,0,17417
701,2019-09-23,967,12359,1385,0,14711
701,2019-09-24,123,10687,1983,2,12795
701,2019-09-25,168,12588,1500,3,14259
701,2019-09-26,110,12383,1580,3,14076
701,2019-09-27,88,8452,1581,2,10123
701,2019-09-28,105,24924,1095,1,26125
701,2019-09-29,364,28179,861,0,29404
701,2019-09-30,66,27998,2402,1,30467
701,2019-10-01,82,21567,1296,2,22947
701,2019-10-02,77,15509,2255,0,17841
701,2019-10-03,971,21498,1307,0,23776
701,2019-10-04,90,13055,1785,2,14932
701,2019-10-05,1442,20633,1247,0,23322
701,2019-10-06,70,15204,1284,3,16561
701,2019-10-07,509,3225,2129,1,5864
701,2019-10-08,962,16968,1713,2,19645
701,2019-10-09,1823,33322,1232,1,36378
701,2019-10-10,1484,11532,1622,2,14640
701,2019-10-11,79,15671,2417,4,18171
701,2019-10-12,211,7930,2258,1,10400
701,2019-10-13,95,7447,1854,1,9397
701,2019-10-14,1430,5527,1389,1,8347
701,2019-10-15,147,12602,1776,2,14527
701,2019-10-16,170,23071,1924,3,25168
701,2019-10-17,85,6938,2174,0,9197
701,2019-10-18,2022,13987,1433,1,17443
701,2019-10-19,1870,7024,1458,0,10352
701,2019-10-20,2350,917,1387,0,4654
701,2019-10-21,1478,9293,1671,5,12447
701,2019-10-22,124,4668,2117,0,6909
701,2019-10-23,1211,12795,1376,0,15382
701,2019-10-24,708,18354,1335,2,20399
701,2019-10-25,129,14846,1218,1,16194
701,2019-10-26,72,24481,1836,1,26390
701,2019-10-27,105,30383,1451,0,31939
701,2019-10-28,154,24732,1629,1,26516
701,2019-10-29,1016,17019,1734,2,19771
701,2019-10-30,447,15065,1379,1,16892
701,2019-10-31,1269,19460,937,2,21668
701,2019-11-01,890,26770,1848,1,29509
703,2019-08-14,49,308,160,0,517
703,2019-08-15,87,664,1,0,752
703,2019-08-16,195,378,114,0,687
703,2019-08-17,440,1550,465,0,2455
703,2019-08-18,880,2311,1015,0,4206
703,2019-08-19,101,15302,1499,0,16902
703,2019-08-20,382,15963,1066,0,17411
703,2019-08-21,150,11557,1530,0,13237
703,2019-08-22,131,14959,1742,1,16833
703,2019-08-23,147,20606,1530,0,22283
703,2019-08-24,113,16083,1440,0,17636
703,2019-08-25,270,28355,1890,7,30522
703,2019-08-26,183,25653,1170,0,27006
703,2019-08-27,187,13470,2065,1,15723
703,2019-08-28,118,24521,1530,0,26169
703,2019-08-29,134,16466,2343,0,18943
703,2019-08-30,92,3167,824,1,4084
703,2019-08-31,39,347,10,0,396
703,2019-09-01,139,338,270,0,747
703,2019-09-02,20,393,55,0,468
703,2019-09-03,109,999,1571,1,2680
703,2019-09-04,89,14339,2115,2,16545
703,2019-09-05,132,18197,2540,0,20869
703,2019-09-06,939,17339,1585,0,19863
703,2019-09-07,269,12061,1939,0,14269
703,2019-09-08,248,8001,2193,2,10444
703,2019-09-09,961,12474,2250,1,15686
703,2019-09-10,954,13025,1855,2,15836
703,2019-09-11,1408,9399,2021,1,12829
703,2019-09-12,77,6371,2227,1,8676
703,2019-09-13,946,4516,1713,0,7175
703,2019-09-14,103,10706,2025,0,12834
703,2019-09-15,116,11442,1412,3,12973
703,2019-09-16,937,16373,1787,0,19097
703,2019-09-17,94,14227,2610,2,16933
703,2019-09-18,89,20108,1243,0,21440
703,2019-09-19,305,4393,1742,1,6441
703,2019-09-20,209,9216,1485,2,10912
703,2019-09-21,189,6321,2544,3,9057
703,2019-09-22,108,15697,1734,2,17541
703,2019-09-23,196,11215,2505,0,13916
703,2019-09-24,986,9111,1167,2,11266
703,2019-09-25,321,11444,1922,0,13687
703,2019-09-26,99,14948,2646,3,17696
703,2019-09-27,960,10830,2233,4,14027
703,2019-09-28,381,25748,1215,2,27346
703,2019-09-29,306,19535,1981,226,22048
703,2019-09-30,936,17185,2039,1,20161
703,2019-10-01,160,22468,1654,0,24282
703,2019-10-02,115,15091,1662,2,16870
703,2019-10-03,113,22685,1167,0,23965
703,2019-10-04,91,21898,1320,3,23312
703,2019-10-05,68,30443,1566,1,32078
703,2019-10-06,84,21030,2325,1,23440
703,2019-10-07,95,8611,1726,4,10436
703,2019-10-08,108,14503,1188,0,15799
703,2019-10-09,97,24398,1566,0,26061
703,2019-10-10,754,13280,1898,1,15933
703,2019-10-11,875,12872,1850,1,15598
703,2019-10-12,153,6312,1908,3,8376
703,2019-10-13,86,13644,1712,0,15442
703,2019-10-14,446,26016,1550,1,28013
703,2019-10-15,87,9278,2448,0,11813
703,2019-10-16,75,14442,1284,5,15806
703,2019-10-17,183,5775,1530,3,7491
703,2019-10-18,563,9463,2056,2,12084
703,2019-10-19,132,5804,1741,1,7678
703,2019-10-20,1610,23921,1453,0,26984
703,2019-10-21,693,16099,1549,1,18342
703,2019-10-22,447,7231,1772,3,9453
703,2019-10-23,106,14937,1491,3,16537
703,2019-10-24,102,26778,1744,0,28624
703,2019-10-25,94,15519,1941,5,17559
703,2019-10-26,940,15853,885,0,17678
703,2019-10-27,156,17699,1661,1,19517
703,2019-10-28,1097,14754,1506,1,17358
703,2019-10-29,482,27361,1198,0,29041
703,2019-10-30,515,20641,1379,1,22536
703,2019-10-31,101,21333,1804,1,23239
703,2019-11-01,96,27743,1434,2,29275
703,2019-11-02,67,18313,1107,0,19487
703,2019-11-03,76,23587,1226,2,24891
703,2019-11-04,650,8194,1744,0,10588
703,2019-11-05,144,3486,1933,1,5564
703,2019-11-06,386,16702,606,2,17696
703,2019-11-07,159,17245,890,0,18294
703,2019-11-08,67,10780,1222,0,12069
703,2019-11-09,990,9367,1284,0,11641
703,2019-11-10,89,15161,1528,0,16778
703,2019-11-11,914,9862,2664,0,13440
703,2019-11-12,149,10612,3253,0,14014
703,2019-11-13,188,15212,1702,0,17102
703,2019-11-14,138,10878,1718,0,12734
703,2019-11-15,132,4481,2401,0,7014
703,2019-11-16,68,2584,3013,0,5665
703,2019-11-17,217,4990,3735,0,8942
703,2019-11-18,120,3355,3083,0,6558
703,2019-11-19,87,3376,2650,0,6113
703,2019-11-20,213,1454,1813,0,3480
703,2019-11-21,933,3749,1890,4,6576
703,2019-11-22,1475,9498,1165,2,12140
703,2019-11-23,113,7305,2008,1,9427
703,2019-11-24,239,6757,2125,1,9122
703,2019-11-25,1110,7107,1977,0,10194
703,2019-11-26,65,8040,1512,2,9619
703,2019-11-27,67,7496,1439,1,9003
703,2019-11-28,179,9486,830,0,10495
703,2019-11-29,40,1176,84,0,1300
703,2019-08-14,49,308,160,0,517
703,2019-08-15,87,664,1,0,752
703,2019-08-16,195,378,114,0,687
703,2019-08-17,440,1550,465,0,2455
703,2019-08-18,880,2311,1015,0,4206
703,2019-08-19,101,15302,1499,0,16902
703,2019-08-20,382,15963,1066,0,17411
703,2019-08-21,150,11557,1530,0,13237
703,2019-08-22,131,14959,1742,1,16833
703,2019-08-23,147,20606,1530,0,22283
703,2019-08-24,113,16083,1440,0,17636
703,2019-08-25,270,28355,1890,7,30522
703,2019-08-26,183,25653,1170,0,27006
703,2019-08-27,187,13470,2065,1,15723
703,2019-08-28,118,24521,1530,0,26169
703,2019-08-29,134,16466,2343,0,18943
703,2019-08-30,92,3167,824,1,4084
703,2019-08-31,39,347,10,0,396
703,2019-09-01,139,338,270,0,747
703,2019-09-02,20,393,55,0,468
703,2019-09-03,109,999,1571,1,2680
703,2019-09-04,89,14339,2115,2,16545
703,2019-09-05,132,18197,2540,0,20869
703,2019-09-06,939,17339,1585,0,19863
703,2019-09-07,269,12061,1939,0,14269
703,2019-09-08,248,8001,2193,2,10444
703,2019-09-09,961,12474,2250,1,15686
703,2019-09-10,954,13025,1855,2,15836
703,2019-09-11,1408,9399,2021,1,12829
703,2019-09-12,77,6371,2227,1,8676
703,2019-09-13,946,4516,1713,0,7175
703,2019-09-14,103,10706,2025,0,12834
703,2019-09-15,116,11442,1412,3,12973
703,2019-09-16,937,16373,1787,0,19097
703,2019-09-17,94,14227,2610,2,16933
703,2019-09-18,89,20108,1243,0,21440
703,2019-09-19,305,4393,1742,1,6441
703,2019-09-20,209,9216,1485,2,10912
703,2019-09-21,189,6321,2544,3,9057
703,2019-09-22,108,15697,1734,2,17541
703,2019-09-23,196,11215,2505,0,13916
703,2019-09-24,986,9111,1167,2,11266
703,2019-09-25,321,11444,1922,0,13687
703,2019-09-26,99,14948,2646,3,17696
703,2019-09-27,960,10830,2233,4,14027
703,2019-09-28,381,25748,1215,2,27346
703,2019-09-29,306,19535,1981,226,22048
703,2019-09-30,936,17185,2039,1,20161
703,2019-10-01,160,22468,1654,0,24282
703,2019-10-02,115,15091,1662,2,16870
703,2019-10-03,113,22685,1167,0,23965
703,2019-10-04,91,21898,1320,3,23312
703,2019-10-05,68,30443,1566,1,32078
703,2019-10-06,84,21030,2325,1,23440
703,2019-10-07,95,8611,1726,4,10436
703,2019-10-08,108,14503,1188,0,15799
703,2019-10-09,97,24398,1566,0,26061
703,2019-10-10,754,13280,1898,1,15933
703,2019-10-11,875,12872,1850,1,15598
703,2019-10-12,153,6312,1908,3,8376
703,2019-10-13,86,13644,1712,0,15442
703,2019-10-14,446,26016,1550,1,28013
703,2019-10-15,87,9278,2448,0,11813
703,2019-10-16,75,14442,1284,5,15806
703,2019-10-17,183,5775,1530,3,7491
703,2019-10-18,563,9463,2056,2,12084
703,2019-10-19,132,5804,1741,1,7678
703,2019-10-20,1610,23921,1453,0,26984
703,2019-10-21,693,16099,1549,1,18342
703,2019-10-22,447,7231,1772,3,9453
703,2019-10-23,106,14937,1491,3,16537
703,2019-10-24,102,26778,1744,0,28624
703,2019-10-25,94,15519,1941,5,17559
703,2019-10-26,940,15853,885,0,17678
703,2019-10-27,156,17699,1661,1,19517
703,2019-10-28,1097,14754,1506,1,17358
703,2019-10-29,482,27361,1198,0,29041
703,2019-10-30,515,20641,1379,1,22536
703,2019-10-31,101,21333,1804,1,23239
703,2019-11-01,96,27743,1434,2,29275
703,2019-11-02,67,18313,1107,0,19487
703,2019-11-03,76,23587,1226,2,24891
703,2019-11-04,650,8194,1744,0,10588
703,2019-11-05,144,3486,1933,1,5564
703,2019-11-06,386,16702,606,2,17696
703,2019-11-07,159,17245,890,0,18294
703,2019-11-08,67,10780,1222,0,12069
703,2019-11-09,990,9367,1284,0,11641
703,2019-11-10,89,15161,1528,0,16778
703,2019-11-11,914,9862,2664,0,13440
703,2019-11-12,149,10612,3253,0,14014
703,2019-11-13,188,15212,1702,0,17102
703,2019-11-14,138,10878,1718,0,12734
703,2019-11-15,132,4481,2401,0,7014
703,2019-11-16,68,2584,3013,0,5665
703,2019-11-17,217,4990,3735,0,8942
703,2019-11-18,120,3355,3083,0,6558
703,2019-11-19,87,3376,2650,0,6113
703,2019-11-20,213,1454,1813,0,3480
703,2019-11-21,933,3749,1890,4,6576
703,2019-11-22,1475,9498,1165,2,12140
703,2019-11-23,113,7305,2008,1,9427
703,2019-11-24,239,6757,2125,1,9122
703,2019-11-25,1110,7107,1977,0,10194
703,2019-11-26,65,8040,1512,2,9619
703,2019-11-27,67,7496,1439,1,9003
703,2019-11-28,179,9486,830,0,10495
703,2019-11-29,40,1176,84,0,1300
703,2019-08-13,0,0,21,0,21
703,2019-08-14,49,308,160,0,517
703,2019-08-15,87,664,1,0,752
703,2019-08-16,195,378,114,0,687
703,2019-08-17,440,1550,465,0,2455
703,2019-08-18,880,2311,1015,0,4206
703,2019-08-19,101,15302,1499,0,16902
703,2019-08-20,382,15963,1066,0,17411
703,2019-08-21,150,11557,1530,0,13237
703,2019-08-22,131,14959,1742,1,16833
703,2019-08-23,147,20606,1530,0,22283
703,2019-08-24,113,16083,1440,0,17636
703,2019-08-25,270,28355,1890,7,30522
703,2019-08-26,183,25653,1170,0,27006
703,2019-08-27,187,13470,2065,1,15723
703,2019-08-28,118,24521,1530,0,26169
703,2019-08-29,134,16466,2343,0,18943
703,2019-08-30,92,3167,824,1,4084
703,2019-08-31,39,347,10,0,396
703,2019-09-01,139,338,270,0,747
703,2019-09-02,20,393,55,0,468
703,2019-09-03,109,999,1571,1,2680
703,2019-09-04,89,14339,2115,2,16545
703,2019-09-05,132,18197,2540,0,20869
703,2019-09-06,939,17339,1585,0,19863
703,2019-09-07,269,12061,1939,0,14269
703,2019-09-08,248,8001,2193,2,10444
703,2019-09-09,961,12474,2250,1,15686
703,2019-09-10,954,13025,1855,2,15836
703,2019-09-11,1408,9399,2021,1,12829
703,2019-09-12,77,6371,2227,1,8676
703,2019-09-13,946,4516,1713,0,7175
703,2019-09-14,103,10706,2025,0,12834
703,2019-09-15,116,11442,1412,3,12973
703,2019-09-16,937,16373,1787,0,19097
703,2019-09-17,94,14227,2610,2,16933
703,2019-09-18,89,20108,1243,0,21440
703,2019-09-19,305,4393,1742,1,6441
703,2019-09-20,209,9216,1485,2,10912
703,2019-09-21,189,6321,2544,3,9057
703,2019-09-22,108,15697,1734,2,17541
703,2019-09-23,196,11215,2505,0,13916
703,2019-09-24,986,9111,1167,2,11266
703,2019-09-25,321,11444,1922,0,13687
703,2019-09-26,99,14948,2646,3,17696
703,2019-09-27,960,10830,2233,4,14027
703,2019-09-28,381,25748,1215,2,27346
703,2019-09-29,306,19535,1981,226,22048
703,2019-09-30,936,17185,2039,1,20161
703,2019-10-01,160,22468,1654,0,24282
703,2019-10-02,115,15091,1662,2,16870
703,2019-10-03,113,22685,1167,0,23965
703,2019-10-04,91,21898,1320,3,23312
703,2019-10-05,68,30443,1566,1,32078
703,2019-10-06,84,21030,2325,1,23440
703,2019-10-07,95,8611,1726,4,10436
703,2019-10-08,108,14503,1188,0,15799
703,2019-10-09,97,24398,1566,0,26061
703,2019-10-10,754,13280,1898,1,15933
703,2019-10-11,875,12872,1850,1,15598
703,2019-10-12,153,6312,1908,3,8376
703,2019-10-13,86,13644,1712,0,15442
703,2019-10-14,446,26016,1550,1,28013
703,2019-10-15,87,9278,2448,0,11813
703,2019-10-16,75,14442,1284,5,15806
703,2019-10-17,183,5775,1530,3,7491
703,2019-10-18,563,9463,2056,2,12084
703,2019-10-19,132,5804,1741,1,7678
703,2019-10-20,1610,23921,1453,0,26984
703,2019-10-21,693,16099,1549,1,18342
703,2019-10-22,447,7231,1772,3,9453
703,2019-10-23,106,14937,1491,3,16537
703,2019-10-24,102,26778,1744,0,28624
703,2019-10-25,94,15519,1941,5,17559
703,2019-10-26,940,15853,885,0,17678
703,2019-10-27,156,17699,1661,1,19517
703,2019-10-28,1097,14754,1506,1,17358
703,2019-10-29,482,27361,1198,0,29041
703,2019-10-30,515,20641,1379,1,22536
703,2019-10-31,101,21333,1804,1,23239
703,2019-11-01,96,27743,1434,2,29275
703,2019-11-02,67,18313,1107,0,19487
703,2019-11-03,76,23587,1226,2,24891
703,2019-11-04,650,8194,1744,0,10588
703,2019-11-05,144,3486,1933,1,5564
703,2019-11-06,386,16702,606,2,17696
703,2019-11-07,159,17245,890,0,18294
703,2019-11-08,67,10780,1222,0,12069
703,2019-11-09,990,9367,1284,0,11641
703,2019-11-10,89,15161,1528,0,16778
703,2019-11-11,914,9862,2664,0,13440
703,2019-11-12,149,10612,3253,0,14014
703,2019-11-13,188,15212,1702,0,17102
703,2019-11-14,138,10878,1718,0,12734
703,2019-11-15,132,4481,2401,0,7014
703,2019-11-16,68,2584,3013,0,5665
703,2019-11-17,217,4990,3735,0,8942
703,2019-11-18,120,3355,3083,0,6558
703,2019-11-19,87,3376,2650,0,6113
703,2019-11-20,213,1454,1813,0,3480
703,2019-11-21,933,3749,1890,4,6576
703,2019-11-22,1475,9498,1165,2,12140
703,2019-11-23,113,7305,2008,1,9427
703,2019-11-24,239,6757,2125,1,9122
703,2019-11-25,1110,7107,1977,0,10194
703,2019-11-26,65,8040,1512,2,9619
703,2019-11-27,67,7496,1439,1,9003
703,2019-11-28,179,9486,830,0,10495
703,2019-11-29,40,1176,84,0,1300
703,2019-08-22,131,14959,1742,1,16833
703,2019-08-23,147,20606,1530,0,22283
703,2019-08-24,113,16083,1440,0,17636
703,2019-08-25,270,28355,1890,7,30522
703,2019-08-26,183,25653,1170,0,27006
703,2019-08-27,187,13470,2065,1,15723
703,2019-08-28,118,24521,1530,0,26169
703,2019-08-29,134,16466,2343,0,18943
703,2019-08-30,92,3167,824,1,4084
703,2019-08-31,39,347,10,0,396
703,2019-09-01,139,338,270,0,747
703,2019-09-02,20,393,55,0,468
703,2019-09-03,109,999,1571,1,2680
703,2019-09-04,89,14339,2115,2,16545
703,2019-09-05,132,18197,2540,0,20869
703,2019-09-06,939,17339,1585,0,19863
703,2019-09-07,269,12061,1939,0,14269
703,2019-09-08,248,8001,2193,2,10444
703,2019-09-09,961,12474,2250,1,15686
703,2019-09-10,954,13025,1855,2,15836
703,2019-09-11,1408,9399,2021,1,12829
703,2019-09-12,77,6371,2227,1,8676
703,2019-09-13,946,4516,1713,0,7175
703,2019-09-14,103,10706,2025,0,12834
703,2019-09-15,116,11442,1412,3,12973
703,2019-09-16,937,16373,1787,0,19097
703,2019-09-17,94,14227,2610,2,16933
703,2019-09-18,89,20108,1243,0,21440
703,2019-09-19,305,4393,1742,1,6441
703,2019-09-20,209,9216,1485,2,10912
703,2019-09-21,189,6321,2544,3,9057
703,2019-09-22,108,15697,1734,2,17541
703,2019-09-23,196,11215,2505,0,13916
703,2019-09-24,986,9111,1167,2,11266
703,2019-09-25,321,11444,1922,0,13687
703,2019-09-26,99,14948,2646,3,17696
703,2019-09-27,960,10830,2233,4,14027
703,2019-09-28,381,25748,1215,2,27346
703,2019-09-29,306,19535,1981,226,22048
703,2019-09-30,936,17185,2039,1,20161
703,2019-10-01,160,22468,1654,0,24282
703,2019-10-02,115,15091,1662,2,16870
703,2019-10-03,113,22685,1167,0,23965
703,2019-10-04,91,21898,1320,3,23312
703,2019-10-05,68,30443,1566,1,32078
703,2019-10-06,84,21030,2325,1,23440
703,2019-10-07,95,8611,1726,4,10436
703,2019-10-08,108,14503,1188,0,15799
703,2019-10-09,97,24398,1566,0,26061
703,2019-10-10,754,13280,1898,1,15933
703,2019-10-11,875,12872,1850,1,15598
703,2019-10-12,153,6312,1908,3,8376
703,2019-10-13,86,13644,1712,0,15442
703,2019-10-14,446,26016,1550,1,28013
703,2019-10-15,87,9278,2448,0,11813
703,2019-10-16,75,14442,1284,5,15806
703,2019-10-17,183,5775,1530,3,7491
703,2019-10-18,563,9463,2056,2,12084
703,2019-10-19,132,5804,1741,1,7678
703,2019-10-20,1610,23921,1453,0,26984
703,2019-10-21,693,16099,1549,1,18342
703,2019-10-22,447,7231,1772,3,9453
703,2019-10-23,106,14937,1491,3,16537
703,2019-10-24,102,26778,1744,0,28624
703,2019-10-25,94,15519,1941,5,17559
703,2019-10-26,940,15853,885,0,17678
703,2019-10-27,156,17699,1661,1,19517
703,2019-10-28,1097,14754,1506,1,17358
703,2019-10-29,482,27361,1198,0,29041
703,2019-10-30,515,20641,1379,1,22536
703,2019-10-31,101,21333,1804,1,23239
703,2019-11-01,96,27743,1434,2,29275
703,2019-11-02,67,18313,1107,0,19487
703,2019-11-03,76,23587,1226,2,24891
703,2019-11-04,650,8194,1744,0,10588
703,2019-11-05,144,3486,1933,1,5564
703,2019-11-06,386,16702,606,2,17696
703,2019-11-07,159,17245,890,0,18294
703,2019-11-08,67,10780,1222,0,12069
703,2019-11-09,990,9367,1284,0,11641
703,2019-11-10,89,15161,1528,0,16778
703,2019-11-11,914,9862,2664,0,13440
703,2019-11-12,149,10612,3253,0,14014
703,2019-11-13,188,15212,1702,0,17102
703,2019-11-14,138,10878,1718,0,12734
703,2019-11-15,132,4481,2401,0,7014
703,2019-11-16,68,2584,3013,0,5665
703,2019-11-17,217,4990,3735,0,8942
703,2019-11-18,120,3355,3083,0,6558
703,2019-11-19,87,3376,2650,0,6113
703,2019-11-20,213,1454,1813,0,3480
703,2019-11-21,933,3749,1890,4,6576
703,2019-11-22,1475,9498,1165,2,12140
703,2019-11-23,113,7305,2008,1,9427
703,2019-11-24,239,6757,2125,1,9122
703,2019-11-25,1110,7107,1977,0,10194
703,2019-11-26,65,8040,1512,2,9619
703,2019-11-27,67,7496,1439,1,9003
704,2019-08-14,68,682,39,0,789
704,2019-08-15,291,647,18,0,956
704,2019-08-16,294,258,37,0,589
704,2019-08-17,349,1647,782,0,2778
704,2019-08-18,1163,1993,1153,0,4309
704,2019-08-19,734,3370,2119,0,6223
704,2019-08-20,533,2434,931,0,3898
704,2019-08-21,460,1159,1093,0,2712
704,2019-08-22,583,1200,1673,0,3456
704,2019-08-23,508,2614,1502,0,4624
704,2019-08-24,433,5171,1157,0,6761
704,2019-08-25,863,24785,1698,2,27348
704,2019-08-26,1237,29084,1935,2,32258
704,2019-08-27,487,10776,1718,0,12981
704,2019-08-28,466,14187,1890,0,16543
704,2019-08-29,964,12961,1264,0,15189
704,2019-08-30,587,3114,544,0,4245
704,2019-08-31,93,424,97,0,614
704,2019-09-01,211,2029,453,0,2693
704,2019-09-02,48,526,97,1,672
704,2019-09-03,982,1091,898,1,2972
704,2019-09-04,474,15169,2147,2,17792
704,2019-09-05,396,14950,2469,0,17815
704,2019-09-06,537,10136,1894,0,12567
704,2019-09-07,630,8726,2504,0,11860
704,2019-09-08,712,7574,1913,0,10199
704,2019-09-09,586,9206,2166,0,11958
704,2019-09-10,556,12666,2964,1,16187
704,2019-09-11,1025,8397,1652,1,11075
704,2019-09-12,2173,7912,2039,2,12126
704,2019-09-13,816,6559,1710,0,9085
704,2019-09-14,451,7438,2191,0,10080
704,2019-09-15,385,9799,1083,1,11268
704,2019-09-16,2047,15156,1909,1,19113
704,2019-09-17,370,14361,1710,1,16442
704,2019-09-18,898,17302,2215,1,20416
704,2019-09-19,696,11751,1440,0,13887
704,2019-09-20,1426,15139,1131,1,17697
704,2019-09-21,501,7612,1621,1,9735
704,2019-09-22,486,14311,1707,0,16504
704,2019-09-23,477,11530,2327,1,14335
704,2019-09-24,583,12404,1892,1,14880
704,2019-09-25,727,8302,1629,1,10659
704,2019-09-26,1068,10767,2036,1,13872
704,2019-09-27,176,8887,1747,5,10815
704,2019-09-28,253,15428,1992,1,17674
704,2019-09-29,1075,27797,2168,1,31041
704,2019-09-30,199,28292,1474,1,29966
704,2019-10-01,181,23149,963,0,24293
704,2019-10-02,279,17376,1715,0,19370
704,2019-10-03,207,14730,1692,1,16630
704,2019-10-04,211,13484,1174,2,14871
704,2019-10-05,1083,19444,1300,1,21828
704,2019-10-06,1700,17335,1640,1,20676
704,2019-10-07,2665,7927,2855,4,13451
704,2019-10-08,711,18957,760,1,20429
704,2019-10-09,1089,26297,1805,1,29192
704,2019-10-10,392,11831,2277,0,14500
704,2019-10-11,636,13182,1412,1,15231
704,2019-10-12,389,7577,1265,4,9235
704,2019-10-13,348,8863,1183,1,10395
704,2019-10-14,1256,6113,1836,1,9206
704,2019-10-15,867,9067,1983,2,11919
704,2019-10-16,1014,20239,1258,1,22512
704,2019-10-17,2182,9053,1864,2,13101
704,2019-10-18,1411,9084,1323,1,11819
704,2019-10-19,1162,6644,1752,0,9558
704,2019-10-20,794,3176,1289,0,5259
704,2019-10-21,397,10739,1609,2,12747
704,2019-10-22,435,7249,1544,2,9230
704,2019-10-23,376,14963,1830,1,17170
704,2019-10-24,1107,19017,1407,1,21532
704,2019-10-25,399,11414,1352,1,13166
704,2019-10-26,1253,21294,1960,1,24508
704,2019-10-27,403,18509,2140,2,21054
704,2019-10-28,1360,14264,2224,1,17849
704,2019-10-29,1396,15489,2170,1,19056
704,2019-10-30,1288,16162,1447,1,18898
704,2019-10-31,391,20716,2172,2,23281
704,2019-11-01,1101,27403,1449,2,29955
704,2019-11-02,366,27106,1674,0,29146
704,2019-11-03,353,53671,1593,0,55617
704,2019-11-04,412,13804,2161,0,16377
704,2019-11-05,446,3214,2600,0,6260
704,2019-11-06,427,14588,2172,2,17189
704,2019-11-07,521,24941,1520,2,26984
704,2019-11-08,1332,18264,1209,0,20805
704,2019-11-09,544,16140,1672,0,18356
704,2019-11-10,1288,16280,1530,0,19098
704,2019-11-11,372,10309,1757,5,12443
704,2019-11-12,413,11996,3488,1,15898
704,2019-11-13,513,20935,1825,0,23273
704,2019-11-14,394,15495,2069,1,17959
704,2019-11-15,1265,5184,2577,0,9026
704,2019-11-16,444,2890,3233,2,6569
704,2019-11-17,567,4465,3336,1,8369
704,2019-11-18,438,3441,3432,0,7311
704,2019-11-19,600,3478,2805,0,6883
704,2019-11-20,597,1484,1469,3,3553
704,2019-11-21,465,3543,1848,2,5858
704,2019-11-22,449,5402,1175,1,7027
704,2019-11-23,460,9079,2534,1,12074
704,2019-11-24,540,8362,1900,1,10803
704,2019-11-25,418,6976,1594,2,8990
704,2019-11-26,1332,6470,1569,2,9373
704,2019-11-27,427,6817,1498,0,8742
704,2019-11-28,359,9197,788,0,10344
704,2019-11-29,183,1001,61,0,1245
704,2019-08-14,68,682,39,0,789
704,2019-08-15,291,647,18,0,956
704,2019-08-16,294,258,37,0,589
704,2019-08-17,349,1647,782,0,2778
704,2019-08-18,1163,1993,1153,0,4309
704,2019-08-19,734,3370,2119,0,6223
704,2019-08-20,533,2434,931,0,3898
704,2019-08-21,460,1159,1093,0,2712
704,2019-08-22,583,1200,1673,0,3456
704,2019-08-23,508,2614,1502,0,4624
704,2019-08-24,433,5171,1157,0,6761
704,2019-08-25,863,24785,1698,2,27348
704,2019-08-26,1237,29084,1935,2,32258
704,2019-08-27,487,10776,1718,0,12981
704,2019-08-28,466,14187,1890,0,16543
704,2019-08-29,964,12961,1264,0,15189
704,2019-08-30,587,3114,544,0,4245
704,2019-08-31,93,424,97,0,614
704,2019-09-01,211,2029,453,0,2693
704,2019-09-02,48,526,97,1,672
704,2019-09-03,982,1091,898,1,2972
704,2019-09-04,474,15169,2147,2,17792
704,2019-09-05,396,14950,2469,0,17815
704,2019-09-06,537,10136,1894,0,12567
704,2019-09-07,630,8726,2504,0,11860
704,2019-09-08,712,7574,1913,0,10199
704,2019-09-09,586,9206,2166,0,11958
704,2019-09-10,556,12666,2964,1,16187
704,2019-09-11,1025,8397,1652,1,11075
704,2019-09-12,2173,7912,2039,2,12126
704,2019-09-13,816,6559,1710,0,9085
704,2019-09-14,451,7438,2191,0,10080
704,2019-09-15,385,9799,1083,1,11268
704,2019-09-16,2047,15156,1909,1,19113
704,2019-09-17,370,14361,1710,1,16442
704,2019-09-18,898,17302,2215,1,20416
704,2019-09-19,696,11751,1440,0,13887
704,2019-09-20,1426,15139,1131,1,17697
704,2019-09-21,501,7612,1621,1,9735
704,2019-09-22,486,14311,1707,0,16504
704,2019-09-23,477,11530,2327,1,14335
704,2019-09-24,583,12404,1892,1,14880
704,2019-09-25,727,8302,1629,1,10659
704,2019-09-26,1068,10767,2036,1,13872
704,2019-09-27,176,8887,1747,5,10815
704,2019-09-28,253,15428,1992,1,17674
704,2019-09-29,1075,27797,2168,1,31041
704,2019-09-30,199,28292,1474,1,29966
704,2019-10-01,181,23149,963,0,24293
704,2019-10-02,279,17376,1715,0,19370
704,2019-10-03,207,14730,1692,1,16630
704,2019-10-04,211,13484,1174,2,14871
704,2019-10-05,1083,19444,1300,1,21828
704,2019-10-06,1700,17335,1640,1,20676
704,2019-10-07,2665,7927,2855,4,13451
704,2019-10-08,711,18957,760,1,20429
704,2019-10-09,1089,26297,1805,1,29192
704,2019-10-10,392,11831,2277,0,14500
704,2019-10-11,636,13182,1412,1,15231
704,2019-10-12,389,7577,1265,4,9235
704,2019-10-13,348,8863,1183,1,10395
704,2019-10-14,1256,6113,1836,1,9206
704,2019-10-15,867,9067,1983,2,11919
704,2019-10-16,1014,20239,1258,1,22512
704,2019-10-17,2182,9053,1864,2,13101
704,2019-10-18,1411,9084,1323,1,11819
704,2019-10-19,1162,6644,1752,0,9558
704,2019-10-20,794,3176,1289,0,5259
704,2019-10-21,397,10739,1609,2,12747
704,2019-10-22,435,7249,1544,2,9230
704,2019-10-23,376,14963,1830,1,17170
704,2019-10-24,1107,19017,1407,1,21532
704,2019-10-25,399,11414,1352,1,13166
704,2019-10-26,1253,21294,1960,1,24508
704,2019-10-27,403,18509,2140,2,21054
704,2019-10-28,1360,14264,2224,1,17849
704,2019-10-29,1396,15489,2170,1,19056
704,2019-10-30,1288,16162,1447,1,18898
704,2019-10-31,391,20716,2172,2,23281
704,2019-11-01,1101,27403,1449,2,29955
704,2019-11-02,366,27106,1674,0,29146
704,2019-11-03,353,53671,1593,0,55617
704,2019-11-04,412,13804,2161,0,16377
704,2019-11-05,446,3214,2600,0,6260
704,2019-11-06,427,14588,2172,2,17189
704,2019-11-07,521,24941,1520,2,26984
704,2019-11-08,1332,18264,1209,0,20805
704,2019-11-09,544,16140,1672,0,18356
704,2019-11-10,1288,16280,1530,0,19098
704,2019-11-11,372,10309,1757,5,12443
704,2019-11-12,413,11996,3488,1,15898
704,2019-11-13,513,20935,1825,0,23273
704,2019-11-14,394,15495,2069,1,17959
704,2019-11-15,1265,5184,2577,0,9026
704,2019-11-16,444,2890,3233,2,6569
704,2019-11-17,567,4465,3336,1,8369
704,2019-11-18,438,3441,3432,0,7311
704,2019-11-19,600,3478,2805,0,6883
704,2019-11-20,597,1484,1469,3,3553
704,2019-11-21,465,3543,1848,2,5858
704,2019-11-22,449,5402,1175,1,7027
704,2019-11-23,460,9079,2534,1,12074
704,2019-11-24,540,8362,1900,1,10803
704,2019-11-25,418,6976,1594,2,8990
704,2019-11-26,1332,6470,1569,2,9373
704,2019-11-27,427,6817,1498,0,8742
704,2019-11-28,359,9197,788,0,10344
704,2019-11-29,183,1001,61,0,1245
704,2019-08-14,68,682,39,0,789
704,2019-08-15,291,647,18,0,956
704,2019-08-16,294,258,37,0,589
704,2019-08-17,349,1647,782,0,2778
704,2019-08-18,1163,1993,1153,0,4309
704,2019-08-19,734,3370,2119,0,6223
704,2019-08-20,533,2434,931,0,3898
704,2019-08-21,460,1159,1093,0,2712
704,2019-08-22,583,1200,1673,0,3456
704,2019-08-23,508,2614,1502,0,4624
704,2019-08-24,433,5171,1157,0,6761
704,2019-08-25,863,24785,1698,2,27348
704,2019-08-26,1237,29084,1935,2,32258
704,2019-08-27,487,10776,1718,0,12981
704,2019-08-28,466,14187,1890,0,16543
704,2019-08-29,964,12961,1264,0,15189
704,2019-08-30,587,3114,544,0,4245
704,2019-08-31,93,424,97,0,614
704,2019-09-01,211,2029,453,0,2693
704,2019-09-02,48,526,97,1,672
704,2019-09-03,982,1091,898,1,2972
704,2019-09-04,474,15169,2147,2,17792
704,2019-09-05,396,14950,2469,0,17815
704,2019-09-06,537,10136,1894,0,12567
704,2019-09-07,630,8726,2504,0,11860
704,2019-09-08,712,7574,1913,0,10199
704,2019-09-09,586,9206,2166,0,11958
704,2019-09-10,556,12666,2964,1,16187
704,2019-09-11,1025,8397,1652,1,11075
704,2019-09-12,2173,7912,2039,2,12126
704,2019-09-13,816,6559,1710,0,9085
704,2019-09-14,451,7438,2191,0,10080
704,2019-09-15,385,9799,1083,1,11268
704,2019-09-16,2047,15156,1909,1,19113
704,2019-09-17,370,14361,1710,1,16442
704,2019-09-18,898,17302,2215,1,20416
704,2019-09-19,696,11751,1440,0,13887
704,2019-09-20,1426,15139,1131,1,17697
704,2019-09-21,501,7612,1621,1,9735
704,2019-09-22,486,14311,1707,0,16504
704,2019-09-23,477,11530,2327,1,14335
704,2019-09-24,583,12404,1892,1,14880
704,2019-09-25,727,8302,1629,1,10659
704,2019-09-26,1068,10767,2036,1,13872
704,2019-09-27,176,8887,1747,5,10815
704,2019-09-28,253,15428,1992,1,17674
704,2019-09-29,1075,27797,2168,1,31041
704,2019-09-30,199,28292,1474,1,29966
704,2019-10-01,181,23149,963,0,24293
704,2019-10-02,279,17376,1715,0,19370
704,2019-10-03,207,14730,1692,1,16630
704,2019-10-04,211,13484,1174,2,14871
704,2019-10-05,1083,19444,1300,1,21828
704,2019-10-06,1700,17335,1640,1,20676
704,2019-10-07,2665,7927,2855,4,13451
704,2019-10-08,711,18957,760,1,20429
704,2019-10-09,1089,26297,1805,1,29192
704,2019-10-10,392,11831,2277,0,14500
704,2019-10-11,636,13182,1412,1,15231
704,2019-10-12,389,7577,1265,4,9235
704,2019-10-13,348,8863,1183,1,10395
704,2019-10-14,1256,6113,1836,1,9206
704,2019-10-15,867,9067,1983,2,11919
704,2019-10-16,1014,20239,1258,1,22512
704,2019-10-17,2182,9053,1864,2,13101
704,2019-10-18,1411,9084,1323,1,11819
704,2019-10-19,1162,6644,1752,0,9558
704,2019-10-20,794,3176,1289,0,5259
704,2019-10-21,397,10739,1609,2,12747
704,2019-10-22,435,7249,1544,2,9230
704,2019-10-23,376,14963,1830,1,17170
704,2019-10-24,1107,19017,1407,1,21532
704,2019-10-25,399,11414,1352,1,13166
704,2019-10-26,1253,21294,1960,1,24508
704,2019-10-27,403,18509,2140,2,21054
704,2019-10-28,1360,14264,2224,1,17849
704,2019-10-29,1396,15489,2170,1,19056
704,2019-10-30,1288,16162,1447,1,18898
704,2019-10-31,391,20716,2172,2,23281
704,2019-11-01,1101,27403,1449,2,29955
704,2019-11-02,366,27106,1674,0,29146
704,2019-11-03,353,53671,1593,0,55617
704,2019-11-04,412,13804,2161,0,16377
704,2019-11-05,446,3214,2600,0,6260
704,2019-11-06,427,14588,2172,2,17189
704,2019-11-07,521,24941,1520,2,26984
704,2019-11-08,1332,18264,1209,0,20805
704,2019-11-09,544,16140,1672,0,18356
704,2019-11-10,1288,16280,1530,0,19098
704,2019-11-11,372,10309,1757,5,12443
704,2019-11-12,413,11996,3488,1,15898
704,2019-11-13,513,20935,1825,0,23273
704,2019-11-14,394,15495,2069,1,17959
704,2019-11-15,1265,5184,2577,0,9026
704,2019-11-16,444,2890,3233,2,6569
704,2019-11-17,567,4465,3336,1,8369
704,2019-11-18,438,3441,3432,0,7311
704,2019-11-19,600,3478,2805,0,6883
704,2019-11-20,597,1484,1469,3,3553
704,2019-11-21,465,3543,1848,2,5858
704,2019-11-22,449,5402,1175,1,7027
704,2019-11-23,460,9079,2534,1,12074
704,2019-11-24,540,8362,1900,1,10803
704,2019-11-25,418,6976,1594,2,8990
704,2019-11-26,1332,6470,1569,2,9373
704,2019-11-27,427,6817,1498,0,8742
704,2019-11-28,359,9197,788,0,10344
704,2019-11-29,183,1001,61,0,1245
704,2019-08-25,863,24785,1698,2,27348
704,2019-08-26,1237,29084,1935,2,32258
704,2019-08-27,487,10776,1718,0,12981
704,2019-08-28,466,14187,1890,0,16543
704,2019-08-29,964,12961,1264,0,15189
704,2019-08-30,587,3114,544,0,4245
704,2019-08-31,93,424,97,0,614
704,2019-09-01,211,2029,453,0,2693
704,2019-09-02,48,526,97,1,672
704,2019-09-03,982,1091,898,1,2972
704,2019-09-04,474,15169,2147,2,17792
704,2019-09-05,396,14950,2469,0,17815
704,2019-09-06,537,10136,1894,0,12567
704,2019-09-07,630,8726,2504,0,11860
704,2019-09-08,712,7574,1913,0,10199
704,2019-09-09,586,9206,2166,0,11958
704,2019-09-10,556,12666,2964,1,16187
704,2019-09-11,1025,8397,1652,1,11075
704,2019-09-12,2173,7912,2039,2,12126
704,2019-09-13,816,6559,1710,0,9085
704,2019-09-14,451,7438,2191,0,10080
704,2019-09-15,385,9799,1083,1,11268
704,2019-09-16,2047,15156,1909,1,19113
704,2019-09-17,370,14361,1710,1,16442
704,2019-09-18,898,17302,2215,1,20416
704,2019-09-19,696,11751,1440,0,13887
704,2019-09-20,1426,15139,1131,1,17697
704,2019-09-21,501,7612,1621,1,9735
704,2019-09-22,486,14311,1707,0,16504
704,2019-09-23,477,11530,2327,1,14335
704,2019-09-24,583,12404,1892,1,14880
704,2019-09-25,727,8302,1629,1,10659
704,2019-09-26,1068,10767,2036,1,13872
704,2019-09-27,176,8887,1747,5,10815
704,2019-09-28,253,15428,1992,1,17674
704,2019-09-29,1075,27797,2168,1,31041
704,2019-09-30,199,28292,1474,1,29966
704,2019-10-01,181,23149,963,0,24293
704,2019-10-02,279,17376,1715,0,19370
704,2019-10-03,207,14730,1692,1,16630
704,2019-10-04,211,13484,1174,2,14871
704,2019-10-05,1083,19444,1300,1,21828
704,2019-10-06,1700,17335,1640,1,20676
704,2019-10-07,2665,7927,2855,4,13451
704,2019-10-08,711,18957,760,1,20429
704,2019-10-09,1089,26297,1805,1,29192
704,2019-10-10,392,11831,2277,0,14500
704,2019-10-11,636,13182,1412,1,15231
704,2019-10-12,389,7577,1265,4,9235
704,2019-10-13,348,8863,1183,1,10395
704,2019-10-14,1256,6113,1836,1,9206
704,2019-10-15,867,9067,1983,2,11919
704,2019-10-16,1014,20239,1258,1,22512
704,2019-10-17,2182,9053,1864,2,13101
704,2019-10-18,1411,9084,1323,1,11819
704,2019-10-19,1162,6644,1752,0,9558
704,2019-10-20,794,3176,1289,0,5259
704,2019-10-21,397,10739,1609,2,12747
704,2019-10-22,435,7249,1544,2,9230
704,2019-10-23,376,14963,1830,1,17170
704,2019-10-24,1107,19017,1407,1,21532
704,2019-10-25,399,11414,1352,1,13166
704,2019-10-26,1253,21294,1960,1,24508
704,2019-10-27,403,18509,2140,2,21054
704,2019-10-28,1360,14264,2224,1,17849
704,2019-10-29,1396,15489,2170,1,19056
704,2019-10-30,1288,16162,1447,1,18898
704,2019-10-31,391,20716,2172,2,23281
704,2019-11-01,1101,27403,1449,2,29955
704,2019-11-02,366,27106,1674,0,29146
704,2019-11-03,353,53671,1593,0,55617
704,2019-11-04,412,13804,2161,0,16377
704,2019-11-05,446,3214,2600,0,6260
704,2019-11-06,427,14588,2172,2,17189
704,2019-11-07,521,24941,1520,2,26984
704,2019-11-08,1332,18264,1209,0,20805
704,2019-11-09,544,16140,1672,0,18356
704,2019-11-10,1288,16280,1530,0,19098
704,2019-11-11,372,10309,1757,5,12443
704,2019-11-12,413,11996,3488,1,15898
704,2019-11-13,513,20935,1825,0,23273
704,2019-11-14,394,15495,2069,1,17959
704,2019-11-15,1265,5184,2577,0,9026
704,2019-11-16,444,2890,3233,2,6569
704,2019-11-17,567,4465,3336,1,8369
704,2019-11-18,438,3441,3432,0,7311
704,2019-11-19,600,3478,2805,0,6883
704,2019-11-20,597,1484,1469,3,3553
704,2019-11-21,465,3543,1848,2,5858
704,2019-11-22,449,5402,1175,1,7027
704,2019-11-23,460,9079,2534,1,12074
704,2019-11-24,540,8362,1900,1,10803
704,2019-11-25,418,6976,1594,2,8990
704,2019-11-26,1332,6470,1569,2,9373
705,2019-08-14,330,673,27,0,1030
705,2019-08-15,453,720,79,1,1253
705,2019-08-16,305,444,73,0,822
705,2019-08-17,217,2103,968,0,3288
705,2019-08-18,319,944,969,1,2233
705,2019-08-19,573,7850,1382,1,9806
705,2019-08-20,406,16381,1430,1,18218
705,2019-08-21,328,11913,1048,0,13289
705,2019-08-22,386,16278,1830,1,18495
705,2019-08-23,322,17070,8007,1,25400
705,2019-08-24,480,15121,1801,3,17405
705,2019-08-25,339,30306,2185,1,32831
705,2019-08-26,1964,26650,1620,0,30234
705,2019-08-27,317,14237,1262,1,15817
705,2019-08-28,1176,15735,1062,3,17976
705,2019-08-29,325,12713,1530,3,14571
705,2019-08-30,254,2783,772,1,3810
705,2019-08-31,168,131,1,0,300
705,2019-09-01,146,893,655,0,1694
705,2019-09-02,75,184,42,0,301
705,2019-09-03,195,3499,1441,2,5137
705,2019-09-04,390,10951,2321,1,13663
705,2019-09-05,314,11025,2302,0,13641
705,2019-09-06,457,12344,2016,1,14818
705,2019-09-07,1144,15806,1648,0,18598
705,2019-09-08,401,7164,1641,0,9206
705,2019-09-09,350,10460,1841,1,12652
705,2019-09-10,275,11819,2008,0,14102
705,2019-09-11,351,9427,2216,3,11997
705,2019-09-12,963,8906,1695,3,11567
705,2019-09-13,432,6915,2468,0,9815
705,2019-09-14,347,7587,2323,0,10257
705,2019-09-15,1120,11150,2614,1,14885
705,2019-09-16,222,19234,1956,2,21414
705,2019-09-17,721,11649,2162,1,14533
705,2019-09-18,331,28535,1638,0,30504
705,2019-09-19,432,6293,1574,0,8299
705,2019-09-20,1247,8196,1690,0,11133
705,2019-09-21,282,7932,2657,0,10871
705,2019-09-22,703,14298,1828,0,16829
705,2019-09-23,1148,13450,1622,4,16224
705,2019-09-24,1232,11993,1201,4,14430
705,2019-09-25,199,11104,1722,2,13027
705,2019-09-26,127,13119,1128,1,14375
705,2019-09-27,152,11613,1222,1,12988
705,2019-09-28,1029,26117,2625,6,29777
705,2019-09-29,968,19747,2162,0,22877
705,2019-09-30,121,25525,1587,0,27233
705,2019-10-01,127,28590,1645,1,30363
705,2019-10-02,189,15391,2746,0,18326
705,2019-10-03,522,23413,1410,1,25346
705,2019-10-04,127,21799,1259,1,23186
705,2019-10-05,110,23521,1898,2,25531
705,2019-10-06,110,15901,835,0,16846
705,2019-10-07,1862,6837,1439,1,10139
705,2019-10-08,146,20248,1282,3,21679
705,2019-10-09,181,33471,1857,0,35509
705,2019-10-10,341,14198,1700,0,16239
705,2019-10-11,372,16650,2035,1,19058
705,2019-10-12,264,8287,1569,2,10122
705,2019-10-13,1117,9477,1673,3,12270
705,2019-10-14,219,8548,2914,0,11681
705,2019-10-15,1103,15631,1494,1,18229
705,2019-10-16,1615,24584,1591,1,27791
705,2019-10-17,474,8921,2063,2,11460
705,2019-10-18,1232,13457,1087,2,15778
705,2019-10-19,1930,5922,1410,0,9262
705,2019-10-20,1138,3036,2544,0,6718
705,2019-10-21,310,11742,1214,0,13266
705,2019-10-22,1235,7372,1397,1,10005
705,2019-10-23,235,15424,2010,6,17675
705,2019-10-24,498,26455,1509,1,28463
705,2019-10-25,271,20080,1661,1,22013
705,2019-10-26,244,18263,1772,2,20281
705,2019-10-27,1117,16730,1118,0,18965
705,2019-10-28,241,24211,1652,0,26104
705,2019-10-29,359,29796,2252,1,32408
705,2019-10-30,1217,29671,1668,0,32556
705,2019-10-31,233,17133,1785,1,19152
705,2019-11-01,640,26724,2124,0,29488
705,2019-11-02,213,27516,1341,3,29073
705,2019-11-03,281,39691,1133,0,41105
705,2019-11-04,275,13606,1598,2,15481
705,2019-11-05,288,3783,1525,0,5596
705,2019-11-06,300,15307,678,0,16285
705,2019-11-07,355,16877,713,0,17945
705,2019-11-08,866,10035,1392,0,12293
705,2019-11-09,730,9036,1770,0,11536
705,2019-11-10,242,14940,2200,0,17382
705,2019-11-11,267,9653,1699,0,11619
705,2019-11-12,1097,10867,3022,0,14986
705,2019-11-13,447,12678,1963,0,15088
705,2019-11-14,281,9430,1903,0,11614
705,2019-11-15,260,4168,3722,0,8150
705,2019-11-16,2078,2730,1562,0,6370
705,2019-11-17,388,7577,2767,0,10732
705,2019-11-18,251,4369,3432,0,8052
705,2019-11-19,298,3329,2516,0,6143
705,2019-11-20,301,1651,2020,0,3972
705,2019-11-21,1165,5911,1977,0,9053
705,2019-11-22,265,9648,1341,0,11254
705,2019-11-23,274,15188,3071,0,18533
705,2019-11-24,1388,8305,1165,0,10858
705,2019-11-25,259,10822,1851,0,12932
705,2019-11-26,284,10314,1859,0,12457
705,2019-11-27,253,11561,1758,0,13572
705,2019-11-28,227,13037,779,0,14043
705,2019-08-14,330,673,27,0,1030
705,2019-08-15,453,720,79,1,1253
705,2019-08-16,305,444,73,0,822
705,2019-08-17,217,2103,968,0,3288
705,2019-08-18,319,944,969,1,2233
705,2019-08-19,573,7850,1382,1,9806
705,2019-08-20,406,16381,1430,1,18218
705,2019-08-21,328,11913,1048,0,13289
705,2019-08-22,386,16278,1830,1,18495
705,2019-08-23,322,17070,8007,1,25400
705,2019-08-24,480,15121,1801,3,17405
705,2019-08-25,339,30306,2185,1,32831
705,2019-08-26,1964,26650,1620,0,30234
705,2019-08-27,317,14237,1262,1,15817
705,2019-08-28,1176,15735,1062,3,17976
705,2019-08-29,325,12713,1530,3,14571
705,2019-08-30,254,2783,772,1,3810
705,2019-08-31,168,131,1,0,300
705,2019-09-01,146,893,655,0,1694
705,2019-09-02,75,184,42,0,301
705,2019-09-03,195,3499,1441,2,5137
705,2019-09-04,390,10951,2321,1,13663
705,2019-09-05,314,11025,2302,0,13641
705,2019-09-06,457,12344,2016,1,14818
705,2019-09-07,1144,15806,1648,0,18598
705,2019-09-08,401,7164,1641,0,9206
705,2019-09-09,350,10460,1841,1,12652
705,2019-09-10,275,11819,2008,0,14102
705,2019-09-11,351,9427,2216,3,11997
705,2019-09-12,963,8906,1695,3,11567
705,2019-09-13,432,6915,2468,0,9815
705,2019-09-14,347,7587,2323,0,10257
705,2019-09-15,1120,11150,2614,1,14885
705,2019-09-16,222,19234,1956,2,21414
705,2019-09-17,721,11649,2162,1,14533
705,2019-09-18,331,28535,1638,0,30504
705,2019-09-19,432,6293,1574,0,8299
705,2019-09-20,1247,8196,1690,0,11133
705,2019-09-21,282,7932,2657,0,10871
705,2019-09-22,703,14298,1828,0,16829
705,2019-09-23,1148,13450,1622,4,16224
705,2019-09-24,1232,11993,1201,4,14430
705,2019-09-25,199,11104,1722,2,13027
705,2019-09-26,127,13119,1128,1,14375
705,2019-09-27,152,11613,1222,1,12988
705,2019-09-28,1029,26117,2625,6,29777
705,2019-09-29,968,19747,2162,0,22877
705,2019-09-30,121,25525,1587,0,27233
705,2019-10-01,127,28590,1645,1,30363
705,2019-10-02,189,15391,2746,0,18326
705,2019-10-03,522,23413,1410,1,25346
705,2019-10-04,127,21799,1259,1,23186
705,2019-10-05,110,23521,1898,2,25531
705,2019-10-06,110,15901,835,0,16846
705,2019-10-07,1862,6837,1439,1,10139
705,2019-10-08,146,20248,1282,3,21679
705,2019-10-09,181,33471,1857,0,35509
705,2019-10-10,341,14198,1700,0,16239
705,2019-10-11,372,16650,2035,1,19058
705,2019-10-12,264,8287,1569,2,10122
705,2019-10-13,1117,9477,1673,3,12270
705,2019-10-14,219,8548,2914,0,11681
705,2019-10-15,1103,15631,1494,1,18229
705,2019-10-16,1615,24584,1591,1,27791
705,2019-10-17,474,8921,2063,2,11460
705,2019-10-18,1232,13457,1087,2,15778
705,2019-10-19,1930,5922,1410,0,9262
705,2019-10-20,1138,3036,2544,0,6718
705,2019-10-21,310,11742,1214,0,13266
705,2019-10-22,1235,7372,1397,1,10005
705,2019-10-23,235,15424,2010,6,17675
705,2019-10-24,498,26455,1509,1,28463
705,2019-10-25,271,20080,1661,1,22013
705,2019-10-26,244,18263,1772,2,20281
705,2019-10-27,1117,16730,1118,0,18965
705,2019-10-28,241,24211,1652,0,26104
705,2019-10-29,359,29796,2252,1,32408
705,2019-10-30,1217,29671,1668,0,32556
705,2019-10-31,233,17133,1785,1,19152
705,2019-11-01,640,26724,2124,0,29488
705,2019-11-02,213,27516,1341,3,29073
705,2019-11-03,281,39691,1133,0,41105
705,2019-11-04,275,13606,1598,2,15481
705,2019-11-05,288,3783,1525,0,5596
705,2019-11-06,300,15307,678,0,16285
705,2019-11-07,355,16877,713,0,17945
705,2019-11-08,866,10035,1392,0,12293
705,2019-11-09,730,9036,1770,0,11536
705,2019-11-10,242,14940,2200,0,17382
705,2019-11-11,267,9653,1699,0,11619
705,2019-11-12,1097,10867,3022,0,14986
705,2019-11-13,447,12678,1963,0,15088
705,2019-11-14,281,9430,1903,0,11614
705,2019-11-15,260,4168,3722,0,8150
705,2019-11-16,2078,2730,1562,0,6370
705,2019-11-17,388,7577,2767,0,10732
705,2019-11-18,251,4369,3432,0,8052
705,2019-11-19,298,3329,2516,0,6143
705,2019-11-20,301,1651,2020,0,3972
705,2019-11-21,1165,5911,1977,0,9053
705,2019-11-22,265,9648,1341,0,11254
705,2019-11-23,274,15188,3071,0,18533
705,2019-11-24,1388,8305,1165,0,10858
705,2019-11-25,259,10822,1851,0,12932
705,2019-11-26,284,10314,1859,0,12457
705,2019-11-27,253,11561,1758,0,13572
705,2019-11-28,227,13037,779,0,14043
705,2019-11-29,0,158,0,0,158
705,2019-08-14,330,673,27,0,1030
705,2019-08-15,453,720,79,1,1253
705,2019-08-16,305,444,73,0,822
705,2019-08-17,217,2103,968,0,3288
705,2019-08-18,319,944,969,1,2233
705,2019-08-19,573,7850,1382,1,9806
705,2019-08-20,406,16381,1430,1,18218
705,2019-08-21,328,11913,1048,0,13289
705,2019-08-22,386,16278,1830,1,18495
705,2019-08-23,322,17070,8007,1,25400
705,2019-08-24,480,15121,1801,3,17405
705,2019-08-25,339,30306,2185,1,32831
705,2019-08-26,1964,26650,1620,0,30234
705,2019-08-27,317,14237,1262,1,15817
705,2019-08-28,1176,15735,1062,3,17976
705,2019-08-29,325,12713,1530,3,14571
705,2019-08-30,254,2783,772,1,3810
705,2019-08-31,168,131,1,0,300
705,2019-09-01,146,893,655,0,1694
705,2019-09-02,75,184,42,0,301
705,2019-09-03,195,3499,1441,2,5137
705,2019-09-04,390,10951,2321,1,13663
705,2019-09-05,314,11025,2302,0,13641
705,2019-09-06,457,12344,2016,1,14818
705,2019-09-07,1144,15806,1648,0,18598
705,2019-09-08,401,7164,1641,0,9206
705,2019-09-09,350,10460,1841,1,12652
705,2019-09-10,275,11819,2008,0,14102
705,2019-09-11,351,9427,2216,3,11997
705,2019-09-12,963,8906,1695,3,11567
705,2019-09-13,432,6915,2468,0,9815
705,2019-09-14,347,7587,2323,0,10257
705,2019-09-15,1120,11150,2614,1,14885
705,2019-09-16,222,19234,1956,2,21414
705,2019-09-17,721,11649,2162,1,14533
705,2019-09-18,331,28535,1638,0,30504
705,2019-09-19,432,6293,1574,0,8299
705,2019-09-20,1247,8196,1690,0,11133
705,2019-09-21,282,7932,2657,0,10871
705,2019-09-22,703,14298,1828,0,16829
705,2019-09-23,1148,13450,1622,4,16224
705,2019-09-24,1232,11993,1201,4,14430
705,2019-09-25,199,11104,1722,2,13027
705,2019-09-26,127,13119,1128,1,14375
705,2019-09-27,152,11613,1222,1,12988
705,2019-09-28,1029,26117,2625,6,29777
705,2019-09-29,968,19747,2162,0,22877
705,2019-09-30,121,25525,1587,0,27233
705,2019-10-01,127,28590,1645,1,30363
705,2019-10-02,189,15391,2746,0,18326
705,2019-10-03,522,23413,1410,1,25346
705,2019-10-04,127,21799,1259,1,23186
705,2019-10-05,110,23521,1898,2,25531
705,2019-10-06,110,15901,835,0,16846
705,2019-10-07,1862,6837,1439,1,10139
705,2019-10-08,146,20248,1282,3,21679
705,2019-10-09,181,33471,1857,0,35509
705,2019-10-10,341,14198,1700,0,16239
705,2019-10-11,372,16650,2035,1,19058
705,2019-10-12,264,8287,1569,2,10122
705,2019-10-13,1117,9477,1673,3,12270
705,2019-10-14,219,8548,2914,0,11681
705,2019-10-15,1103,15631,1494,1,18229
705,2019-10-16,1615,24584,1591,1,27791
705,2019-10-17,474,8921,2063,2,11460
705,2019-10-18,1232,13457,1087,2,15778
705,2019-10-19,1930,5922,1410,0,9262
705,2019-10-20,1138,3036,2544,0,6718
705,2019-10-21,310,11742,1214,0,13266
705,2019-10-22,1235,7372,1397,1,10005
705,2019-10-23,235,15424,2010,6,17675
705,2019-10-24,498,26455,1509,1,28463
705,2019-10-25,271,20080,1661,1,22013
705,2019-10-26,244,18263,1772,2,20281
705,2019-10-27,1117,16730,1118,0,18965
705,2019-10-28,241,24211,1652,0,26104
705,2019-10-29,359,29796,2252,1,32408
705,2019-10-30,1217,29671,1668,0,32556
705,2019-10-31,233,17133,1785,1,19152
705,2019-11-01,640,26724,2124,0,29488
705,2019-11-02,213,27516,1341,3,29073
705,2019-11-03,281,39691,1133,0,41105
705,2019-11-04,275,13606,1598,2,15481
705,2019-11-05,288,3783,1525,0,5596
705,2019-11-06,300,15307,678,0,16285
705,2019-11-07,355,16877,713,0,17945
705,2019-11-08,866,10035,1392,0,12293
705,2019-11-09,730,9036,1770,0,11536
705,2019-11-10,242,14940,2200,0,17382
705,2019-11-11,267,9653,1699,0,11619
705,2019-11-12,1097,10867,3022,0,14986
705,2019-11-13,447,12678,1963,0,15088
705,2019-11-14,281,9430,1903,0,11614
705,2019-11-15,260,4168,3722,0,8150
705,2019-11-16,2078,2730,1562,0,6370
705,2019-11-17,388,7577,2767,0,10732
705,2019-11-18,251,4369,3432,0,8052
705,2019-11-19,298,3329,2516,0,6143
705,2019-11-20,301,1651,2020,0,3972
705,2019-11-21,1165,5911,1977,0,9053
705,2019-11-22,265,9648,1341,0,11254
705,2019-11-23,274,15188,3071,0,18533
705,2019-11-24,1388,8305,1165,0,10858
705,2019-11-25,259,10822,1851,0,12932
705,2019-11-26,284,10314,1859,0,12457
705,2019-11-27,253,11561,1758,0,13572
705,2019-11-28,227,13037,779,0,14043
705,2019-08-15,453,720,79,1,1253
705,2019-08-16,305,444,73,0,822
705,2019-08-17,217,2103,968,0,3288
705,2019-08-18,319,944,969,1,2233
705,2019-08-19,573,7850,1382,1,9806
705,2019-08-20,406,16381,1430,1,18218
705,2019-08-21,328,11913,1048,0,13289
705,2019-08-22,386,16278,1830,1,18495
705,2019-08-23,322,17070,8007,1,25400
705,2019-08-24,480,15121,1801,3,17405
705,2019-08-25,339,30306,2185,1,32831
705,2019-08-26,1964,26650,1620,0,30234
705,2019-08-27,317,14237,1262,1,15817
705,2019-08-28,1176,15735,1062,3,17976
705,2019-08-29,325,12713,1530,3,14571
705,2019-08-30,254,2783,772,1,3810
705,2019-08-31,168,131,1,0,300
705,2019-09-01,146,893,655,0,1694
705,2019-09-02,75,184,42,0,301
705,2019-09-03,195,3499,1441,2,5137
705,2019-09-04,390,10951,2321,1,13663
705,2019-09-05,314,11025,2302,0,13641
705,2019-09-06,457,12344,2016,1,14818
705,2019-09-07,1144,15806,1648,0,18598
705,2019-09-08,401,7164,1641,0,9206
705,2019-09-09,350,10460,1841,1,12652
705,2019-09-10,275,11819,2008,0,14102
705,2019-09-11,351,9427,2216,3,11997
705,2019-09-12,963,8906,1695,3,11567
705,2019-09-13,432,6915,2468,0,9815
705,2019-09-14,347,7587,2323,0,10257
705,2019-09-15,1120,11150,2614,1,14885
705,2019-09-16,222,19234,1956,2,21414
705,2019-09-17,721,11649,2162,1,14533
705,2019-09-18,331,28535,1638,0,30504
705,2019-09-19,432,6293,1574,0,8299
705,2019-09-20,1247,8196,1690,0,11133
705,2019-09-21,282,7932,2657,0,10871
705,2019-09-22,703,14298,1828,0,16829
705,2019-09-23,1148,13450,1622,4,16224
705,2019-09-24,1232,11993,1201,4,14430
705,2019-09-25,199,11104,1722,2,13027
705,2019-09-26,127,13119,1128,1,14375
705,2019-09-27,152,11613,1222,1,12988
705,2019-09-28,1029,26117,2625,6,29777
705,2019-09-29,968,19747,2162,0,22877
705,2019-09-30,121,25525,1587,0,27233
705,2019-10-01,127,28590,1645,1,30363
705,2019-10-02,189,15391,2746,0,18326
705,2019-10-03,522,23413,1410,1,25346
705,2019-10-04,127,21799,1259,1,23186
705,2019-10-05,110,23521,1898,2,25531
705,2019-10-06,110,15901,835,0,16846
705,2019-10-07,1862,6837,1439,1,10139
705,2019-10-08,146,20248,1282,3,21679
705,2019-10-09,181,33471,1857,0,35509
705,2019-10-10,341,14198,1700,0,16239
705,2019-10-11,372,16650,2035,1,19058
705,2019-10-12,264,8287,1569,2,10122
705,2019-10-13,1117,9477,1673,3,12270
705,2019-10-14,219,8548,2914,0,11681
705,2019-10-15,1103,15631,1494,1,18229
705,2019-10-16,1615,24584,1591,1,27791
705,2019-10-17,474,8921,2063,2,11460
705,2019-10-18,1232,13457,1087,2,15778
705,2019-10-19,1930,5922,1410,0,9262
705,2019-10-20,1138,3036,2544,0,6718
705,2019-10-21,310,11742,1214,0,13266
705,2019-10-22,1235,7372,1397,1,10005
705,2019-10-23,235,15424,2010,6,17675
705,2019-10-24,498,26455,1509,1,28463
705,2019-10-25,271,20080,1661,1,22013
705,2019-10-26,244,18263,1772,2,20281
705,2019-10-27,1117,16730,1118,0,18965
705,2019-10-28,241,24211,1652,0,26104
705,2019-10-29,359,29796,2252,1,32408
705,2019-10-30,1217,29671,1668,0,32556
705,2019-10-31,233,17133,1785,1,19152
705,2019-11-01,640,26724,2124,0,29488
705,2019-11-02,213,27516,1341,3,29073
705,2019-11-03,281,39691,1133,0,41105
705,2019-11-04,275,13606,1598,2,15481
706,2019-08-14,103,93,66,0,262
706,2019-08-15,208,94,203,0,505
706,2019-08-16,179,474,210,1,864
706,2019-08-17,311,1509,986,0,2806
706,2019-08-18,280,1564,1105,0,2949
706,2019-08-19,409,3267,1562,0,5238
706,2019-08-20,636,1637,1634,1,3908
706,2019-08-21,316,1941,1614,1,3872
706,2019-08-22,312,3876,661,2,4851
706,2019-08-23,293,557,1356,2,2208
706,2019-08-24,295,3538,1446,2,5281
706,2019-08-25,293,13153,1617,4,15067
706,2019-08-26,1096,4775,2349,1,8221
706,2019-08-27,1526,4313,2160,2,8001
706,2019-08-28,292,7955,1806,0,10053
706,2019-08-29,345,9064,1264,0,10673
706,2019-08-30,251,2432,451,0,3134
706,2019-08-31,40,277,3,0,320
706,2019-09-01,50,1014,183,0,1247
706,2019-09-02,26,1013,85,0,1124
706,2019-09-03,102,3129,1585,1,4817
706,2019-09-04,1125,9804,2445,0,13374
706,2019-09-05,416,6038,2290,2,8746
706,2019-09-06,334,11265,2187,3,13789
706,2019-09-07,385,11622,1820,0,13827
706,2019-09-08,409,4942,1891,1,7243
706,2019-09-09,418,8586,2289,0,11293
706,2019-09-10,1102,9419,2226,0,12747
706,2019-09-11,345,6800,1583,3,8731
706,2019-09-12,305,8794,2383,1,11483
706,2019-09-13,1285,4723,2837,0,8845
706,2019-09-14,258,6329,2625,1,9213
706,2019-09-15,273,10495,1455,2,12225
706,2019-09-16,231,7448,2201,0,9880
706,2019-09-17,247,8867,1811,1,10926
706,2019-09-18,332,11535,821,0,12688
706,2019-09-19,469,6653,1715,2,8839
706,2019-09-20,355,11572,1504,2,13433
706,2019-09-21,286,7298,1980,0,9564
706,2019-09-22,233,9259,2108,0,11600
706,2019-09-23,1193,8689,2184,1,12067
706,2019-09-24,1256,8000,1900,3,11159
706,2019-09-25,241,6209,1527,4,7981
706,2019-09-26,1003,9027,1728,1,11759
706,2019-09-27,119,8072,1647,2,9840
706,2019-09-28,1889,15254,1520,3,18666
706,2019-09-29,156,17349,1252,3,18760
706,2019-09-30,126,17013,1649,3,18791
706,2019-10-01,858,15256,1633,2,17749
706,2019-10-02,1883,11917,1103,0,14903
706,2019-10-03,141,13015,748,1,13905
706,2019-10-04,144,11460,1354,1,12959
706,2019-10-05,128,13387,1463,2,14980
706,2019-10-06,1082,9994,1194,2,12272
706,2019-10-07,1000,4448,1313,0,6761
706,2019-10-08,175,17514,2182,1,19872
706,2019-10-09,160,33144,1603,3,34910
706,2019-10-10,257,18165,1374,2,19798
706,2019-10-11,322,9335,1762,0,11419
706,2019-10-12,510,5503,1643,1,7657
706,2019-10-13,1126,7163,1378,1,9668
706,2019-10-14,1128,4254,2146,2,7530
706,2019-10-15,425,7652,1156,4,9237
706,2019-10-16,330,12313,1155,2,13800
706,2019-10-17,274,4183,2531,1,6989
706,2019-10-18,255,7938,1671,0,9864
706,2019-10-19,1957,3743,1870,0,7570
706,2019-10-20,252,1082,1158,2,2494
706,2019-10-21,1130,9742,1127,1,12000
706,2019-10-22,311,4769,2225,1,7306
706,2019-10-23,211,13177,1197,0,14585
706,2019-10-24,303,17959,940,3,19205
706,2019-10-25,258,9982,2136,2,12378
706,2019-10-26,234,12849,1780,0,14863
706,2019-10-27,2004,15287,1821,0,19112
706,2019-10-28,526,13322,2076,0,15924
706,2019-10-29,310,14893,1015,0,16218
706,2019-10-30,1144,15188,1231,0,17563
706,2019-10-31,881,11717,1994,0,14592
706,2019-11-01,221,13654,1615,0,15490
706,2019-11-02,226,12649,1711,0,14586
706,2019-11-03,215,21954,1050,0,23219
706,2019-11-04,753,6350,2200,0,9303
706,2019-11-05,322,1319,2363,0,4004
706,2019-11-06,257,7480,654,0,8391
706,2019-11-07,340,13299,947,0,14586
706,2019-11-08,351,12435,1339,0,14125
706,2019-11-09,1173,7896,2103,0,11172
706,2019-11-10,488,11782,1489,0,13759
706,2019-11-11,276,7687,2187,0,10150
706,2019-11-12,242,9337,3035,0,12614
706,2019-11-13,250,12610,1824,0,14684
706,2019-11-14,303,8920,1752,0,10975
706,2019-11-15,240,2822,2126,0,5188
706,2019-11-16,291,946,1848,0,3085
706,2019-11-17,490,4025,2836,0,7351
706,2019-11-18,437,3254,3042,0,6733
706,2019-11-19,987,2700,2945,0,6632
706,2019-11-20,289,841,2004,0,3134
706,2019-11-21,266,3501,1739,0,5506
706,2019-11-22,1209,4915,1407,0,7531
706,2019-11-23,268,5650,1959,0,7877
706,2019-11-24,262,6702,2108,0,9072
706,2019-11-25,274,5546,1294,0,7114
706,2019-11-26,350,4368,2051,0,6769
706,2019-11-27,258,5612,1418,0,7288
706,2019-11-28,243,7471,730,0,8444
706,2019-08-14,103,93,66,0,262
706,2019-08-15,208,94,203,0,505
706,2019-08-16,179,474,210,1,864
706,2019-08-17,311,1509,986,0,2806
706,2019-08-18,280,1564,1105,0,2949
706,2019-08-19,409,3267,1562,0,5238
706,2019-08-20,636,1637,1634,1,3908
706,2019-08-21,316,1941,1614,1,3872
706,2019-08-22,312,3876,661,2,4851
706,2019-08-23,293,557,1356,2,2208
706,2019-08-24,295,3538,1446,2,5281
706,2019-08-25,293,13153,1617,4,15067
706,2019-08-26,1096,4775,2349,1,8221
706,2019-08-27,1526,4313,2160,2,8001
706,2019-08-28,292,7955,1806,0,10053
706,2019-08-29,345,9064,1264,0,10673
706,2019-08-30,251,2432,451,0,3134
706,2019-08-31,40,277,3,0,320
706,2019-09-01,50,1014,183,0,1247
706,2019-09-02,26,1013,85,0,1124
706,2019-09-03,102,3129,1585,1,4817
706,2019-09-04,1125,9804,2445,0,13374
706,2019-09-05,416,6038,2290,2,8746
706,2019-09-06,334,11265,2187,3,13789
706,2019-09-07,385,11622,1820,0,13827
706,2019-09-08,409,4942,1891,1,7243
706,2019-09-09,418,8586,2289,0,11293
706,2019-09-10,1102,9419,2226,0,12747
706,2019-09-11,345,6800,1583,3,8731
706,2019-09-12,305,8794,2383,1,11483
706,2019-09-13,1285,4723,2837,0,8845
706,2019-09-14,258,6329,2625,1,9213
706,2019-09-15,273,10495,1455,2,12225
706,2019-09-16,231,7448,2201,0,9880
706,2019-09-17,247,8867,1811,1,10926
706,2019-09-18,332,11535,821,0,12688
706,2019-09-19,469,6653,1715,2,8839
706,2019-09-20,355,11572,1504,2,13433
706,2019-09-21,286,7298,1980,0,9564
706,2019-09-22,233,9259,2108,0,11600
706,2019-09-23,1193,8689,2184,1,12067
706,2019-09-24,1256,8000,1900,3,11159
706,2019-09-25,241,6209,1527,4,7981
706,2019-09-26,1003,9027,1728,1,11759
706,2019-09-27,119,8072,1647,2,9840
706,2019-09-28,1889,15254,1520,3,18666
706,2019-09-29,156,17349,1252,3,18760
706,2019-09-30,126,17013,1649,3,18791
706,2019-10-01,858,15256,1633,2,17749
706,2019-10-02,1883,11917,1103,0,14903
706,2019-10-03,141,13015,748,1,13905
706,2019-10-04,144,11460,1354,1,12959
706,2019-10-05,128,13387,1463,2,14980
706,2019-10-06,1082,9994,1194,2,12272
706,2019-10-07,1000,4448,1313,0,6761
706,2019-10-08,175,17514,2182,1,19872
706,2019-10-09,160,33144,1603,3,34910
706,2019-10-10,257,18165,1374,2,19798
706,2019-10-11,322,9335,1762,0,11419
706,2019-10-12,510,5503,1643,1,7657
706,2019-10-13,1126,7163,1378,1,9668
706,2019-10-14,1128,4254,2146,2,7530
706,2019-10-15,425,7652,1156,4,9237
706,2019-10-16,330,12313,1155,2,13800
706,2019-10-17,274,4183,2531,1,6989
706,2019-10-18,255,7938,1671,0,9864
706,2019-10-19,1957,3743,1870,0,7570
706,2019-10-20,252,1082,1158,2,2494
706,2019-10-21,1130,9742,1127,1,12000
706,2019-10-22,311,4769,2225,1,7306
706,2019-10-23,211,13177,1197,0,14585
706,2019-10-24,303,17959,940,3,19205
706,2019-10-25,258,9982,2136,2,12378
706,2019-10-26,234,12849,1780,0,14863
706,2019-10-27,2004,15287,1821,0,19112
706,2019-10-28,526,13322,2076,0,15924
706,2019-10-29,310,14893,1015,0,16218
706,2019-10-30,1144,15188,1231,0,17563
706,2019-10-31,881,11717,1994,0,14592
706,2019-11-01,221,13654,1615,0,15490
706,2019-11-02,226,12649,1711,0,14586
706,2019-11-03,215,21954,1050,0,23219
706,2019-11-04,753,6350,2200,0,9303
706,2019-11-05,322,1319,2363,0,4004
706,2019-11-06,257,7480,654,0,8391
706,2019-11-07,340,13299,947,0,14586
706,2019-11-08,351,12435,1339,0,14125
706,2019-11-09,1173,7896,2103,0,11172
706,2019-11-10,488,11782,1489,0,13759
706,2019-11-11,276,7687,2187,0,10150
706,2019-11-12,242,9337,3035,0,12614
706,2019-11-13,250,12610,1824,0,14684
706,2019-11-14,303,8920,1752,0,10975
706,2019-11-15,240,2822,2126,0,5188
706,2019-11-16,291,946,1848,0,3085
706,2019-11-17,490,4025,2836,0,7351
706,2019-11-18,437,3254,3042,0,6733
706,2019-11-19,987,2700,2945,0,6632
706,2019-11-20,289,841,2004,0,3134
706,2019-11-21,266,3501,1739,0,5506
706,2019-11-22,1209,4915,1407,0,7531
706,2019-11-23,268,5650,1959,0,7877
706,2019-11-24,262,6702,2108,0,9072
706,2019-11-25,274,5546,1294,0,7114
706,2019-11-26,350,4368,2051,0,6769
706,2019-11-27,258,5612,1418,0,7288
706,2019-11-28,243,7471,730,0,8444
706,2019-11-29,0,454,0,0,454
706,2019-08-14,103,93,66,0,262
706,2019-08-15,208,94,203,0,505
706,2019-08-16,179,474,210,1,864
706,2019-08-17,311,1509,986,0,2806
706,2019-08-18,280,1564,1105,0,2949
706,2019-08-19,409,3267,1562,0,5238
706,2019-08-20,636,1637,1634,1,3908
706,2019-08-21,316,1941,1614,1,3872
706,2019-08-22,312,3876,661,2,4851
706,2019-08-23,293,557,1356,2,2208
706,2019-08-24,295,3538,1446,2,5281
706,2019-08-25,293,13153,1617,4,15067
706,2019-08-26,1096,4775,2349,1,8221
706,2019-08-27,1526,4313,2160,2,8001
706,2019-08-28,292,7955,1806,0,10053
706,2019-08-29,345,9064,1264,0,10673
706,2019-08-30,251,2432,451,0,3134
706,2019-08-31,40,277,3,0,320
706,2019-09-01,50,1014,183,0,1247
706,2019-09-02,26,1013,85,0,1124
706,2019-09-03,102,3129,1585,1,4817
706,2019-09-04,1125,9804,2445,0,13374
706,2019-09-05,416,6038,2290,2,8746
706,2019-09-06,334,11265,2187,3,13789
706,2019-09-07,385,11622,1820,0,13827
706,2019-09-08,409,4942,1891,1,7243
706,2019-09-09,418,8586,2289,0,11293
706,2019-09-10,1102,9419,2226,0,12747
706,2019-09-11,345,6800,1583,3,8731
706,2019-09-12,305,8794,2383,1,11483
706,2019-09-13,1285,4723,2837,0,8845
706,2019-09-14,258,6329,2625,1,9213
706,2019-09-15,273,10495,1455,2,12225
706,2019-09-16,231,7448,2201,0,9880
706,2019-09-17,247,8867,1811,1,10926
706,2019-09-18,332,11535,821,0,12688
706,2019-09-19,469,6653,1715,2,8839
706,2019-09-20,355,11572,1504,2,13433
706,2019-09-21,286,7298,1980,0,9564
706,2019-09-22,233,9259,2108,0,11600
706,2019-09-23,1193,8689,2184,1,12067
706,2019-09-24,1256,8000,1900,3,11159
706,2019-09-25,241,6209,1527,4,7981
706,2019-09-26,1003,9027,1728,1,11759
706,2019-09-27,119,8072,1647,2,9840
706,2019-09-28,1889,15254,1520,3,18666
706,2019-09-29,156,17349,1252,3,18760
706,2019-09-30,126,17013,1649,3,18791
706,2019-10-01,858,15256,1633,2,17749
706,2019-10-02,1883,11917,1103,0,14903
706,2019-10-03,141,13015,748,1,13905
706,2019-10-04,144,11460,1354,1,12959
706,2019-10-05,128,13387,1463,2,14980
706,2019-10-06,1082,9994,1194,2,12272
706,2019-10-07,1000,4448,1313,0,6761
706,2019-10-08,175,17514,2182,1,19872
706,2019-10-09,160,33144,1603,3,34910
706,2019-10-10,257,18165,1374,2,19798
706,2019-10-11,322,9335,1762,0,11419
706,2019-10-12,510,5503,1643,1,7657
706,2019-10-13,1126,7163,1378,1,9668
706,2019-10-14,1128,4254,2146,2,7530
706,2019-10-15,425,7652,1156,4,9237
706,2019-10-16,330,12313,1155,2,13800
706,2019-10-17,274,4183,2531,1,6989
706,2019-10-18,255,7938,1671,0,9864
706,2019-10-19,1957,3743,1870,0,7570
706,2019-10-20,252,1082,1158,2,2494
706,2019-10-21,1130,9742,1127,1,12000
706,2019-10-22,311,4769,2225,1,7306
706,2019-10-23,211,13177,1197,0,14585
706,2019-10-24,303,17959,940,3,19205
706,2019-10-25,258,9982,2136,2,12378
706,2019-10-26,234,12849,1780,0,14863
706,2019-10-27,2004,15287,1821,0,19112
706,2019-10-28,526,13322,2076,0,15924
706,2019-10-29,310,14893,1015,0,16218
706,2019-10-30,1144,15188,1231,0,17563
706,2019-10-31,881,11717,1994,0,14592
706,2019-11-01,221,13654,1615,0,15490
706,2019-11-02,226,12649,1711,0,14586
706,2019-11-03,215,21954,1050,0,23219
706,2019-11-04,753,6350,2200,0,9303
706,2019-11-05,322,1319,2363,0,4004
706,2019-11-06,257,7480,654,0,8391
706,2019-11-07,340,13299,947,0,14586
706,2019-11-08,351,12435,1339,0,14125
706,2019-11-09,1173,7896,2103,0,11172
706,2019-11-10,488,11782,1489,0,13759
706,2019-11-11,276,7687,2187,0,10150
706,2019-11-12,242,9337,3035,0,12614
706,2019-11-13,250,12610,1824,0,14684
706,2019-11-14,303,8920,1752,0,10975
706,2019-11-15,240,2822,2126,0,5188
706,2019-11-16,291,946,1848,0,3085
706,2019-11-17,490,4025,2836,0,7351
706,2019-11-18,437,3254,3042,0,6733
706,2019-11-19,987,2700,2945,0,6632
706,2019-11-20,289,841,2004,0,3134
706,2019-11-21,266,3501,1739,0,5506
706,2019-11-22,1209,4915,1407,0,7531
706,2019-11-23,268,5650,1959,0,7877
706,2019-11-24,262,6702,2108,0,9072
706,2019-11-25,274,5546,1294,0,7114
706,2019-11-26,350,4368,2051,0,6769
706,2019-11-27,258,5612,1418,0,7288
706,2019-11-28,243,7471,730,0,8444
706,2019-08-16,179,474,210,1,864
706,2019-08-17,311,1509,986,0,2806
706,2019-08-18,280,1564,1105,0,2949
706,2019-08-19,409,3267,1562,0,5238
706,2019-08-20,636,1637,1634,1,3908
706,2019-08-21,316,1941,1614,1,3872
706,2019-08-22,312,3876,661,2,4851
706,2019-08-23,293,557,1356,2,2208
706,2019-08-24,295,3538,1446,2,5281
706,2019-08-25,293,13153,1617,4,15067
706,2019-08-26,1096,4775,2349,1,8221
706,2019-08-27,1526,4313,2160,2,8001
706,2019-08-28,292,7955,1806,0,10053
706,2019-08-29,345,9064,1264,0,10673
706,2019-08-30,251,2432,451,0,3134
706,2019-08-31,40,277,3,0,320
706,2019-09-01,50,1014,183,0,1247
706,2019-09-02,26,1013,85,0,1124
706,2019-09-03,102,3129,1585,1,4817
706,2019-09-04,1125,9804,2445,0,13374
706,2019-09-05,416,6038,2290,2,8746
706,2019-09-06,334,11265,2187,3,13789
706,2019-09-07,385,11622,1820,0,13827
706,2019-09-08,409,4942,1891,1,7243
706,2019-09-09,418,8586,2289,0,11293
706,2019-09-10,1102,9419,2226,0,12747
706,2019-09-11,345,6800,1583,3,8731
706,2019-09-12,305,8794,2383,1,11483
706,2019-09-13,1285,4723,2837,0,8845
706,2019-09-14,258,6329,2625,1,9213
706,2019-09-15,273,10495,1455,2,12225
706,2019-09-16,231,7448,2201,0,9880
706,2019-09-17,247,8867,1811,1,10926
706,2019-09-18,332,11535,821,0,12688
706,2019-09-19,469,6653,1715,2,8839
706,2019-09-20,355,11572,1504,2,13433
706,2019-09-21,286,7298,1980,0,9564
706,2019-09-22,233,9259,2108,0,11600
706,2019-09-23,1193,8689,2184,1,12067
706,2019-09-24,1256,8000,1900,3,11159
706,2019-09-25,241,6209,1527,4,7981
706,2019-09-26,1003,9027,1728,1,11759
706,2019-09-27,119,8072,1647,2,9840
706,2019-09-28,1889,15254,1520,3,18666
706,2019-09-29,156,17349,1252,3,18760
706,2019-09-30,126,17013,1649,3,18791
706,2019-10-01,858,15256,1633,2,17749
706,2019-10-02,1883,11917,1103,0,14903
706,2019-10-03,141,13015,748,1,13905
706,2019-10-04,144,11460,1354,1,12959
706,2019-10-05,128,13387,1463,2,14980
706,2019-10-06,1082,9994,1194,2,12272
706,2019-10-07,1000,4448,1313,0,6761
706,2019-10-08,175,17514,2182,1,19872
706,2019-10-09,160,33144,1603,3,34910
706,2019-10-10,257,18165,1374,2,19798
706,2019-10-11,322,9335,1762,0,11419
706,2019-10-12,510,5503,1643,1,7657
706,2019-10-13,1126,7163,1378,1,9668
706,2019-10-14,1128,4254,2146,2,7530
706,2019-10-15,425,7652,1156,4,9237
706,2019-10-16,330,12313,1155,2,13800
706,2019-10-17,274,4183,2531,1,6989
706,2019-10-18,255,7938,1671,0,9864
706,2019-10-19,1957,3743,1870,0,7570
706,2019-10-20,252,1082,1158,2,2494
706,2019-10-21,1130,9742,1127,1,12000
706,2019-10-22,311,4769,2225,1,7306
706,2019-10-23,211,13177,1197,0,14585
706,2019-10-24,303,17959,940,3,19205
706,2019-10-25,258,9982,2136,2,12378
707,2019-08-14,117,757,148,0,1022
707,2019-08-15,147,638,22,0,807
707,2019-08-16,116,370,73,0,559
707,2019-08-17,413,789,477,0,1679
707,2019-08-18,203,2138,1270,2,3613
707,2019-08-19,351,4007,1110,1,5469
707,2019-08-20,221,2233,1822,1,4277
707,2019-08-21,389,1217,991,0,2597
707,2019-08-22,2108,13571,1252,0,16931
707,2019-08-23,2654,12940,1170,2,16766
707,2019-08-24,1744,4295,1181,878,8098
707,2019-08-25,2484,24553,1633,2,28672
707,2019-08-26,924,36643,1797,2,39366
707,2019-08-27,342,8647,1444,0,10433
707,2019-08-28,1051,12760,1620,1,15432
707,2019-08-29,1429,12571,1716,0,15716
707,2019-08-30,810,3491,408,2,4711
707,2019-08-31,132,180,1,0,313
707,2019-09-01,110,1187,14,0,1311
707,2019-09-02,53,159,2,0,214
707,2019-09-03,354,1341,1084,0,2779
707,2019-09-04,662,13297,1474,2,15435
707,2019-09-05,1769,9028,2600,2,13399
707,2019-09-06,2326,14594,1783,1,18704
707,2019-09-07,904,8400,2069,1,11374
707,2019-09-08,1270,31881,2149,0,35300
707,2019-09-09,633,8002,1579,0,10214
707,2019-09-10,418,8807,2181,0,11406
707,2019-09-11,1275,6025,2380,2,9682
707,2019-09-12,1075,10964,2058,1,14098
707,2019-09-13,2127,5823,1680,1,9631
707,2019-09-14,518,7069,2331,2,9920
707,2019-09-15,181,6791,2379,2,9353
707,2019-09-16,344,9735,1684,1,11764
707,2019-09-17,966,6488,1980,0,9434
707,2019-09-18,361,19651,1714,1,21727
707,2019-09-19,726,8000,2203,1,10930
707,2019-09-20,244,7332,1678,2,9256
707,2019-09-21,812,5828,2629,2,9271
707,2019-09-22,222,14558,2099,0,16879
707,2019-09-23,566,13659,2450,3,16678
707,2019-09-24,365,12098,1970,5,14438
707,2019-09-25,480,11451,2018,3,13952
707,2019-09-26,273,10018,2455,0,12746
707,2019-09-27,199,11010,2561,2,13772
707,2019-09-28,1069,16250,1362,3,18684
707,2019-09-29,1057,27607,1634,3,30301
707,2019-09-30,1532,26964,1290,3,29789
707,2019-10-01,142,23051,952,0,24145
707,2019-10-02,841,17212,1865,3,19921
707,2019-10-03,143,14407,1492,2,16044
707,2019-10-04,1156,23321,1258,1,25736
707,2019-10-05,128,21951,2001,2,24082
707,2019-10-06,130,17512,1496,0,19138
707,2019-10-07,1013,8687,1356,0,11056
707,2019-10-08,125,12860,1556,1,14542
707,2019-10-09,126,25135,1498,1,26760
707,2019-10-10,134,12726,1747,3,14610
707,2019-10-11,232,11355,1354,0,12941
707,2019-10-12,262,6236,1940,3,8441
707,2019-10-13,1062,12583,2487,2,16134
707,2019-10-14,1683,6615,2249,0,10547
707,2019-10-15,200,15282,1900,3,17385
707,2019-10-16,234,25166,1403,1,26804
707,2019-10-17,103,8966,1501,0,10570
707,2019-10-18,1006,9239,1594,0,11839
707,2019-10-19,94,5611,2589,1,8295
707,2019-10-20,98,3059,1924,2,5083
707,2019-10-21,167,10776,1556,0,12499
707,2019-10-22,201,7291,1907,1,9400
707,2019-10-23,218,8923,949,2,10092
707,2019-10-24,1207,14018,1558,2,16785
707,2019-10-25,294,11678,1495,3,13470
707,2019-10-26,407,22356,883,1,23647
707,2019-10-27,1943,19014,2115,0,23072
707,2019-10-28,804,23355,1163,0,25322
707,2019-10-29,332,29329,1842,1,31504
707,2019-10-30,1006,20811,2020,2,23839
707,2019-10-31,1761,20996,2276,0,25033
707,2019-11-01,753,17086,1063,0,18902
707,2019-11-02,407,33977,1589,1,35974
707,2019-11-03,756,28095,1399,0,30250
707,2019-11-04,1842,10991,1845,2,14680
707,2019-11-05,806,3448,1890,2,6146
707,2019-11-06,927,14772,1151,1,16851
707,2019-11-07,924,20865,1139,2,22930
707,2019-11-08,1973,15708,932,423,19036
707,2019-11-09,964,11632,1335,2,13933
707,2019-11-10,1094,15060,1216,1,17371
707,2019-11-11,1364,10289,1644,1,13298
707,2019-11-12,879,11750,2735,1,15365
707,2019-11-13,566,23795,1554,2,25917
707,2019-11-14,660,11180,2587,3,14430
707,2019-11-15,1202,4276,2704,0,8182
707,2019-11-16,444,2802,2200,0,5446
707,2019-11-17,367,4320,3007,0,7694
707,2019-11-18,280,3392,3439,1,7112
707,2019-11-19,310,3352,3135,2,6799
707,2019-11-20,1404,1299,3177,0,5880
707,2019-11-21,905,5874,1739,0,8518
707,2019-11-22,281,5975,1752,4,8012
707,2019-11-23,566,9906,2521,0,12993
707,2019-11-24,1217,10268,1586,0,13071
707,2019-11-25,1993,11573,1145,0,14711
707,2019-11-26,2496,10014,1375,0,13885
707,2019-11-27,1686,6797,2085,0,10568
707,2019-11-28,1010,13204,317,0,14531
707,2019-11-29,259,791,0,0,1050
707,2019-08-14,117,757,148,0,1022
707,2019-08-15,147,638,22,0,807
707,2019-08-16,116,370,73,0,559
707,2019-08-17,413,789,477,0,1679
707,2019-08-18,203,2138,1270,2,3613
707,2019-08-19,351,4007,1110,1,5469
707,2019-08-20,221,2233,1822,1,4277
707,2019-08-21,389,1217,991,0,2597
707,2019-08-22,2108,13571,1252,0,16931
707,2019-08-23,2654,12940,1170,2,16766
707,2019-08-24,1744,4295,1181,878,8098
707,2019-08-25,2484,24553,1633,2,28672
707,2019-08-26,924,36643,1797,2,39366
707,2019-08-27,342,8647,1444,0,10433
707,2019-08-28,1051,12760,1620,1,15432
707,2019-08-29,1429,12571,1716,0,15716
707,2019-08-30,810,3491,408,2,4711
707,2019-08-31,132,180,1,0,313
707,2019-09-01,110,1187,14,0,1311
707,2019-09-02,53,159,2,0,214
707,2019-09-03,354,1341,1084,0,2779
707,2019-09-04,662,13297,1474,2,15435
707,2019-09-05,1769,9028,2600,2,13399
707,2019-09-06,2326,14594,1783,1,18704
707,2019-09-07,904,8400,2069,1,11374
707,2019-09-08,1270,31881,2149,0,35300
707,2019-09-09,633,8002,1579,0,10214
707,2019-09-10,418,8807,2181,0,11406
707,2019-09-11,1275,6025,2380,2,9682
707,2019-09-12,1075,10964,2058,1,14098
707,2019-09-13,2127,5823,1680,1,9631
707,2019-09-14,518,7069,2331,2,9920
707,2019-09-15,181,6791,2379,2,9353
707,2019-09-16,344,9735,1684,1,11764
707,2019-09-17,966,6488,1980,0,9434
707,2019-09-18,361,19651,1714,1,21727
707,2019-09-19,726,8000,2203,1,10930
707,2019-09-20,244,7332,1678,2,9256
707,2019-09-21,812,5828,2629,2,9271
707,2019-09-22,222,14558,2099,0,16879
707,2019-09-23,566,13659,2450,3,16678
707,2019-09-24,365,12098,1970,5,14438
707,2019-09-25,480,11451,2018,3,13952
707,2019-09-26,273,10018,2455,0,12746
707,2019-09-27,199,11010,2561,2,13772
707,2019-09-28,1069,16250,1362,3,18684
707,2019-09-29,1057,27607,1634,3,30301
707,2019-09-30,1532,26964,1290,3,29789
707,2019-10-01,142,23051,952,0,24145
707,2019-10-02,841,17212,1865,3,19921
707,2019-10-03,143,14407,1492,2,16044
707,2019-10-04,1156,23321,1258,1,25736
707,2019-10-05,128,21951,2001,2,24082
707,2019-10-06,130,17512,1496,0,19138
707,2019-10-07,1013,8687,1356,0,11056
707,2019-10-08,125,12860,1556,1,14542
707,2019-10-09,126,25135,1498,1,26760
707,2019-10-10,134,12726,1747,3,14610
707,2019-10-11,232,11355,1354,0,12941
707,2019-10-12,262,6236,1940,3,8441
707,2019-10-13,1062,12583,2487,2,16134
707,2019-10-14,1683,6615,2249,0,10547
707,2019-10-15,200,15282,1900,3,17385
707,2019-10-16,234,25166,1403,1,26804
707,2019-10-17,103,8966,1501,0,10570
707,2019-10-18,1006,9239,1594,0,11839
707,2019-10-19,94,5611,2589,1,8295
707,2019-10-20,98,3059,1924,2,5083
707,2019-10-21,167,10776,1556,0,12499
707,2019-10-22,201,7291,1907,1,9400
707,2019-10-23,218,8923,949,2,10092
707,2019-10-24,1207,14018,1558,2,16785
707,2019-10-25,294,11678,1495,3,13470
707,2019-10-26,407,22356,883,1,23647
707,2019-10-27,1943,19014,2115,0,23072
707,2019-10-28,804,23355,1163,0,25322
707,2019-10-29,332,29329,1842,1,31504
707,2019-10-30,1006,20811,2020,2,23839
707,2019-10-31,1761,20996,2276,0,25033
707,2019-11-01,753,17086,1063,0,18902
707,2019-11-02,407,33977,1589,1,35974
707,2019-11-03,756,28095,1399,0,30250
707,2019-11-04,1842,10991,1845,2,14680
707,2019-11-05,806,3448,1890,2,6146
707,2019-11-06,927,14772,1151,1,16851
707,2019-11-07,924,20865,1139,2,22930
707,2019-11-08,1973,15708,932,423,19036
707,2019-11-09,964,11632,1335,2,13933
707,2019-11-10,1094,15060,1216,1,17371
707,2019-11-11,1364,10289,1644,1,13298
707,2019-11-12,879,11750,2735,1,15365
707,2019-11-13,566,23795,1554,2,25917
707,2019-11-14,660,11180,2587,3,14430
707,2019-11-15,1202,4276,2704,0,8182
707,2019-11-16,444,2802,2200,0,5446
707,2019-11-17,367,4320,3007,0,7694
707,2019-11-18,280,3392,3439,1,7112
707,2019-11-19,310,3352,3135,2,6799
707,2019-11-20,1404,1299,3177,0,5880
707,2019-11-21,905,5874,1739,0,8518
707,2019-11-22,281,5975,1752,4,8012
707,2019-11-23,566,9906,2521,0,12993
707,2019-11-24,1217,10268,1586,0,13071
707,2019-11-25,1993,11573,1145,0,14711
707,2019-11-26,2496,10014,1375,0,13885
707,2019-11-27,1686,6797,2085,0,10568
707,2019-11-28,1010,13204,317,0,14531
707,2019-11-29,259,791,0,0,1050
707,2019-08-14,117,757,148,0,1022
707,2019-08-15,147,638,22,0,807
707,2019-08-16,116,370,73,0,559
707,2019-08-17,413,789,477,0,1679
707,2019-08-18,203,2138,1270,2,3613
707,2019-08-19,351,4007,1110,1,5469
707,2019-08-20,221,2233,1822,1,4277
707,2019-08-21,389,1217,991,0,2597
707,2019-08-22,2108,13571,1252,0,16931
707,2019-08-23,2654,12940,1170,2,16766
707,2019-08-24,1744,4295,1181,878,8098
707,2019-08-25,2484,24553,1633,2,28672
707,2019-08-26,924,36643,1797,2,39366
707,2019-08-27,342,8647,1444,0,10433
707,2019-08-28,1051,12760,1620,1,15432
707,2019-08-29,1429,12571,1716,0,15716
707,2019-08-30,810,3491,408,2,4711
707,2019-08-31,132,180,1,0,313
707,2019-09-01,110,1187,14,0,1311
707,2019-09-02,53,159,2,0,214
707,2019-09-03,354,1341,1084,0,2779
707,2019-09-04,662,13297,1474,2,15435
707,2019-09-05,1769,9028,2600,2,13399
707,2019-09-06,2326,14594,1783,1,18704
707,2019-09-07,904,8400,2069,1,11374
707,2019-09-08,1270,31881,2149,0,35300
707,2019-09-09,633,8002,1579,0,10214
707,2019-09-10,418,8807,2181,0,11406
707,2019-09-11,1275,6025,2380,2,9682
707,2019-09-12,1075,10964,2058,1,14098
707,2019-09-13,2127,5823,1680,1,9631
707,2019-09-14,518,7069,2331,2,9920
707,2019-09-15,181,6791,2379,2,9353
707,2019-09-16,344,9735,1684,1,11764
707,2019-09-17,966,6488,1980,0,9434
707,2019-09-18,361,19651,1714,1,21727
707,2019-09-19,726,8000,2203,1,10930
707,2019-09-20,244,7332,1678,2,9256
707,2019-09-21,812,5828,2629,2,9271
707,2019-09-22,222,14558,2099,0,16879
707,2019-09-23,566,13659,2450,3,16678
707,2019-09-24,365,12098,1970,5,14438
707,2019-09-25,480,11451,2018,3,13952
707,2019-09-26,273,10018,2455,0,12746
707,2019-09-27,199,11010,2561,2,13772
707,2019-09-28,1069,16250,1362,3,18684
707,2019-09-29,1057,27607,1634,3,30301
707,2019-09-30,1532,26964,1290,3,29789
707,2019-10-01,142,23051,952,0,24145
707,2019-10-02,841,17212,1865,3,19921
707,2019-10-03,143,14407,1492,2,16044
707,2019-10-04,1156,23321,1258,1,25736
707,2019-10-05,128,21951,2001,2,24082
707,2019-10-06,130,17512,1496,0,19138
707,2019-10-07,1013,8687,1356,0,11056
707,2019-10-08,125,12860,1556,1,14542
707,2019-10-09,126,25135,1498,1,26760
707,2019-10-10,134,12726,1747,3,14610
707,2019-10-11,232,11355,1354,0,12941
707,2019-10-12,262,6236,1940,3,8441
707,2019-10-13,1062,12583,2487,2,16134
707,2019-10-14,1683,6615,2249,0,10547
707,2019-10-15,200,15282,1900,3,17385
707,2019-10-16,234,25166,1403,1,26804
707,2019-10-17,103,8966,1501,0,10570
707,2019-10-18,1006,9239,1594,0,11839
707,2019-10-19,94,5611,2589,1,8295
707,2019-10-20,98,3059,1924,2,5083
707,2019-10-21,167,10776,1556,0,12499
707,2019-10-22,201,7291,1907,1,9400
707,2019-10-23,218,8923,949,2,10092
707,2019-10-24,1207,14018,1558,2,16785
707,2019-10-25,294,11678,1495,3,13470
707,2019-10-26,407,22356,883,1,23647
707,2019-10-27,1943,19014,2115,0,23072
707,2019-10-28,804,23355,1163,0,25322
707,2019-10-29,332,29329,1842,1,31504
707,2019-10-30,1006,20811,2020,2,23839
707,2019-10-31,1761,20996,2276,0,25033
707,2019-11-01,753,17086,1063,0,18902
707,2019-11-02,407,33977,1589,1,35974
707,2019-11-03,756,28095,1399,0,30250
707,2019-11-04,1842,10991,1845,2,14680
707,2019-11-05,806,3448,1890,2,6146
707,2019-11-06,927,14772,1151,1,16851
707,2019-11-07,924,20865,1139,2,22930
707,2019-11-08,1973,15708,932,423,19036
707,2019-11-09,964,11632,1335,2,13933
707,2019-11-10,1094,15060,1216,1,17371
707,2019-11-11,1364,10289,1644,1,13298
707,2019-11-12,879,11750,2735,1,15365
707,2019-11-13,566,23795,1554,2,25917
707,2019-11-14,660,11180,2587,3,14430
707,2019-11-15,1202,4276,2704,0,8182
707,2019-11-16,444,2802,2200,0,5446
707,2019-11-17,367,4320,3007,0,7694
707,2019-11-18,280,3392,3439,1,7112
707,2019-11-19,310,3352,3135,2,6799
707,2019-11-20,1404,1299,3177,0,5880
707,2019-11-21,905,5874,1739,0,8518
707,2019-11-22,281,5975,1752,4,8012
707,2019-11-23,566,9906,2521,0,12993
707,2019-11-24,1217,10268,1586,0,13071
707,2019-11-25,1993,11573,1145,0,14711
707,2019-11-26,2496,10014,1375,0,13885
707,2019-11-27,1686,6797,2085,0,10568
707,2019-11-28,1010,13204,317,0,14531
707,2019-08-18,203,2138,1270,2,3613
707,2019-08-19,351,4007,1110,1,5469
707,2019-08-20,221,2233,1822,1,4277
707,2019-08-21,389,1217,991,0,2597
707,2019-08-22,2108,13571,1252,0,16931
707,2019-08-23,2654,12940,1170,2,16766
707,2019-08-24,1744,4295,1181,878,8098
707,2019-08-25,2484,24553,1633,2,28672
707,2019-08-26,924,36643,1797,2,39366
707,2019-08-27,342,8647,1444,0,10433
707,2019-08-28,1051,12760,1620,1,15432
707,2019-08-29,1429,12571,1716,0,15716
707,2019-08-30,810,3491,408,2,4711
707,2019-08-31,132,180,1,0,313
707,2019-09-01,110,1187,14,0,1311
707,2019-09-02,53,159,2,0,214
707,2019-09-03,354,1341,1084,0,2779
707,2019-09-04,662,13297,1474,2,15435
707,2019-09-05,1769,9028,2600,2,13399
707,2019-09-06,2326,14594,1783,1,18704
707,2019-09-07,904,8400,2069,1,11374
707,2019-09-08,1270,31881,2149,0,35300
707,2019-09-09,633,8002,1579,0,10214
707,2019-09-10,418,8807,2181,0,11406
707,2019-09-11,1275,6025,2380,2,9682
707,2019-09-12,1075,10964,2058,1,14098
707,2019-09-13,2127,5823,1680,1,9631
707,2019-09-14,518,7069,2331,2,9920
707,2019-09-15,181,6791,2379,2,9353
707,2019-09-16,344,9735,1684,1,11764
707,2019-09-17,966,6488,1980,0,9434
707,2019-09-18,361,19651,1714,1,21727
707,2019-09-19,726,8000,2203,1,10930
707,2019-09-20,244,7332,1678,2,9256
707,2019-09-21,812,5828,2629,2,9271
707,2019-09-22,222,14558,2099,0,16879
707,2019-09-23,566,13659,2450,3,16678
707,2019-09-24,365,12098,1970,5,14438
707,2019-09-25,480,11451,2018,3,13952
707,2019-09-26,273,10018,2455,0,12746
707,2019-09-27,199,11010,2561,2,13772
707,2019-09-28,1069,16250,1362,3,18684
707,2019-09-29,1057,27607,1634,3,30301
707,2019-09-30,1532,26964,1290,3,29789
707,2019-10-01,142,23051,952,0,24145
707,2019-10-02,841,17212,1865,3,19921
707,2019-10-03,143,14407,1492,2,16044
707,2019-10-04,1156,23321,1258,1,25736
707,2019-10-05,128,21951,2001,2,24082
707,2019-10-06,130,17512,1496,0,19138
707,2019-10-07,1013,8687,1356,0,11056
707,2019-10-08,125,12860,1556,1,14542
707,2019-10-09,126,25135,1498,1,26760
707,2019-10-10,134,12726,1747,3,14610
707,2019-10-11,232,11355,1354,0,12941
707,2019-10-12,262,6236,1940,3,8441
707,2019-10-13,1062,12583,2487,2,16134
707,2019-10-14,1683,6615,2249,0,10547
707,2019-10-15,200,15282,1900,3,17385
707,2019-10-16,234,25166,1403,1,26804
707,2019-10-17,103,8966,1501,0,10570
707,2019-10-18,1006,9239,1594,0,11839
707,2019-10-19,94,5611,2589,1,8295
707,2019-10-20,98,3059,1924,2,5083
707,2019-10-21,167,10776,1556,0,12499
707,2019-10-22,201,7291,1907,1,9400
707,2019-10-23,218,8923,949,2,10092
707,2019-10-24,1207,14018,1558,2,16785
707,2019-10-25,294,11678,1495,3,13470
707,2019-10-26,407,22356,883,1,23647
707,2019-10-27,1943,19014,2115,0,23072
707,2019-10-28,804,23355,1163,0,25322
707,2019-10-29,332,29329,1842,1,31504
707,2019-10-30,1006,20811,2020,2,23839
707,2019-10-31,1761,20996,2276,0,25033
707,2019-11-01,753,17086,1063,0,18902
707,2019-11-02,407,33977,1589,1,35974
707,2019-11-03,756,28095,1399,0,30250
707,2019-11-04,1842,10991,1845,2,14680
707,2019-11-05,806,3448,1890,2,6146
707,2019-11-06,927,14772,1151,1,16851
707,2019-11-07,924,20865,1139,2,22930
707,2019-11-08,1973,15708,932,423,19036
707,2019-11-09,964,11632,1335,2,13933
707,2019-11-10,1094,15060,1216,1,17371
707,2019-11-11,1364,10289,1644,1,13298
707,2019-11-12,879,11750,2735,1,15365
707,2019-11-13,566,23795,1554,2,25917
707,2019-11-14,660,11180,2587,3,14430
707,2019-11-15,1202,4276,2704,0,8182
707,2019-11-16,444,2802,2200,0,5446
707,2019-11-17,367,4320,3007,0,7694
707,2019-11-18,280,3392,3439,1,7112
707,2019-11-19,310,3352,3135,2,6799
707,2019-11-20,1404,1299,3177,0,5880
707,2019-11-21,905,5874,1739,0,8518
707,2019-11-22,281,5975,1752,4,8012
708,2019-08-14,485,239,140,0,864
708,2019-08-15,1084,342,29,1,1456
708,2019-08-16,643,606,130,0,1379
708,2019-08-17,1061,957,526,0,2544
708,2019-08-18,1111,1678,998,0,3787
708,2019-08-19,839,15292,1100,1,17232
708,2019-08-20,1074,24752,1046,0,26872
708,2019-08-21,522,13803,1450,1,15776
708,2019-08-22,276,15086,1518,1,16881
708,2019-08-23,968,20367,969,0,22304
708,2019-08-24,389,25724,1248,1,27362
708,2019-08-25,1153,39076,2618,2,42849
708,2019-08-26,360,43897,1547,4,45808
708,2019-08-27,385,23266,1889,0,25540
708,2019-08-28,1162,33592,1890,0,36644
708,2019-08-29,257,23116,1841,1,25215
708,2019-08-30,393,4983,478,1,5855
708,2019-08-31,129,28,2,1,160
708,2019-09-01,319,1806,163,1,2289
708,2019-09-02,159,792,4,0,955
708,2019-09-03,319,698,1270,0,2287
708,2019-09-04,352,75049,2190,3,77594
708,2019-09-05,1040,8285,1860,1,11186
708,2019-09-06,1027,13891,2270,0,17188
708,2019-09-07,1102,12814,1573,0,15489
708,2019-09-08,336,7203,2031,0,9570
708,2019-09-09,1149,6561,1374,0,9084
708,2019-09-10,1017,7768,2630,1,11416
708,2019-09-11,197,6356,2423,2,8978
708,2019-09-12,146,7688,2274,2,10110
708,2019-09-13,292,5347,1782,0,7421
708,2019-09-14,260,8124,1959,0,10343
708,2019-09-15,131,13240,2079,2,15452
708,2019-09-16,198,13534,1649,1,15382
708,2019-09-17,1011,8394,2753,1,12159
708,2019-09-18,417,19004,1441,0,20862
708,2019-09-19,285,11036,1260,0,12581
708,2019-09-20,282,22634,2017,3,24936
708,2019-09-21,1015,8680,1867,0,11562
708,2019-09-22,294,10081,2034,1,12410
708,2019-09-23,1151,14127,2171,1,17450
708,2019-09-24,164,12801,2023,4,14992
708,2019-09-25,258,11163,1741,2,13164
708,2019-09-26,179,13387,2743,0,16309
708,2019-09-27,1035,8738,2592,4,12369
708,2019-09-28,176,25628,2018,1,27823
708,2019-09-29,902,29067,1687,1,31657
708,2019-09-30,472,29339,2052,7,31870
708,2019-10-01,136,24934,1420,1,26491
708,2019-10-02,156,19297,1631,603,21687
708,2019-10-03,161,14899,1560,2,16622
708,2019-10-04,125,12478,1822,2,14427
708,2019-10-05,157,21822,1493,1,23473
708,2019-10-06,141,17671,1245,4,19061
708,2019-10-07,164,7002,1921,0,9087
708,2019-10-08,231,19243,1529,0,21003
708,2019-10-09,866,25728,2433,3,29030
708,2019-10-10,238,12940,1616,2,14796
708,2019-10-11,126,16104,2112,1,18343
708,2019-10-12,169,9850,2607,4,12630
708,2019-10-13,192,12454,1941,0,14587
708,2019-10-14,114,6306,2362,4,8786
708,2019-10-15,1062,15186,1828,4,18080
708,2019-10-16,1072,24575,1230,0,26877
708,2019-10-17,162,9239,2374,1,11776
708,2019-10-18,285,14984,1555,1,16825
708,2019-10-19,344,8808,2431,0,11583
708,2019-10-20,692,3109,2414,2,6217
708,2019-10-21,328,10915,1717,0,12960
708,2019-10-22,1033,6840,1480,2,9355
708,2019-10-23,1942,8662,1727,2,12333
708,2019-10-24,1373,14048,1216,1,16638
708,2019-10-25,256,16305,1478,2,18041
708,2019-10-26,178,17760,1232,0,19170
708,2019-10-27,258,27990,973,0,29221
708,2019-10-28,998,25898,1469,0,28365
708,2019-10-29,932,18326,1888,2,21148
708,2019-10-30,144,16247,1525,3,17919
708,2019-10-31,98,20480,1530,1,22109
708,2019-11-01,240,27700,1481,0,29421
708,2019-11-02,460,17575,1406,2,19443
708,2019-11-03,406,37630,1424,0,39460
708,2019-11-04,189,11268,865,3,12325
708,2019-11-05,1629,4587,1404,0,7620
708,2019-11-06,762,21088,1532,774,24156
708,2019-11-07,260,29095,1562,4,30921
708,2019-11-08,754,17778,1096,0,19628
708,2019-11-09,1427,11945,1437,1,14810
708,2019-11-10,2767,14421,1790,2,18980
708,2019-11-11,124,9821,2836,1,12782
708,2019-11-12,114,10270,3775,2,14161
708,2019-11-13,126,12995,2212,0,15333
708,2019-11-14,1155,9155,2359,4,12673
708,2019-11-15,192,4187,2006,3,6388
708,2019-11-16,87,2969,2715,1,5772
708,2019-11-17,234,4144,3334,0,7712
708,2019-11-18,191,2723,2971,1,5886
708,2019-11-19,146,3407,2519,3,6075
708,2019-11-20,1908,1453,2247,0,5608
708,2019-11-21,140,5731,2539,0,8410
708,2019-11-22,209,9091,1688,2,10990
708,2019-11-23,1103,7448,2688,2,11241
708,2019-11-24,440,9163,1968,4,11575
708,2019-11-25,172,12185,2284,0,14641
708,2019-11-26,136,6012,1548,11,7707
708,2019-11-27,88,11020,1829,0,12937
708,2019-11-28,519,14381,603,0,15503
708,2019-11-29,21,774,0,0,795
708,2019-08-14,485,239,140,0,864
708,2019-08-15,1084,342,29,1,1456
708,2019-08-16,643,606,130,0,1379
708,2019-08-17,1061,957,526,0,2544
708,2019-08-18,1111,1678,998,0,3787
708,2019-08-19,839,15292,1100,1,17232
708,2019-08-20,1074,24752,1046,0,26872
708,2019-08-21,522,13803,1450,1,15776
708,2019-08-22,276,15086,1518,1,16881
708,2019-08-23,968,20367,969,0,22304
708,2019-08-24,389,25724,1248,1,27362
708,2019-08-25,1153,39076,2618,2,42849
708,2019-08-26,360,43897,1547,4,45808
708,2019-08-27,385,23266,1889,0,25540
708,2019-08-28,1162,33592,1890,0,36644
708,2019-08-29,257,23116,1841,1,25215
708,2019-08-30,393,4983,478,1,5855
708,2019-08-31,129,28,2,1,160
708,2019-09-01,319,1806,163,1,2289
708,2019-09-02,159,792,4,0,955
708,2019-09-03,319,698,1270,0,2287
708,2019-09-04,352,75049,2190,3,77594
708,2019-09-05,1040,8285,1860,1,11186
708,2019-09-06,1027,13891,2270,0,17188
708,2019-09-07,1102,12814,1573,0,15489
708,2019-09-08,336,7203,2031,0,9570
708,2019-09-09,1149,6561,1374,0,9084
708,2019-09-10,1017,7768,2630,1,11416
708,2019-09-11,197,6356,2423,2,8978
708,2019-09-12,146,7688,2274,2,10110
708,2019-09-13,292,5347,1782,0,7421
708,2019-09-14,260,8124,1959,0,10343
708,2019-09-15,131,13240,2079,2,15452
708,2019-09-16,198,13534,1649,1,15382
708,2019-09-17,1011,8394,2753,1,12159
708,2019-09-18,417,19004,1441,0,20862
708,2019-09-19,285,11036,1260,0,12581
708,2019-09-20,282,22634,2017,3,24936
708,2019-09-21,1015,8680,1867,0,11562
708,2019-09-22,294,10081,2034,1,12410
708,2019-09-23,1151,14127,2171,1,17450
708,2019-09-24,164,12801,2023,4,14992
708,2019-09-25,258,11163,1741,2,13164
708,2019-09-26,179,13387,2743,0,16309
708,2019-09-27,1035,8738,2592,4,12369
708,2019-09-28,176,25628,2018,1,27823
708,2019-09-29,902,29067,1687,1,31657
708,2019-09-30,472,29339,2052,7,31870
708,2019-10-01,136,24934,1420,1,26491
708,2019-10-02,156,19297,1631,603,21687
708,2019-10-03,161,14899,1560,2,16622
708,2019-10-04,125,12478,1822,2,14427
708,2019-10-05,157,21822,1493,1,23473
708,2019-10-06,141,17671,1245,4,19061
708,2019-10-07,164,7002,1921,0,9087
708,2019-10-08,231,19243,1529,0,21003
708,2019-10-09,866,25728,2433,3,29030
708,2019-10-10,238,12940,1616,2,14796
708,2019-10-11,126,16104,2112,1,18343
708,2019-10-12,169,9850,2607,4,12630
708,2019-10-13,192,12454,1941,0,14587
708,2019-10-14,114,6306,2362,4,8786
708,2019-10-15,1062,15186,1828,4,18080
708,2019-10-16,1072,24575,1230,0,26877
708,2019-10-17,162,9239,2374,1,11776
708,2019-10-18,285,14984,1555,1,16825
708,2019-10-19,344,8808,2431,0,11583
708,2019-10-20,692,3109,2414,2,6217
708,2019-10-21,328,10915,1717,0,12960
708,2019-10-22,1033,6840,1480,2,9355
708,2019-10-23,1942,8662,1727,2,12333
708,2019-10-24,1373,14048,1216,1,16638
708,2019-10-25,256,16305,1478,2,18041
708,2019-10-26,178,17760,1232,0,19170
708,2019-10-27,258,27990,973,0,29221
708,2019-10-28,998,25898,1469,0,28365
708,2019-10-29,932,18326,1888,2,21148
708,2019-10-30,144,16247,1525,3,17919
708,2019-10-31,98,20480,1530,1,22109
708,2019-11-01,240,27700,1481,0,29421
708,2019-11-02,460,17575,1406,2,19443
708,2019-11-03,406,37630,1424,0,39460
708,2019-11-04,189,11268,865,3,12325
708,2019-11-05,1629,4587,1404,0,7620
708,2019-11-06,762,21088,1532,774,24156
708,2019-11-07,260,29095,1562,4,30921
708,2019-11-08,754,17778,1096,0,19628
708,2019-11-09,1427,11945,1437,1,14810
708,2019-11-10,2767,14421,1790,2,18980
708,2019-11-11,124,9821,2836,1,12782
708,2019-11-12,114,10270,3775,2,14161
708,2019-11-13,126,12995,2212,0,15333
708,2019-11-14,1155,9155,2359,4,12673
708,2019-11-15,192,4187,2006,3,6388
708,2019-11-16,87,2969,2715,1,5772
708,2019-11-17,234,4144,3334,0,7712
708,2019-11-18,191,2723,2971,1,5886
708,2019-11-19,146,3407,2519,3,6075
708,2019-11-20,1908,1453,2247,0,5608
708,2019-11-21,140,5731,2539,0,8410
708,2019-11-22,209,9091,1688,2,10990
708,2019-11-23,1103,7448,2688,2,11241
708,2019-11-24,440,9163,1968,4,11575
708,2019-11-25,172,12185,2284,0,14641
708,2019-11-26,136,6012,1548,11,7707
708,2019-11-27,88,11020,1829,0,12937
708,2019-11-28,519,14381,603,0,15503
708,2019-11-29,21,774,0,0,795
708,2019-08-14,485,239,140,0,864
708,2019-08-15,1084,342,29,1,1456
708,2019-08-16,643,606,130,0,1379
708,2019-08-17,1061,957,526,0,2544
708,2019-08-18,1111,1678,998,0,3787
708,2019-08-19,839,15292,1100,1,17232
708,2019-08-20,1074,24752,1046,0,26872
708,2019-08-21,522,13803,1450,1,15776
708,2019-08-22,276,15086,1518,1,16881
708,2019-08-23,968,20367,969,0,22304
708,2019-08-24,389,25724,1248,1,27362
708,2019-08-25,1153,39076,2618,2,42849
708,2019-08-26,360,43897,1547,4,45808
708,2019-08-27,385,23266,1889,0,25540
708,2019-08-28,1162,33592,1890,0,36644
708,2019-08-29,257,23116,1841,1,25215
708,2019-08-30,393,4983,478,1,5855
708,2019-08-31,129,28,2,1,160
708,2019-09-01,319,1806,163,1,2289
708,2019-09-02,159,792,4,0,955
708,2019-09-03,319,698,1270,0,2287
708,2019-09-04,352,75049,2190,3,77594
708,2019-09-05,1040,8285,1860,1,11186
708,2019-09-06,1027,13891,2270,0,17188
708,2019-09-07,1102,12814,1573,0,15489
708,2019-09-08,336,7203,2031,0,9570
708,2019-09-09,1149,6561,1374,0,9084
708,2019-09-10,1017,7768,2630,1,11416
708,2019-09-11,197,6356,2423,2,8978
708,2019-09-12,146,7688,2274,2,10110
708,2019-09-13,292,5347,1782,0,7421
708,2019-09-14,260,8124,1959,0,10343
708,2019-09-15,131,13240,2079,2,15452
708,2019-09-16,198,13534,1649,1,15382
708,2019-09-17,1011,8394,2753,1,12159
708,2019-09-18,417,19004,1441,0,20862
708,2019-09-19,285,11036,1260,0,12581
708,2019-09-20,282,22634,2017,3,24936
708,2019-09-21,1015,8680,1867,0,11562
708,2019-09-22,294,10081,2034,1,12410
708,2019-09-23,1151,14127,2171,1,17450
708,2019-09-24,164,12801,2023,4,14992
708,2019-09-25,258,11163,1741,2,13164
708,2019-09-26,179,13387,2743,0,16309
708,2019-09-27,1035,8738,2592,4,12369
708,2019-09-28,176,25628,2018,1,27823
708,2019-09-29,902,29067,1687,1,31657
708,2019-09-30,472,29339,2052,7,31870
708,2019-10-01,136,24934,1420,1,26491
708,2019-10-02,156,19297,1631,603,21687
708,2019-10-03,161,14899,1560,2,16622
708,2019-10-04,125,12478,1822,2,14427
708,2019-10-05,157,21822,1493,1,23473
708,2019-10-06,141,17671,1245,4,19061
708,2019-10-07,164,7002,1921,0,9087
708,2019-10-08,231,19243,1529,0,21003
708,2019-10-09,866,25728,2433,3,29030
708,2019-10-10,238,12940,1616,2,14796
708,2019-10-11,126,16104,2112,1,18343
708,2019-10-12,169,9850,2607,4,12630
708,2019-10-13,192,12454,1941,0,14587
708,2019-10-14,114,6306,2362,4,8786
708,2019-10-15,1062,15186,1828,4,18080
708,2019-10-16,1072,24575,1230,0,26877
708,2019-10-17,162,9239,2374,1,11776
708,2019-10-18,285,14984,1555,1,16825
708,2019-10-19,344,8808,2431,0,11583
708,2019-10-20,692,3109,2414,2,6217
708,2019-10-21,328,10915,1717,0,12960
708,2019-10-22,1033,6840,1480,2,9355
708,2019-10-23,1942,8662,1727,2,12333
708,2019-10-24,1373,14048,1216,1,16638
708,2019-10-25,256,16305,1478,2,18041
708,2019-10-26,178,17760,1232,0,19170
708,2019-10-27,258,27990,973,0,29221
708,2019-10-28,998,25898,1469,0,28365
708,2019-10-29,932,18326,1888,2,21148
708,2019-10-30,144,16247,1525,3,17919
708,2019-10-31,98,20480,1530,1,22109
708,2019-11-01,240,27700,1481,0,29421
708,2019-11-02,460,17575,1406,2,19443
708,2019-11-03,406,37630,1424,0,39460
708,2019-11-04,189,11268,865,3,12325
708,2019-11-05,1629,4587,1404,0,7620
708,2019-11-06,762,21088,1532,774,24156
708,2019-11-07,260,29095,1562,4,30921
708,2019-11-08,754,17778,1096,0,19628
708,2019-11-09,1427,11945,1437,1,14810
708,2019-11-10,2767,14421,1790,2,18980
708,2019-11-11,124,9821,2836,1,12782
708,2019-11-12,114,10270,3775,2,14161
708,2019-11-13,126,12995,2212,0,15333
708,2019-11-14,1155,9155,2359,4,12673
708,2019-11-15,192,4187,2006,3,6388
708,2019-11-16,87,2969,2715,1,5772
708,2019-11-17,234,4144,3334,0,7712
708,2019-11-18,191,2723,2971,1,5886
708,2019-11-19,146,3407,2519,3,6075
708,2019-11-20,1908,1453,2247,0,5608
708,2019-11-21,140,5731,2539,0,8410
708,2019-11-22,209,9091,1688,2,10990
708,2019-11-23,1103,7448,2688,2,11241
708,2019-11-24,440,9163,1968,4,11575
708,2019-11-25,172,12185,2284,0,14641
708,2019-11-26,136,6012,1548,11,7707
708,2019-11-27,88,11020,1829,0,12937
708,2019-11-28,519,14381,603,0,15503
708,2019-08-15,1084,342,29,1,1456
708,2019-08-16,643,606,130,0,1379
708,2019-08-17,1061,957,526,0,2544
708,2019-08-18,1111,1678,998,0,3787
708,2019-08-19,839,15292,1100,1,17232
708,2019-08-20,1074,24752,1046,0,26872
708,2019-08-21,522,13803,1450,1,15776
708,2019-08-22,276,15086,1518,1,16881
708,2019-08-23,968,20367,969,0,22304
708,2019-08-24,389,25724,1248,1,27362
708,2019-08-25,1153,39076,2618,2,42849
708,2019-08-26,360,43897,1547,4,45808
708,2019-08-27,385,23266,1889,0,25540
708,2019-08-28,1162,33592,1890,0,36644
708,2019-08-29,257,23116,1841,1,25215
708,2019-08-30,393,4983,478,1,5855
708,2019-08-31,129,28,2,1,160
708,2019-09-01,319,1806,163,1,2289
708,2019-09-02,159,792,4,0,955
708,2019-09-03,319,698,1270,0,2287
708,2019-09-04,352,75049,2190,3,77594
708,2019-09-05,1040,8285,1860,1,11186
708,2019-09-06,1027,13891,2270,0,17188
708,2019-09-07,1102,12814,1573,0,15489
708,2019-09-08,336,7203,2031,0,9570
708,2019-09-09,1149,6561,1374,0,9084
708,2019-09-10,1017,7768,2630,1,11416
708,2019-09-11,197,6356,2423,2,8978
708,2019-09-12,146,7688,2274,2,10110
708,2019-09-13,292,5347,1782,0,7421
708,2019-09-14,260,8124,1959,0,10343
708,2019-09-15,131,13240,2079,2,15452
708,2019-09-16,198,13534,1649,1,15382
708,2019-09-17,1011,8394,2753,1,12159
708,2019-09-18,417,19004,1441,0,20862
708,2019-09-19,285,11036,1260,0,12581
708,2019-09-20,282,22634,2017,3,24936
708,2019-09-21,1015,8680,1867,0,11562
708,2019-09-22,294,10081,2034,1,12410
708,2019-09-23,1151,14127,2171,1,17450
708,2019-09-24,164,12801,2023,4,14992
708,2019-09-25,258,11163,1741,2,13164
708,2019-09-26,179,13387,2743,0,16309
708,2019-09-27,1035,8738,2592,4,12369
708,2019-09-28,176,25628,2018,1,27823
708,2019-09-29,902,29067,1687,1,31657
708,2019-09-30,472,29339,2052,7,31870
708,2019-10-01,136,24934,1420,1,26491
708,2019-10-02,156,19297,1631,603,21687
708,2019-10-03,161,14899,1560,2,16622
708,2019-10-04,125,12478,1822,2,14427
708,2019-10-05,157,21822,1493,1,23473
708,2019-10-06,141,17671,1245,4,19061
708,2019-10-07,164,7002,1921,0,9087
708,2019-10-08,231,19243,1529,0,21003
708,2019-10-09,866,25728,2433,3,29030
708,2019-10-10,238,12940,1616,2,14796
708,2019-10-11,126,16104,2112,1,18343
708,2019-10-12,169,9850,2607,4,12630
708,2019-10-13,192,12454,1941,0,14587
708,2019-10-14,114,6306,2362,4,8786
708,2019-10-15,1062,15186,1828,4,18080
708,2019-10-16,1072,24575,1230,0,26877
708,2019-10-17,162,9239,2374,1,11776
708,2019-10-18,285,14984,1555,1,16825
708,2019-10-19,344,8808,2431,0,11583
708,2019-10-20,692,3109,2414,2,6217
708,2019-10-21,328,10915,1717,0,12960
708,2019-10-22,1033,6840,1480,2,9355
708,2019-10-23,1942,8662,1727,2,12333
708,2019-10-24,1373,14048,1216,1,16638
708,2019-10-25,256,16305,1478,2,18041
708,2019-10-26,178,17760,1232,0,19170
708,2019-10-27,258,27990,973,0,29221
708,2019-10-28,998,25898,1469,0,28365
708,2019-10-29,932,18326,1888,2,21148
708,2019-10-30,144,16247,1525,3,17919
708,2019-10-31,98,20480,1530,1,22109
708,2019-11-01,240,27700,1481,0,29421
708,2019-11-02,460,17575,1406,2,19443
708,2019-11-03,406,37630,1424,0,39460
708,2019-11-04,189,11268,865,3,12325
708,2019-11-05,1629,4587,1404,0,7620
708,2019-11-06,762,21088,1532,774,24156
708,2019-11-07,260,29095,1562,4,30921
708,2019-11-08,754,17778,1096,0,19628
708,2019-11-09,1427,11945,1437,1,14810
708,2019-11-10,2767,14421,1790,2,18980
708,2019-11-11,124,9821,2836,1,12782
708,2019-11-12,114,10270,3775,2,14161
708,2019-11-13,126,12995,2212,0,15333
708,2019-11-14,1155,9155,2359,4,12673
708,2019-11-15,192,4187,2006,3,6388
708,2019-11-16,87,2969,2715,1,5772
708,2019-11-17,234,4144,3334,0,7712
708,2019-11-18,191,2723,2971,1,5886
708,2019-11-19,146,3407,2519,3,6075
708,2019-11-20,1908,1453,2247,0,5608
708,2019-11-21,140,5731,2539,0,8410
708,2019-11-22,209,9091,1688,2,10990
708,2019-11-23,1103,7448,2688,2,11241
708,2019-11-24,440,9163,1968,4,11575
708,2019-11-25,172,12185,2284,0,14641
708,2019-11-26,136,6012,1548,11,7707
710,2019-08-14,3931,71,133,0,4135
710,2019-08-15,428854,787,5,1,429647
710,2019-08-16,372488,439,91,1,373019
710,2019-08-17,368156,1194,422,0,369772
710,2019-08-18,466349,667,1135,0,468151
710,2019-08-19,794663,1718,684,1,797066
710,2019-08-20,748736,1638,2120,2,752496
710,2019-08-21,776294,919,1355,0,778568
710,2019-08-22,799200,1614,1281,1,802096
710,2019-08-23,724851,2399,1663,0,728913
710,2019-08-24,549243,12370,1433,1,563047
710,2019-08-25,484607,17081,2284,3,503975
710,2019-08-26,827478,14813,1223,1,843515
710,2019-08-27,870779,14263,1096,1,886139
710,2019-08-28,836061,39735,2282,0,878078
710,2019-08-29,811599,20829,1807,1,834236
710,2019-08-30,621575,3172,920,3,625670
710,2019-08-31,66892,160,3,0,67055
710,2019-09-01,114547,1249,477,0,116273
710,2019-09-02,142353,158,0,0,142511
710,2019-09-03,261603,628,1938,0,264169
710,2019-09-04,833219,6221,1877,2,841319
710,2019-09-05,860066,6872,1768,1,868707
710,2019-09-06,873202,8260,1762,0,883224
710,2019-09-07,583989,6586,1899,0,592474
710,2019-09-08,513498,4192,1973,1,519664
710,2019-09-09,881977,6583,1394,1,889955
710,2019-09-10,916840,12016,2351,2,931209
710,2019-09-11,989609,10636,2001,3,1002249
710,2019-09-12,980607,6465,2427,1,989500
710,2019-09-13,1001208,4793,2196,1,1008198
710,2019-09-14,548773,10300,891,1,559965
710,2019-09-15,468733,9165,2532,2,480432
710,2019-09-16,909102,13667,2067,0,924836
710,2019-09-17,787672,8809,2697,1,799179
710,2019-09-18,695586,18689,1409,1,715685
710,2019-09-19,897447,4949,1176,3,903575
710,2019-09-20,776599,10590,1890,0,789079
710,2019-09-21,591654,6777,2070,1,600502
710,2019-09-22,514434,8344,1810,2,524590
710,2019-09-23,821216,8588,3145,1,832950
710,2019-09-24,779226,9594,1869,4,790693
710,2019-09-25,833687,6404,1394,2,841487
710,2019-09-26,715509,9082,1478,0,726069
710,2019-09-27,649922,7291,1460,3,658676
710,2019-09-28,487692,22837,1514,2,512045
710,2019-09-29,418444,26622,1623,3,446692
710,2019-09-30,665002,17941,2593,1,685537
710,2019-10-01,652785,14618,1218,1,668622
710,2019-10-02,658056,10869,1669,1,670595
710,2019-10-03,667165,12356,1792,1,681314
710,2019-10-04,594276,17031,1630,4,612941
710,2019-10-05,463829,21199,1053,1,486082
710,2019-10-06,439989,14981,2201,1,457172
710,2019-10-07,728920,4243,2191,1,735355
710,2019-10-08,691015,16295,2290,0,709600
710,2019-10-09,629412,30863,1525,2,661802
710,2019-10-10,687907,12101,1913,1,701922
710,2019-10-11,606347,13820,1656,0,621823
710,2019-10-12,467338,7727,2198,0,477263
710,2019-10-13,436315,6758,1649,2,444724
710,2019-10-14,785470,6866,1676,0,794012
710,2019-10-15,797134,12647,1342,0,811123
710,2019-10-16,572520,22324,885,1,595730
710,2019-10-17,623008,6501,1910,1,631420
710,2019-10-18,660132,7024,1702,2,668860
710,2019-10-19,480719,4964,2724,928,489335
710,2019-10-20,448539,707,2054,0,451300
710,2019-10-21,636425,9433,1309,1,647168
710,2019-10-22,652803,6395,1775,0,660973
710,2019-10-23,668913,12533,938,0,682384
710,2019-10-24,573702,23883,771,2,598358
710,2019-10-25,570218,13547,1834,2,585601
710,2019-10-26,419172,12293,1397,1,432863
710,2019-10-27,362330,26981,1469,0,390780
710,2019-10-28,525783,23375,1570,0,550728
710,2019-10-29,525937,16373,1675,4,543989
710,2019-10-30,528770,22811,2149,0,553730
710,2019-10-31,561918,17683,1243,0,580844
710,2019-11-01,563288,24441,1330,1,589060
710,2019-11-02,389171,16300,1317,593,407381
710,2019-11-03,334199,20848,1422,3,356472
710,2019-11-04,558053,11820,1537,0,571410
710,2019-11-05,622913,959,1296,1,625169
710,2019-11-06,562989,19401,563,1,582954
710,2019-11-07,455733,18265,1500,3,475501
710,2019-11-08,452900,8299,844,1,462044
710,2019-11-09,386288,11846,1754,0,399888
710,2019-11-10,349660,21915,2273,0,373848
710,2019-11-11,527770,14194,2993,1,544958
710,2019-11-12,472873,16110,2763,1,491747
710,2019-11-13,9773,12281,2591,2,24647
710,2019-11-14,5833,17013,2084,1,24931
710,2019-11-15,5731,5744,1749,0,13224
710,2019-11-16,3247,2506,2031,1,7785
710,2019-11-17,2677,3831,2196,0,8704
710,2019-11-18,5432,2539,3462,3,11436
710,2019-11-19,3343,5091,2677,0,11111
710,2019-11-20,2569,1412,2870,1,6852
710,2019-11-21,2851,5251,1996,1,10099
710,2019-11-22,2094,8343,1276,1,11714
710,2019-11-23,1645,6982,2618,4,11249
710,2019-11-24,2082,5369,1562,1,9014
710,2019-11-25,1454,6559,1797,1,9811
710,2019-11-26,1497,5822,1082,0,8401
710,2019-11-27,1770,6344,1174,1,9289
710,2019-11-28,1706,8565,654,0,10925
710,2019-11-29,54,2,2,0,58
710,2019-08-14,3931,71,133,0,4135
710,2019-08-15,428854,787,5,1,429647
710,2019-08-16,372488,439,91,1,373019
710,2019-08-17,368156,1194,422,0,369772
710,2019-08-18,466349,667,1135,0,468151
710,2019-08-19,794663,1718,684,1,797066
710,2019-08-20,748736,1638,2120,2,752496
710,2019-08-21,776294,919,1355,0,778568
710,2019-08-22,799200,1614,1281,1,802096
710,2019-08-23,724851,2399,1663,0,728913
710,2019-08-24,549243,12370,1433,1,563047
710,2019-08-25,484607,17081,2284,3,503975
710,2019-08-26,827478,14813,1223,1,843515
710,2019-08-27,870779,14263,1096,1,886139
710,2019-08-28,836061,39735,2282,0,878078
710,2019-08-29,811599,20829,1807,1,834236
710,2019-08-30,621575,3172,920,3,625670
710,2019-08-31,66892,160,3,0,67055
710,2019-09-01,114547,1249,477,0,116273
710,2019-09-02,142353,158,0,0,142511
710,2019-09-03,261603,628,1938,0,264169
710,2019-09-04,833219,6221,1877,2,841319
710,2019-09-05,860066,6872,1768,1,868707
710,2019-09-06,873202,8260,1762,0,883224
710,2019-09-07,583989,6586,1899,0,592474
710,2019-09-08,513498,4192,1973,1,519664
710,2019-09-09,881977,6583,1394,1,889955
710,2019-09-10,916840,12016,2351,2,931209
710,2019-09-11,989609,10636,2001,3,1002249
710,2019-09-12,980607,6465,2427,1,989500
710,2019-09-13,1001208,4793,2196,1,1008198
710,2019-09-14,548773,10300,891,1,559965
710,2019-09-15,468733,9165,2532,2,480432
710,2019-09-16,909102,13667,2067,0,924836
710,2019-09-17,787672,8809,2697,1,799179
710,2019-09-18,695586,18689,1409,1,715685
710,2019-09-19,897447,4949,1176,3,903575
710,2019-09-20,776599,10590,1890,0,789079
710,2019-09-21,591654,6777,2070,1,600502
710,2019-09-22,514434,8344,1810,2,524590
710,2019-09-23,821216,8588,3145,1,832950
710,2019-09-24,779226,9594,1869,4,790693
710,2019-09-25,833687,6404,1394,2,841487
710,2019-09-26,715509,9082,1478,0,726069
710,2019-09-27,649922,7291,1460,3,658676
710,2019-09-28,487692,22837,1514,2,512045
710,2019-09-29,418444,26622,1623,3,446692
710,2019-09-30,665002,17941,2593,1,685537
710,2019-10-01,652785,14618,1218,1,668622
710,2019-10-02,658056,10869,1669,1,670595
710,2019-10-03,667165,12356,1792,1,681314
710,2019-10-04,594276,17031,1630,4,612941
710,2019-10-05,463829,21199,1053,1,486082
710,2019-10-06,439989,14981,2201,1,457172
710,2019-10-07,728920,4243,2191,1,735355
710,2019-10-08,691015,16295,2290,0,709600
710,2019-10-09,629412,30863,1525,2,661802
710,2019-10-10,687907,12101,1913,1,701922
710,2019-10-11,606347,13820,1656,0,621823
710,2019-10-12,467338,7727,2198,0,477263
710,2019-10-13,436315,6758,1649,2,444724
710,2019-10-14,785470,6866,1676,0,794012
710,2019-10-15,797134,12647,1342,0,811123
710,2019-10-16,572520,22324,885,1,595730
710,2019-10-17,623008,6501,1910,1,631420
710,2019-10-18,660132,7024,1702,2,668860
710,2019-10-19,480719,4964,2724,928,489335
710,2019-10-20,448539,707,2054,0,451300
710,2019-10-21,636425,9433,1309,1,647168
710,2019-10-22,652803,6395,1775,0,660973
710,2019-10-23,668913,12533,938,0,682384
710,2019-10-24,573702,23883,771,2,598358
710,2019-10-25,570218,13547,1834,2,585601
710,2019-10-26,419172,12293,1397,1,432863
710,2019-10-27,362330,26981,1469,0,390780
710,2019-10-28,525783,23375,1570,0,550728
710,2019-10-29,525937,16373,1675,4,543989
710,2019-10-30,528770,22811,2149,0,553730
710,2019-10-31,561918,17683,1243,0,580844
710,2019-11-01,563288,24441,1330,1,589060
710,2019-11-02,389171,16300,1317,593,407381
710,2019-11-03,334199,20848,1422,3,356472
710,2019-11-04,558053,11820,1537,0,571410
710,2019-11-05,622913,959,1296,1,625169
710,2019-11-06,562989,19401,563,1,582954
710,2019-11-07,455733,18265,1500,3,475501
710,2019-11-08,452900,8299,844,1,462044
710,2019-11-09,386288,11846,1754,0,399888
710,2019-11-10,349660,21915,2273,0,373848
710,2019-11-11,527770,14194,2993,1,544958
710,2019-11-12,472873,16110,2763,1,491747
710,2019-11-13,9773,12281,2591,2,24647
710,2019-11-14,5833,17013,2084,1,24931
710,2019-11-15,5731,5744,1749,0,13224
710,2019-11-16,3247,2506,2031,1,7785
710,2019-11-17,2677,3831,2196,0,8704
710,2019-11-18,5432,2539,3462,3,11436
710,2019-11-19,3343,5091,2677,0,11111
710,2019-11-20,2569,1412,2870,1,6852
710,2019-11-21,2851,5251,1996,1,10099
710,2019-11-22,2094,8343,1276,1,11714
710,2019-11-23,1645,6982,2618,4,11249
710,2019-11-24,2082,5369,1562,1,9014
710,2019-11-25,1454,6559,1797,1,9811
710,2019-11-26,1497,5822,1082,0,8401
710,2019-11-27,1770,6344,1174,1,9289
710,2019-11-28,1706,8565,654,0,10925
710,2019-11-29,54,2,2,0,58
710,2019-08-14,3931,71,133,0,4135
710,2019-08-15,428854,787,5,1,429647
710,2019-08-16,372488,439,91,1,373019
710,2019-08-17,368156,1194,422,0,369772
710,2019-08-18,466349,667,1135,0,468151
710,2019-08-19,794663,1718,684,1,797066
710,2019-08-20,748736,1638,2120,2,752496
710,2019-08-21,776294,919,1355,0,778568
710,2019-08-22,799200,1614,1281,1,802096
710,2019-08-23,724851,2399,1663,0,728913
710,2019-08-24,549243,12370,1433,1,563047
710,2019-08-25,484607,17081,2284,3,503975
710,2019-08-26,827478,14813,1223,1,843515
710,2019-08-27,870779,14263,1096,1,886139
710,2019-08-28,836061,39735,2282,0,878078
710,2019-08-29,811599,20829,1807,1,834236
710,2019-08-30,621575,3172,920,3,625670
710,2019-08-31,66892,160,3,0,67055
710,2019-09-01,114547,1249,477,0,116273
710,2019-09-02,142353,158,0,0,142511
710,2019-09-03,261603,628,1938,0,264169
710,2019-09-04,833219,6221,1877,2,841319
710,2019-09-05,860066,6872,1768,1,868707
710,2019-09-06,873202,8260,1762,0,883224
710,2019-09-07,583989,6586,1899,0,592474
710,2019-09-08,513498,4192,1973,1,519664
710,2019-09-09,881977,6583,1394,1,889955
710,2019-09-10,916840,12016,2351,2,931209
710,2019-09-11,989609,10636,2001,3,1002249
710,2019-09-12,980607,6465,2427,1,989500
710,2019-09-13,1001208,4793,2196,1,1008198
710,2019-09-14,548773,10300,891,1,559965
710,2019-09-15,468733,9165,2532,2,480432
710,2019-09-16,909102,13667,2067,0,924836
710,2019-09-17,787672,8809,2697,1,799179
710,2019-09-18,695586,18689,1409,1,715685
710,2019-09-19,897447,4949,1176,3,903575
710,2019-09-20,776599,10590,1890,0,789079
710,2019-09-21,591654,6777,2070,1,600502
710,2019-09-22,514434,8344,1810,2,524590
710,2019-09-23,821216,8588,3145,1,832950
710,2019-09-24,779226,9594,1869,4,790693
710,2019-09-25,833687,6404,1394,2,841487
710,2019-09-26,715509,9082,1478,0,726069
710,2019-09-27,649922,7291,1460,3,658676
710,2019-09-28,487692,22837,1514,2,512045
710,2019-09-29,418444,26622,1623,3,446692
710,2019-09-30,665002,17941,2593,1,685537
710,2019-10-01,652785,14618,1218,1,668622
710,2019-10-02,658056,10869,1669,1,670595
710,2019-10-03,667165,12356,1792,1,681314
710,2019-10-04,594276,17031,1630,4,612941
710,2019-10-05,463829,21199,1053,1,486082
710,2019-10-06,439989,14981,2201,1,457172
710,2019-10-07,728920,4243,2191,1,735355
710,2019-10-08,691015,16295,2290,0,709600
710,2019-10-09,629412,30863,1525,2,661802
710,2019-10-10,687907,12101,1913,1,701922
710,2019-10-11,606347,13820,1656,0,621823
710,2019-10-12,467338,7727,2198,0,477263
710,2019-10-13,436315,6758,1649,2,444724
710,2019-10-14,785470,6866,1676,0,794012
710,2019-10-15,797134,12647,1342,0,811123
710,2019-10-16,572520,22324,885,1,595730
710,2019-10-17,623008,6501,1910,1,631420
710,2019-10-18,660132,7024,1702,2,668860
710,2019-10-19,480719,4964,2724,928,489335
710,2019-10-20,448539,707,2054,0,451300
710,2019-10-21,636425,9433,1309,1,647168
710,2019-10-22,652803,6395,1775,0,660973
710,2019-10-23,668913,12533,938,0,682384
710,2019-10-24,573702,23883,771,2,598358
710,2019-10-25,570218,13547,1834,2,585601
710,2019-10-26,419172,12293,1397,1,432863
710,2019-10-27,362330,26981,1469,0,390780
710,2019-10-28,525783,23375,1570,0,550728
710,2019-10-29,525937,16373,1675,4,543989
710,2019-10-30,528770,22811,2149,0,553730
710,2019-10-31,561918,17683,1243,0,580844
710,2019-11-01,563288,24441,1330,1,589060
710,2019-11-02,389171,16300,1317,593,407381
710,2019-11-03,334199,20848,1422,3,356472
710,2019-11-04,558053,11820,1537,0,571410
710,2019-11-05,622913,959,1296,1,625169
710,2019-11-06,562989,19401,563,1,582954
710,2019-11-07,455733,18265,1500,3,475501
710,2019-11-08,452900,8299,844,1,462044
710,2019-11-09,386288,11846,1754,0,399888
710,2019-11-10,349660,21915,2273,0,373848
710,2019-11-11,527770,14194,2993,1,544958
710,2019-11-12,472873,16110,2763,1,491747
710,2019-11-13,9773,12281,2591,2,24647
710,2019-11-14,5833,17013,2084,1,24931
710,2019-11-15,5731,5744,1749,0,13224
710,2019-11-16,3247,2506,2031,1,7785
710,2019-11-17,2677,3831,2196,0,8704
710,2019-11-18,5432,2539,3462,3,11436
710,2019-11-19,3343,5091,2677,0,11111
710,2019-11-20,2569,1412,2870,1,6852
710,2019-11-21,2851,5251,1996,1,10099
710,2019-11-22,2094,8343,1276,1,11714
710,2019-11-23,1645,6982,2618,4,11249
710,2019-11-24,2082,5369,1562,1,9014
710,2019-11-25,1454,6559,1797,1,9811
710,2019-11-26,1497,5822,1082,0,8401
710,2019-11-27,1770,6344,1174,1,9289
710,2019-11-28,1706,8565,654,0,10925
710,2019-11-29,54,2,2,0,58
710,2019-08-15,428854,787,5,1,429647
710,2019-08-16,372488,439,91,1,373019
710,2019-08-17,368156,1194,422,0,369772
710,2019-08-18,466349,667,1135,0,468151
710,2019-08-19,794663,1718,684,1,797066
710,2019-08-20,748736,1638,2120,2,752496
710,2019-08-21,776294,919,1355,0,778568
710,2019-08-22,799200,1614,1281,1,802096
710,2019-08-23,724851,2399,1663,0,728913
710,2019-08-24,549243,12370,1433,1,563047
710,2019-08-25,484607,17081,2284,3,503975
710,2019-08-26,827478,14813,1223,1,843515
710,2019-08-27,870779,14263,1096,1,886139
710,2019-08-28,836061,39735,2282,0,878078
710,2019-08-29,811599,20829,1807,1,834236
710,2019-08-30,621575,3172,920,3,625670
710,2019-08-31,66892,160,3,0,67055
710,2019-09-01,114547,1249,477,0,116273
710,2019-09-02,142353,158,0,0,142511
710,2019-09-03,261603,628,1938,0,264169
710,2019-09-04,833219,6221,1877,2,841319
710,2019-09-05,860066,6872,1768,1,868707
710,2019-09-06,873202,8260,1762,0,883224
710,2019-09-07,583989,6586,1899,0,592474
710,2019-09-08,513498,4192,1973,1,519664
710,2019-09-09,881977,6583,1394,1,889955
710,2019-09-10,916840,12016,2351,2,931209
710,2019-09-11,989609,10636,2001,3,1002249
710,2019-09-12,980607,6465,2427,1,989500
710,2019-09-13,1001208,4793,2196,1,1008198
710,2019-09-14,548773,10300,891,1,559965
710,2019-09-15,468733,9165,2532,2,480432
710,2019-09-16,909102,13667,2067,0,924836
710,2019-09-17,787672,8809,2697,1,799179
710,2019-09-18,695586,18689,1409,1,715685
710,2019-09-19,897447,4949,1176,3,903575
710,2019-09-20,776599,10590,1890,0,789079
710,2019-09-21,591654,6777,2070,1,600502
710,2019-09-22,514434,8344,1810,2,524590
710,2019-09-23,821216,8588,3145,1,832950
710,2019-09-24,779226,9594,1869,4,790693
710,2019-09-25,833687,6404,1394,2,841487
710,2019-09-26,715509,9082,1478,0,726069
710,2019-09-27,649922,7291,1460,3,658676
710,2019-09-28,487692,22837,1514,2,512045
710,2019-09-29,418444,26622,1623,3,446692
710,2019-09-30,665002,17941,2593,1,685537
710,2019-10-01,652785,14618,1218,1,668622
710,2019-10-02,658056,10869,1669,1,670595
710,2019-10-03,667165,12356,1792,1,681314
710,2019-10-04,594276,17031,1630,4,612941
710,2019-10-05,463829,21199,1053,1,486082
710,2019-10-06,439989,14981,2201,1,457172
710,2019-10-07,728920,4243,2191,1,735355
710,2019-10-08,691015,16295,2290,0,709600
710,2019-10-09,629412,30863,1525,2,661802
710,2019-10-10,687907,12101,1913,1,701922
710,2019-10-11,606347,13820,1656,0,621823
710,2019-10-12,467338,7727,2198,0,477263
710,2019-10-13,436315,6758,1649,2,444724
710,2019-10-14,785470,6866,1676,0,794012
710,2019-10-15,797134,12647,1342,0,811123
710,2019-10-16,572520,22324,885,1,595730
710,2019-10-17,623008,6501,1910,1,631420
710,2019-10-18,660132,7024,1702,2,668860
710,2019-10-19,480719,4964,2724,928,489335
710,2019-10-20,448539,707,2054,0,451300
710,2019-10-21,636425,9433,1309,1,647168
710,2019-10-22,652803,6395,1775,0,660973
710,2019-10-23,668913,12533,938,0,682384
710,2019-10-24,573702,23883,771,2,598358
710,2019-10-25,570218,13547,1834,2,585601
710,2019-10-26,419172,12293,1397,1,432863
710,2019-10-27,362330,26981,1469,0,390780
710,2019-10-28,525783,23375,1570,0,550728
710,2019-10-29,525937,16373,1675,4,543989
710,2019-10-30,528770,22811,2149,0,553730
710,2019-10-31,561918,17683,1243,0,580844
710,2019-11-01,563288,24441,1330,1,589060
710,2019-11-02,389171,16300,1317,593,407381
710,2019-11-03,334199,20848,1422,3,356472
710,2019-11-04,558053,11820,1537,0,571410
710,2019-11-05,622913,959,1296,1,625169
710,2019-11-06,562989,19401,563,1,582954
710,2019-11-07,455733,18265,1500,3,475501
710,2019-11-08,452900,8299,844,1,462044
710,2019-11-09,386288,11846,1754,0,399888
710,2019-11-10,349660,21915,2273,0,373848
710,2019-11-11,527770,14194,2993,1,544958
710,2019-11-12,472873,16110,2763,1,491747
710,2019-11-13,9773,12281,2591,2,24647
710,2019-11-14,5833,17013,2084,1,24931
710,2019-11-15,5731,5744,1749,0,13224
710,2019-11-16,3247,2506,2031,1,7785
710,2019-11-17,2677,3831,2196,0,8704
710,2019-11-18,5432,2539,3462,3,11436
710,2019-11-19,3343,5091,2677,0,11111
710,2019-11-20,2569,1412,2870,1,6852
710,2019-11-21,2851,5251,1996,1,10099
710,2019-11-22,2094,8343,1276,1,11714
710,2019-11-23,1645,6982,2618,4,11249
710,2019-11-24,2082,5369,1562,1,9014
710,2019-11-25,1454,6559,1797,1,9811
710,2019-11-26,1497,5822,1082,0,8401
710,2019-11-27,1770,6344,1174,1,9289
711,2019-08-14,5,75,29,0,109
711,2019-08-15,171,750,53,0,974
711,2019-08-16,202,417,263,0,882
711,2019-08-17,640,1707,765,0,3112
711,2019-08-18,274,2375,1339,0,3988
711,2019-08-19,1951,16066,1053,0,19070
711,2019-08-20,245,17759,1073,0,19077
711,2019-08-21,658,12322,1449,1,14430
711,2019-08-22,192,18781,2097,1,21071
711,2019-08-23,199,20816,1438,2,22455
711,2019-08-24,278,19619,1959,1,21857
711,2019-08-25,325,29757,1963,1,32046
711,2019-08-26,182,27992,1889,0,30063
711,2019-08-27,276,21057,2166,1,23500
711,2019-08-28,1521,11024,2520,1,15066
711,2019-08-29,551,10708,2393,3,13655
711,2019-08-30,690,3345,645,1,4681
711,2019-08-31,212,115,95,0,422
711,2019-09-01,197,220,272,0,689
711,2019-09-02,219,136,33,0,388
711,2019-09-03,115,1669,814,2,2600
711,2019-09-04,1106,12628,1710,0,15444
711,2019-09-05,509,8388,1508,0,10405
711,2019-09-06,196,10050,2082,0,12328
711,2019-09-07,428,7316,1641,0,9385
711,2019-09-08,538,8835,2711,0,12084
711,2019-09-09,246,7693,1468,2,9409
711,2019-09-10,271,7685,1991,0,9947
711,2019-09-11,289,6522,1268,3,8082
711,2019-09-12,1860,7446,1754,1,11061
711,2019-09-13,1317,5316,1755,3,8391
711,2019-09-14,1086,6634,2610,0,10330
711,2019-09-15,162,7830,1751,2,9745
711,2019-09-16,159,13647,1824,3,15633
711,2019-09-17,1101,10145,2193,0,13439
711,2019-09-18,152,20366,1252,2,21772
711,2019-09-19,402,4034,1711,0,6147
711,2019-09-20,229,7634,1788,0,9651
711,2019-09-21,156,6678,1800,1,8635
711,2019-09-22,1029,10327,1350,0,12706
711,2019-09-23,224,9211,1931,1,11367
711,2019-09-24,276,9160,1081,2,10519
711,2019-09-25,1068,9123,1432,3,11626
711,2019-09-26,424,10402,2199,0,13025
711,2019-09-27,246,8897,1884,2,11029
711,2019-09-28,1095,31257,1934,2,34288
711,2019-09-29,160,19697,1431,2,21290
711,2019-09-30,1023,16394,1145,0,18562
711,2019-10-01,404,17674,1698,3,19779
711,2019-10-02,1075,13250,2385,0,16710
711,2019-10-03,2097,15345,1045,0,18487
711,2019-10-04,924,13193,1830,1,15948
711,2019-10-05,1078,23315,2074,0,26467
711,2019-10-06,169,11856,667,2,12694
711,2019-10-07,2453,7382,1025,0,10860
711,2019-10-08,1318,13969,2216,4,17507
711,2019-10-09,159,15644,1763,1,17567
711,2019-10-10,275,11375,2277,0,13927
711,2019-10-11,657,11873,1418,1,13949
711,2019-10-12,137,7621,1900,1,9659
711,2019-10-13,346,10038,1868,4,12256
711,2019-10-14,132,6499,2813,0,9444
711,2019-10-15,415,9269,1132,0,10816
711,2019-10-16,775,13537,1703,0,16015
711,2019-10-17,154,5835,2309,1,8299
711,2019-10-18,217,9189,1542,2,10950
711,2019-10-19,154,5812,1962,0,7928
711,2019-10-20,157,31367,1464,0,32988
711,2019-10-21,1055,24504,927,0,26486
711,2019-10-22,157,11163,1550,1,12871
711,2019-10-23,1058,15197,1910,3,18168
711,2019-10-24,224,20074,1936,1,22235
711,2019-10-25,1054,11682,1691,1,14428
711,2019-10-26,625,14365,2699,0,17689
711,2019-10-27,174,16504,2024,1,18703
711,2019-10-28,144,23343,2550,1,26038
711,2019-10-29,206,18010,1579,1,19796
711,2019-10-30,159,16514,1206,0,17879
711,2019-10-31,1032,13069,1635,2,15738
711,2019-11-01,246,15221,1678,1,17146
711,2019-11-02,166,15118,1951,2,17237
711,2019-11-03,168,36773,1668,0,38609
711,2019-11-04,432,11151,1910,1,13494
711,2019-11-05,219,3361,3015,1,6596
711,2019-11-06,226,14589,1611,1,16427
711,2019-11-07,235,16439,1741,3,18418
711,2019-11-08,174,10253,1964,1,12392
711,2019-11-09,1096,9021,3422,0,13539
711,2019-11-10,196,16174,1912,0,18282
711,2019-11-11,211,9665,2349,2,12227
711,2019-11-12,225,10353,3154,1,13733
711,2019-11-13,919,19607,2311,1,22838
711,2019-11-14,191,11076,1137,1,12405
711,2019-11-15,171,4462,2156,0,6789
711,2019-11-16,176,2539,1651,0,4366
711,2019-11-17,260,4439,2902,0,7601
711,2019-11-18,834,2510,3429,0,6773
711,2019-11-19,245,3227,2849,0,6321
711,2019-11-20,1388,2021,1833,0,5242
711,2019-11-21,293,3633,1754,0,5680
711,2019-11-22,820,6046,1373,0,8239
711,2019-11-23,502,6316,2671,0,9489
711,2019-11-24,1281,7107,2063,0,10451
711,2019-11-25,145,10762,2072,0,12979
711,2019-11-26,869,6244,1552,0,8665
711,2019-11-27,249,11645,1775,3,13672
711,2019-11-28,92,8173,2,0,8267
711,2019-11-29,33,162,0,0,195
711,2019-08-14,5,75,29,0,109
711,2019-08-15,171,750,53,0,974
711,2019-08-16,202,417,263,0,882
711,2019-08-17,640,1707,765,0,3112
711,2019-08-18,274,2375,1339,0,3988
711,2019-08-19,1951,16066,1053,0,19070
711,2019-08-20,245,17759,1073,0,19077
711,2019-08-21,658,12322,1449,1,14430
711,2019-08-22,192,18781,2097,1,21071
711,2019-08-23,199,20816,1438,2,22455
711,2019-08-24,278,19619,1959,1,21857
711,2019-08-25,325,29757,1963,1,32046
711,2019-08-26,182,27992,1889,0,30063
711,2019-08-27,276,21057,2166,1,23500
711,2019-08-28,1521,11024,2520,1,15066
711,2019-08-29,551,10708,2393,3,13655
711,2019-08-30,690,3345,645,1,4681
711,2019-08-31,212,115,95,0,422
711,2019-09-01,197,220,272,0,689
711,2019-09-02,219,136,33,0,388
711,2019-09-03,115,1669,814,2,2600
711,2019-09-04,1106,12628,1710,0,15444
711,2019-09-05,509,8388,1508,0,10405
711,2019-09-06,196,10050,2082,0,12328
711,2019-09-07,428,7316,1641,0,9385
711,2019-09-08,538,8835,2711,0,12084
711,2019-09-09,246,7693,1468,2,9409
711,2019-09-10,271,7685,1991,0,9947
711,2019-09-11,289,6522,1268,3,8082
711,2019-09-12,1860,7446,1754,1,11061
711,2019-09-13,1317,5316,1755,3,8391
711,2019-09-14,1086,6634,2610,0,10330
711,2019-09-15,162,7830,1751,2,9745
711,2019-09-16,159,13647,1824,3,15633
711,2019-09-17,1101,10145,2193,0,13439
711,2019-09-18,152,20366,1252,2,21772
711,2019-09-19,402,4034,1711,0,6147
711,2019-09-20,229,7634,1788,0,9651
711,2019-09-21,156,6678,1800,1,8635
711,2019-09-22,1029,10327,1350,0,12706
711,2019-09-23,224,9211,1931,1,11367
711,2019-09-24,276,9160,1081,2,10519
711,2019-09-25,1068,9123,1432,3,11626
711,2019-09-26,424,10402,2199,0,13025
711,2019-09-27,246,8897,1884,2,11029
711,2019-09-28,1095,31257,1934,2,34288
711,2019-09-29,160,19697,1431,2,21290
711,2019-09-30,1023,16394,1145,0,18562
711,2019-10-01,404,17674,1698,3,19779
711,2019-10-02,1075,13250,2385,0,16710
711,2019-10-03,2097,15345,1045,0,18487
711,2019-10-04,924,13193,1830,1,15948
711,2019-10-05,1078,23315,2074,0,26467
711,2019-10-06,169,11856,667,2,12694
711,2019-10-07,2453,7382,1025,0,10860
711,2019-10-08,1318,13969,2216,4,17507
711,2019-10-09,159,15644,1763,1,17567
711,2019-10-10,275,11375,2277,0,13927
711,2019-10-11,657,11873,1418,1,13949
711,2019-10-12,137,7621,1900,1,9659
711,2019-10-13,346,10038,1868,4,12256
711,2019-10-14,132,6499,2813,0,9444
711,2019-10-15,415,9269,1132,0,10816
711,2019-10-16,775,13537,1703,0,16015
711,2019-10-17,154,5835,2309,1,8299
711,2019-10-18,217,9189,1542,2,10950
711,2019-10-19,154,5812,1962,0,7928
711,2019-10-20,157,31367,1464,0,32988
711,2019-10-21,1055,24504,927,0,26486
711,2019-10-22,157,11163,1550,1,12871
711,2019-10-23,1058,15197,1910,3,18168
711,2019-10-24,224,20074,1936,1,22235
711,2019-10-25,1054,11682,1691,1,14428
711,2019-10-26,625,14365,2699,0,17689
711,2019-10-27,174,16504,2024,1,18703
711,2019-10-28,144,23343,2550,1,26038
711,2019-10-29,206,18010,1579,1,19796
711,2019-10-30,159,16514,1206,0,17879
711,2019-10-31,1032,13069,1635,2,15738
711,2019-11-01,246,15221,1678,1,17146
711,2019-11-02,166,15118,1951,2,17237
711,2019-11-03,168,36773,1668,0,38609
711,2019-11-04,432,11151,1910,1,13494
711,2019-11-05,219,3361,3015,1,6596
711,2019-11-06,226,14589,1611,1,16427
711,2019-11-07,235,16439,1741,3,18418
711,2019-11-08,174,10253,1964,1,12392
711,2019-11-09,1096,9021,3422,0,13539
711,2019-11-10,196,16174,1912,0,18282
711,2019-11-11,211,9665,2349,2,12227
711,2019-11-12,225,10353,3154,1,13733
711,2019-11-13,919,19607,2311,1,22838
711,2019-11-14,191,11076,1137,1,12405
711,2019-11-15,171,4462,2156,0,6789
711,2019-11-16,176,2539,1651,0,4366
711,2019-11-17,260,4439,2902,0,7601
711,2019-11-18,834,2510,3429,0,6773
711,2019-11-19,245,3227,2849,0,6321
711,2019-11-20,1388,2021,1833,0,5242
711,2019-11-21,293,3633,1754,0,5680
711,2019-11-22,820,6046,1373,0,8239
711,2019-11-23,502,6316,2671,0,9489
711,2019-11-24,1281,7107,2063,0,10451
711,2019-11-25,145,10762,2072,0,12979
711,2019-11-26,869,6244,1552,0,8665
711,2019-11-27,249,11645,1775,3,13672
711,2019-11-28,92,8173,2,0,8267
711,2019-11-29,33,162,0,0,195
711,2019-08-14,5,75,29,0,109
711,2019-08-15,171,750,53,0,974
711,2019-08-16,202,417,263,0,882
711,2019-08-17,640,1707,765,0,3112
711,2019-08-18,274,2375,1339,0,3988
711,2019-08-19,1951,16066,1053,0,19070
711,2019-08-20,245,17759,1073,0,19077
711,2019-08-21,658,12322,1449,1,14430
711,2019-08-22,192,18781,2097,1,21071
711,2019-08-23,199,20816,1438,2,22455
711,2019-08-24,278,19619,1959,1,21857
711,2019-08-25,325,29757,1963,1,32046
711,2019-08-26,182,27992,1889,0,30063
711,2019-08-27,276,21057,2166,1,23500
711,2019-08-28,1521,11024,2520,1,15066
711,2019-08-29,551,10708,2393,3,13655
711,2019-08-30,690,3345,645,1,4681
711,2019-08-31,212,115,95,0,422
711,2019-09-01,197,220,272,0,689
711,2019-09-02,219,136,33,0,388
711,2019-09-03,115,1669,814,2,2600
711,2019-09-04,1106,12628,1710,0,15444
711,2019-09-05,509,8388,1508,0,10405
711,2019-09-06,196,10050,2082,0,12328
711,2019-09-07,428,7316,1641,0,9385
711,2019-09-08,538,8835,2711,0,12084
711,2019-09-09,246,7693,1468,2,9409
711,2019-09-10,271,7685,1991,0,9947
711,2019-09-11,289,6522,1268,3,8082
711,2019-09-12,1860,7446,1754,1,11061
711,2019-09-13,1317,5316,1755,3,8391
711,2019-09-14,1086,6634,2610,0,10330
711,2019-09-15,162,7830,1751,2,9745
711,2019-09-16,159,13647,1824,3,15633
711,2019-09-17,1101,10145,2193,0,13439
711,2019-09-18,152,20366,1252,2,21772
711,2019-09-19,402,4034,1711,0,6147
711,2019-09-20,229,7634,1788,0,9651
711,2019-09-21,156,6678,1800,1,8635
711,2019-09-22,1029,10327,1350,0,12706
711,2019-09-23,224,9211,1931,1,11367
711,2019-09-24,276,9160,1081,2,10519
711,2019-09-25,1068,9123,1432,3,11626
711,2019-09-26,424,10402,2199,0,13025
711,2019-09-27,246,8897,1884,2,11029
711,2019-09-28,1095,31257,1934,2,34288
711,2019-09-29,160,19697,1431,2,21290
711,2019-09-30,1023,16394,1145,0,18562
711,2019-10-01,404,17674,1698,3,19779
711,2019-10-02,1075,13250,2385,0,16710
711,2019-10-03,2097,15345,1045,0,18487
711,2019-10-04,924,13193,1830,1,15948
711,2019-10-05,1078,23315,2074,0,26467
711,2019-10-06,169,11856,667,2,12694
711,2019-10-07,2453,7382,1025,0,10860
711,2019-10-08,1318,13969,2216,4,17507
711,2019-10-09,159,15644,1763,1,17567
711,2019-10-10,275,11375,2277,0,13927
711,2019-10-11,657,11873,1418,1,13949
711,2019-10-12,137,7621,1900,1,9659
711,2019-10-13,346,10038,1868,4,12256
711,2019-10-14,132,6499,2813,0,9444
711,2019-10-15,415,9269,1132,0,10816
711,2019-10-16,775,13537,1703,0,16015
711,2019-10-17,154,5835,2309,1,8299
711,2019-10-18,217,9189,1542,2,10950
711,2019-10-19,154,5812,1962,0,7928
711,2019-10-20,157,31367,1464,0,32988
711,2019-10-21,1055,24504,927,0,26486
711,2019-10-22,157,11163,1550,1,12871
711,2019-10-23,1058,15197,1910,3,18168
711,2019-10-24,224,20074,1936,1,22235
711,2019-10-25,1054,11682,1691,1,14428
711,2019-10-26,625,14365,2699,0,17689
711,2019-10-27,174,16504,2024,1,18703
711,2019-10-28,144,23343,2550,1,26038
711,2019-10-29,206,18010,1579,1,19796
711,2019-10-30,159,16514,1206,0,17879
711,2019-10-31,1032,13069,1635,2,15738
711,2019-11-01,246,15221,1678,1,17146
711,2019-11-02,166,15118,1951,2,17237
711,2019-11-03,168,36773,1668,0,38609
711,2019-11-04,432,11151,1910,1,13494
711,2019-11-05,219,3361,3015,1,6596
711,2019-11-06,226,14589,1611,1,16427
711,2019-11-07,235,16439,1741,3,18418
711,2019-11-08,174,10253,1964,1,12392
711,2019-11-09,1096,9021,3422,0,13539
711,2019-11-10,196,16174,1912,0,18282
711,2019-11-11,211,9665,2349,2,12227
711,2019-11-12,225,10353,3154,1,13733
711,2019-11-13,919,19607,2311,1,22838
711,2019-11-14,191,11076,1137,1,12405
711,2019-11-15,171,4462,2156,0,6789
711,2019-11-16,176,2539,1651,0,4366
711,2019-11-17,260,4439,2902,0,7601
711,2019-11-18,834,2510,3429,0,6773
711,2019-11-19,245,3227,2849,0,6321
711,2019-11-20,1388,2021,1833,0,5242
711,2019-11-21,293,3633,1754,0,5680
711,2019-11-22,820,6046,1373,0,8239
711,2019-11-23,502,6316,2671,0,9489
711,2019-11-24,1281,7107,2063,0,10451
711,2019-11-25,145,10762,2072,0,12979
711,2019-11-26,869,6244,1552,0,8665
711,2019-11-27,249,11645,1775,3,13672
711,2019-11-28,92,8173,2,0,8267
711,2019-08-21,658,12322,1449,1,14430
711,2019-08-22,192,18781,2097,1,21071
711,2019-08-23,199,20816,1438,2,22455
711,2019-08-24,278,19619,1959,1,21857
711,2019-08-25,325,29757,1963,1,32046
711,2019-08-26,182,27992,1889,0,30063
711,2019-08-27,276,21057,2166,1,23500
711,2019-08-28,1521,11024,2520,1,15066
711,2019-08-29,551,10708,2393,3,13655
711,2019-08-30,690,3345,645,1,4681
711,2019-08-31,212,115,95,0,422
711,2019-09-01,197,220,272,0,689
711,2019-09-02,219,136,33,0,388
711,2019-09-03,115,1669,814,2,2600
711,2019-09-04,1106,12628,1710,0,15444
711,2019-09-05,509,8388,1508,0,10405
711,2019-09-06,196,10050,2082,0,12328
711,2019-09-07,428,7316,1641,0,9385
711,2019-09-08,538,8835,2711,0,12084
711,2019-09-09,246,7693,1468,2,9409
711,2019-09-10,271,7685,1991,0,9947
711,2019-09-11,289,6522,1268,3,8082
711,2019-09-12,1860,7446,1754,1,11061
711,2019-09-13,1317,5316,1755,3,8391
711,2019-09-14,1086,6634,2610,0,10330
711,2019-09-15,162,7830,1751,2,9745
711,2019-09-16,159,13647,1824,3,15633
711,2019-09-17,1101,10145,2193,0,13439
711,2019-09-18,152,20366,1252,2,21772
711,2019-09-19,402,4034,1711,0,6147
711,2019-09-20,229,7634,1788,0,9651
711,2019-09-21,156,6678,1800,1,8635
711,2019-09-22,1029,10327,1350,0,12706
711,2019-09-23,224,9211,1931,1,11367
711,2019-09-24,276,9160,1081,2,10519
711,2019-09-25,1068,9123,1432,3,11626
711,2019-09-26,424,10402,2199,0,13025
711,2019-09-27,246,8897,1884,2,11029
711,2019-09-28,1095,31257,1934,2,34288
711,2019-09-29,160,19697,1431,2,21290
711,2019-09-30,1023,16394,1145,0,18562
711,2019-10-01,404,17674,1698,3,19779
711,2019-10-02,1075,13250,2385,0,16710
711,2019-10-03,2097,15345,1045,0,18487
711,2019-10-04,924,13193,1830,1,15948
711,2019-10-05,1078,23315,2074,0,26467
711,2019-10-06,169,11856,667,2,12694
711,2019-10-07,2453,7382,1025,0,10860
711,2019-10-08,1318,13969,2216,4,17507
711,2019-10-09,159,15644,1763,1,17567
711,2019-10-10,275,11375,2277,0,13927
711,2019-10-11,657,11873,1418,1,13949
711,2019-10-12,137,7621,1900,1,9659
711,2019-10-13,346,10038,1868,4,12256
711,2019-10-14,132,6499,2813,0,9444
711,2019-10-15,415,9269,1132,0,10816
711,2019-10-16,775,13537,1703,0,16015
711,2019-10-17,154,5835,2309,1,8299
711,2019-10-18,217,9189,1542,2,10950
711,2019-10-19,154,5812,1962,0,7928
711,2019-10-20,157,31367,1464,0,32988
711,2019-10-21,1055,24504,927,0,26486
711,2019-10-22,157,11163,1550,1,12871
711,2019-10-23,1058,15197,1910,3,18168
711,2019-10-24,224,20074,1936,1,22235
711,2019-10-25,1054,11682,1691,1,14428
711,2019-10-26,625,14365,2699,0,17689
711,2019-10-27,174,16504,2024,1,18703
711,2019-10-28,144,23343,2550,1,26038
711,2019-10-29,206,18010,1579,1,19796
711,2019-10-30,159,16514,1206,0,17879
711,2019-10-31,1032,13069,1635,2,15738
711,2019-11-01,246,15221,1678,1,17146
711,2019-11-02,166,15118,1951,2,17237
711,2019-11-03,168,36773,1668,0,38609
711,2019-11-04,432,11151,1910,1,13494
711,2019-11-05,219,3361,3015,1,6596
711,2019-11-06,226,14589,1611,1,16427
711,2019-11-07,235,16439,1741,3,18418
711,2019-11-08,174,10253,1964,1,12392
711,2019-11-09,1096,9021,3422,0,13539
711,2019-11-10,196,16174,1912,0,18282
711,2019-11-11,211,9665,2349,2,12227
711,2019-11-12,225,10353,3154,1,13733
711,2019-11-13,919,19607,2311,1,22838
711,2019-11-14,191,11076,1137,1,12405
711,2019-11-15,171,4462,2156,0,6789
711,2019-11-16,176,2539,1651,0,4366
711,2019-11-17,260,4439,2902,0,7601
711,2019-11-18,834,2510,3429,0,6773
711,2019-11-19,245,3227,2849,0,6321
711,2019-11-20,1388,2021,1833,0,5242
711,2019-11-21,293,3633,1754,0,5680
711,2019-11-22,820,6046,1373,0,8239
711,2019-11-23,502,6316,2671,0,9489
711,2019-11-24,1281,7107,2063,0,10451
711,2019-11-25,145,10762,2072,0,12979
711,2019-11-26,869,6244,1552,0,8665
711,2019-11-27,249,11645,1775,3,13672
712,2019-08-14,7,2,135,0,144
712,2019-08-15,311,352,120,0,783
712,2019-08-16,472,241,155,0,868
712,2019-08-17,524,1622,479,1,2626
712,2019-08-18,736,933,1594,2,3265
712,2019-08-19,437,1716,1066,0,3219
712,2019-08-20,860,3042,1028,0,4930
712,2019-08-21,1377,1157,1157,1,3692
712,2019-08-22,877,5419,1756,3,8055
712,2019-08-23,994,1523,1380,0,3897
712,2019-08-24,780,11985,1460,1,14226
712,2019-08-25,1019,18831,1740,1,21591
712,2019-08-26,663,25900,1980,1,28544
712,2019-08-27,668,15902,1579,1,18150
712,2019-08-28,598,15906,1818,0,18322
712,2019-08-29,726,12611,1713,0,15050
712,2019-08-30,619,3394,451,1,4465
712,2019-08-31,162,34,0,0,196
712,2019-09-01,1036,1319,90,0,2445
712,2019-09-02,133,77,14,0,224
712,2019-09-03,262,573,1172,2,2009
712,2019-09-04,1353,10084,2203,0,13640
712,2019-09-05,1275,10284,1971,3,13533
712,2019-09-06,1332,15182,2842,0,19356
712,2019-09-07,456,11747,2428,1,14632
712,2019-09-08,1450,11035,1761,1,14247
712,2019-09-09,1437,7178,1497,0,10112
712,2019-09-10,452,7408,904,0,8764
712,2019-09-11,477,9084,1740,1,11302
712,2019-09-12,423,7815,2370,2,10610
712,2019-09-13,1538,7870,2005,0,11413
712,2019-09-14,1442,11074,3012,0,15528
712,2019-09-15,579,10460,2278,3,13320
712,2019-09-16,1428,9050,1577,1,12056
712,2019-09-17,942,13723,1948,1,16614
712,2019-09-18,969,20265,1602,0,22836
712,2019-09-19,595,4817,2135,0,7547
712,2019-09-20,1506,15213,2344,2,19065
712,2019-09-21,410,9951,2081,0,12442
712,2019-09-22,1409,14758,1617,1,17785
712,2019-09-23,545,11006,2174,3,13728
712,2019-09-24,503,8900,1000,1,10404
712,2019-09-25,375,10340,2202,4,12921
712,2019-09-26,224,15599,1770,0,17593
712,2019-09-27,1089,12223,961,1,14274
712,2019-09-28,184,24247,1947,2,26380
712,2019-09-29,301,19183,1234,1,20719
712,2019-09-30,211,18241,1887,4,20343
712,2019-10-01,1017,16650,2324,1,19992
712,2019-10-02,240,12912,1207,0,14359
712,2019-10-03,1118,14326,1935,0,17379
712,2019-10-04,175,13563,1092,1,14831
712,2019-10-05,452,21161,1632,1,23246
712,2019-10-06,215,17638,1669,1,19523
712,2019-10-07,219,7644,2204,0,10067
712,2019-10-08,172,19441,709,0,20322
712,2019-10-09,1852,25209,1505,5,28571
712,2019-10-10,320,12818,1686,3,14827
712,2019-10-11,1539,18514,1638,0,21691
712,2019-10-12,294,10776,1366,2,12438
712,2019-10-13,1330,12315,2222,1,15868
712,2019-10-14,244,6248,2304,0,8796
712,2019-10-15,1539,14507,1470,2,17518
712,2019-10-16,268,24357,965,0,25590
712,2019-10-17,1190,8489,1770,0,11449
712,2019-10-18,433,8979,1920,0,11332
712,2019-10-19,2137,5613,1752,0,9502
712,2019-10-20,615,3026,1962,2,5605
712,2019-10-21,327,19464,1796,0,21587
712,2019-10-22,838,10908,1656,2,13404
712,2019-10-23,295,14586,1673,1,16555
712,2019-10-24,1949,25780,1821,1,29551
712,2019-10-25,1210,14788,1442,2,17442
712,2019-10-26,276,13905,1411,0,15592
712,2019-10-27,322,16856,1611,0,18789
712,2019-10-28,1355,14353,1865,0,17573
712,2019-10-29,977,15677,752,3,17409
712,2019-10-30,342,16323,1678,3,18346
712,2019-10-31,856,12891,1453,0,15200
712,2019-11-01,328,14406,965,1,15700
712,2019-11-02,288,23763,1157,0,25208
712,2019-11-03,270,38258,725,1,39254
712,2019-11-04,312,11192,1595,30,13129
712,2019-11-05,332,3235,1464,0,5031
712,2019-11-06,376,15023,1623,0,17022
712,2019-11-07,419,16918,691,0,18028
712,2019-11-08,1216,10245,1235,0,12696
712,2019-11-09,894,9019,1588,0,11501
712,2019-11-10,298,26677,1389,0,28364
712,2019-11-11,1121,16869,1438,0,19428
712,2019-11-12,358,18745,2633,0,21736
712,2019-11-13,712,14299,1930,0,16941
712,2019-11-14,321,8612,1928,0,10861
712,2019-11-15,287,4428,1289,0,6004
712,2019-11-16,436,2992,2817,0,6245
712,2019-11-17,462,3656,3312,0,7430
712,2019-11-18,337,2469,3611,0,6417
712,2019-11-19,361,3166,3000,0,6527
712,2019-11-20,315,1553,1768,0,3636
712,2019-11-21,340,3399,1711,0,5450
712,2019-11-22,318,5383,2128,0,7829
712,2019-11-23,299,6017,2171,0,8487
712,2019-11-24,265,7952,2212,0,10429
712,2019-11-25,291,10819,2799,0,13909
712,2019-11-26,280,8564,1761,0,10605
712,2019-11-27,225,6639,1140,0,8004
712,2019-08-14,7,2,135,0,144
712,2019-08-15,311,352,120,0,783
712,2019-08-16,472,241,155,0,868
712,2019-08-17,524,1622,479,1,2626
712,2019-08-18,736,933,1594,2,3265
712,2019-08-19,437,1716,1066,0,3219
712,2019-08-20,860,3042,1028,0,4930
712,2019-08-21,1377,1157,1157,1,3692
712,2019-08-22,877,5419,1756,3,8055
712,2019-08-23,994,1523,1380,0,3897
712,2019-08-24,780,11985,1460,1,14226
712,2019-08-25,1019,18831,1740,1,21591
712,2019-08-26,663,25900,1980,1,28544
712,2019-08-27,668,15902,1579,1,18150
712,2019-08-28,598,15906,1818,0,18322
712,2019-08-29,726,12611,1713,0,15050
712,2019-08-30,619,3394,451,1,4465
712,2019-08-31,162,34,0,0,196
712,2019-09-01,1036,1319,90,0,2445
712,2019-09-02,133,77,14,0,224
712,2019-09-03,262,573,1172,2,2009
712,2019-09-04,1353,10084,2203,0,13640
712,2019-09-05,1275,10284,1971,3,13533
712,2019-09-06,1332,15182,2842,0,19356
712,2019-09-07,456,11747,2428,1,14632
712,2019-09-08,1450,11035,1761,1,14247
712,2019-09-09,1437,7178,1497,0,10112
712,2019-09-10,452,7408,904,0,8764
712,2019-09-11,477,9084,1740,1,11302
712,2019-09-12,423,7815,2370,2,10610
712,2019-09-13,1538,7870,2005,0,11413
712,2019-09-14,1442,11074,3012,0,15528
712,2019-09-15,579,10460,2278,3,13320
712,2019-09-16,1428,9050,1577,1,12056
712,2019-09-17,942,13723,1948,1,16614
712,2019-09-18,969,20265,1602,0,22836
712,2019-09-19,595,4817,2135,0,7547
712,2019-09-20,1506,15213,2344,2,19065
712,2019-09-21,410,9951,2081,0,12442
712,2019-09-22,1409,14758,1617,1,17785
712,2019-09-23,545,11006,2174,3,13728
712,2019-09-24,503,8900,1000,1,10404
712,2019-09-25,375,10340,2202,4,12921
712,2019-09-26,224,15599,1770,0,17593
712,2019-09-27,1089,12223,961,1,14274
712,2019-09-28,184,24247,1947,2,26380
712,2019-09-29,301,19183,1234,1,20719
712,2019-09-30,211,18241,1887,4,20343
712,2019-10-01,1017,16650,2324,1,19992
712,2019-10-02,240,12912,1207,0,14359
712,2019-10-03,1118,14326,1935,0,17379
712,2019-10-04,175,13563,1092,1,14831
712,2019-10-05,452,21161,1632,1,23246
712,2019-10-06,215,17638,1669,1,19523
712,2019-10-07,219,7644,2204,0,10067
712,2019-10-08,172,19441,709,0,20322
712,2019-10-09,1852,25209,1505,5,28571
712,2019-10-10,320,12818,1686,3,14827
712,2019-10-11,1539,18514,1638,0,21691
712,2019-10-12,294,10776,1366,2,12438
712,2019-10-13,1330,12315,2222,1,15868
712,2019-10-14,244,6248,2304,0,8796
712,2019-10-15,1539,14507,1470,2,17518
712,2019-10-16,268,24357,965,0,25590
712,2019-10-17,1190,8489,1770,0,11449
712,2019-10-18,433,8979,1920,0,11332
712,2019-10-19,2137,5613,1752,0,9502
712,2019-10-20,615,3026,1962,2,5605
712,2019-10-21,327,19464,1796,0,21587
712,2019-10-22,838,10908,1656,2,13404
712,2019-10-23,295,14586,1673,1,16555
712,2019-10-24,1949,25780,1821,1,29551
712,2019-10-25,1210,14788,1442,2,17442
712,2019-10-26,276,13905,1411,0,15592
712,2019-10-27,322,16856,1611,0,18789
712,2019-10-28,1355,14353,1865,0,17573
712,2019-10-29,977,15677,752,3,17409
712,2019-10-30,342,16323,1678,3,18346
712,2019-10-31,856,12891,1453,0,15200
712,2019-11-01,328,14406,965,1,15700
712,2019-11-02,288,23763,1157,0,25208
712,2019-11-03,270,38258,725,1,39254
712,2019-11-04,312,11192,1595,30,13129
712,2019-11-05,332,3235,1464,0,5031
712,2019-11-06,376,15023,1623,0,17022
712,2019-11-07,419,16918,691,0,18028
712,2019-11-08,1216,10245,1235,0,12696
712,2019-11-09,894,9019,1588,0,11501
712,2019-11-10,298,26677,1389,0,28364
712,2019-11-11,1121,16869,1438,0,19428
712,2019-11-12,358,18745,2633,0,21736
712,2019-11-13,712,14299,1930,0,16941
712,2019-11-14,321,8612,1928,0,10861
712,2019-11-15,287,4428,1289,0,6004
712,2019-11-16,436,2992,2817,0,6245
712,2019-11-17,462,3656,3312,0,7430
712,2019-11-18,337,2469,3611,0,6417
712,2019-11-19,361,3166,3000,0,6527
712,2019-11-20,315,1553,1768,0,3636
712,2019-11-21,340,3399,1711,0,5450
712,2019-11-22,318,5383,2128,0,7829
712,2019-11-23,299,6017,2171,0,8487
712,2019-11-24,265,7952,2212,0,10429
712,2019-11-25,291,10819,2799,0,13909
712,2019-11-26,280,8564,1761,0,10605
712,2019-11-27,225,6639,1140,0,8004
712,2019-11-28,0,8055,0,0,8055
712,2019-11-29,0,679,0,0,679
712,2019-08-14,7,2,135,0,144
712,2019-08-15,311,352,120,0,783
712,2019-08-16,472,241,155,0,868
712,2019-08-17,524,1622,479,1,2626
712,2019-08-18,736,933,1594,2,3265
712,2019-08-19,437,1716,1066,0,3219
712,2019-08-20,860,3042,1028,0,4930
712,2019-08-21,1377,1157,1157,1,3692
712,2019-08-22,877,5419,1756,3,8055
712,2019-08-23,994,1523,1380,0,3897
712,2019-08-24,780,11985,1460,1,14226
712,2019-08-25,1019,18831,1740,1,21591
712,2019-08-26,663,25900,1980,1,28544
712,2019-08-27,668,15902,1579,1,18150
712,2019-08-28,598,15906,1818,0,18322
712,2019-08-29,726,12611,1713,0,15050
712,2019-08-30,619,3394,451,1,4465
712,2019-08-31,162,34,0,0,196
712,2019-09-01,1036,1319,90,0,2445
712,2019-09-02,133,77,14,0,224
712,2019-09-03,262,573,1172,2,2009
712,2019-09-04,1353,10084,2203,0,13640
712,2019-09-05,1275,10284,1971,3,13533
712,2019-09-06,1332,15182,2842,0,19356
712,2019-09-07,456,11747,2428,1,14632
712,2019-09-08,1450,11035,1761,1,14247
712,2019-09-09,1437,7178,1497,0,10112
712,2019-09-10,452,7408,904,0,8764
712,2019-09-11,477,9084,1740,1,11302
712,2019-09-12,423,7815,2370,2,10610
712,2019-09-13,1538,7870,2005,0,11413
712,2019-09-14,1442,11074,3012,0,15528
712,2019-09-15,579,10460,2278,3,13320
712,2019-09-16,1428,9050,1577,1,12056
712,2019-09-17,942,13723,1948,1,16614
712,2019-09-18,969,20265,1602,0,22836
712,2019-09-19,595,4817,2135,0,7547
712,2019-09-20,1506,15213,2344,2,19065
712,2019-09-21,410,9951,2081,0,12442
712,2019-09-22,1409,14758,1617,1,17785
712,2019-09-23,545,11006,2174,3,13728
712,2019-09-24,503,8900,1000,1,10404
712,2019-09-25,375,10340,2202,4,12921
712,2019-09-26,224,15599,1770,0,17593
712,2019-09-27,1089,12223,961,1,14274
712,2019-09-28,184,24247,1947,2,26380
712,2019-09-29,301,19183,1234,1,20719
712,2019-09-30,211,18241,1887,4,20343
712,2019-10-01,1017,16650,2324,1,19992
712,2019-10-02,240,12912,1207,0,14359
712,2019-10-03,1118,14326,1935,0,17379
712,2019-10-04,175,13563,1092,1,14831
712,2019-10-05,452,21161,1632,1,23246
712,2019-10-06,215,17638,1669,1,19523
712,2019-10-07,219,7644,2204,0,10067
712,2019-10-08,172,19441,709,0,20322
712,2019-10-09,1852,25209,1505,5,28571
712,2019-10-10,320,12818,1686,3,14827
712,2019-10-11,1539,18514,1638,0,21691
712,2019-10-12,294,10776,1366,2,12438
712,2019-10-13,1330,12315,2222,1,15868
712,2019-10-14,244,6248,2304,0,8796
712,2019-10-15,1539,14507,1470,2,17518
712,2019-10-16,268,24357,965,0,25590
712,2019-10-17,1190,8489,1770,0,11449
712,2019-10-18,433,8979,1920,0,11332
712,2019-10-19,2137,5613,1752,0,9502
712,2019-10-20,615,3026,1962,2,5605
712,2019-10-21,327,19464,1796,0,21587
712,2019-10-22,838,10908,1656,2,13404
712,2019-10-23,295,14586,1673,1,16555
712,2019-10-24,1949,25780,1821,1,29551
712,2019-10-25,1210,14788,1442,2,17442
712,2019-10-26,276,13905,1411,0,15592
712,2019-10-27,322,16856,1611,0,18789
712,2019-10-28,1355,14353,1865,0,17573
712,2019-10-29,977,15677,752,3,17409
712,2019-10-30,342,16323,1678,3,18346
712,2019-10-31,856,12891,1453,0,15200
712,2019-11-01,328,14406,965,1,15700
712,2019-11-02,288,23763,1157,0,25208
712,2019-11-03,270,38258,725,1,39254
712,2019-11-04,312,11192,1595,30,13129
712,2019-11-05,332,3235,1464,0,5031
712,2019-11-06,376,15023,1623,0,17022
712,2019-11-07,419,16918,691,0,18028
712,2019-11-08,1216,10245,1235,0,12696
712,2019-11-09,894,9019,1588,0,11501
712,2019-11-10,298,26677,1389,0,28364
712,2019-11-11,1121,16869,1438,0,19428
712,2019-11-12,358,18745,2633,0,21736
712,2019-11-13,712,14299,1930,0,16941
712,2019-11-14,321,8612,1928,0,10861
712,2019-11-15,287,4428,1289,0,6004
712,2019-11-16,436,2992,2817,0,6245
712,2019-11-17,462,3656,3312,0,7430
712,2019-11-18,337,2469,3611,0,6417
712,2019-11-19,361,3166,3000,0,6527
712,2019-11-20,315,1553,1768,0,3636
712,2019-11-21,340,3399,1711,0,5450
712,2019-11-22,318,5383,2128,0,7829
712,2019-11-23,299,6017,2171,0,8487
712,2019-11-24,265,7952,2212,0,10429
712,2019-11-25,291,10819,2799,0,13909
712,2019-11-26,280,8564,1761,0,10605
712,2019-11-27,225,6639,1140,0,8004
712,2019-08-17,524,1622,479,1,2626
712,2019-08-18,736,933,1594,2,3265
712,2019-08-19,437,1716,1066,0,3219
712,2019-08-20,860,3042,1028,0,4930
712,2019-08-21,1377,1157,1157,1,3692
712,2019-08-22,877,5419,1756,3,8055
712,2019-08-23,994,1523,1380,0,3897
712,2019-08-24,780,11985,1460,1,14226
712,2019-08-25,1019,18831,1740,1,21591
712,2019-08-26,663,25900,1980,1,28544
712,2019-08-27,668,15902,1579,1,18150
712,2019-08-28,598,15906,1818,0,18322
712,2019-08-29,726,12611,1713,0,15050
712,2019-08-30,619,3394,451,1,4465
712,2019-08-31,162,34,0,0,196
712,2019-09-01,1036,1319,90,0,2445
712,2019-09-02,133,77,14,0,224
712,2019-09-03,262,573,1172,2,2009
712,2019-09-04,1353,10084,2203,0,13640
712,2019-09-05,1275,10284,1971,3,13533
712,2019-09-06,1332,15182,2842,0,19356
712,2019-09-07,456,11747,2428,1,14632
712,2019-09-08,1450,11035,1761,1,14247
712,2019-09-09,1437,7178,1497,0,10112
712,2019-09-10,452,7408,904,0,8764
712,2019-09-11,477,9084,1740,1,11302
712,2019-09-12,423,7815,2370,2,10610
712,2019-09-13,1538,7870,2005,0,11413
712,2019-09-14,1442,11074,3012,0,15528
712,2019-09-15,579,10460,2278,3,13320
712,2019-09-16,1428,9050,1577,1,12056
712,2019-09-17,942,13723,1948,1,16614
712,2019-09-18,969,20265,1602,0,22836
712,2019-09-19,595,4817,2135,0,7547
712,2019-09-20,1506,15213,2344,2,19065
712,2019-09-21,410,9951,2081,0,12442
712,2019-09-22,1409,14758,1617,1,17785
712,2019-09-23,545,11006,2174,3,13728
712,2019-09-24,503,8900,1000,1,10404
712,2019-09-25,375,10340,2202,4,12921
712,2019-09-26,224,15599,1770,0,17593
712,2019-09-27,1089,12223,961,1,14274
712,2019-09-28,184,24247,1947,2,26380
712,2019-09-29,301,19183,1234,1,20719
712,2019-09-30,211,18241,1887,4,20343
712,2019-10-01,1017,16650,2324,1,19992
712,2019-10-02,240,12912,1207,0,14359
712,2019-10-03,1118,14326,1935,0,17379
712,2019-10-04,175,13563,1092,1,14831
712,2019-10-05,452,21161,1632,1,23246
712,2019-10-06,215,17638,1669,1,19523
712,2019-10-07,219,7644,2204,0,10067
712,2019-10-08,172,19441,709,0,20322
712,2019-10-09,1852,25209,1505,5,28571
712,2019-10-10,320,12818,1686,3,14827
712,2019-10-11,1539,18514,1638,0,21691
712,2019-10-12,294,10776,1366,2,12438
712,2019-10-13,1330,12315,2222,1,15868
712,2019-10-14,244,6248,2304,0,8796
712,2019-10-15,1539,14507,1470,2,17518
712,2019-10-16,268,24357,965,0,25590
712,2019-10-17,1190,8489,1770,0,11449
712,2019-10-18,433,8979,1920,0,11332
712,2019-10-19,2137,5613,1752,0,9502
712,2019-10-20,615,3026,1962,2,5605
712,2019-10-21,327,19464,1796,0,21587
712,2019-10-22,838,10908,1656,2,13404
712,2019-10-23,295,14586,1673,1,16555
712,2019-10-24,1949,25780,1821,1,29551
712,2019-10-25,1210,14788,1442,2,17442
712,2019-10-26,276,13905,1411,0,15592
712,2019-10-27,322,16856,1611,0,18789
712,2019-10-28,1355,14353,1865,0,17573
712,2019-10-29,977,15677,752,3,17409
712,2019-10-30,342,16323,1678,3,18346
712,2019-10-31,856,12891,1453,0,15200
712,2019-11-01,328,14406,965,1,15700
712,2019-11-02,288,23763,1157,0,25208
712,2019-11-03,270,38258,725,1,39254
712,2019-11-04,312,11192,1595,30,13129
713,2019-08-15,70,367,25,0,462
713,2019-08-16,196,351,95,0,642
713,2019-08-17,261,1653,513,1,2428
713,2019-08-18,279,2454,798,2,3533
713,2019-08-19,954,16280,949,1,18184
713,2019-08-20,290,17079,821,1,18191
713,2019-08-21,924,12053,1188,0,14165
713,2019-08-22,528,20734,730,0,21992
713,2019-08-23,493,20713,1351,3,22560
713,2019-08-24,1160,15413,1236,0,17809
713,2019-08-25,196,41274,1067,2,42539
713,2019-08-26,152,30391,2287,2,32832
713,2019-08-27,1312,13590,2021,1,16924
713,2019-08-28,1451,5018,2250,1,8720
713,2019-08-29,340,10179,2259,0,12778
713,2019-08-30,196,3196,461,0,3853
713,2019-08-31,68,248,1,0,317
713,2019-09-01,263,1433,94,1,1791
713,2019-09-02,71,239,12,0,322
713,2019-09-03,987,990,918,2,2897
713,2019-09-04,335,11547,1963,1,13846
713,2019-09-05,157,15398,2116,0,17671
713,2019-09-06,251,15310,1379,1,16941
713,2019-09-07,309,13555,1671,0,15535
713,2019-09-08,1156,7413,1563,2,10134
713,2019-09-09,624,8727,2261,3,11615
713,2019-09-10,1387,13491,2194,0,17072
713,2019-09-11,663,6681,2006,3,9353
713,2019-09-12,500,11092,2204,2,13798
713,2019-09-13,283,8356,1926,2,10567
713,2019-09-14,264,8568,2127,0,10959
713,2019-09-15,211,9412,2241,2,11866
713,2019-09-16,182,13746,1829,4,15761
713,2019-09-17,181,8010,1922,8,10121
713,2019-09-18,251,11764,1801,10,13826
713,2019-09-19,360,11708,2022,8,14098
713,2019-09-20,335,28674,1744,8,30761
713,2019-09-21,542,6769,1583,9,8903
713,2019-09-22,552,14685,1908,11,17156
713,2019-09-23,1148,11643,3328,12,16131
713,2019-09-24,1014,8790,2047,12,11863
713,2019-09-25,252,9707,2432,11,12402
713,2019-09-26,1229,10086,1558,10,12883
713,2019-09-27,407,11126,1869,3,13405
713,2019-09-28,415,15350,1133,2,16900
713,2019-09-29,455,17337,1779,0,19571
713,2019-09-30,437,18416,1358,0,20211
713,2019-10-01,959,17045,1289,0,19293
713,2019-10-02,429,12937,1204,8,14578
713,2019-10-03,279,15201,1264,9,16753
713,2019-10-04,1695,13093,1775,11,16574
713,2019-10-05,1441,22109,1632,10,25192
713,2019-10-06,1104,17302,1652,10,20068
713,2019-10-07,1081,8600,1971,12,11664
713,2019-10-08,325,13172,2213,10,15720
713,2019-10-09,258,15078,1602,10,16948
713,2019-10-10,1144,11589,1677,4715,19125
713,2019-10-11,1158,14610,1677,11,17456
713,2019-10-12,200,8378,1174,5,9757
713,2019-10-13,1068,8863,1507,1,11439
713,2019-10-14,392,6584,2370,0,9346
713,2019-10-15,469,8835,1729,1,11034
713,2019-10-16,114,18826,1582,2,20524
713,2019-10-17,1904,8619,1755,5,12283
713,2019-10-18,267,9463,2046,2,11778
713,2019-10-19,239,5908,2319,0,8466
713,2019-10-20,922,3638,1930,1,6491
713,2019-10-21,658,11823,1543,2,14026
713,2019-10-22,1040,7504,1464,3,10011
713,2019-10-23,165,14609,891,0,15665
713,2019-10-24,176,19195,1011,0,20382
713,2019-10-25,1019,11180,1557,3,13759
713,2019-10-26,266,14098,1377,0,15741
713,2019-10-27,496,16707,1714,1,18918
713,2019-10-28,383,14231,1428,1,16043
713,2019-10-29,713,27617,1398,1,29729
713,2019-10-30,619,33681,1484,0,35784
713,2019-10-31,928,15001,1589,2,17520
713,2019-11-01,741,15249,1243,2,17235
713,2019-11-02,147,15347,2399,0,17893
713,2019-11-03,1089,22850,854,0,24793
713,2019-11-04,196,10843,2193,1,13233
713,2019-11-05,1151,3519,1731,1,6402
713,2019-11-06,591,8380,1175,4,10150
713,2019-11-07,679,14038,1189,2,15908
713,2019-11-08,147,15750,920,0,16817
713,2019-11-09,1126,16184,1814,0,19124
713,2019-11-10,1204,15367,643,0,17214
713,2019-11-11,473,10230,1206,4,11913
713,2019-11-12,1876,11256,2416,1,15549
713,2019-11-13,1145,20427,1687,0,23259
713,2019-11-14,163,10803,2154,0,13120
713,2019-11-15,285,3882,2679,1,6847
713,2019-11-16,156,2572,3912,2,6642
713,2019-11-17,362,3527,3479,0,7368
713,2019-11-18,250,3796,2791,1,6838
713,2019-11-19,205,3378,2829,0,6412
713,2019-11-20,539,1923,2106,1,4569
713,2019-11-21,146,5846,1672,2,7666
713,2019-11-22,147,9509,1391,1,11048
713,2019-11-23,154,12073,2610,2,14839
713,2019-11-24,251,9138,2281,3,11673
713,2019-11-25,219,11872,2346,1,14438
713,2019-11-26,171,8869,1487,3,10530
713,2019-11-27,112,10570,1864,0,12546
713,2019-11-28,516,13599,715,0,14830
713,2019-11-29,40,228,3,0,271
713,2019-08-15,70,367,25,0,462
713,2019-08-16,196,351,95,0,642
713,2019-08-17,261,1653,513,1,2428
713,2019-08-18,279,2454,798,2,3533
713,2019-08-19,954,16280,949,1,18184
713,2019-08-20,290,17079,821,1,18191
713,2019-08-21,924,12053,1188,0,14165
713,2019-08-22,528,20734,730,0,21992
713,2019-08-23,493,20713,1351,3,22560
713,2019-08-24,1160,15413,1236,0,17809
713,2019-08-25,196,41274,1067,2,42539
713,2019-08-26,152,30391,2287,2,32832
713,2019-08-27,1312,13590,2021,1,16924
713,2019-08-28,1451,5018,2250,1,8720
713,2019-08-29,340,10179,2259,0,12778
713,2019-08-30,196,3196,461,0,3853
713,2019-08-31,68,248,1,0,317
713,2019-09-01,263,1433,94,1,1791
713,2019-09-02,71,239,12,0,322
713,2019-09-03,987,990,918,2,2897
713,2019-09-04,335,11547,1963,1,13846
713,2019-09-05,157,15398,2116,0,17671
713,2019-09-06,251,15310,1379,1,16941
713,2019-09-07,309,13555,1671,0,15535
713,2019-09-08,1156,7413,1563,2,10134
713,2019-09-09,624,8727,2261,3,11615
713,2019-09-10,1387,13491,2194,0,17072
713,2019-09-11,663,6681,2006,3,9353
713,2019-09-12,500,11092,2204,2,13798
713,2019-09-13,283,8356,1926,2,10567
713,2019-09-14,264,8568,2127,0,10959
713,2019-09-15,211,9412,2241,2,11866
713,2019-09-16,182,13746,1829,4,15761
713,2019-09-17,181,8010,1922,8,10121
713,2019-09-18,251,11764,1801,10,13826
713,2019-09-19,360,11708,2022,8,14098
713,2019-09-20,335,28674,1744,8,30761
713,2019-09-21,542,6769,1583,9,8903
713,2019-09-22,552,14685,1908,11,17156
713,2019-09-23,1148,11643,3328,12,16131
713,2019-09-24,1014,8790,2047,12,11863
713,2019-09-25,252,9707,2432,11,12402
713,2019-09-26,1229,10086,1558,10,12883
713,2019-09-27,407,11126,1869,3,13405
713,2019-09-28,415,15350,1133,2,16900
713,2019-09-29,455,17337,1779,0,19571
713,2019-09-30,437,18416,1358,0,20211
713,2019-10-01,959,17045,1289,0,19293
713,2019-10-02,429,12937,1204,8,14578
713,2019-10-03,279,15201,1264,9,16753
713,2019-10-04,1695,13093,1775,11,16574
713,2019-10-05,1441,22109,1632,10,25192
713,2019-10-06,1104,17302,1652,10,20068
713,2019-10-07,1081,8600,1971,12,11664
713,2019-10-08,325,13172,2213,10,15720
713,2019-10-09,258,15078,1602,10,16948
713,2019-10-10,1144,11589,1677,4715,19125
713,2019-10-11,1158,14610,1677,11,17456
713,2019-10-12,200,8378,1174,5,9757
713,2019-10-13,1068,8863,1507,1,11439
713,2019-10-14,392,6584,2370,0,9346
713,2019-10-15,469,8835,1729,1,11034
713,2019-10-16,114,18826,1582,2,20524
713,2019-10-17,1904,8619,1755,5,12283
713,2019-10-18,267,9463,2046,2,11778
713,2019-10-19,239,5908,2319,0,8466
713,2019-10-20,922,3638,1930,1,6491
713,2019-10-21,658,11823,1543,2,14026
713,2019-10-22,1040,7504,1464,3,10011
713,2019-10-23,165,14609,891,0,15665
713,2019-10-24,176,19195,1011,0,20382
713,2019-10-25,1019,11180,1557,3,13759
713,2019-10-26,266,14098,1377,0,15741
713,2019-10-27,496,16707,1714,1,18918
713,2019-10-28,383,14231,1428,1,16043
713,2019-10-29,713,27617,1398,1,29729
713,2019-10-30,619,33681,1484,0,35784
713,2019-10-31,928,15001,1589,2,17520
713,2019-11-01,741,15249,1243,2,17235
713,2019-11-02,147,15347,2399,0,17893
713,2019-11-03,1089,22850,854,0,24793
713,2019-11-04,196,10843,2193,1,13233
713,2019-11-05,1151,3519,1731,1,6402
713,2019-11-06,591,8380,1175,4,10150
713,2019-11-07,679,14038,1189,2,15908
713,2019-11-08,147,15750,920,0,16817
713,2019-11-09,1126,16184,1814,0,19124
713,2019-11-10,1204,15367,643,0,17214
713,2019-11-11,473,10230,1206,4,11913
713,2019-11-12,1876,11256,2416,1,15549
713,2019-11-13,1145,20427,1687,0,23259
713,2019-11-14,163,10803,2154,0,13120
713,2019-11-15,285,3882,2679,1,6847
713,2019-11-16,156,2572,3912,2,6642
713,2019-11-17,362,3527,3479,0,7368
713,2019-11-18,250,3796,2791,1,6838
713,2019-11-19,205,3378,2829,0,6412
713,2019-11-20,539,1923,2106,1,4569
713,2019-11-21,146,5846,1672,2,7666
713,2019-11-22,147,9509,1391,1,11048
713,2019-11-23,154,12073,2610,2,14839
713,2019-11-24,251,9138,2281,3,11673
713,2019-11-25,219,11872,2346,1,14438
713,2019-11-26,171,8869,1487,3,10530
713,2019-11-27,112,10570,1864,0,12546
713,2019-11-28,516,13599,715,0,14830
713,2019-11-29,40,228,3,0,271
713,2019-08-15,70,367,25,0,462
713,2019-08-16,196,351,95,0,642
713,2019-08-17,261,1653,513,1,2428
713,2019-08-18,279,2454,798,2,3533
713,2019-08-19,954,16280,949,1,18184
713,2019-08-20,290,17079,821,1,18191
713,2019-08-21,924,12053,1188,0,14165
713,2019-08-22,528,20734,730,0,21992
713,2019-08-23,493,20713,1351,3,22560
713,2019-08-24,1160,15413,1236,0,17809
713,2019-08-25,196,41274,1067,2,42539
713,2019-08-26,152,30391,2287,2,32832
713,2019-08-27,1312,13590,2021,1,16924
713,2019-08-28,1451,5018,2250,1,8720
713,2019-08-29,340,10179,2259,0,12778
713,2019-08-30,196,3196,461,0,3853
713,2019-08-31,68,248,1,0,317
713,2019-09-01,263,1433,94,1,1791
713,2019-09-02,71,239,12,0,322
713,2019-09-03,987,990,918,2,2897
713,2019-09-04,335,11547,1963,1,13846
713,2019-09-05,157,15398,2116,0,17671
713,2019-09-06,251,15310,1379,1,16941
713,2019-09-07,309,13555,1671,0,15535
713,2019-09-08,1156,7413,1563,2,10134
713,2019-09-09,624,8727,2261,3,11615
713,2019-09-10,1387,13491,2194,0,17072
713,2019-09-11,663,6681,2006,3,9353
713,2019-09-12,500,11092,2204,2,13798
713,2019-09-13,283,8356,1926,2,10567
713,2019-09-14,264,8568,2127,0,10959
713,2019-09-15,211,9412,2241,2,11866
713,2019-09-16,182,13746,1829,4,15761
713,2019-09-17,181,8010,1922,8,10121
713,2019-09-18,251,11764,1801,10,13826
713,2019-09-19,360,11708,2022,8,14098
713,2019-09-20,335,28674,1744,8,30761
713,2019-09-21,542,6769,1583,9,8903
713,2019-09-22,552,14685,1908,11,17156
713,2019-09-23,1148,11643,3328,12,16131
713,2019-09-24,1014,8790,2047,12,11863
713,2019-09-25,252,9707,2432,11,12402
713,2019-09-26,1229,10086,1558,10,12883
713,2019-09-27,407,11126,1869,3,13405
713,2019-09-28,415,15350,1133,2,16900
713,2019-09-29,455,17337,1779,0,19571
713,2019-09-30,437,18416,1358,0,20211
713,2019-10-01,959,17045,1289,0,19293
713,2019-10-02,429,12937,1204,8,14578
713,2019-10-03,279,15201,1264,9,16753
713,2019-10-04,1695,13093,1775,11,16574
713,2019-10-05,1441,22109,1632,10,25192
713,2019-10-06,1104,17302,1652,10,20068
713,2019-10-07,1081,8600,1971,12,11664
713,2019-10-08,325,13172,2213,10,15720
713,2019-10-09,258,15078,1602,10,16948
713,2019-10-10,1144,11589,1677,4715,19125
713,2019-10-11,1158,14610,1677,11,17456
713,2019-10-12,200,8378,1174,5,9757
713,2019-10-13,1068,8863,1507,1,11439
713,2019-10-14,392,6584,2370,0,9346
713,2019-10-15,469,8835,1729,1,11034
713,2019-10-16,114,18826,1582,2,20524
713,2019-10-17,1904,8619,1755,5,12283
713,2019-10-18,267,9463,2046,2,11778
713,2019-10-19,239,5908,2319,0,8466
713,2019-10-20,922,3638,1930,1,6491
713,2019-10-21,658,11823,1543,2,14026
713,2019-10-22,1040,7504,1464,3,10011
713,2019-10-23,165,14609,891,0,15665
713,2019-10-24,176,19195,1011,0,20382
713,2019-10-25,1019,11180,1557,3,13759
713,2019-10-26,266,14098,1377,0,15741
713,2019-10-27,496,16707,1714,1,18918
713,2019-10-28,383,14231,1428,1,16043
713,2019-10-29,713,27617,1398,1,29729
713,2019-10-30,619,33681,1484,0,35784
713,2019-10-31,928,15001,1589,2,17520
713,2019-11-01,741,15249,1243,2,17235
713,2019-11-02,147,15347,2399,0,17893
713,2019-11-03,1089,22850,854,0,24793
713,2019-11-04,196,10843,2193,1,13233
713,2019-11-05,1151,3519,1731,1,6402
713,2019-11-06,591,8380,1175,4,10150
713,2019-11-07,679,14038,1189,2,15908
713,2019-11-08,147,15750,920,0,16817
713,2019-11-09,1126,16184,1814,0,19124
713,2019-11-10,1204,15367,643,0,17214
713,2019-11-11,473,10230,1206,4,11913
713,2019-11-12,1876,11256,2416,1,15549
713,2019-11-13,1145,20427,1687,0,23259
713,2019-11-14,163,10803,2154,0,13120
713,2019-11-15,285,3882,2679,1,6847
713,2019-11-16,156,2572,3912,2,6642
713,2019-11-17,362,3527,3479,0,7368
713,2019-11-18,250,3796,2791,1,6838
713,2019-11-19,205,3378,2829,0,6412
713,2019-11-20,539,1923,2106,1,4569
713,2019-11-21,146,5846,1672,2,7666
713,2019-11-22,147,9509,1391,1,11048
713,2019-11-23,154,12073,2610,2,14839
713,2019-11-24,251,9138,2281,3,11673
713,2019-11-25,219,11872,2346,1,14438
713,2019-11-26,171,8869,1487,3,10530
713,2019-11-27,112,10570,1864,0,12546
713,2019-11-28,516,13599,715,0,14830
713,2019-11-29,40,228,3,0,271
713,2019-08-17,261,1653,513,1,2428
713,2019-08-18,279,2454,798,2,3533
713,2019-08-19,954,16280,949,1,18184
713,2019-08-20,290,17079,821,1,18191
713,2019-08-21,924,12053,1188,0,14165
713,2019-08-22,528,20734,730,0,21992
713,2019-08-23,493,20713,1351,3,22560
713,2019-08-24,1160,15413,1236,0,17809
713,2019-08-25,196,41274,1067,2,42539
713,2019-08-26,152,30391,2287,2,32832
713,2019-08-27,1312,13590,2021,1,16924
713,2019-08-28,1451,5018,2250,1,8720
713,2019-08-29,340,10179,2259,0,12778
713,2019-08-30,196,3196,461,0,3853
713,2019-08-31,68,248,1,0,317
713,2019-09-01,263,1433,94,1,1791
713,2019-09-02,71,239,12,0,322
713,2019-09-03,987,990,918,2,2897
713,2019-09-04,335,11547,1963,1,13846
713,2019-09-05,157,15398,2116,0,17671
713,2019-09-06,251,15310,1379,1,16941
713,2019-09-07,309,13555,1671,0,15535
713,2019-09-08,1156,7413,1563,2,10134
713,2019-09-09,624,8727,2261,3,11615
713,2019-09-10,1387,13491,2194,0,17072
713,2019-09-11,663,6681,2006,3,9353
713,2019-09-12,500,11092,2204,2,13798
713,2019-09-13,283,8356,1926,2,10567
713,2019-09-14,264,8568,2127,0,10959
713,2019-09-15,211,9412,2241,2,11866
713,2019-09-16,182,13746,1829,4,15761
713,2019-09-17,181,8010,1922,8,10121
713,2019-09-18,251,11764,1801,10,13826
713,2019-09-19,360,11708,2022,8,14098
713,2019-09-20,335,28674,1744,8,30761
713,2019-09-21,542,6769,1583,9,8903
713,2019-09-22,552,14685,1908,11,17156
713,2019-09-23,1148,11643,3328,12,16131
713,2019-09-24,1014,8790,2047,12,11863
713,2019-09-25,252,9707,2432,11,12402
713,2019-09-26,1229,10086,1558,10,12883
713,2019-09-27,407,11126,1869,3,13405
713,2019-09-28,415,15350,1133,2,16900
713,2019-09-29,455,17337,1779,0,19571
713,2019-09-30,437,18416,1358,0,20211
713,2019-10-01,959,17045,1289,0,19293
713,2019-10-02,429,12937,1204,8,14578
713,2019-10-03,279,15201,1264,9,16753
713,2019-10-04,1695,13093,1775,11,16574
713,2019-10-05,1441,22109,1632,10,25192
713,2019-10-06,1104,17302,1652,10,20068
713,2019-10-07,1081,8600,1971,12,11664
713,2019-10-08,325,13172,2213,10,15720
713,2019-10-09,258,15078,1602,10,16948
713,2019-10-10,1144,11589,1677,4715,19125
713,2019-10-11,1158,14610,1677,11,17456
713,2019-10-12,200,8378,1174,5,9757
713,2019-10-13,1068,8863,1507,1,11439
713,2019-10-14,392,6584,2370,0,9346
713,2019-10-15,469,8835,1729,1,11034
713,2019-10-16,114,18826,1582,2,20524
713,2019-10-17,1904,8619,1755,5,12283
713,2019-10-18,267,9463,2046,2,11778
713,2019-10-19,239,5908,2319,0,8466
713,2019-10-20,922,3638,1930,1,6491
713,2019-10-21,658,11823,1543,2,14026
713,2019-10-22,1040,7504,1464,3,10011
713,2019-10-23,165,14609,891,0,15665
713,2019-10-24,176,19195,1011,0,20382
713,2019-10-25,1019,11180,1557,3,13759
713,2019-10-26,266,14098,1377,0,15741
713,2019-10-27,496,16707,1714,1,18918
713,2019-10-28,383,14231,1428,1,16043
713,2019-10-29,713,27617,1398,1,29729
713,2019-10-30,619,33681,1484,0,35784
713,2019-10-31,928,15001,1589,2,17520
713,2019-11-01,741,15249,1243,2,17235
713,2019-11-02,147,15347,2399,0,17893
713,2019-11-03,1089,22850,854,0,24793
713,2019-11-04,196,10843,2193,1,13233
713,2019-11-05,1151,3519,1731,1,6402
713,2019-11-06,591,8380,1175,4,10150
713,2019-11-07,679,14038,1189,2,15908
713,2019-11-08,147,15750,920,0,16817
713,2019-11-09,1126,16184,1814,0,19124
713,2019-11-10,1204,15367,643,0,17214
713,2019-11-11,473,10230,1206,4,11913
713,2019-11-12,1876,11256,2416,1,15549
713,2019-11-13,1145,20427,1687,0,23259
713,2019-11-14,163,10803,2154,0,13120
713,2019-11-15,285,3882,2679,1,6847
713,2019-11-16,156,2572,3912,2,6642
713,2019-11-17,362,3527,3479,0,7368
713,2019-11-18,250,3796,2791,1,6838
713,2019-11-19,205,3378,2829,0,6412
713,2019-11-20,539,1923,2106,1,4569
713,2019-11-21,146,5846,1672,2,7666
713,2019-11-22,147,9509,1391,1,11048
713,2019-11-23,154,12073,2610,2,14839
713,2019-11-24,251,9138,2281,3,11673
713,2019-11-25,219,11872,2346,1,14438
713,2019-11-26,171,8869,1487,3,10530
730,2019-08-16,119,131,154,1,405
730,2019-08-17,313,1920,540,1,2774
730,2019-08-18,119,907,1525,0,2551
730,2019-08-19,178,717,1081,1,1977
730,2019-08-20,140,2969,1518,4,4631
730,2019-08-21,125,1077,1472,2,2676
730,2019-08-22,739,12305,1396,3,14443
730,2019-08-23,101,12786,866,1,13754
730,2019-08-24,90,3266,811,0,4167
730,2019-08-25,884,2185,2212,4,5285
730,2019-08-26,85,624,1440,6,2155
730,2019-08-27,1025,7473,2312,0,10810
730,2019-08-28,151,3781,1800,0,5732
730,2019-08-29,83,11383,3058,0,14524
730,2019-08-30,121,3158,657,2,3938
730,2019-08-31,46,104,4,2,156
730,2019-09-01,1370,1566,230,1,3167
730,2019-09-02,59,820,15,0,894
730,2019-09-03,104,1273,1335,0,2712
730,2019-09-04,71,12230,1779,3,14083
730,2019-09-05,113,14601,1602,2,16318
730,2019-09-06,238,14836,2215,0,17289
730,2019-09-07,180,16924,2229,0,19333
730,2019-09-08,1106,7579,1777,1,10463
730,2019-09-09,1003,7054,2040,0,10097
730,2019-09-10,283,8499,2189,0,10971
730,2019-09-11,964,5906,2019,1,8890
730,2019-09-12,288,11134,2232,3,13657
730,2019-09-13,994,5519,2672,1,9186
730,2019-09-14,341,8655,1615,0,10611
730,2019-09-15,259,9507,1802,1,11569
730,2019-09-16,178,6860,2419,0,9457
730,2019-09-17,307,9032,2136,0,11475
730,2019-09-18,707,11785,1474,2,13968
730,2019-09-19,444,5487,1718,0,7649
730,2019-09-20,1250,11941,2052,2,15245
730,2019-09-21,222,10282,1890,0,12394
730,2019-09-22,166,8193,1992,0,10351
730,2019-09-23,146,9110,2033,0,11289
730,2019-09-24,298,7146,1322,3,8769
730,2019-09-25,238,6179,1617,4,8038
730,2019-09-26,975,17190,1674,1,19840
730,2019-09-27,1136,6154,1958,1,9249
730,2019-09-28,274,14178,2804,3,17259
730,2019-09-29,985,16981,2035,2,20003
730,2019-09-30,138,16731,1885,2,18756
730,2019-10-01,1069,15557,1652,1,18279
730,2019-10-02,234,10944,2206,0,13384
730,2019-10-03,106,13238,1590,1,14935
730,2019-10-04,257,10840,1207,1,12305
730,2019-10-05,287,13270,2039,3,15599
730,2019-10-06,1193,12389,1953,0,15535
730,2019-10-07,184,4329,1587,0,6100
730,2019-10-08,1007,10688,1368,0,13063
730,2019-10-09,532,14966,1685,1,17184
730,2019-10-10,200,10616,2088,17,12921
730,2019-10-11,362,9607,2134,1,12104
730,2019-10-12,992,6917,1758,0,9667
730,2019-10-13,55,7184,1894,1,9134
730,2019-10-14,120,4266,2431,2,6819
730,2019-10-15,414,7387,1403,3,9207
730,2019-10-16,1665,12058,1592,1,15316
730,2019-10-17,1147,4342,1971,1,7461
730,2019-10-18,700,6806,2132,1,9639
730,2019-10-19,425,3861,1816,0,6102
730,2019-10-20,961,1541,1723,3,4228
730,2019-10-21,351,9158,1478,2,10989
730,2019-10-22,984,4763,1628,1,7376
730,2019-10-23,1286,6883,1401,1,9571
730,2019-10-24,395,12834,1204,0,14433
730,2019-10-25,417,14009,1962,4,16392
730,2019-10-26,688,23599,2063,0,26350
730,2019-10-27,144,29081,2239,0,31464
730,2019-10-28,1684,23322,2388,0,27394
730,2019-10-29,1292,15943,2222,2,19459
730,2019-10-30,343,14166,1338,3,15850
730,2019-10-31,1906,11374,1701,0,14981
730,2019-11-01,164,24409,1054,1,25628
730,2019-11-02,343,15846,1849,1,18039
730,2019-11-03,409,22623,835,0,23867
730,2019-11-04,591,9094,1569,2,11256
730,2019-11-05,393,1415,2050,0,3858
730,2019-11-06,483,7223,1688,0,9394
730,2019-11-07,1133,13122,671,2,14928
730,2019-11-08,435,8504,1388,0,10327
730,2019-11-09,221,7818,1654,1,9694
730,2019-11-10,408,23018,1445,2,24873
730,2019-11-11,1221,14826,1553,2,17602
730,2019-11-12,733,15703,3022,2,19460
730,2019-11-13,258,12810,1318,1,14387
730,2019-11-14,166,12218,1163,4,13551
730,2019-11-15,498,4932,2166,1,7597
730,2019-11-16,332,2810,3004,0,6146
730,2019-11-17,573,2914,2727,0,6214
730,2019-11-18,166,2646,3854,1,6667
730,2019-11-19,528,5059,3120,3,8710
730,2019-11-20,2122,1149,3042,0,6313
730,2019-11-21,140,5756,1345,1,7242
730,2019-11-22,548,8895,1507,1,10951
730,2019-11-23,477,6695,2276,2,9450
730,2019-11-24,201,6492,1798,1,8492
730,2019-11-25,144,6957,2053,0,9154
730,2019-11-26,1043,6430,1877,0,9350
730,2019-11-27,347,6728,1224,0,8299
730,2019-11-28,85,7421,497,0,8003
730,2019-11-29,82,742,3,1,828
730,2019-08-16,119,131,154,1,405
730,2019-08-17,313,1920,540,1,2774
730,2019-08-18,119,907,1525,0,2551
730,2019-08-19,178,717,1081,1,1977
730,2019-08-20,140,2969,1518,4,4631
730,2019-08-21,125,1077,1472,2,2676
730,2019-08-22,739,12305,1396,3,14443
730,2019-08-23,101,12786,866,1,13754
730,2019-08-24,90,3266,811,0,4167
730,2019-08-25,884,2185,2212,4,5285
730,2019-08-26,85,624,1440,6,2155
730,2019-08-27,1025,7473,2312,0,10810
730,2019-08-28,151,3781,1800,0,5732
730,2019-08-29,83,11383,3058,0,14524
730,2019-08-30,121,3158,657,2,3938
730,2019-08-31,46,104,4,2,156
730,2019-09-01,1370,1566,230,1,3167
730,2019-09-02,59,820,15,0,894
730,2019-09-03,104,1273,1335,0,2712
730,2019-09-04,71,12230,1779,3,14083
730,2019-09-05,113,14601,1602,2,16318
730,2019-09-06,238,14836,2215,0,17289
730,2019-09-07,180,16924,2229,0,19333
730,2019-09-08,1106,7579,1777,1,10463
730,2019-09-09,1003,7054,2040,0,10097
730,2019-09-10,283,8499,2189,0,10971
730,2019-09-11,964,5906,2019,1,8890
730,2019-09-12,288,11134,2232,3,13657
730,2019-09-13,994,5519,2672,1,9186
730,2019-09-14,341,8655,1615,0,10611
730,2019-09-15,259,9507,1802,1,11569
730,2019-09-16,178,6860,2419,0,9457
730,2019-09-17,307,9032,2136,0,11475
730,2019-09-18,707,11785,1474,2,13968
730,2019-09-19,444,5487,1718,0,7649
730,2019-09-20,1250,11941,2052,2,15245
730,2019-09-21,222,10282,1890,0,12394
730,2019-09-22,166,8193,1992,0,10351
730,2019-09-23,146,9110,2033,0,11289
730,2019-09-24,298,7146,1322,3,8769
730,2019-09-25,238,6179,1617,4,8038
730,2019-09-26,975,17190,1674,1,19840
730,2019-09-27,1136,6154,1958,1,9249
730,2019-09-28,274,14178,2804,3,17259
730,2019-09-29,985,16981,2035,2,20003
730,2019-09-30,138,16731,1885,2,18756
730,2019-10-01,1069,15557,1652,1,18279
730,2019-10-02,234,10944,2206,0,13384
730,2019-10-03,106,13238,1590,1,14935
730,2019-10-04,257,10840,1207,1,12305
730,2019-10-05,287,13270,2039,3,15599
730,2019-10-06,1193,12389,1953,0,15535
730,2019-10-07,184,4329,1587,0,6100
730,2019-10-08,1007,10688,1368,0,13063
730,2019-10-09,532,14966,1685,1,17184
730,2019-10-10,200,10616,2088,17,12921
730,2019-10-11,362,9607,2134,1,12104
730,2019-10-12,992,6917,1758,0,9667
730,2019-10-13,55,7184,1894,1,9134
730,2019-10-14,120,4266,2431,2,6819
730,2019-10-15,414,7387,1403,3,9207
730,2019-10-16,1665,12058,1592,1,15316
730,2019-10-17,1147,4342,1971,1,7461
730,2019-10-18,700,6806,2132,1,9639
730,2019-10-19,425,3861,1816,0,6102
730,2019-10-20,961,1541,1723,3,4228
730,2019-10-21,351,9158,1478,2,10989
730,2019-10-22,984,4763,1628,1,7376
730,2019-10-23,1286,6883,1401,1,9571
730,2019-10-24,395,12834,1204,0,14433
730,2019-10-25,417,14009,1962,4,16392
730,2019-10-26,688,23599,2063,0,26350
730,2019-10-27,144,29081,2239,0,31464
730,2019-10-28,1684,23322,2388,0,27394
730,2019-10-29,1292,15943,2222,2,19459
730,2019-10-30,343,14166,1338,3,15850
730,2019-10-31,1906,11374,1701,0,14981
730,2019-11-01,164,24409,1054,1,25628
730,2019-11-02,343,15846,1849,1,18039
730,2019-11-03,409,22623,835,0,23867
730,2019-11-04,591,9094,1569,2,11256
730,2019-11-05,393,1415,2050,0,3858
730,2019-11-06,483,7223,1688,0,9394
730,2019-11-07,1133,13122,671,2,14928
730,2019-11-08,435,8504,1388,0,10327
730,2019-11-09,221,7818,1654,1,9694
730,2019-11-10,408,23018,1445,2,24873
730,2019-11-11,1221,14826,1553,2,17602
730,2019-11-12,733,15703,3022,2,19460
730,2019-11-13,258,12810,1318,1,14387
730,2019-11-14,166,12218,1163,4,13551
730,2019-11-15,498,4932,2166,1,7597
730,2019-11-16,332,2810,3004,0,6146
730,2019-11-17,573,2914,2727,0,6214
730,2019-11-18,166,2646,3854,1,6667
730,2019-11-19,528,5059,3120,3,8710
730,2019-11-20,2122,1149,3042,0,6313
730,2019-11-21,140,5756,1345,1,7242
730,2019-11-22,548,8895,1507,1,10951
730,2019-11-23,477,6695,2276,2,9450
730,2019-11-24,201,6492,1798,1,8492
730,2019-11-25,144,6957,2053,0,9154
730,2019-11-26,1043,6430,1877,0,9350
730,2019-11-27,347,6728,1224,0,8299
730,2019-11-28,85,7421,497,0,8003
730,2019-11-29,82,742,3,1,828
730,2019-08-16,119,131,154,1,405
730,2019-08-17,313,1920,540,1,2774
730,2019-08-18,119,907,1525,0,2551
730,2019-08-19,178,717,1081,1,1977
730,2019-08-20,140,2969,1518,4,4631
730,2019-08-21,125,1077,1472,2,2676
730,2019-08-22,739,12305,1396,3,14443
730,2019-08-23,101,12786,866,1,13754
730,2019-08-24,90,3266,811,0,4167
730,2019-08-25,884,2185,2212,4,5285
730,2019-08-26,85,624,1440,6,2155
730,2019-08-27,1025,7473,2312,0,10810
730,2019-08-28,151,3781,1800,0,5732
730,2019-08-29,83,11383,3058,0,14524
730,2019-08-30,121,3158,657,2,3938
730,2019-08-31,46,104,4,2,156
730,2019-09-01,1370,1566,230,1,3167
730,2019-09-02,59,820,15,0,894
730,2019-09-03,104,1273,1335,0,2712
730,2019-09-04,71,12230,1779,3,14083
730,2019-09-05,113,14601,1602,2,16318
730,2019-09-06,238,14836,2215,0,17289
730,2019-09-07,180,16924,2229,0,19333
730,2019-09-08,1106,7579,1777,1,10463
730,2019-09-09,1003,7054,2040,0,10097
730,2019-09-10,283,8499,2189,0,10971
730,2019-09-11,964,5906,2019,1,8890
730,2019-09-12,288,11134,2232,3,13657
730,2019-09-13,994,5519,2672,1,9186
730,2019-09-14,341,8655,1615,0,10611
730,2019-09-15,259,9507,1802,1,11569
730,2019-09-16,178,6860,2419,0,9457
730,2019-09-17,307,9032,2136,0,11475
730,2019-09-18,707,11785,1474,2,13968
730,2019-09-19,444,5487,1718,0,7649
730,2019-09-20,1250,11941,2052,2,15245
730,2019-09-21,222,10282,1890,0,12394
730,2019-09-22,166,8193,1992,0,10351
730,2019-09-23,146,9110,2033,0,11289
730,2019-09-24,298,7146,1322,3,8769
730,2019-09-25,238,6179,1617,4,8038
730,2019-09-26,975,17190,1674,1,19840
730,2019-09-27,1136,6154,1958,1,9249
730,2019-09-28,274,14178,2804,3,17259
730,2019-09-29,985,16981,2035,2,20003
730,2019-09-30,138,16731,1885,2,18756
730,2019-10-01,1069,15557,1652,1,18279
730,2019-10-02,234,10944,2206,0,13384
730,2019-10-03,106,13238,1590,1,14935
730,2019-10-04,257,10840,1207,1,12305
730,2019-10-05,287,13270,2039,3,15599
730,2019-10-06,1193,12389,1953,0,15535
730,2019-10-07,184,4329,1587,0,6100
730,2019-10-08,1007,10688,1368,0,13063
730,2019-10-09,532,14966,1685,1,17184
730,2019-10-10,200,10616,2088,17,12921
730,2019-10-11,362,9607,2134,1,12104
730,2019-10-12,992,6917,1758,0,9667
730,2019-10-13,55,7184,1894,1,9134
730,2019-10-14,120,4266,2431,2,6819
730,2019-10-15,414,7387,1403,3,9207
730,2019-10-16,1665,12058,1592,1,15316
730,2019-10-17,1147,4342,1971,1,7461
730,2019-10-18,700,6806,2132,1,9639
730,2019-10-19,425,3861,1816,0,6102
730,2019-10-20,961,1541,1723,3,4228
730,2019-10-21,351,9158,1478,2,10989
730,2019-10-22,984,4763,1628,1,7376
730,2019-10-23,1286,6883,1401,1,9571
730,2019-10-24,395,12834,1204,0,14433
730,2019-10-25,417,14009,1962,4,16392
730,2019-10-26,688,23599,2063,0,26350
730,2019-10-27,144,29081,2239,0,31464
730,2019-10-28,1684,23322,2388,0,27394
730,2019-10-29,1292,15943,2222,2,19459
730,2019-10-30,343,14166,1338,3,15850
730,2019-10-31,1906,11374,1701,0,14981
730,2019-11-01,164,24409,1054,1,25628
730,2019-11-02,343,15846,1849,1,18039
730,2019-11-03,409,22623,835,0,23867
730,2019-11-04,591,9094,1569,2,11256
730,2019-11-05,393,1415,2050,0,3858
730,2019-11-06,483,7223,1688,0,9394
730,2019-11-07,1133,13122,671,2,14928
730,2019-11-08,435,8504,1388,0,10327
730,2019-11-09,221,7818,1654,1,9694
730,2019-11-10,408,23018,1445,2,24873
730,2019-11-11,1221,14826,1553,2,17602
730,2019-11-12,733,15703,3022,2,19460
730,2019-11-13,258,12810,1318,1,14387
730,2019-11-14,166,12218,1163,4,13551
730,2019-11-15,498,4932,2166,1,7597
730,2019-11-16,332,2810,3004,0,6146
730,2019-11-17,573,2914,2727,0,6214
730,2019-11-18,166,2646,3854,1,6667
730,2019-11-19,528,5059,3120,3,8710
730,2019-11-20,2122,1149,3042,0,6313
730,2019-11-21,140,5756,1345,1,7242
730,2019-11-22,548,8895,1507,1,10951
730,2019-11-23,477,6695,2276,2,9450
730,2019-11-24,201,6492,1798,1,8492
730,2019-11-25,144,6957,2053,0,9154
730,2019-11-26,1043,6430,1877,0,9350
730,2019-11-27,347,6728,1224,0,8299
730,2019-11-28,85,7421,497,0,8003
730,2019-11-29,82,742,3,1,828
730,2019-08-16,119,131,154,1,405
730,2019-08-17,313,1920,540,1,2774
730,2019-08-18,119,907,1525,0,2551
730,2019-08-19,178,717,1081,1,1977
730,2019-08-20,140,2969,1518,4,4631
730,2019-08-21,125,1077,1472,2,2676
730,2019-08-22,739,12305,1396,3,14443
730,2019-08-23,101,12786,866,1,13754
730,2019-08-24,90,3266,811,0,4167
730,2019-08-25,884,2185,2212,4,5285
730,2019-08-26,85,624,1440,6,2155
730,2019-08-27,1025,7473,2312,0,10810
730,2019-08-28,151,3781,1800,0,5732
730,2019-08-29,83,11383,3058,0,14524
730,2019-08-30,121,3158,657,2,3938
730,2019-08-31,46,104,4,2,156
730,2019-09-01,1370,1566,230,1,3167
730,2019-09-02,59,820,15,0,894
730,2019-09-03,104,1273,1335,0,2712
730,2019-09-04,71,12230,1779,3,14083
730,2019-09-05,113,14601,1602,2,16318
730,2019-09-06,238,14836,2215,0,17289
730,2019-09-07,180,16924,2229,0,19333
730,2019-09-08,1106,7579,1777,1,10463
730,2019-09-09,1003,7054,2040,0,10097
730,2019-09-10,283,8499,2189,0,10971
730,2019-09-11,964,5906,2019,1,8890
730,2019-09-12,288,11134,2232,3,13657
730,2019-09-13,994,5519,2672,1,9186
730,2019-09-14,341,8655,1615,0,10611
730,2019-09-15,259,9507,1802,1,11569
730,2019-09-16,178,6860,2419,0,9457
730,2019-09-17,307,9032,2136,0,11475
730,2019-09-18,707,11785,1474,2,13968
730,2019-09-19,444,5487,1718,0,7649
730,2019-09-20,1250,11941,2052,2,15245
730,2019-09-21,222,10282,1890,0,12394
730,2019-09-22,166,8193,1992,0,10351
730,2019-09-23,146,9110,2033,0,11289
730,2019-09-24,298,7146,1322,3,8769
730,2019-09-25,238,6179,1617,4,8038
730,2019-09-26,975,17190,1674,1,19840
730,2019-09-27,1136,6154,1958,1,9249
730,2019-09-28,274,14178,2804,3,17259
730,2019-09-29,985,16981,2035,2,20003
730,2019-09-30,138,16731,1885,2,18756
730,2019-10-01,1069,15557,1652,1,18279
730,2019-10-02,234,10944,2206,0,13384
730,2019-10-03,106,13238,1590,1,14935
730,2019-10-04,257,10840,1207,1,12305
730,2019-10-05,287,13270,2039,3,15599
730,2019-10-06,1193,12389,1953,0,15535
730,2019-10-07,184,4329,1587,0,6100
730,2019-10-08,1007,10688,1368,0,13063
730,2019-10-09,532,14966,1685,1,17184
730,2019-10-10,200,10616,2088,17,12921
730,2019-10-11,362,9607,2134,1,12104
730,2019-10-12,992,6917,1758,0,9667
730,2019-10-13,55,7184,1894,1,9134
730,2019-10-14,120,4266,2431,2,6819
730,2019-10-15,414,7387,1403,3,9207
730,2019-10-16,1665,12058,1592,1,15316
730,2019-10-17,1147,4342,1971,1,7461
730,2019-10-18,700,6806,2132,1,9639
730,2019-10-19,425,3861,1816,0,6102
730,2019-10-20,961,1541,1723,3,4228
730,2019-10-21,351,9158,1478,2,10989
730,2019-10-22,984,4763,1628,1,7376
730,2019-10-23,1286,6883,1401,1,9571
730,2019-10-24,395,12834,1204,0,14433
730,2019-10-25,417,14009,1962,4,16392
730,2019-10-26,688,23599,2063,0,26350
730,2019-10-27,144,29081,2239,0,31464
730,2019-10-28,1684,23322,2388,0,27394
730,2019-10-29,1292,15943,2222,2,19459
730,2019-10-30,343,14166,1338,3,15850
730,2019-10-31,1906,11374,1701,0,14981
730,2019-11-01,164,24409,1054,1,25628
730,2019-11-02,343,15846,1849,1,18039
730,2019-11-03,409,22623,835,0,23867
730,2019-11-04,591,9094,1569,2,11256
730,2019-11-05,393,1415,2050,0,3858
730,2019-11-06,483,7223,1688,0,9394
730,2019-11-07,1133,13122,671,2,14928
730,2019-11-08,435,8504,1388,0,10327
730,2019-11-09,221,7818,1654,1,9694
730,2019-11-10,408,23018,1445,2,24873
730,2019-11-11,1221,14826,1553,2,17602
730,2019-11-12,733,15703,3022,2,19460
730,2019-11-13,258,12810,1318,1,14387
730,2019-11-14,166,12218,1163,4,13551
730,2019-11-15,498,4932,2166,1,7597
730,2019-11-16,332,2810,3004,0,6146
730,2019-11-17,573,2914,2727,0,6214
730,2019-11-18,166,2646,3854,1,6667
730,2019-11-19,528,5059,3120,3,8710
730,2019-11-20,2122,1149,3042,0,6313
730,2019-11-21,140,5756,1345,1,7242
730,2019-11-22,548,8895,1507,1,10951
730,2019-11-23,477,6695,2276,2,9450
730,2019-11-24,201,6492,1798,1,8492
730,2019-11-25,144,6957,2053,0,9154
730,2019-11-26,1043,6430,1877,0,9350
730,2019-11-27,347,6728,1224,0,8299
730,2019-11-28,85,7421,497,0,8003
730,2019-11-29,82,742,3,1,828
731,2019-08-16,1726,187,8,0,1921
731,2019-08-17,1350,910,1074,0,3334
731,2019-08-18,1846,1370,936,1,4153
731,2019-08-19,3360,806,964,0,5130
731,2019-08-20,3409,1904,932,1,6246
731,2019-08-21,2798,671,1236,1,4706
731,2019-08-22,985,1229,1709,1,3924
731,2019-08-23,554,7188,1630,0,9372
731,2019-08-24,849,2250,1115,0,4214
731,2019-08-25,848,14532,1589,2,16971
731,2019-08-26,646,13025,1309,0,14980
731,2019-08-27,740,8650,1171,2,10563
731,2019-08-28,672,2584,2291,1,5548
731,2019-08-29,729,9616,1299,0,11644
731,2019-08-30,1231,2943,674,1,4849
731,2019-08-31,420,31,2,0,453
731,2019-09-01,847,630,368,0,1845
731,2019-09-02,807,52,39,0,898
731,2019-09-03,569,3514,1506,1,5590
731,2019-09-04,876,10107,1729,0,12712
731,2019-09-05,969,9108,2647,0,12724
731,2019-09-06,1899,10579,2179,0,14657
731,2019-09-07,622,7376,2344,1,10343
731,2019-09-08,687,6344,1646,1,8678
731,2019-09-09,1184,12186,2532,1,15903
731,2019-09-10,522,9529,2110,2,12163
731,2019-09-11,583,7881,1841,1,10306
731,2019-09-12,307,12853,1288,0,14448
731,2019-09-13,383,7695,1837,2,9917
731,2019-09-14,347,6587,1808,1,8743
731,2019-09-15,1990,13402,2072,1,17465
731,2019-09-16,1123,11760,1891,0,14774
731,2019-09-17,401,8925,1800,0,11126
731,2019-09-18,322,12171,1251,0,13744
731,2019-09-19,2296,7626,1911,2,11835
731,2019-09-20,699,12342,2343,2,15386
731,2019-09-21,1391,8648,2115,0,12154
731,2019-09-22,534,8941,1524,1,11000
731,2019-09-23,1993,12956,1827,1,16777
731,2019-09-24,710,8559,1594,4,10867
731,2019-09-25,1299,10243,1754,1,13297
731,2019-09-26,1202,11309,1802,0,14313
731,2019-09-27,448,6781,1675,3,8907
731,2019-09-28,502,15160,1573,2,17237
731,2019-09-29,364,16656,1512,3,18535
731,2019-09-30,338,16023,2824,1,19186
731,2019-10-01,341,17753,1039,0,19133
731,2019-10-02,812,12858,2101,0,15771
731,2019-10-03,340,14763,978,3,16084
731,2019-10-04,436,13938,1548,3,15925
731,2019-10-05,233,15002,1585,0,16820
731,2019-10-06,1779,11643,1626,1,15049
731,2019-10-07,321,6663,1591,0,8575
731,2019-10-08,1210,12502,1389,2,15103
731,2019-10-09,329,14561,2131,1,17022
731,2019-10-10,369,11770,2223,1,14363
731,2019-10-11,291,12700,1214,0,14205
731,2019-10-12,516,7729,2463,0,10708
731,2019-10-13,304,8827,1296,1,10428
731,2019-10-14,285,5748,2351,1,8385
731,2019-10-15,316,9468,2130,0,11914
731,2019-10-16,770,13220,909,1,14900
731,2019-10-17,263,6110,1834,2,8209
731,2019-10-18,268,8594,1610,1,10473
731,2019-10-19,1134,6094,1730,0,8958
731,2019-10-20,2014,2995,1550,1,6560
731,2019-10-21,261,19508,875,1,20645
731,2019-10-22,272,10583,1687,2,12544
731,2019-10-23,1275,8978,1701,1,11955
731,2019-10-24,753,13696,1619,2,16070
731,2019-10-25,295,16046,1712,2,18055
731,2019-10-26,333,16991,2358,0,19682
731,2019-10-27,310,28517,2384,0,31211
731,2019-10-28,721,24500,2540,0,27761
731,2019-10-29,424,17587,2010,4,20025
731,2019-10-30,1208,24034,1127,0,26369
731,2019-10-31,955,15087,1546,3,17591
731,2019-11-01,286,14833,1655,0,16774
731,2019-11-02,377,14352,1292,0,16021
731,2019-11-03,306,22607,1459,3,24375
731,2019-11-04,1268,11559,1160,0,13987
731,2019-11-05,1226,3190,2308,0,6724
731,2019-11-06,418,8205,2134,2,10759
731,2019-11-07,424,22133,2300,2,24859
731,2019-11-08,239,15759,2150,1,18149
731,2019-11-09,254,8734,2358,0,11346
731,2019-11-10,250,14458,2337,0,17045
731,2019-11-11,446,14033,2591,2,17072
731,2019-11-12,1809,12888,2608,2,17307
731,2019-11-13,351,12834,1632,5,14822
731,2019-11-14,2083,8988,2019,0,13090
731,2019-11-15,309,4284,2149,1,6743
731,2019-11-16,301,3109,2422,0,5832
731,2019-11-17,1324,4546,3551,1,9422
731,2019-11-18,917,3515,3379,4,7815
731,2019-11-19,2849,4969,2674,1,10493
731,2019-11-20,2955,1692,2099,1,6747
731,2019-11-21,1823,3912,1739,0,7474
731,2019-11-22,1319,8208,1705,2,11234
731,2019-11-23,1801,6683,2782,5,11271
731,2019-11-24,351,5010,1968,0,7329
731,2019-11-25,340,6846,1781,0,8967
731,2019-11-26,399,6368,1617,0,8384
731,2019-11-27,271,6410,1411,0,8092
731,2019-11-28,316,7272,633,0,8221
731,2019-11-29,89,160,2,0,251
731,2019-08-16,1726,187,8,0,1921
731,2019-08-17,1350,910,1074,0,3334
731,2019-08-18,1846,1370,936,1,4153
731,2019-08-19,3360,806,964,0,5130
731,2019-08-20,3409,1904,932,1,6246
731,2019-08-21,2798,671,1236,1,4706
731,2019-08-22,985,1229,1709,1,3924
731,2019-08-23,554,7188,1630,0,9372
731,2019-08-24,849,2250,1115,0,4214
731,2019-08-25,848,14532,1589,2,16971
731,2019-08-26,646,13025,1309,0,14980
731,2019-08-27,740,8650,1171,2,10563
731,2019-08-28,672,2584,2291,1,5548
731,2019-08-29,729,9616,1299,0,11644
731,2019-08-30,1231,2943,674,1,4849
731,2019-08-31,420,31,2,0,453
731,2019-09-01,847,630,368,0,1845
731,2019-09-02,807,52,39,0,898
731,2019-09-03,569,3514,1506,1,5590
731,2019-09-04,876,10107,1729,0,12712
731,2019-09-05,969,9108,2647,0,12724
731,2019-09-06,1899,10579,2179,0,14657
731,2019-09-07,622,7376,2344,1,10343
731,2019-09-08,687,6344,1646,1,8678
731,2019-09-09,1184,12186,2532,1,15903
731,2019-09-10,522,9529,2110,2,12163
731,2019-09-11,583,7881,1841,1,10306
731,2019-09-12,307,12853,1288,0,14448
731,2019-09-13,383,7695,1837,2,9917
731,2019-09-14,347,6587,1808,1,8743
731,2019-09-15,1990,13402,2072,1,17465
731,2019-09-16,1123,11760,1891,0,14774
731,2019-09-17,401,8925,1800,0,11126
731,2019-09-18,322,12171,1251,0,13744
731,2019-09-19,2296,7626,1911,2,11835
731,2019-09-20,699,12342,2343,2,15386
731,2019-09-21,1391,8648,2115,0,12154
731,2019-09-22,534,8941,1524,1,11000
731,2019-09-23,1993,12956,1827,1,16777
731,2019-09-24,710,8559,1594,4,10867
731,2019-09-25,1299,10243,1754,1,13297
731,2019-09-26,1202,11309,1802,0,14313
731,2019-09-27,448,6781,1675,3,8907
731,2019-09-28,502,15160,1573,2,17237
731,2019-09-29,364,16656,1512,3,18535
731,2019-09-30,338,16023,2824,1,19186
731,2019-10-01,341,17753,1039,0,19133
731,2019-10-02,812,12858,2101,0,15771
731,2019-10-03,340,14763,978,3,16084
731,2019-10-04,436,13938,1548,3,15925
731,2019-10-05,233,15002,1585,0,16820
731,2019-10-06,1779,11643,1626,1,15049
731,2019-10-07,321,6663,1591,0,8575
731,2019-10-08,1210,12502,1389,2,15103
731,2019-10-09,329,14561,2131,1,17022
731,2019-10-10,369,11770,2223,1,14363
731,2019-10-11,291,12700,1214,0,14205
731,2019-10-12,516,7729,2463,0,10708
731,2019-10-13,304,8827,1296,1,10428
731,2019-10-14,285,5748,2351,1,8385
731,2019-10-15,316,9468,2130,0,11914
731,2019-10-16,770,13220,909,1,14900
731,2019-10-17,263,6110,1834,2,8209
731,2019-10-18,268,8594,1610,1,10473
731,2019-10-19,1134,6094,1730,0,8958
731,2019-10-20,2014,2995,1550,1,6560
731,2019-10-21,261,19508,875,1,20645
731,2019-10-22,272,10583,1687,2,12544
731,2019-10-23,1275,8978,1701,1,11955
731,2019-10-24,753,13696,1619,2,16070
731,2019-10-25,295,16046,1712,2,18055
731,2019-10-26,333,16991,2358,0,19682
731,2019-10-27,310,28517,2384,0,31211
731,2019-10-28,721,24500,2540,0,27761
731,2019-10-29,424,17587,2010,4,20025
731,2019-10-30,1208,24034,1127,0,26369
731,2019-10-31,955,15087,1546,3,17591
731,2019-11-01,286,14833,1655,0,16774
731,2019-11-02,377,14352,1292,0,16021
731,2019-11-03,306,22607,1459,3,24375
731,2019-11-04,1268,11559,1160,0,13987
731,2019-11-05,1226,3190,2308,0,6724
731,2019-11-06,418,8205,2134,2,10759
731,2019-11-07,424,22133,2300,2,24859
731,2019-11-08,239,15759,2150,1,18149
731,2019-11-09,254,8734,2358,0,11346
731,2019-11-10,250,14458,2337,0,17045
731,2019-11-11,446,14033,2591,2,17072
731,2019-11-12,1809,12888,2608,2,17307
731,2019-11-13,351,12834,1632,5,14822
731,2019-11-14,2083,8988,2019,0,13090
731,2019-11-15,309,4284,2149,1,6743
731,2019-11-16,301,3109,2422,0,5832
731,2019-11-17,1324,4546,3551,1,9422
731,2019-11-18,917,3515,3379,4,7815
731,2019-11-19,2849,4969,2674,1,10493
731,2019-11-20,2955,1692,2099,1,6747
731,2019-11-21,1823,3912,1739,0,7474
731,2019-11-22,1319,8208,1705,2,11234
731,2019-11-23,1801,6683,2782,5,11271
731,2019-11-24,351,5010,1968,0,7329
731,2019-11-25,340,6846,1781,0,8967
731,2019-11-26,399,6368,1617,0,8384
731,2019-11-27,271,6410,1411,0,8092
731,2019-11-28,316,7272,633,0,8221
731,2019-11-29,89,160,2,0,251
731,2019-08-16,1726,187,8,0,1921
731,2019-08-17,1350,910,1074,0,3334
731,2019-08-18,1846,1370,936,1,4153
731,2019-08-19,3360,806,964,0,5130
731,2019-08-20,3409,1904,932,1,6246
731,2019-08-21,2798,671,1236,1,4706
731,2019-08-22,985,1229,1709,1,3924
731,2019-08-23,554,7188,1630,0,9372
731,2019-08-24,849,2250,1115,0,4214
731,2019-08-25,848,14532,1589,2,16971
731,2019-08-26,646,13025,1309,0,14980
731,2019-08-27,740,8650,1171,2,10563
731,2019-08-28,672,2584,2291,1,5548
731,2019-08-29,729,9616,1299,0,11644
731,2019-08-30,1231,2943,674,1,4849
731,2019-08-31,420,31,2,0,453
731,2019-09-01,847,630,368,0,1845
731,2019-09-02,807,52,39,0,898
731,2019-09-03,569,3514,1506,1,5590
731,2019-09-04,876,10107,1729,0,12712
731,2019-09-05,969,9108,2647,0,12724
731,2019-09-06,1899,10579,2179,0,14657
731,2019-09-07,622,7376,2344,1,10343
731,2019-09-08,687,6344,1646,1,8678
731,2019-09-09,1184,12186,2532,1,15903
731,2019-09-10,522,9529,2110,2,12163
731,2019-09-11,583,7881,1841,1,10306
731,2019-09-12,307,12853,1288,0,14448
731,2019-09-13,383,7695,1837,2,9917
731,2019-09-14,347,6587,1808,1,8743
731,2019-09-15,1990,13402,2072,1,17465
731,2019-09-16,1123,11760,1891,0,14774
731,2019-09-17,401,8925,1800,0,11126
731,2019-09-18,322,12171,1251,0,13744
731,2019-09-19,2296,7626,1911,2,11835
731,2019-09-20,699,12342,2343,2,15386
731,2019-09-21,1391,8648,2115,0,12154
731,2019-09-22,534,8941,1524,1,11000
731,2019-09-23,1993,12956,1827,1,16777
731,2019-09-24,710,8559,1594,4,10867
731,2019-09-25,1299,10243,1754,1,13297
731,2019-09-26,1202,11309,1802,0,14313
731,2019-09-27,448,6781,1675,3,8907
731,2019-09-28,502,15160,1573,2,17237
731,2019-09-29,364,16656,1512,3,18535
731,2019-09-30,338,16023,2824,1,19186
731,2019-10-01,341,17753,1039,0,19133
731,2019-10-02,812,12858,2101,0,15771
731,2019-10-03,340,14763,978,3,16084
731,2019-10-04,436,13938,1548,3,15925
731,2019-10-05,233,15002,1585,0,16820
731,2019-10-06,1779,11643,1626,1,15049
731,2019-10-07,321,6663,1591,0,8575
731,2019-10-08,1210,12502,1389,2,15103
731,2019-10-09,329,14561,2131,1,17022
731,2019-10-10,369,11770,2223,1,14363
731,2019-10-11,291,12700,1214,0,14205
731,2019-10-12,516,7729,2463,0,10708
731,2019-10-13,304,8827,1296,1,10428
731,2019-10-14,285,5748,2351,1,8385
731,2019-10-15,316,9468,2130,0,11914
731,2019-10-16,770,13220,909,1,14900
731,2019-10-17,263,6110,1834,2,8209
731,2019-10-18,268,8594,1610,1,10473
731,2019-10-19,1134,6094,1730,0,8958
731,2019-10-20,2014,2995,1550,1,6560
731,2019-10-21,261,19508,875,1,20645
731,2019-10-22,272,10583,1687,2,12544
731,2019-10-23,1275,8978,1701,1,11955
731,2019-10-24,753,13696,1619,2,16070
731,2019-10-25,295,16046,1712,2,18055
731,2019-10-26,333,16991,2358,0,19682
731,2019-10-27,310,28517,2384,0,31211
731,2019-10-28,721,24500,2540,0,27761
731,2019-10-29,424,17587,2010,4,20025
731,2019-10-30,1208,24034,1127,0,26369
731,2019-10-31,955,15087,1546,3,17591
731,2019-11-01,286,14833,1655,0,16774
731,2019-11-02,377,14352,1292,0,16021
731,2019-11-03,306,22607,1459,3,24375
731,2019-11-04,1268,11559,1160,0,13987
731,2019-11-05,1226,3190,2308,0,6724
731,2019-11-06,418,8205,2134,2,10759
731,2019-11-07,424,22133,2300,2,24859
731,2019-11-08,239,15759,2150,1,18149
731,2019-11-09,254,8734,2358,0,11346
731,2019-11-10,250,14458,2337,0,17045
731,2019-11-11,446,14033,2591,2,17072
731,2019-11-12,1809,12888,2608,2,17307
731,2019-11-13,351,12834,1632,5,14822
731,2019-11-14,2083,8988,2019,0,13090
731,2019-11-15,309,4284,2149,1,6743
731,2019-11-16,301,3109,2422,0,5832
731,2019-11-17,1324,4546,3551,1,9422
731,2019-11-18,917,3515,3379,4,7815
731,2019-11-19,2849,4969,2674,1,10493
731,2019-11-20,2955,1692,2099,1,6747
731,2019-11-21,1823,3912,1739,0,7474
731,2019-11-22,1319,8208,1705,2,11234
731,2019-11-23,1801,6683,2782,5,11271
731,2019-11-24,351,5010,1968,0,7329
731,2019-11-25,340,6846,1781,0,8967
731,2019-11-26,399,6368,1617,0,8384
731,2019-11-27,271,6410,1411,0,8092
731,2019-11-28,316,7272,633,0,8221
731,2019-11-29,89,160,2,0,251
731,2019-08-18,1846,1370,936,1,4153
731,2019-08-19,3360,806,964,0,5130
731,2019-08-20,3409,1904,932,1,6246
731,2019-08-21,2798,671,1236,1,4706
731,2019-08-22,985,1229,1709,1,3924
731,2019-08-23,554,7188,1630,0,9372
731,2019-08-24,849,2250,1115,0,4214
731,2019-08-25,848,14532,1589,2,16971
731,2019-08-26,646,13025,1309,0,14980
731,2019-08-27,740,8650,1171,2,10563
731,2019-08-28,672,2584,2291,1,5548
731,2019-08-29,729,9616,1299,0,11644
731,2019-08-30,1231,2943,674,1,4849
731,2019-08-31,420,31,2,0,453
731,2019-09-01,847,630,368,0,1845
731,2019-09-02,807,52,39,0,898
731,2019-09-03,569,3514,1506,1,5590
731,2019-09-04,876,10107,1729,0,12712
731,2019-09-05,969,9108,2647,0,12724
731,2019-09-06,1899,10579,2179,0,14657
731,2019-09-07,622,7376,2344,1,10343
731,2019-09-08,687,6344,1646,1,8678
731,2019-09-09,1184,12186,2532,1,15903
731,2019-09-10,522,9529,2110,2,12163
731,2019-09-11,583,7881,1841,1,10306
731,2019-09-12,307,12853,1288,0,14448
731,2019-09-13,383,7695,1837,2,9917
731,2019-09-14,347,6587,1808,1,8743
731,2019-09-15,1990,13402,2072,1,17465
731,2019-09-16,1123,11760,1891,0,14774
731,2019-09-17,401,8925,1800,0,11126
731,2019-09-18,322,12171,1251,0,13744
731,2019-09-19,2296,7626,1911,2,11835
731,2019-09-20,699,12342,2343,2,15386
731,2019-09-21,1391,8648,2115,0,12154
731,2019-09-22,534,8941,1524,1,11000
731,2019-09-23,1993,12956,1827,1,16777
731,2019-09-24,710,8559,1594,4,10867
731,2019-09-25,1299,10243,1754,1,13297
731,2019-09-26,1202,11309,1802,0,14313
731,2019-09-27,448,6781,1675,3,8907
731,2019-09-28,502,15160,1573,2,17237
731,2019-09-29,364,16656,1512,3,18535
731,2019-09-30,338,16023,2824,1,19186
731,2019-10-01,341,17753,1039,0,19133
731,2019-10-02,812,12858,2101,0,15771
731,2019-10-03,340,14763,978,3,16084
731,2019-10-04,436,13938,1548,3,15925
731,2019-10-05,233,15002,1585,0,16820
731,2019-10-06,1779,11643,1626,1,15049
731,2019-10-07,321,6663,1591,0,8575
731,2019-10-08,1210,12502,1389,2,15103
731,2019-10-09,329,14561,2131,1,17022
731,2019-10-10,369,11770,2223,1,14363
731,2019-10-11,291,12700,1214,0,14205
731,2019-10-12,516,7729,2463,0,10708
731,2019-10-13,304,8827,1296,1,10428
731,2019-10-14,285,5748,2351,1,8385
731,2019-10-15,316,9468,2130,0,11914
731,2019-10-16,770,13220,909,1,14900
731,2019-10-17,263,6110,1834,2,8209
731,2019-10-18,268,8594,1610,1,10473
731,2019-10-19,1134,6094,1730,0,8958
731,2019-10-20,2014,2995,1550,1,6560
731,2019-10-21,261,19508,875,1,20645
731,2019-10-22,272,10583,1687,2,12544
731,2019-10-23,1275,8978,1701,1,11955
731,2019-10-24,753,13696,1619,2,16070
731,2019-10-25,295,16046,1712,2,18055
731,2019-10-26,333,16991,2358,0,19682
731,2019-10-27,310,28517,2384,0,31211
731,2019-10-28,721,24500,2540,0,27761
731,2019-10-29,424,17587,2010,4,20025
731,2019-10-30,1208,24034,1127,0,26369
731,2019-10-31,955,15087,1546,3,17591
731,2019-11-01,286,14833,1655,0,16774
731,2019-11-02,377,14352,1292,0,16021
731,2019-11-03,306,22607,1459,3,24375
731,2019-11-04,1268,11559,1160,0,13987
731,2019-11-05,1226,3190,2308,0,6724
731,2019-11-06,418,8205,2134,2,10759
731,2019-11-07,424,22133,2300,2,24859
731,2019-11-08,239,15759,2150,1,18149
731,2019-11-09,254,8734,2358,0,11346
731,2019-11-10,250,14458,2337,0,17045
731,2019-11-11,446,14033,2591,2,17072
731,2019-11-12,1809,12888,2608,2,17307
731,2019-11-13,351,12834,1632,5,14822
731,2019-11-14,2083,8988,2019,0,13090
731,2019-11-15,309,4284,2149,1,6743
731,2019-11-16,301,3109,2422,0,5832
731,2019-11-17,1324,4546,3551,1,9422
731,2019-11-18,917,3515,3379,4,7815
731,2019-11-19,2849,4969,2674,1,10493
731,2019-11-20,2955,1692,2099,1,6747
731,2019-11-21,1823,3912,1739,0,7474
731,2019-11-22,1319,8208,1705,2,11234
731,2019-11-23,1801,6683,2782,5,11271
732,2019-08-17,264,590,391,0,1245
732,2019-08-18,532,2375,1065,1,3973
732,2019-08-19,569,13784,1215,0,15568
732,2019-08-20,445,43047,1363,1,44856
732,2019-08-21,446,41618,1040,1,43105
732,2019-08-22,508,24088,1227,4,25827
732,2019-08-23,1726,21513,936,2,24177
732,2019-08-24,724,26639,1218,1,28582
732,2019-08-25,575,32792,1354,2,34723
732,2019-08-26,851,27351,1356,1,29559
732,2019-08-27,557,22075,1561,2,24195
732,2019-08-28,551,28151,1352,2,30056
732,2019-08-29,570,13669,1962,1,16202
732,2019-08-30,426,3336,751,2,4515
732,2019-08-31,135,13397,15,0,13547
732,2019-09-01,203,3669,95,0,3967
732,2019-09-02,177,176,8,0,361
732,2019-09-03,323,1894,1344,1,3562
732,2019-09-04,1467,62534,2203,2,66206
732,2019-09-05,656,14439,1693,2,16790
732,2019-09-06,661,16018,2082,1,18762
732,2019-09-07,679,14201,2201,1,17082
732,2019-09-08,677,4838,2321,0,7836
732,2019-09-09,633,6756,1927,1,9317
732,2019-09-10,695,8703,2245,0,11643
732,2019-09-11,307,7058,1906,2,9273
732,2019-09-12,214,7406,2340,1,9961
732,2019-09-13,581,6321,1968,0,8870
732,2019-09-14,1423,5967,1224,1,8615
732,2019-09-15,1407,14996,2520,1,18924
732,2019-09-16,545,16867,1561,2,18975
732,2019-09-17,1463,10903,2224,1,14591
732,2019-09-18,1051,20270,1267,3,22591
732,2019-09-19,740,9679,1989,0,12408
732,2019-09-20,1484,12078,1544,1,15107
732,2019-09-21,1118,7656,1620,1,10395
732,2019-09-22,2230,14798,2037,3,19068
732,2019-09-23,3177,12673,1906,2,17758
732,2019-09-24,607,9678,2322,3,12610
732,2019-09-25,352,12418,1474,2,14246
732,2019-09-26,312,10822,1769,1,12904
732,2019-09-27,335,11753,2400,2,14490
732,2019-09-28,370,15972,1590,1,17933
732,2019-09-29,329,28682,1543,1,30555
732,2019-09-30,782,19114,1668,0,21564
732,2019-10-01,1155,16543,1248,0,18946
732,2019-10-02,1040,17613,2436,0,21089
732,2019-10-03,604,14678,2321,0,17603
732,2019-10-04,757,18496,1305,3,20561
732,2019-10-05,294,24018,1422,0,25734
732,2019-10-06,274,17620,1640,1,19535
732,2019-10-07,380,7529,2170,4,10083
732,2019-10-08,331,19982,1590,2,21905
732,2019-10-09,733,26420,1485,0,28638
732,2019-10-10,1346,18367,1589,1,21303
732,2019-10-11,625,13555,1540,0,15720
732,2019-10-12,578,8055,1674,4,10311
732,2019-10-13,1229,23246,1855,0,26330
732,2019-10-14,507,20155,1560,2,22224
732,2019-10-15,1288,25395,2264,0,28947
732,2019-10-16,729,34479,941,0,36149
732,2019-10-17,524,19899,1817,5,22245
732,2019-10-18,1312,19889,1193,2,22396
732,2019-10-19,594,17262,1972,2,19830
732,2019-10-20,2328,14890,1734,1,18953
732,2019-10-21,2110,21427,1686,1,25224
732,2019-10-22,544,17974,1687,2,20207
732,2019-10-23,491,19351,1562,1,21405
732,2019-10-24,1048,30845,2103,1,33997
732,2019-10-25,1599,30376,1921,1,33897
732,2019-10-26,480,27825,1509,0,29814
732,2019-10-27,515,38177,1353,0,40045
732,2019-10-28,1454,35456,1244,3,38157
732,2019-10-29,584,40143,1652,1,42380
732,2019-10-30,1249,31900,891,0,34040
732,2019-10-31,512,32400,1611,1,34524
732,2019-11-01,2288,38757,1616,2,42663
732,2019-11-02,840,37615,1321,1,39777
732,2019-11-03,1422,49883,1195,0,52500
732,2019-11-04,1139,24994,1376,0,27509
732,2019-11-05,546,14439,1712,1,16698
732,2019-11-06,547,27017,952,4,28520
732,2019-11-07,664,45327,1149,1,47141
732,2019-11-08,481,26542,801,0,27824
732,2019-11-09,543,21365,1297,1,23206
732,2019-11-10,529,21096,1193,0,22818
732,2019-11-11,1317,14653,658,2,16630
732,2019-11-12,1436,18952,3022,0,23410
732,2019-11-13,526,13939,1463,0,15928
732,2019-11-14,947,9084,2448,0,12479
732,2019-11-15,1426,4277,3019,0,8722
732,2019-11-16,500,3566,2390,0,6456
732,2019-11-17,1466,3692,3590,0,8748
732,2019-11-18,595,3328,3369,0,7292
732,2019-11-19,605,3450,2498,0,6553
732,2019-11-20,534,2254,2373,0,5161
732,2019-11-21,660,3934,1973,0,6567
732,2019-11-22,565,5932,1638,0,8135
732,2019-11-23,1585,6282,2472,0,10339
732,2019-11-24,2389,7346,1617,0,11352
732,2019-11-25,881,7374,2079,0,10334
732,2019-11-26,521,6696,1304,2,8523
732,2019-11-27,1091,6751,951,0,8793
732,2019-11-28,1072,9346,662,0,11080
732,2019-11-29,245,515,13,0,773
732,2019-08-17,264,590,391,0,1245
732,2019-08-18,532,2375,1065,1,3973
732,2019-08-19,569,13784,1215,0,15568
732,2019-08-20,445,43047,1363,1,44856
732,2019-08-21,446,41618,1040,1,43105
732,2019-08-22,508,24088,1227,4,25827
732,2019-08-23,1726,21513,936,2,24177
732,2019-08-24,724,26639,1218,1,28582
732,2019-08-25,575,32792,1354,2,34723
732,2019-08-26,851,27351,1356,1,29559
732,2019-08-27,557,22075,1561,2,24195
732,2019-08-28,551,28151,1352,2,30056
732,2019-08-29,570,13669,1962,1,16202
732,2019-08-30,426,3336,751,2,4515
732,2019-08-31,135,13397,15,0,13547
732,2019-09-01,203,3669,95,0,3967
732,2019-09-02,177,176,8,0,361
732,2019-09-03,323,1894,1344,1,3562
732,2019-09-04,1467,62534,2203,2,66206
732,2019-09-05,656,14439,1693,2,16790
732,2019-09-06,661,16018,2082,1,18762
732,2019-09-07,679,14201,2201,1,17082
732,2019-09-08,677,4838,2321,0,7836
732,2019-09-09,633,6756,1927,1,9317
732,2019-09-10,695,8703,2245,0,11643
732,2019-09-11,307,7058,1906,2,9273
732,2019-09-12,214,7406,2340,1,9961
732,2019-09-13,581,6321,1968,0,8870
732,2019-09-14,1423,5967,1224,1,8615
732,2019-09-15,1407,14996,2520,1,18924
732,2019-09-16,545,16867,1561,2,18975
732,2019-09-17,1463,10903,2224,1,14591
732,2019-09-18,1051,20270,1267,3,22591
732,2019-09-19,740,9679,1989,0,12408
732,2019-09-20,1484,12078,1544,1,15107
732,2019-09-21,1118,7656,1620,1,10395
732,2019-09-22,2230,14798,2037,3,19068
732,2019-09-23,3177,12673,1906,2,17758
732,2019-09-24,607,9678,2322,3,12610
732,2019-09-25,352,12418,1474,2,14246
732,2019-09-26,312,10822,1769,1,12904
732,2019-09-27,335,11753,2400,2,14490
732,2019-09-28,370,15972,1590,1,17933
732,2019-09-29,329,28682,1543,1,30555
732,2019-09-30,782,19114,1668,0,21564
732,2019-10-01,1155,16543,1248,0,18946
732,2019-10-02,1040,17613,2436,0,21089
732,2019-10-03,604,14678,2321,0,17603
732,2019-10-04,757,18496,1305,3,20561
732,2019-10-05,294,24018,1422,0,25734
732,2019-10-06,274,17620,1640,1,19535
732,2019-10-07,380,7529,2170,4,10083
732,2019-10-08,331,19982,1590,2,21905
732,2019-10-09,733,26420,1485,0,28638
732,2019-10-10,1346,18367,1589,1,21303
732,2019-10-11,625,13555,1540,0,15720
732,2019-10-12,578,8055,1674,4,10311
732,2019-10-13,1229,23246,1855,0,26330
732,2019-10-14,507,20155,1560,2,22224
732,2019-10-15,1288,25395,2264,0,28947
732,2019-10-16,729,34479,941,0,36149
732,2019-10-17,524,19899,1817,5,22245
732,2019-10-18,1312,19889,1193,2,22396
732,2019-10-19,594,17262,1972,2,19830
732,2019-10-20,2328,14890,1734,1,18953
732,2019-10-21,2110,21427,1686,1,25224
732,2019-10-22,544,17974,1687,2,20207
732,2019-10-23,491,19351,1562,1,21405
732,2019-10-24,1048,30845,2103,1,33997
732,2019-10-25,1599,30376,1921,1,33897
732,2019-10-26,480,27825,1509,0,29814
732,2019-10-27,515,38177,1353,0,40045
732,2019-10-28,1454,35456,1244,3,38157
732,2019-10-29,584,40143,1652,1,42380
732,2019-10-30,1249,31900,891,0,34040
732,2019-10-31,512,32400,1611,1,34524
732,2019-11-01,2288,38757,1616,2,42663
732,2019-11-02,840,37615,1321,1,39777
732,2019-11-03,1422,49883,1195,0,52500
732,2019-11-04,1139,24994,1376,0,27509
732,2019-11-05,546,14439,1712,1,16698
732,2019-11-06,547,27017,952,4,28520
732,2019-11-07,664,45327,1149,1,47141
732,2019-11-08,481,26542,801,0,27824
732,2019-11-09,543,21365,1297,1,23206
732,2019-11-10,529,21096,1193,0,22818
732,2019-11-11,1317,14653,658,2,16630
732,2019-11-12,1436,18952,3022,0,23410
732,2019-11-13,526,13939,1463,0,15928
732,2019-11-14,947,9084,2448,0,12479
732,2019-11-15,1426,4277,3019,0,8722
732,2019-11-16,500,3566,2390,0,6456
732,2019-11-17,1466,3692,3590,0,8748
732,2019-11-18,595,3328,3369,0,7292
732,2019-11-19,605,3450,2498,0,6553
732,2019-11-20,534,2254,2373,0,5161
732,2019-11-21,660,3934,1973,0,6567
732,2019-11-22,565,5932,1638,0,8135
732,2019-11-23,1585,6282,2472,0,10339
732,2019-11-24,2389,7346,1617,0,11352
732,2019-11-25,881,7374,2079,0,10334
732,2019-11-26,521,6696,1304,2,8523
732,2019-11-27,1091,6751,951,0,8793
732,2019-11-28,1072,9346,662,0,11080
732,2019-11-29,245,515,13,0,773
732,2019-08-17,264,590,391,0,1245
732,2019-08-18,532,2375,1065,1,3973
732,2019-08-19,569,13784,1215,0,15568
732,2019-08-20,445,43047,1363,1,44856
732,2019-08-21,446,41618,1040,1,43105
732,2019-08-22,508,24088,1227,4,25827
732,2019-08-23,1726,21513,936,2,24177
732,2019-08-24,724,26639,1218,1,28582
732,2019-08-25,575,32792,1354,2,34723
732,2019-08-26,851,27351,1356,1,29559
732,2019-08-27,557,22075,1561,2,24195
732,2019-08-28,551,28151,1352,2,30056
732,2019-08-29,570,13669,1962,1,16202
732,2019-08-30,426,3336,751,2,4515
732,2019-08-31,135,13397,15,0,13547
732,2019-09-01,203,3669,95,0,3967
732,2019-09-02,177,176,8,0,361
732,2019-09-03,323,1894,1344,1,3562
732,2019-09-04,1467,62534,2203,2,66206
732,2019-09-05,656,14439,1693,2,16790
732,2019-09-06,661,16018,2082,1,18762
732,2019-09-07,679,14201,2201,1,17082
732,2019-09-08,677,4838,2321,0,7836
732,2019-09-09,633,6756,1927,1,9317
732,2019-09-10,695,8703,2245,0,11643
732,2019-09-11,307,7058,1906,2,9273
732,2019-09-12,214,7406,2340,1,9961
732,2019-09-13,581,6321,1968,0,8870
732,2019-09-14,1423,5967,1224,1,8615
732,2019-09-15,1407,14996,2520,1,18924
732,2019-09-16,545,16867,1561,2,18975
732,2019-09-17,1463,10903,2224,1,14591
732,2019-09-18,1051,20270,1267,3,22591
732,2019-09-19,740,9679,1989,0,12408
732,2019-09-20,1484,12078,1544,1,15107
732,2019-09-21,1118,7656,1620,1,10395
732,2019-09-22,2230,14798,2037,3,19068
732,2019-09-23,3177,12673,1906,2,17758
732,2019-09-24,607,9678,2322,3,12610
732,2019-09-25,352,12418,1474,2,14246
732,2019-09-26,312,10822,1769,1,12904
732,2019-09-27,335,11753,2400,2,14490
732,2019-09-28,370,15972,1590,1,17933
732,2019-09-29,329,28682,1543,1,30555
732,2019-09-30,782,19114,1668,0,21564
732,2019-10-01,1155,16543,1248,0,18946
732,2019-10-02,1040,17613,2436,0,21089
732,2019-10-03,604,14678,2321,0,17603
732,2019-10-04,757,18496,1305,3,20561
732,2019-10-05,294,24018,1422,0,25734
732,2019-10-06,274,17620,1640,1,19535
732,2019-10-07,380,7529,2170,4,10083
732,2019-10-08,331,19982,1590,2,21905
732,2019-10-09,733,26420,1485,0,28638
732,2019-10-10,1346,18367,1589,1,21303
732,2019-10-11,625,13555,1540,0,15720
732,2019-10-12,578,8055,1674,4,10311
732,2019-10-13,1229,23246,1855,0,26330
732,2019-10-14,507,20155,1560,2,22224
732,2019-10-15,1288,25395,2264,0,28947
732,2019-10-16,729,34479,941,0,36149
732,2019-10-17,524,19899,1817,5,22245
732,2019-10-18,1312,19889,1193,2,22396
732,2019-10-19,594,17262,1972,2,19830
732,2019-10-20,2328,14890,1734,1,18953
732,2019-10-21,2110,21427,1686,1,25224
732,2019-10-22,544,17974,1687,2,20207
732,2019-10-23,491,19351,1562,1,21405
732,2019-10-24,1048,30845,2103,1,33997
732,2019-10-25,1599,30376,1921,1,33897
732,2019-10-26,480,27825,1509,0,29814
732,2019-10-27,515,38177,1353,0,40045
732,2019-10-28,1454,35456,1244,3,38157
732,2019-10-29,584,40143,1652,1,42380
732,2019-10-30,1249,31900,891,0,34040
732,2019-10-31,512,32400,1611,1,34524
732,2019-11-01,2288,38757,1616,2,42663
732,2019-11-02,840,37615,1321,1,39777
732,2019-11-03,1422,49883,1195,0,52500
732,2019-11-04,1139,24994,1376,0,27509
732,2019-11-05,546,14439,1712,1,16698
732,2019-11-06,547,27017,952,4,28520
732,2019-11-07,664,45327,1149,1,47141
732,2019-11-08,481,26542,801,0,27824
732,2019-11-09,543,21365,1297,1,23206
732,2019-11-10,529,21096,1193,0,22818
732,2019-11-11,1317,14653,658,2,16630
732,2019-11-12,1436,18952,3022,0,23410
732,2019-11-13,526,13939,1463,0,15928
732,2019-11-14,947,9084,2448,0,12479
732,2019-11-15,1426,4277,3019,0,8722
732,2019-11-16,500,3566,2390,0,6456
732,2019-11-17,1466,3692,3590,0,8748
732,2019-11-18,595,3328,3369,0,7292
732,2019-11-19,605,3450,2498,0,6553
732,2019-11-20,534,2254,2373,0,5161
732,2019-11-21,660,3934,1973,0,6567
732,2019-11-22,565,5932,1638,0,8135
732,2019-11-23,1585,6282,2472,0,10339
732,2019-11-24,2389,7346,1617,0,11352
732,2019-11-25,881,7374,2079,0,10334
732,2019-11-26,521,6696,1304,2,8523
732,2019-11-27,1091,6751,951,0,8793
732,2019-11-28,1072,9346,662,0,11080
732,2019-11-29,245,515,13,0,773
732,2019-08-18,532,2375,1065,1,3973
732,2019-08-19,569,13784,1215,0,15568
732,2019-08-20,445,43047,1363,1,44856
732,2019-08-21,446,41618,1040,1,43105
732,2019-08-22,508,24088,1227,4,25827
732,2019-08-23,1726,21513,936,2,24177
732,2019-08-24,724,26639,1218,1,28582
732,2019-08-25,575,32792,1354,2,34723
732,2019-08-26,851,27351,1356,1,29559
732,2019-08-27,557,22075,1561,2,24195
732,2019-08-28,551,28151,1352,2,30056
732,2019-08-29,570,13669,1962,1,16202
732,2019-08-30,426,3336,751,2,4515
732,2019-08-31,135,13397,15,0,13547
732,2019-09-01,203,3669,95,0,3967
732,2019-09-02,177,176,8,0,361
732,2019-09-03,323,1894,1344,1,3562
732,2019-09-04,1467,62534,2203,2,66206
732,2019-09-05,656,14439,1693,2,16790
732,2019-09-06,661,16018,2082,1,18762
732,2019-09-07,679,14201,2201,1,17082
732,2019-09-08,677,4838,2321,0,7836
732,2019-09-09,633,6756,1927,1,9317
732,2019-09-10,695,8703,2245,0,11643
732,2019-09-11,307,7058,1906,2,9273
732,2019-09-12,214,7406,2340,1,9961
732,2019-09-13,581,6321,1968,0,8870
732,2019-09-14,1423,5967,1224,1,8615
732,2019-09-15,1407,14996,2520,1,18924
732,2019-09-16,545,16867,1561,2,18975
732,2019-09-17,1463,10903,2224,1,14591
732,2019-09-18,1051,20270,1267,3,22591
732,2019-09-19,740,9679,1989,0,12408
732,2019-09-20,1484,12078,1544,1,15107
732,2019-09-21,1118,7656,1620,1,10395
732,2019-09-22,2230,14798,2037,3,19068
732,2019-09-23,3177,12673,1906,2,17758
732,2019-09-24,607,9678,2322,3,12610
732,2019-09-25,352,12418,1474,2,14246
732,2019-09-26,312,10822,1769,1,12904
732,2019-09-27,335,11753,2400,2,14490
732,2019-09-28,370,15972,1590,1,17933
732,2019-09-29,329,28682,1543,1,30555
732,2019-09-30,782,19114,1668,0,21564
732,2019-10-01,1155,16543,1248,0,18946
732,2019-10-02,1040,17613,2436,0,21089
732,2019-10-03,604,14678,2321,0,17603
732,2019-10-04,757,18496,1305,3,20561
732,2019-10-05,294,24018,1422,0,25734
732,2019-10-06,274,17620,1640,1,19535
732,2019-10-07,380,7529,2170,4,10083
732,2019-10-08,331,19982,1590,2,21905
732,2019-10-09,733,26420,1485,0,28638
732,2019-10-10,1346,18367,1589,1,21303
732,2019-10-11,625,13555,1540,0,15720
732,2019-10-12,578,8055,1674,4,10311
732,2019-10-13,1229,23246,1855,0,26330
732,2019-10-14,507,20155,1560,2,22224
732,2019-10-15,1288,25395,2264,0,28947
732,2019-10-16,729,34479,941,0,36149
732,2019-10-17,524,19899,1817,5,22245
732,2019-10-18,1312,19889,1193,2,22396
732,2019-10-19,594,17262,1972,2,19830
732,2019-10-20,2328,14890,1734,1,18953
732,2019-10-21,2110,21427,1686,1,25224
732,2019-10-22,544,17974,1687,2,20207
732,2019-10-23,491,19351,1562,1,21405
732,2019-10-24,1048,30845,2103,1,33997
732,2019-10-25,1599,30376,1921,1,33897
732,2019-10-26,480,27825,1509,0,29814
732,2019-10-27,515,38177,1353,0,40045
732,2019-10-28,1454,35456,1244,3,38157
732,2019-10-29,584,40143,1652,1,42380
732,2019-10-30,1249,31900,891,0,34040
732,2019-10-31,512,32400,1611,1,34524
732,2019-11-01,2288,38757,1616,2,42663
732,2019-11-02,840,37615,1321,1,39777
732,2019-11-03,1422,49883,1195,0,52500
732,2019-11-04,1139,24994,1376,0,27509
732,2019-11-05,546,14439,1712,1,16698
732,2019-11-06,547,27017,952,4,28520
732,2019-11-07,664,45327,1149,1,47141
732,2019-11-08,481,26542,801,0,27824
732,2019-11-09,543,21365,1297,1,23206
732,2019-11-10,529,21096,1193,0,22818
732,2019-11-11,1317,14653,658,2,16630
732,2019-11-12,1436,18952,3022,0,23410
732,2019-11-13,526,13939,1463,0,15928
732,2019-11-14,947,9084,2448,0,12479
732,2019-11-15,1426,4277,3019,0,8722
732,2019-11-16,500,3566,2390,0,6456
732,2019-11-17,1466,3692,3590,0,8748
732,2019-11-18,595,3328,3369,0,7292
732,2019-11-19,605,3450,2498,0,6553
732,2019-11-20,534,2254,2373,0,5161
732,2019-11-21,660,3934,1973,0,6567
732,2019-11-22,565,5932,1638,0,8135
732,2019-11-23,1585,6282,2472,0,10339
732,2019-11-24,2389,7346,1617,0,11352
732,2019-11-25,881,7374,2079,0,10334
732,2019-11-26,521,6696,1304,2,8523
735,2019-08-17,245,1183,475,0,1903
735,2019-08-18,428,1520,1339,0,3287
735,2019-08-19,519,4075,927,1,5522
735,2019-08-20,352,1304,946,0,2602
735,2019-08-21,327,2837,1099,0,4263
735,2019-08-22,379,907,1010,1,2297
735,2019-08-23,401,8539,1280,0,10220
735,2019-08-24,375,6694,2430,0,9499
735,2019-08-25,1161,4209,1710,1,7081
735,2019-08-26,255,1299,1179,0,2733
735,2019-08-27,277,5140,2069,0,7486
735,2019-08-28,1077,11220,1507,0,13804
735,2019-08-29,360,12647,1648,2,14657
735,2019-08-30,344,2773,801,0,3918
735,2019-08-31,81,44,3,0,128
735,2019-09-01,155,1154,539,0,1848
735,2019-09-02,207,285,106,0,598
735,2019-09-03,120,539,916,1,1576
735,2019-09-04,270,13620,1863,0,15753
735,2019-09-05,1105,15970,1304,0,18379
735,2019-09-06,340,10189,1833,1,12363
735,2019-09-07,2236,10505,1547,0,14288
735,2019-09-08,1881,6833,1738,2,10454
735,2019-09-09,1225,10958,1458,2,13643
735,2019-09-10,268,10658,1662,1,12589
735,2019-09-11,1056,6734,1936,3,9729
735,2019-09-12,1026,8762,2061,0,11849
735,2019-09-13,462,4211,2820,1,7494
735,2019-09-14,315,9813,2393,1,12522
735,2019-09-15,257,12381,2180,1,14819
735,2019-09-16,270,14775,2009,1,17055
735,2019-09-17,1161,12041,2250,2,15454
735,2019-09-18,1288,11434,1733,1,14456
735,2019-09-19,457,2426,2323,1,5207
735,2019-09-20,295,13176,2307,1,15779
735,2019-09-21,363,10578,2048,1,12990
735,2019-09-22,1106,9568,1082,3,11759
735,2019-09-23,327,12989,2232,0,15548
735,2019-09-24,1272,10287,1577,3,13139
735,2019-09-25,218,10908,1552,2,12680
735,2019-09-26,1123,14653,2001,1,17778
735,2019-09-27,215,6822,2290,4,9331
735,2019-09-28,191,17442,1763,2,19398
735,2019-09-29,144,17330,2183,1,19658
735,2019-09-30,970,17256,1529,0,19755
735,2019-10-01,113,22340,1378,2,23833
735,2019-10-02,533,14445,1774,1,16753
735,2019-10-03,153,24274,1307,0,25734
735,2019-10-04,1014,20290,1417,1,22722
735,2019-10-05,859,17157,1787,0,19803
735,2019-10-06,986,11972,1913,1,14872
735,2019-10-07,136,7877,1941,2,9956
735,2019-10-08,168,18475,2173,1,20817
735,2019-10-09,926,17620,1629,0,20175
735,2019-10-10,332,10769,1999,0,13100
735,2019-10-11,459,11113,1688,1,13261
735,2019-10-12,1558,7194,2200,4,10956
735,2019-10-13,305,9353,1014,1,10673
735,2019-10-14,218,8109,1503,2,9832
735,2019-10-15,1459,10422,1775,1,13657
735,2019-10-16,261,12796,1889,2,14948
735,2019-10-17,267,7031,2113,2,9413
735,2019-10-18,1185,8585,1703,0,11473
735,2019-10-19,1121,5585,2738,1,9445
735,2019-10-20,256,2913,1635,0,4804
735,2019-10-21,251,19345,1151,2,20749
735,2019-10-22,1182,10292,2354,2,13830
735,2019-10-23,1189,15199,1886,1,18275
735,2019-10-24,430,25734,1181,2,27347
735,2019-10-25,290,19455,1103,1,20849
735,2019-10-26,487,17115,1873,0,19475
735,2019-10-27,2865,28889,1096,1,32851
735,2019-10-28,241,16565,1349,2,18157
735,2019-10-29,298,26715,1949,0,28962
735,2019-10-30,260,22176,1300,0,23736
735,2019-10-31,252,20926,1134,1,22313
735,2019-11-01,203,27772,1406,3,29384
735,2019-11-02,360,27906,1442,0,29708
735,2019-11-03,226,40353,1913,0,42492
735,2019-11-04,1154,13475,1832,0,16461
735,2019-11-05,281,5777,1455,0,7513
735,2019-11-06,226,15675,1748,10,17659
735,2019-11-07,776,16820,1386,2,18984
735,2019-11-08,296,10405,1347,0,12048
735,2019-11-09,260,9120,2060,0,11440
735,2019-11-10,308,24745,2385,0,27438
735,2019-11-11,271,16634,2205,4,19114
735,2019-11-12,251,18145,2745,1,21142
735,2019-11-13,1184,23630,1934,0,26748
735,2019-11-14,424,14226,2693,2,17345
735,2019-11-15,231,4394,2706,0,7331
735,2019-11-16,257,4852,1892,2,7003
735,2019-11-17,279,3893,2842,0,7014
735,2019-11-18,367,3270,3224,0,6861
735,2019-11-19,882,5089,2230,1,8202
735,2019-11-20,300,1325,2005,2,3632
735,2019-11-21,314,4079,2006,2,6401
735,2019-11-22,492,4819,1354,1,6666
735,2019-11-23,293,10834,2746,2,13875
735,2019-11-24,338,9114,2537,1,11990
735,2019-11-25,240,7617,2017,0,9874
735,2019-11-26,243,10289,1617,2,12151
735,2019-11-27,693,10938,1165,1,12797
735,2019-11-28,447,7709,917,0,9073
735,2019-11-29,127,649,54,0,830
735,2019-08-17,245,1183,475,0,1903
735,2019-08-18,428,1520,1339,0,3287
735,2019-08-19,519,4075,927,1,5522
735,2019-08-20,352,1304,946,0,2602
735,2019-08-21,327,2837,1099,0,4263
735,2019-08-22,379,907,1010,1,2297
735,2019-08-23,401,8539,1280,0,10220
735,2019-08-24,375,6694,2430,0,9499
735,2019-08-25,1161,4209,1710,1,7081
735,2019-08-26,255,1299,1179,0,2733
735,2019-08-27,277,5140,2069,0,7486
735,2019-08-28,1077,11220,1507,0,13804
735,2019-08-29,360,12647,1648,2,14657
735,2019-08-30,344,2773,801,0,3918
735,2019-08-31,81,44,3,0,128
735,2019-09-01,155,1154,539,0,1848
735,2019-09-02,207,285,106,0,598
735,2019-09-03,120,539,916,1,1576
735,2019-09-04,270,13620,1863,0,15753
735,2019-09-05,1105,15970,1304,0,18379
735,2019-09-06,340,10189,1833,1,12363
735,2019-09-07,2236,10505,1547,0,14288
735,2019-09-08,1881,6833,1738,2,10454
735,2019-09-09,1225,10958,1458,2,13643
735,2019-09-10,268,10658,1662,1,12589
735,2019-09-11,1056,6734,1936,3,9729
735,2019-09-12,1026,8762,2061,0,11849
735,2019-09-13,462,4211,2820,1,7494
735,2019-09-14,315,9813,2393,1,12522
735,2019-09-15,257,12381,2180,1,14819
735,2019-09-16,270,14775,2009,1,17055
735,2019-09-17,1161,12041,2250,2,15454
735,2019-09-18,1288,11434,1733,1,14456
735,2019-09-19,457,2426,2323,1,5207
735,2019-09-20,295,13176,2307,1,15779
735,2019-09-21,363,10578,2048,1,12990
735,2019-09-22,1106,9568,1082,3,11759
735,2019-09-23,327,12989,2232,0,15548
735,2019-09-24,1272,10287,1577,3,13139
735,2019-09-25,218,10908,1552,2,12680
735,2019-09-26,1123,14653,2001,1,17778
735,2019-09-27,215,6822,2290,4,9331
735,2019-09-28,191,17442,1763,2,19398
735,2019-09-29,144,17330,2183,1,19658
735,2019-09-30,970,17256,1529,0,19755
735,2019-10-01,113,22340,1378,2,23833
735,2019-10-02,533,14445,1774,1,16753
735,2019-10-03,153,24274,1307,0,25734
735,2019-10-04,1014,20290,1417,1,22722
735,2019-10-05,859,17157,1787,0,19803
735,2019-10-06,986,11972,1913,1,14872
735,2019-10-07,136,7877,1941,2,9956
735,2019-10-08,168,18475,2173,1,20817
735,2019-10-09,926,17620,1629,0,20175
735,2019-10-10,332,10769,1999,0,13100
735,2019-10-11,459,11113,1688,1,13261
735,2019-10-12,1558,7194,2200,4,10956
735,2019-10-13,305,9353,1014,1,10673
735,2019-10-14,218,8109,1503,2,9832
735,2019-10-15,1459,10422,1775,1,13657
735,2019-10-16,261,12796,1889,2,14948
735,2019-10-17,267,7031,2113,2,9413
735,2019-10-18,1185,8585,1703,0,11473
735,2019-10-19,1121,5585,2738,1,9445
735,2019-10-20,256,2913,1635,0,4804
735,2019-10-21,251,19345,1151,2,20749
735,2019-10-22,1182,10292,2354,2,13830
735,2019-10-23,1189,15199,1886,1,18275
735,2019-10-24,430,25734,1181,2,27347
735,2019-10-25,290,19455,1103,1,20849
735,2019-10-26,487,17115,1873,0,19475
735,2019-10-27,2865,28889,1096,1,32851
735,2019-10-28,241,16565,1349,2,18157
735,2019-10-29,298,26715,1949,0,28962
735,2019-10-30,260,22176,1300,0,23736
735,2019-10-31,252,20926,1134,1,22313
735,2019-11-01,203,27772,1406,3,29384
735,2019-11-02,360,27906,1442,0,29708
735,2019-11-03,226,40353,1913,0,42492
735,2019-11-04,1154,13475,1832,0,16461
735,2019-11-05,281,5777,1455,0,7513
735,2019-11-06,226,15675,1748,10,17659
735,2019-11-07,776,16820,1386,2,18984
735,2019-11-08,296,10405,1347,0,12048
735,2019-11-09,260,9120,2060,0,11440
735,2019-11-10,308,24745,2385,0,27438
735,2019-11-11,271,16634,2205,4,19114
735,2019-11-12,251,18145,2745,1,21142
735,2019-11-13,1184,23630,1934,0,26748
735,2019-11-14,424,14226,2693,2,17345
735,2019-11-15,231,4394,2706,0,7331
735,2019-11-16,257,4852,1892,2,7003
735,2019-11-17,279,3893,2842,0,7014
735,2019-11-18,367,3270,3224,0,6861
735,2019-11-19,882,5089,2230,1,8202
735,2019-11-20,300,1325,2005,2,3632
735,2019-11-21,314,4079,2006,2,6401
735,2019-11-22,492,4819,1354,1,6666
735,2019-11-23,293,10834,2746,2,13875
735,2019-11-24,338,9114,2537,1,11990
735,2019-11-25,240,7617,2017,0,9874
735,2019-11-26,243,10289,1617,2,12151
735,2019-11-27,693,10938,1165,1,12797
735,2019-11-28,447,7709,917,0,9073
735,2019-11-29,127,649,54,0,830
735,2019-08-17,245,1183,475,0,1903
735,2019-08-18,428,1520,1339,0,3287
735,2019-08-19,519,4075,927,1,5522
735,2019-08-20,352,1304,946,0,2602
735,2019-08-21,327,2837,1099,0,4263
735,2019-08-22,379,907,1010,1,2297
735,2019-08-23,401,8539,1280,0,10220
735,2019-08-24,375,6694,2430,0,9499
735,2019-08-25,1161,4209,1710,1,7081
735,2019-08-26,255,1299,1179,0,2733
735,2019-08-27,277,5140,2069,0,7486
735,2019-08-28,1077,11220,1507,0,13804
735,2019-08-29,360,12647,1648,2,14657
735,2019-08-30,344,2773,801,0,3918
735,2019-08-31,81,44,3,0,128
735,2019-09-01,155,1154,539,0,1848
735,2019-09-02,207,285,106,0,598
735,2019-09-03,120,539,916,1,1576
735,2019-09-04,270,13620,1863,0,15753
735,2019-09-05,1105,15970,1304,0,18379
735,2019-09-06,340,10189,1833,1,12363
735,2019-09-07,2236,10505,1547,0,14288
735,2019-09-08,1881,6833,1738,2,10454
735,2019-09-09,1225,10958,1458,2,13643
735,2019-09-10,268,10658,1662,1,12589
735,2019-09-11,1056,6734,1936,3,9729
735,2019-09-12,1026,8762,2061,0,11849
735,2019-09-13,462,4211,2820,1,7494
735,2019-09-14,315,9813,2393,1,12522
735,2019-09-15,257,12381,2180,1,14819
735,2019-09-16,270,14775,2009,1,17055
735,2019-09-17,1161,12041,2250,2,15454
735,2019-09-18,1288,11434,1733,1,14456
735,2019-09-19,457,2426,2323,1,5207
735,2019-09-20,295,13176,2307,1,15779
735,2019-09-21,363,10578,2048,1,12990
735,2019-09-22,1106,9568,1082,3,11759
735,2019-09-23,327,12989,2232,0,15548
735,2019-09-24,1272,10287,1577,3,13139
735,2019-09-25,218,10908,1552,2,12680
735,2019-09-26,1123,14653,2001,1,17778
735,2019-09-27,215,6822,2290,4,9331
735,2019-09-28,191,17442,1763,2,19398
735,2019-09-29,144,17330,2183,1,19658
735,2019-09-30,970,17256,1529,0,19755
735,2019-10-01,113,22340,1378,2,23833
735,2019-10-02,533,14445,1774,1,16753
735,2019-10-03,153,24274,1307,0,25734
735,2019-10-04,1014,20290,1417,1,22722
735,2019-10-05,859,17157,1787,0,19803
735,2019-10-06,986,11972,1913,1,14872
735,2019-10-07,136,7877,1941,2,9956
735,2019-10-08,168,18475,2173,1,20817
735,2019-10-09,926,17620,1629,0,20175
735,2019-10-10,332,10769,1999,0,13100
735,2019-10-11,459,11113,1688,1,13261
735,2019-10-12,1558,7194,2200,4,10956
735,2019-10-13,305,9353,1014,1,10673
735,2019-10-14,218,8109,1503,2,9832
735,2019-10-15,1459,10422,1775,1,13657
735,2019-10-16,261,12796,1889,2,14948
735,2019-10-17,267,7031,2113,2,9413
735,2019-10-18,1185,8585,1703,0,11473
735,2019-10-19,1121,5585,2738,1,9445
735,2019-10-20,256,2913,1635,0,4804
735,2019-10-21,251,19345,1151,2,20749
735,2019-10-22,1182,10292,2354,2,13830
735,2019-10-23,1189,15199,1886,1,18275
735,2019-10-24,430,25734,1181,2,27347
735,2019-10-25,290,19455,1103,1,20849
735,2019-10-26,487,17115,1873,0,19475
735,2019-10-27,2865,28889,1096,1,32851
735,2019-10-28,241,16565,1349,2,18157
735,2019-10-29,298,26715,1949,0,28962
735,2019-10-30,260,22176,1300,0,23736
735,2019-10-31,252,20926,1134,1,22313
735,2019-11-01,203,27772,1406,3,29384
735,2019-11-02,360,27906,1442,0,29708
735,2019-11-03,226,40353,1913,0,42492
735,2019-11-04,1154,13475,1832,0,16461
735,2019-11-05,281,5777,1455,0,7513
735,2019-11-06,226,15675,1748,10,17659
735,2019-11-07,776,16820,1386,2,18984
735,2019-11-08,296,10405,1347,0,12048
735,2019-11-09,260,9120,2060,0,11440
735,2019-11-10,308,24745,2385,0,27438
735,2019-11-11,271,16634,2205,4,19114
735,2019-11-12,251,18145,2745,1,21142
735,2019-11-13,1184,23630,1934,0,26748
735,2019-11-14,424,14226,2693,2,17345
735,2019-11-15,231,4394,2706,0,7331
735,2019-11-16,257,4852,1892,2,7003
735,2019-11-17,279,3893,2842,0,7014
735,2019-11-18,367,3270,3224,0,6861
735,2019-11-19,882,5089,2230,1,8202
735,2019-11-20,300,1325,2005,2,3632
735,2019-11-21,314,4079,2006,2,6401
735,2019-11-22,492,4819,1354,1,6666
735,2019-11-23,293,10834,2746,2,13875
735,2019-11-24,338,9114,2537,1,11990
735,2019-11-25,240,7617,2017,0,9874
735,2019-11-26,243,10289,1617,2,12151
735,2019-11-27,693,10938,1165,1,12797
735,2019-11-28,447,7709,917,0,9073
735,2019-11-29,127,649,54,0,830
735,2019-08-19,519,4075,927,1,5522
735,2019-08-20,352,1304,946,0,2602
735,2019-08-21,327,2837,1099,0,4263
735,2019-08-22,379,907,1010,1,2297
735,2019-08-23,401,8539,1280,0,10220
735,2019-08-24,375,6694,2430,0,9499
735,2019-08-25,1161,4209,1710,1,7081
735,2019-08-26,255,1299,1179,0,2733
735,2019-08-27,277,5140,2069,0,7486
735,2019-08-28,1077,11220,1507,0,13804
735,2019-08-29,360,12647,1648,2,14657
735,2019-08-30,344,2773,801,0,3918
735,2019-08-31,81,44,3,0,128
735,2019-09-01,155,1154,539,0,1848
735,2019-09-02,207,285,106,0,598
735,2019-09-03,120,539,916,1,1576
735,2019-09-04,270,13620,1863,0,15753
735,2019-09-05,1105,15970,1304,0,18379
735,2019-09-06,340,10189,1833,1,12363
735,2019-09-07,2236,10505,1547,0,14288
735,2019-09-08,1881,6833,1738,2,10454
735,2019-09-09,1225,10958,1458,2,13643
735,2019-09-10,268,10658,1662,1,12589
735,2019-09-11,1056,6734,1936,3,9729
735,2019-09-12,1026,8762,2061,0,11849
735,2019-09-13,462,4211,2820,1,7494
735,2019-09-14,315,9813,2393,1,12522
735,2019-09-15,257,12381,2180,1,14819
735,2019-09-16,270,14775,2009,1,17055
735,2019-09-17,1161,12041,2250,2,15454
735,2019-09-18,1288,11434,1733,1,14456
735,2019-09-19,457,2426,2323,1,5207
735,2019-09-20,295,13176,2307,1,15779
735,2019-09-21,363,10578,2048,1,12990
735,2019-09-22,1106,9568,1082,3,11759
735,2019-09-23,327,12989,2232,0,15548
735,2019-09-24,1272,10287,1577,3,13139
735,2019-09-25,218,10908,1552,2,12680
735,2019-09-26,1123,14653,2001,1,17778
735,2019-09-27,215,6822,2290,4,9331
735,2019-09-28,191,17442,1763,2,19398
735,2019-09-29,144,17330,2183,1,19658
735,2019-09-30,970,17256,1529,0,19755
735,2019-10-01,113,22340,1378,2,23833
735,2019-10-02,533,14445,1774,1,16753
735,2019-10-03,153,24274,1307,0,25734
735,2019-10-04,1014,20290,1417,1,22722
735,2019-10-05,859,17157,1787,0,19803
735,2019-10-06,986,11972,1913,1,14872
735,2019-10-07,136,7877,1941,2,9956
735,2019-10-08,168,18475,2173,1,20817
735,2019-10-09,926,17620,1629,0,20175
735,2019-10-10,332,10769,1999,0,13100
735,2019-10-11,459,11113,1688,1,13261
735,2019-10-12,1558,7194,2200,4,10956
735,2019-10-13,305,9353,1014,1,10673
735,2019-10-14,218,8109,1503,2,9832
735,2019-10-15,1459,10422,1775,1,13657
735,2019-10-16,261,12796,1889,2,14948
735,2019-10-17,267,7031,2113,2,9413
735,2019-10-18,1185,8585,1703,0,11473
735,2019-10-19,1121,5585,2738,1,9445
735,2019-10-20,256,2913,1635,0,4804
735,2019-10-21,251,19345,1151,2,20749
735,2019-10-22,1182,10292,2354,2,13830
735,2019-10-23,1189,15199,1886,1,18275
735,2019-10-24,430,25734,1181,2,27347
735,2019-10-25,290,19455,1103,1,20849
735,2019-10-26,487,17115,1873,0,19475
735,2019-10-27,2865,28889,1096,1,32851
735,2019-10-28,241,16565,1349,2,18157
735,2019-10-29,298,26715,1949,0,28962
735,2019-10-30,260,22176,1300,0,23736
735,2019-10-31,252,20926,1134,1,22313
735,2019-11-01,203,27772,1406,3,29384
735,2019-11-02,360,27906,1442,0,29708
735,2019-11-03,226,40353,1913,0,42492
735,2019-11-04,1154,13475,1832,0,16461
735,2019-11-05,281,5777,1455,0,7513
735,2019-11-06,226,15675,1748,10,17659
735,2019-11-07,776,16820,1386,2,18984
735,2019-11-08,296,10405,1347,0,12048
735,2019-11-09,260,9120,2060,0,11440
735,2019-11-10,308,24745,2385,0,27438
735,2019-11-11,271,16634,2205,4,19114
735,2019-11-12,251,18145,2745,1,21142
735,2019-11-13,1184,23630,1934,0,26748
735,2019-11-14,424,14226,2693,2,17345
735,2019-11-15,231,4394,2706,0,7331
735,2019-11-16,257,4852,1892,2,7003
735,2019-11-17,279,3893,2842,0,7014
735,2019-11-18,367,3270,3224,0,6861
735,2019-11-19,882,5089,2230,1,8202
735,2019-11-20,300,1325,2005,2,3632
735,2019-11-21,314,4079,2006,2,6401
735,2019-11-22,492,4819,1354,1,6666
735,2019-11-23,293,10834,2746,2,13875
735,2019-11-24,338,9114,2537,1,11990
735,2019-11-25,240,7617,2017,0,9874
735,2019-11-26,243,10289,1617,2,12151
735,2019-11-27,693,10938,1165,1,12797
736,2019-08-17,85,1604,802,0,2491
736,2019-08-18,611,2412,1767,1,4791
736,2019-08-19,479,1591,1578,1,3649
736,2019-08-20,396,1533,961,0,2890
736,2019-08-21,332,2614,1701,2,4649
736,2019-08-22,401,2614,1386,1,4402
736,2019-08-23,2030,1764,1919,3,5716
736,2019-08-24,401,1715,1129,1,3246
736,2019-08-25,334,7553,1898,1,9786
736,2019-08-26,609,1287,1370,1,3267
736,2019-08-27,292,7486,1713,0,9491
736,2019-08-28,1112,2256,1620,0,4988
736,2019-08-29,323,9227,2538,5,12093
736,2019-08-30,236,2449,115,1,2801
736,2019-08-31,70,62,0,0,132
736,2019-09-01,92,1514,180,0,1786
736,2019-09-02,38,255,3,1,297
736,2019-09-03,119,622,1233,2,1976
736,2019-09-04,274,4396,1648,3,6321
736,2019-09-05,253,8602,2212,0,11067
736,2019-09-06,1159,8725,1992,1,11877
736,2019-09-07,324,12441,1706,1,14472
736,2019-09-08,1630,3998,1989,0,7617
736,2019-09-09,314,7140,2473,0,9927
736,2019-09-10,213,7874,1412,2,9501
736,2019-09-11,142,5842,2134,1,8119
736,2019-09-12,1033,11458,2522,2,15015
736,2019-09-13,618,6011,1685,2,8316
736,2019-09-14,265,9839,1660,1,11765
736,2019-09-15,1301,10012,2368,0,13681
736,2019-09-16,1082,5994,2388,6,9470
736,2019-09-17,312,10281,1768,8,12369
736,2019-09-18,447,19707,1240,9,21403
736,2019-09-19,584,9004,1260,10,10858
736,2019-09-20,398,20994,2957,9,24358
736,2019-09-21,1968,10739,1753,9,14469
736,2019-09-22,259,13642,1495,7,15403
736,2019-09-23,2031,11816,2054,1,15902
736,2019-09-24,326,9546,2198,2,12072
736,2019-09-25,2023,10516,1459,1,13999
736,2019-09-26,141,13916,1305,3,15365
736,2019-09-27,121,8522,1122,3,9768
736,2019-09-28,128,24721,1758,3,26610
736,2019-09-29,142,29106,1569,3,30820
736,2019-09-30,130,30548,1430,0,32108
736,2019-10-01,127,28239,1760,0,30126
736,2019-10-02,135,14497,2110,0,16742
736,2019-10-03,185,23168,1472,1,24826
736,2019-10-04,127,14671,1753,2,16553
736,2019-10-05,137,15265,1491,3,16896
736,2019-10-06,993,12108,1882,0,14983
736,2019-10-07,160,7398,2227,3,9788
736,2019-10-08,258,18601,1473,5,20337
736,2019-10-09,913,17373,1768,0,20054
736,2019-10-10,798,11222,2165,0,14185
736,2019-10-11,709,13794,1980,1,16484
736,2019-10-12,258,9489,1823,1,11571
736,2019-10-13,256,8957,1622,3,10838
736,2019-10-14,1102,6082,1756,0,8940
736,2019-10-15,663,8636,1887,0,11186
736,2019-10-16,543,12860,1181,4,14588
736,2019-10-17,314,5738,1963,1,8016
736,2019-10-18,1191,14630,2145,2,17968
736,2019-10-19,2193,9049,1555,2,12799
736,2019-10-20,269,2993,1895,1,5158
736,2019-10-21,236,10758,1531,0,12525
736,2019-10-22,257,7371,2467,1,10096
736,2019-10-23,245,14531,2171,4,16951
736,2019-10-24,598,19061,2001,0,21660
736,2019-10-25,366,11292,1725,1,13384
736,2019-10-26,241,13736,1607,0,15584
736,2019-10-27,624,28398,1323,0,30345
736,2019-10-28,576,25802,2035,1,28414
736,2019-10-29,894,18189,1561,0,20644
736,2019-10-30,275,15792,1406,0,17473
736,2019-10-31,1193,12905,1421,0,15519
736,2019-11-01,725,14928,1108,0,16761
736,2019-11-02,229,14297,1326,3,15855
736,2019-11-03,745,37419,1248,0,39412
736,2019-11-04,272,10939,1807,1,13019
736,2019-11-05,283,3604,1099,0,4986
736,2019-11-06,286,8759,809,0,9854
736,2019-11-07,1227,13906,1299,3,16435
736,2019-11-08,1196,9810,1471,1,12478
736,2019-11-09,271,8814,1486,0,10571
736,2019-11-10,246,25950,1287,1,27484
736,2019-11-11,261,17671,1734,2,19668
736,2019-11-12,342,12859,3214,3,16418
736,2019-11-13,345,12268,1335,1,13949
736,2019-11-14,260,8716,2349,0,11325
736,2019-11-15,369,3960,2404,2,6735
736,2019-11-16,317,3127,2231,1,5676
736,2019-11-17,353,5777,3112,3,9245
736,2019-11-18,272,2522,2673,1,5468
736,2019-11-19,314,3268,2841,1,6424
736,2019-11-20,298,1504,2492,0,4294
736,2019-11-21,1743,5922,1799,2,9466
736,2019-11-22,343,8566,1577,6,10492
736,2019-11-23,265,6963,2342,1,9571
736,2019-11-24,447,5462,1194,0,7103
736,2019-11-25,977,6967,1802,1,9747
736,2019-11-26,723,6954,2289,1,9967
736,2019-11-27,268,6903,1410,3,8584
736,2019-11-28,275,7797,442,0,8514
736,2019-11-29,114,526,7,0,647
736,2019-08-17,85,1604,802,0,2491
736,2019-08-18,611,2412,1767,1,4791
736,2019-08-19,479,1591,1578,1,3649
736,2019-08-20,396,1533,961,0,2890
736,2019-08-21,332,2614,1701,2,4649
736,2019-08-22,401,2614,1386,1,4402
736,2019-08-23,2030,1764,1919,3,5716
736,2019-08-24,401,1715,1129,1,3246
736,2019-08-25,334,7553,1898,1,9786
736,2019-08-26,609,1287,1370,1,3267
736,2019-08-27,292,7486,1713,0,9491
736,2019-08-28,1112,2256,1620,0,4988
736,2019-08-29,323,9227,2538,5,12093
736,2019-08-30,236,2449,115,1,2801
736,2019-08-31,70,62,0,0,132
736,2019-09-01,92,1514,180,0,1786
736,2019-09-02,38,255,3,1,297
736,2019-09-03,119,622,1233,2,1976
736,2019-09-04,274,4396,1648,3,6321
736,2019-09-05,253,8602,2212,0,11067
736,2019-09-06,1159,8725,1992,1,11877
736,2019-09-07,324,12441,1706,1,14472
736,2019-09-08,1630,3998,1989,0,7617
736,2019-09-09,314,7140,2473,0,9927
736,2019-09-10,213,7874,1412,2,9501
736,2019-09-11,142,5842,2134,1,8119
736,2019-09-12,1033,11458,2522,2,15015
736,2019-09-13,618,6011,1685,2,8316
736,2019-09-14,265,9839,1660,1,11765
736,2019-09-15,1301,10012,2368,0,13681
736,2019-09-16,1082,5994,2388,6,9470
736,2019-09-17,312,10281,1768,8,12369
736,2019-09-18,447,19707,1240,9,21403
736,2019-09-19,584,9004,1260,10,10858
736,2019-09-20,398,20994,2957,9,24358
736,2019-09-21,1968,10739,1753,9,14469
736,2019-09-22,259,13642,1495,7,15403
736,2019-09-23,2031,11816,2054,1,15902
736,2019-09-24,326,9546,2198,2,12072
736,2019-09-25,2023,10516,1459,1,13999
736,2019-09-26,141,13916,1305,3,15365
736,2019-09-27,121,8522,1122,3,9768
736,2019-09-28,128,24721,1758,3,26610
736,2019-09-29,142,29106,1569,3,30820
736,2019-09-30,130,30548,1430,0,32108
736,2019-10-01,127,28239,1760,0,30126
736,2019-10-02,135,14497,2110,0,16742
736,2019-10-03,185,23168,1472,1,24826
736,2019-10-04,127,14671,1753,2,16553
736,2019-10-05,137,15265,1491,3,16896
736,2019-10-06,993,12108,1882,0,14983
736,2019-10-07,160,7398,2227,3,9788
736,2019-10-08,258,18601,1473,5,20337
736,2019-10-09,913,17373,1768,0,20054
736,2019-10-10,798,11222,2165,0,14185
736,2019-10-11,709,13794,1980,1,16484
736,2019-10-12,258,9489,1823,1,11571
736,2019-10-13,256,8957,1622,3,10838
736,2019-10-14,1102,6082,1756,0,8940
736,2019-10-15,663,8636,1887,0,11186
736,2019-10-16,543,12860,1181,4,14588
736,2019-10-17,314,5738,1963,1,8016
736,2019-10-18,1191,14630,2145,2,17968
736,2019-10-19,2193,9049,1555,2,12799
736,2019-10-20,269,2993,1895,1,5158
736,2019-10-21,236,10758,1531,0,12525
736,2019-10-22,257,7371,2467,1,10096
736,2019-10-23,245,14531,2171,4,16951
736,2019-10-24,598,19061,2001,0,21660
736,2019-10-25,366,11292,1725,1,13384
736,2019-10-26,241,13736,1607,0,15584
736,2019-10-27,624,28398,1323,0,30345
736,2019-10-28,576,25802,2035,1,28414
736,2019-10-29,894,18189,1561,0,20644
736,2019-10-30,275,15792,1406,0,17473
736,2019-10-31,1193,12905,1421,0,15519
736,2019-11-01,725,14928,1108,0,16761
736,2019-11-02,229,14297,1326,3,15855
736,2019-11-03,745,37419,1248,0,39412
736,2019-11-04,272,10939,1807,1,13019
736,2019-11-05,283,3604,1099,0,4986
736,2019-11-06,286,8759,809,0,9854
736,2019-11-07,1227,13906,1299,3,16435
736,2019-11-08,1196,9810,1471,1,12478
736,2019-11-09,271,8814,1486,0,10571
736,2019-11-10,246,25950,1287,1,27484
736,2019-11-11,261,17671,1734,2,19668
736,2019-11-12,342,12859,3214,3,16418
736,2019-11-13,345,12268,1335,1,13949
736,2019-11-14,260,8716,2349,0,11325
736,2019-11-15,369,3960,2404,2,6735
736,2019-11-16,317,3127,2231,1,5676
736,2019-11-17,353,5777,3112,3,9245
736,2019-11-18,272,2522,2673,1,5468
736,2019-11-19,314,3268,2841,1,6424
736,2019-11-20,298,1504,2492,0,4294
736,2019-11-21,1743,5922,1799,2,9466
736,2019-11-22,343,8566,1577,6,10492
736,2019-11-23,265,6963,2342,1,9571
736,2019-11-24,447,5462,1194,0,7103
736,2019-11-25,977,6967,1802,1,9747
736,2019-11-26,723,6954,2289,1,9967
736,2019-11-27,268,6903,1410,3,8584
736,2019-11-28,275,7797,442,0,8514
736,2019-11-29,114,526,7,0,647
736,2019-08-17,85,1604,802,0,2491
736,2019-08-18,611,2412,1767,1,4791
736,2019-08-19,479,1591,1578,1,3649
736,2019-08-20,396,1533,961,0,2890
736,2019-08-21,332,2614,1701,2,4649
736,2019-08-22,401,2614,1386,1,4402
736,2019-08-23,2030,1764,1919,3,5716
736,2019-08-24,401,1715,1129,1,3246
736,2019-08-25,334,7553,1898,1,9786
736,2019-08-26,609,1287,1370,1,3267
736,2019-08-27,292,7486,1713,0,9491
736,2019-08-28,1112,2256,1620,0,4988
736,2019-08-29,323,9227,2538,5,12093
736,2019-08-30,236,2449,115,1,2801
736,2019-08-31,70,62,0,0,132
736,2019-09-01,92,1514,180,0,1786
736,2019-09-02,38,255,3,1,297
736,2019-09-03,119,622,1233,2,1976
736,2019-09-04,274,4396,1648,3,6321
736,2019-09-05,253,8602,2212,0,11067
736,2019-09-06,1159,8725,1992,1,11877
736,2019-09-07,324,12441,1706,1,14472
736,2019-09-08,1630,3998,1989,0,7617
736,2019-09-09,314,7140,2473,0,9927
736,2019-09-10,213,7874,1412,2,9501
736,2019-09-11,142,5842,2134,1,8119
736,2019-09-12,1033,11458,2522,2,15015
736,2019-09-13,618,6011,1685,2,8316
736,2019-09-14,265,9839,1660,1,11765
736,2019-09-15,1301,10012,2368,0,13681
736,2019-09-16,1082,5994,2388,6,9470
736,2019-09-17,312,10281,1768,8,12369
736,2019-09-18,447,19707,1240,9,21403
736,2019-09-19,584,9004,1260,10,10858
736,2019-09-20,398,20994,2957,9,24358
736,2019-09-21,1968,10739,1753,9,14469
736,2019-09-22,259,13642,1495,7,15403
736,2019-09-23,2031,11816,2054,1,15902
736,2019-09-24,326,9546,2198,2,12072
736,2019-09-25,2023,10516,1459,1,13999
736,2019-09-26,141,13916,1305,3,15365
736,2019-09-27,121,8522,1122,3,9768
736,2019-09-28,128,24721,1758,3,26610
736,2019-09-29,142,29106,1569,3,30820
736,2019-09-30,130,30548,1430,0,32108
736,2019-10-01,127,28239,1760,0,30126
736,2019-10-02,135,14497,2110,0,16742
736,2019-10-03,185,23168,1472,1,24826
736,2019-10-04,127,14671,1753,2,16553
736,2019-10-05,137,15265,1491,3,16896
736,2019-10-06,993,12108,1882,0,14983
736,2019-10-07,160,7398,2227,3,9788
736,2019-10-08,258,18601,1473,5,20337
736,2019-10-09,913,17373,1768,0,20054
736,2019-10-10,798,11222,2165,0,14185
736,2019-10-11,709,13794,1980,1,16484
736,2019-10-12,258,9489,1823,1,11571
736,2019-10-13,256,8957,1622,3,10838
736,2019-10-14,1102,6082,1756,0,8940
736,2019-10-15,663,8636,1887,0,11186
736,2019-10-16,543,12860,1181,4,14588
736,2019-10-17,314,5738,1963,1,8016
736,2019-10-18,1191,14630,2145,2,17968
736,2019-10-19,2193,9049,1555,2,12799
736,2019-10-20,269,2993,1895,1,5158
736,2019-10-21,236,10758,1531,0,12525
736,2019-10-22,257,7371,2467,1,10096
736,2019-10-23,245,14531,2171,4,16951
736,2019-10-24,598,19061,2001,0,21660
736,2019-10-25,366,11292,1725,1,13384
736,2019-10-26,241,13736,1607,0,15584
736,2019-10-27,624,28398,1323,0,30345
736,2019-10-28,576,25802,2035,1,28414
736,2019-10-29,894,18189,1561,0,20644
736,2019-10-30,275,15792,1406,0,17473
736,2019-10-31,1193,12905,1421,0,15519
736,2019-11-01,725,14928,1108,0,16761
736,2019-11-02,229,14297,1326,3,15855
736,2019-11-03,745,37419,1248,0,39412
736,2019-11-04,272,10939,1807,1,13019
736,2019-11-05,283,3604,1099,0,4986
736,2019-11-06,286,8759,809,0,9854
736,2019-11-07,1227,13906,1299,3,16435
736,2019-11-08,1196,9810,1471,1,12478
736,2019-11-09,271,8814,1486,0,10571
736,2019-11-10,246,25950,1287,1,27484
736,2019-11-11,261,17671,1734,2,19668
736,2019-11-12,342,12859,3214,3,16418
736,2019-11-13,345,12268,1335,1,13949
736,2019-11-14,260,8716,2349,0,11325
736,2019-11-15,369,3960,2404,2,6735
736,2019-11-16,317,3127,2231,1,5676
736,2019-11-17,353,5777,3112,3,9245
736,2019-11-18,272,2522,2673,1,5468
736,2019-11-19,314,3268,2841,1,6424
736,2019-11-20,298,1504,2492,0,4294
736,2019-11-21,1743,5922,1799,2,9466
736,2019-11-22,343,8566,1577,6,10492
736,2019-11-23,265,6963,2342,1,9571
736,2019-11-24,447,5462,1194,0,7103
736,2019-11-25,977,6967,1802,1,9747
736,2019-11-26,723,6954,2289,1,9967
736,2019-11-27,268,6903,1410,3,8584
736,2019-11-28,275,7797,442,0,8514
736,2019-11-29,114,526,7,0,647
736,2019-08-18,611,2412,1767,1,4791
736,2019-08-19,479,1591,1578,1,3649
736,2019-08-20,396,1533,961,0,2890
736,2019-08-21,332,2614,1701,2,4649
736,2019-08-22,401,2614,1386,1,4402
736,2019-08-23,2030,1764,1919,3,5716
736,2019-08-24,401,1715,1129,1,3246
736,2019-08-25,334,7553,1898,1,9786
736,2019-08-26,609,1287,1370,1,3267
736,2019-08-27,292,7486,1713,0,9491
736,2019-08-28,1112,2256,1620,0,4988
736,2019-08-29,323,9227,2538,5,12093
736,2019-08-30,236,2449,115,1,2801
736,2019-08-31,70,62,0,0,132
736,2019-09-01,92,1514,180,0,1786
736,2019-09-02,38,255,3,1,297
736,2019-09-03,119,622,1233,2,1976
736,2019-09-04,274,4396,1648,3,6321
736,2019-09-05,253,8602,2212,0,11067
736,2019-09-06,1159,8725,1992,1,11877
736,2019-09-07,324,12441,1706,1,14472
736,2019-09-08,1630,3998,1989,0,7617
736,2019-09-09,314,7140,2473,0,9927
736,2019-09-10,213,7874,1412,2,9501
736,2019-09-11,142,5842,2134,1,8119
736,2019-09-12,1033,11458,2522,2,15015
736,2019-09-13,618,6011,1685,2,8316
736,2019-09-14,265,9839,1660,1,11765
736,2019-09-15,1301,10012,2368,0,13681
736,2019-09-16,1082,5994,2388,6,9470
736,2019-09-17,312,10281,1768,8,12369
736,2019-09-18,447,19707,1240,9,21403
736,2019-09-19,584,9004,1260,10,10858
736,2019-09-20,398,20994,2957,9,24358
736,2019-09-21,1968,10739,1753,9,14469
736,2019-09-22,259,13642,1495,7,15403
736,2019-09-23,2031,11816,2054,1,15902
736,2019-09-24,326,9546,2198,2,12072
736,2019-09-25,2023,10516,1459,1,13999
736,2019-09-26,141,13916,1305,3,15365
736,2019-09-27,121,8522,1122,3,9768
736,2019-09-28,128,24721,1758,3,26610
736,2019-09-29,142,29106,1569,3,30820
736,2019-09-30,130,30548,1430,0,32108
736,2019-10-01,127,28239,1760,0,30126
736,2019-10-02,135,14497,2110,0,16742
736,2019-10-03,185,23168,1472,1,24826
736,2019-10-04,127,14671,1753,2,16553
736,2019-10-05,137,15265,1491,3,16896
736,2019-10-06,993,12108,1882,0,14983
736,2019-10-07,160,7398,2227,3,9788
736,2019-10-08,258,18601,1473,5,20337
736,2019-10-09,913,17373,1768,0,20054
736,2019-10-10,798,11222,2165,0,14185
736,2019-10-11,709,13794,1980,1,16484
736,2019-10-12,258,9489,1823,1,11571
736,2019-10-13,256,8957,1622,3,10838
736,2019-10-14,1102,6082,1756,0,8940
736,2019-10-15,663,8636,1887,0,11186
736,2019-10-16,543,12860,1181,4,14588
736,2019-10-17,314,5738,1963,1,8016
736,2019-10-18,1191,14630,2145,2,17968
736,2019-10-19,2193,9049,1555,2,12799
736,2019-10-20,269,2993,1895,1,5158
736,2019-10-21,236,10758,1531,0,12525
736,2019-10-22,257,7371,2467,1,10096
736,2019-10-23,245,14531,2171,4,16951
736,2019-10-24,598,19061,2001,0,21660
736,2019-10-25,366,11292,1725,1,13384
736,2019-10-26,241,13736,1607,0,15584
736,2019-10-27,624,28398,1323,0,30345
736,2019-10-28,576,25802,2035,1,28414
736,2019-10-29,894,18189,1561,0,20644
736,2019-10-30,275,15792,1406,0,17473
736,2019-10-31,1193,12905,1421,0,15519
736,2019-11-01,725,14928,1108,0,16761
736,2019-11-02,229,14297,1326,3,15855
736,2019-11-03,745,37419,1248,0,39412
736,2019-11-04,272,10939,1807,1,13019
736,2019-11-05,283,3604,1099,0,4986
736,2019-11-06,286,8759,809,0,9854
736,2019-11-07,1227,13906,1299,3,16435
736,2019-11-08,1196,9810,1471,1,12478
736,2019-11-09,271,8814,1486,0,10571
736,2019-11-10,246,25950,1287,1,27484
736,2019-11-11,261,17671,1734,2,19668
736,2019-11-12,342,12859,3214,3,16418
736,2019-11-13,345,12268,1335,1,13949
736,2019-11-14,260,8716,2349,0,11325
736,2019-11-15,369,3960,2404,2,6735
736,2019-11-16,317,3127,2231,1,5676
736,2019-11-17,353,5777,3112,3,9245
736,2019-11-18,272,2522,2673,1,5468
736,2019-11-19,314,3268,2841,1,6424
736,2019-11-20,298,1504,2492,0,4294
736,2019-11-21,1743,5922,1799,2,9466
736,2019-11-22,343,8566,1577,6,10492
736,2019-11-23,265,6963,2342,1,9571
736,2019-11-24,447,5462,1194,0,7103
736,2019-11-25,977,6967,1802,1,9747
736,2019-11-26,723,6954,2289,1,9967
736,2019-11-27,268,6903,1410,3,8584
737,2019-08-17,234,436,865,0,1535
737,2019-08-18,341,6427,1161,0,7929
737,2019-08-19,404,1785,1487,0,3676
737,2019-08-20,318,1425,1797,0,3540
737,2019-08-21,358,2820,940,1,4119
737,2019-08-22,383,3714,1260,1,5358
737,2019-08-23,381,1798,1412,0,3591
737,2019-08-24,414,1995,1303,1,3713
737,2019-08-25,285,4663,1533,2,6483
737,2019-08-26,799,2594,1890,0,5283
737,2019-08-27,266,6195,1530,1,7992
737,2019-08-28,1190,4633,2274,1,8098
737,2019-08-29,570,9471,1640,0,11681
737,2019-08-30,394,2743,1099,0,4236
737,2019-08-31,117,48,0,0,165
737,2019-09-01,237,1576,157,0,1970
737,2019-09-02,29,200,122,0,351
737,2019-09-03,818,1253,846,2,2919
737,2019-09-04,319,12433,2055,0,14807
737,2019-09-05,353,10768,1874,0,12995
737,2019-09-06,328,9912,1276,3,11519
737,2019-09-07,464,8385,2365,0,11214
737,2019-09-08,401,5483,2161,0,8045
737,2019-09-09,2010,8037,2620,0,12667
737,2019-09-10,253,10643,1915,1,12812
737,2019-09-11,177,9186,2426,2,11791
737,2019-09-12,315,8539,2310,5,11169
737,2019-09-13,449,5945,2507,2,8903
737,2019-09-14,991,13971,1483,0,16445
737,2019-09-15,245,9269,2271,1,11786
737,2019-09-16,768,12881,2368,0,16017
737,2019-09-17,1093,12100,1990,0,15183
737,2019-09-18,327,12072,1524,0,13923
737,2019-09-19,533,8416,2488,3,11440
737,2019-09-20,468,13074,2232,2,15776
737,2019-09-21,314,5881,1621,2,7818
737,2019-09-22,243,13379,1987,0,15609
737,2019-09-23,372,13081,1420,0,14873
737,2019-09-24,359,9326,2137,4,11826
737,2019-09-25,1098,8217,1543,0,10858
737,2019-09-26,238,12064,1352,4,13658
737,2019-09-27,170,13793,2114,3,16080
737,2019-09-28,169,15286,1598,1,17054
737,2019-09-29,1427,18881,1019,0,21327
737,2019-09-30,155,18279,1855,0,20289
737,2019-10-01,740,17781,1914,2,20437
737,2019-10-02,692,12768,1436,0,14896
737,2019-10-03,1833,16020,1386,0,19239
737,2019-10-04,1079,12604,1617,0,15300
737,2019-10-05,263,21330,1520,0,23113
737,2019-10-06,1004,17636,2055,2,20697
737,2019-10-07,267,8792,3310,1,12370
737,2019-10-08,1124,12405,1366,4,14899
737,2019-10-09,311,15373,1657,0,17341
737,2019-10-10,1109,16654,2984,2,20749
737,2019-10-11,453,14003,1881,28,16365
737,2019-10-12,1119,10338,1703,1,13161
737,2019-10-13,237,9300,1566,0,11103
737,2019-10-14,2581,5770,1517,2,9870
737,2019-10-15,1294,14818,1909,0,18021
737,2019-10-16,364,24252,1003,4,25623
737,2019-10-17,2046,8526,2621,0,13193
737,2019-10-18,248,15024,1398,1,16671
737,2019-10-19,317,8473,1060,0,9850
737,2019-10-20,282,3041,1733,3,5059
737,2019-10-21,1107,11628,1718,5,14458
737,2019-10-22,365,8170,1722,1,10258
737,2019-10-23,792,9764,1873,0,12429
737,2019-10-24,678,13940,1360,1,15979
737,2019-10-25,291,15938,1757,2,17988
737,2019-10-26,251,16773,2476,1,19501
737,2019-10-27,250,27647,2456,0,30353
737,2019-10-28,297,24729,2335,0,27361
737,2019-10-29,337,18001,1748,0,20086
737,2019-10-30,264,15458,1113,1,16836
737,2019-10-31,262,12788,1875,2,14927
737,2019-11-01,224,15213,1235,1,16673
737,2019-11-02,242,14581,865,1,15689
737,2019-11-03,224,37491,1308,0,39023
737,2019-11-04,292,11636,1232,0,13160
737,2019-11-05,1025,6717,2283,1,10026
737,2019-11-06,1540,7926,2336,3,11805
737,2019-11-07,322,22184,1398,2,23906
737,2019-11-08,419,17870,1361,0,19650
737,2019-11-09,1773,16455,1509,0,19737
737,2019-11-10,258,15102,1249,2,16611
737,2019-11-11,279,14147,1205,3,15634
737,2019-11-12,285,15395,2759,1,18440
737,2019-11-13,1279,12332,1567,5,15183
737,2019-11-14,276,8770,1595,2,10643
737,2019-11-15,276,4125,2084,1,6486
737,2019-11-16,1218,2772,2223,1,6214
737,2019-11-17,451,3667,3455,0,7573
737,2019-11-18,274,2455,2846,2,5577
737,2019-11-19,326,5285,2285,1,7897
737,2019-11-20,398,1362,2267,4,4031
737,2019-11-21,1216,3714,2486,1,7417
737,2019-11-22,452,8056,1093,1,9602
737,2019-11-23,394,7116,2532,1,10043
737,2019-11-24,338,5858,1266,2,7464
737,2019-11-25,308,6830,1489,0,8627
737,2019-11-26,247,5525,1279,237,7288
737,2019-11-27,1196,6874,2093,0,10163
737,2019-11-28,346,7634,608,0,8588
737,2019-11-29,153,326,3,0,482
737,2019-08-17,234,436,865,0,1535
737,2019-08-18,341,6427,1161,0,7929
737,2019-08-19,404,1785,1487,0,3676
737,2019-08-20,318,1425,1797,0,3540
737,2019-08-21,358,2820,940,1,4119
737,2019-08-22,383,3714,1260,1,5358
737,2019-08-23,381,1798,1412,0,3591
737,2019-08-24,414,1995,1303,1,3713
737,2019-08-25,285,4663,1533,2,6483
737,2019-08-26,799,2594,1890,0,5283
737,2019-08-27,266,6195,1530,1,7992
737,2019-08-28,1190,4633,2274,1,8098
737,2019-08-29,570,9471,1640,0,11681
737,2019-08-30,394,2743,1099,0,4236
737,2019-08-31,117,48,0,0,165
737,2019-09-01,237,1576,157,0,1970
737,2019-09-02,29,200,122,0,351
737,2019-09-03,818,1253,846,2,2919
737,2019-09-04,319,12433,2055,0,14807
737,2019-09-05,353,10768,1874,0,12995
737,2019-09-06,328,9912,1276,3,11519
737,2019-09-07,464,8385,2365,0,11214
737,2019-09-08,401,5483,2161,0,8045
737,2019-09-09,2010,8037,2620,0,12667
737,2019-09-10,253,10643,1915,1,12812
737,2019-09-11,177,9186,2426,2,11791
737,2019-09-12,315,8539,2310,5,11169
737,2019-09-13,449,5945,2507,2,8903
737,2019-09-14,991,13971,1483,0,16445
737,2019-09-15,245,9269,2271,1,11786
737,2019-09-16,768,12881,2368,0,16017
737,2019-09-17,1093,12100,1990,0,15183
737,2019-09-18,327,12072,1524,0,13923
737,2019-09-19,533,8416,2488,3,11440
737,2019-09-20,468,13074,2232,2,15776
737,2019-09-21,314,5881,1621,2,7818
737,2019-09-22,243,13379,1987,0,15609
737,2019-09-23,372,13081,1420,0,14873
737,2019-09-24,359,9326,2137,4,11826
737,2019-09-25,1098,8217,1543,0,10858
737,2019-09-26,238,12064,1352,4,13658
737,2019-09-27,170,13793,2114,3,16080
737,2019-09-28,169,15286,1598,1,17054
737,2019-09-29,1427,18881,1019,0,21327
737,2019-09-30,155,18279,1855,0,20289
737,2019-10-01,740,17781,1914,2,20437
737,2019-10-02,692,12768,1436,0,14896
737,2019-10-03,1833,16020,1386,0,19239
737,2019-10-04,1079,12604,1617,0,15300
737,2019-10-05,263,21330,1520,0,23113
737,2019-10-06,1004,17636,2055,2,20697
737,2019-10-07,267,8792,3310,1,12370
737,2019-10-08,1124,12405,1366,4,14899
737,2019-10-09,311,15373,1657,0,17341
737,2019-10-10,1109,16654,2984,2,20749
737,2019-10-11,453,14003,1881,28,16365
737,2019-10-12,1119,10338,1703,1,13161
737,2019-10-13,237,9300,1566,0,11103
737,2019-10-14,2581,5770,1517,2,9870
737,2019-10-15,1294,14818,1909,0,18021
737,2019-10-16,364,24252,1003,4,25623
737,2019-10-17,2046,8526,2621,0,13193
737,2019-10-18,248,15024,1398,1,16671
737,2019-10-19,317,8473,1060,0,9850
737,2019-10-20,282,3041,1733,3,5059
737,2019-10-21,1107,11628,1718,5,14458
737,2019-10-22,365,8170,1722,1,10258
737,2019-10-23,792,9764,1873,0,12429
737,2019-10-24,678,13940,1360,1,15979
737,2019-10-25,291,15938,1757,2,17988
737,2019-10-26,251,16773,2476,1,19501
737,2019-10-27,250,27647,2456,0,30353
737,2019-10-28,297,24729,2335,0,27361
737,2019-10-29,337,18001,1748,0,20086
737,2019-10-30,264,15458,1113,1,16836
737,2019-10-31,262,12788,1875,2,14927
737,2019-11-01,224,15213,1235,1,16673
737,2019-11-02,242,14581,865,1,15689
737,2019-11-03,224,37491,1308,0,39023
737,2019-11-04,292,11636,1232,0,13160
737,2019-11-05,1025,6717,2283,1,10026
737,2019-11-06,1540,7926,2336,3,11805
737,2019-11-07,322,22184,1398,2,23906
737,2019-11-08,419,17870,1361,0,19650
737,2019-11-09,1773,16455,1509,0,19737
737,2019-11-10,258,15102,1249,2,16611
737,2019-11-11,279,14147,1205,3,15634
737,2019-11-12,285,15395,2759,1,18440
737,2019-11-13,1279,12332,1567,5,15183
737,2019-11-14,276,8770,1595,2,10643
737,2019-11-15,276,4125,2084,1,6486
737,2019-11-16,1218,2772,2223,1,6214
737,2019-11-17,451,3667,3455,0,7573
737,2019-11-18,274,2455,2846,2,5577
737,2019-11-19,326,5285,2285,1,7897
737,2019-11-20,398,1362,2267,4,4031
737,2019-11-21,1216,3714,2486,1,7417
737,2019-11-22,452,8056,1093,1,9602
737,2019-11-23,394,7116,2532,1,10043
737,2019-11-24,338,5858,1266,2,7464
737,2019-11-25,308,6830,1489,0,8627
737,2019-11-26,247,5525,1279,237,7288
737,2019-11-27,1196,6874,2093,0,10163
737,2019-11-28,346,7634,608,0,8588
737,2019-11-29,153,326,3,0,482
737,2019-08-17,234,436,865,0,1535
737,2019-08-18,341,6427,1161,0,7929
737,2019-08-19,404,1785,1487,0,3676
737,2019-08-20,318,1425,1797,0,3540
737,2019-08-21,358,2820,940,1,4119
737,2019-08-22,383,3714,1260,1,5358
737,2019-08-23,381,1798,1412,0,3591
737,2019-08-24,414,1995,1303,1,3713
737,2019-08-25,285,4663,1533,2,6483
737,2019-08-26,799,2594,1890,0,5283
737,2019-08-27,266,6195,1530,1,7992
737,2019-08-28,1190,4633,2274,1,8098
737,2019-08-29,570,9471,1640,0,11681
737,2019-08-30,394,2743,1099,0,4236
737,2019-08-31,117,48,0,0,165
737,2019-09-01,237,1576,157,0,1970
737,2019-09-02,29,200,122,0,351
737,2019-09-03,818,1253,846,2,2919
737,2019-09-04,319,12433,2055,0,14807
737,2019-09-05,353,10768,1874,0,12995
737,2019-09-06,328,9912,1276,3,11519
737,2019-09-07,464,8385,2365,0,11214
737,2019-09-08,401,5483,2161,0,8045
737,2019-09-09,2010,8037,2620,0,12667
737,2019-09-10,253,10643,1915,1,12812
737,2019-09-11,177,9186,2426,2,11791
737,2019-09-12,315,8539,2310,5,11169
737,2019-09-13,449,5945,2507,2,8903
737,2019-09-14,991,13971,1483,0,16445
737,2019-09-15,245,9269,2271,1,11786
737,2019-09-16,768,12881,2368,0,16017
737,2019-09-17,1093,12100,1990,0,15183
737,2019-09-18,327,12072,1524,0,13923
737,2019-09-19,533,8416,2488,3,11440
737,2019-09-20,468,13074,2232,2,15776
737,2019-09-21,314,5881,1621,2,7818
737,2019-09-22,243,13379,1987,0,15609
737,2019-09-23,372,13081,1420,0,14873
737,2019-09-24,359,9326,2137,4,11826
737,2019-09-25,1098,8217,1543,0,10858
737,2019-09-26,238,12064,1352,4,13658
737,2019-09-27,170,13793,2114,3,16080
737,2019-09-28,169,15286,1598,1,17054
737,2019-09-29,1427,18881,1019,0,21327
737,2019-09-30,155,18279,1855,0,20289
737,2019-10-01,740,17781,1914,2,20437
737,2019-10-02,692,12768,1436,0,14896
737,2019-10-03,1833,16020,1386,0,19239
737,2019-10-04,1079,12604,1617,0,15300
737,2019-10-05,263,21330,1520,0,23113
737,2019-10-06,1004,17636,2055,2,20697
737,2019-10-07,267,8792,3310,1,12370
737,2019-10-08,1124,12405,1366,4,14899
737,2019-10-09,311,15373,1657,0,17341
737,2019-10-10,1109,16654,2984,2,20749
737,2019-10-11,453,14003,1881,28,16365
737,2019-10-12,1119,10338,1703,1,13161
737,2019-10-13,237,9300,1566,0,11103
737,2019-10-14,2581,5770,1517,2,9870
737,2019-10-15,1294,14818,1909,0,18021
737,2019-10-16,364,24252,1003,4,25623
737,2019-10-17,2046,8526,2621,0,13193
737,2019-10-18,248,15024,1398,1,16671
737,2019-10-19,317,8473,1060,0,9850
737,2019-10-20,282,3041,1733,3,5059
737,2019-10-21,1107,11628,1718,5,14458
737,2019-10-22,365,8170,1722,1,10258
737,2019-10-23,792,9764,1873,0,12429
737,2019-10-24,678,13940,1360,1,15979
737,2019-10-25,291,15938,1757,2,17988
737,2019-10-26,251,16773,2476,1,19501
737,2019-10-27,250,27647,2456,0,30353
737,2019-10-28,297,24729,2335,0,27361
737,2019-10-29,337,18001,1748,0,20086
737,2019-10-30,264,15458,1113,1,16836
737,2019-10-31,262,12788,1875,2,14927
737,2019-11-01,224,15213,1235,1,16673
737,2019-11-02,242,14581,865,1,15689
737,2019-11-03,224,37491,1308,0,39023
737,2019-11-04,292,11636,1232,0,13160
737,2019-11-05,1025,6717,2283,1,10026
737,2019-11-06,1540,7926,2336,3,11805
737,2019-11-07,322,22184,1398,2,23906
737,2019-11-08,419,17870,1361,0,19650
737,2019-11-09,1773,16455,1509,0,19737
737,2019-11-10,258,15102,1249,2,16611
737,2019-11-11,279,14147,1205,3,15634
737,2019-11-12,285,15395,2759,1,18440
737,2019-11-13,1279,12332,1567,5,15183
737,2019-11-14,276,8770,1595,2,10643
737,2019-11-15,276,4125,2084,1,6486
737,2019-11-16,1218,2772,2223,1,6214
737,2019-11-17,451,3667,3455,0,7573
737,2019-11-18,274,2455,2846,2,5577
737,2019-11-19,326,5285,2285,1,7897
737,2019-11-20,398,1362,2267,4,4031
737,2019-11-21,1216,3714,2486,1,7417
737,2019-11-22,452,8056,1093,1,9602
737,2019-11-23,394,7116,2532,1,10043
737,2019-11-24,338,5858,1266,2,7464
737,2019-11-25,308,6830,1489,0,8627
737,2019-11-26,247,5525,1279,237,7288
737,2019-11-27,1196,6874,2093,0,10163
737,2019-11-28,346,7634,608,0,8588
737,2019-11-29,153,326,3,0,482
737,2019-08-21,358,2820,940,1,4119
737,2019-08-22,383,3714,1260,1,5358
737,2019-08-23,381,1798,1412,0,3591
737,2019-08-24,414,1995,1303,1,3713
737,2019-08-25,285,4663,1533,2,6483
737,2019-08-26,799,2594,1890,0,5283
737,2019-08-27,266,6195,1530,1,7992
737,2019-08-28,1190,4633,2274,1,8098
737,2019-08-29,570,9471,1640,0,11681
737,2019-08-30,394,2743,1099,0,4236
737,2019-08-31,117,48,0,0,165
737,2019-09-01,237,1576,157,0,1970
737,2019-09-02,29,200,122,0,351
737,2019-09-03,818,1253,846,2,2919
737,2019-09-04,319,12433,2055,0,14807
737,2019-09-05,353,10768,1874,0,12995
737,2019-09-06,328,9912,1276,3,11519
737,2019-09-07,464,8385,2365,0,11214
737,2019-09-08,401,5483,2161,0,8045
737,2019-09-09,2010,8037,2620,0,12667
737,2019-09-10,253,10643,1915,1,12812
737,2019-09-11,177,9186,2426,2,11791
737,2019-09-12,315,8539,2310,5,11169
737,2019-09-13,449,5945,2507,2,8903
737,2019-09-14,991,13971,1483,0,16445
737,2019-09-15,245,9269,2271,1,11786
737,2019-09-16,768,12881,2368,0,16017
737,2019-09-17,1093,12100,1990,0,15183
737,2019-09-18,327,12072,1524,0,13923
737,2019-09-19,533,8416,2488,3,11440
737,2019-09-20,468,13074,2232,2,15776
737,2019-09-21,314,5881,1621,2,7818
737,2019-09-22,243,13379,1987,0,15609
737,2019-09-23,372,13081,1420,0,14873
737,2019-09-24,359,9326,2137,4,11826
737,2019-09-25,1098,8217,1543,0,10858
737,2019-09-26,238,12064,1352,4,13658
737,2019-09-27,170,13793,2114,3,16080
737,2019-09-28,169,15286,1598,1,17054
737,2019-09-29,1427,18881,1019,0,21327
737,2019-09-30,155,18279,1855,0,20289
737,2019-10-01,740,17781,1914,2,20437
737,2019-10-02,692,12768,1436,0,14896
737,2019-10-03,1833,16020,1386,0,19239
737,2019-10-04,1079,12604,1617,0,15300
737,2019-10-05,263,21330,1520,0,23113
737,2019-10-06,1004,17636,2055,2,20697
737,2019-10-07,267,8792,3310,1,12370
737,2019-10-08,1124,12405,1366,4,14899
737,2019-10-09,311,15373,1657,0,17341
737,2019-10-10,1109,16654,2984,2,20749
737,2019-10-11,453,14003,1881,28,16365
737,2019-10-12,1119,10338,1703,1,13161
737,2019-10-13,237,9300,1566,0,11103
737,2019-10-14,2581,5770,1517,2,9870
737,2019-10-15,1294,14818,1909,0,18021
737,2019-10-16,364,24252,1003,4,25623
737,2019-10-17,2046,8526,2621,0,13193
737,2019-10-18,248,15024,1398,1,16671
737,2019-10-19,317,8473,1060,0,9850
737,2019-10-20,282,3041,1733,3,5059
737,2019-10-21,1107,11628,1718,5,14458
737,2019-10-22,365,8170,1722,1,10258
737,2019-10-23,792,9764,1873,0,12429
737,2019-10-24,678,13940,1360,1,15979
737,2019-10-25,291,15938,1757,2,17988
737,2019-10-26,251,16773,2476,1,19501
737,2019-10-27,250,27647,2456,0,30353
737,2019-10-28,297,24729,2335,0,27361
737,2019-10-29,337,18001,1748,0,20086
737,2019-10-30,264,15458,1113,1,16836
737,2019-10-31,262,12788,1875,2,14927
737,2019-11-01,224,15213,1235,1,16673
737,2019-11-02,242,14581,865,1,15689
737,2019-11-03,224,37491,1308,0,39023
737,2019-11-04,292,11636,1232,0,13160
737,2019-11-05,1025,6717,2283,1,10026
737,2019-11-06,1540,7926,2336,3,11805
737,2019-11-07,322,22184,1398,2,23906
737,2019-11-08,419,17870,1361,0,19650
737,2019-11-09,1773,16455,1509,0,19737
737,2019-11-10,258,15102,1249,2,16611
737,2019-11-11,279,14147,1205,3,15634
737,2019-11-12,285,15395,2759,1,18440
737,2019-11-13,1279,12332,1567,5,15183
737,2019-11-14,276,8770,1595,2,10643
737,2019-11-15,276,4125,2084,1,6486
737,2019-11-16,1218,2772,2223,1,6214
737,2019-11-17,451,3667,3455,0,7573
737,2019-11-18,274,2455,2846,2,5577
737,2019-11-19,326,5285,2285,1,7897
737,2019-11-20,398,1362,2267,4,4031
737,2019-11-21,1216,3714,2486,1,7417
737,2019-11-22,452,8056,1093,1,9602
737,2019-11-23,394,7116,2532,1,10043
737,2019-11-24,338,5858,1266,2,7464
737,2019-11-25,308,6830,1489,0,8627
737,2019-11-26,247,5525,1279,237,7288
738,2019-08-17,127,661,270,0,1058
738,2019-08-18,1079,231,1071,0,2381
738,2019-08-19,354,691,1442,0,2487
738,2019-08-20,684,1156,1549,0,3389
738,2019-08-21,1265,1493,2036,0,4794
738,2019-08-22,1323,2355,1884,0,5562
738,2019-08-23,1721,962,1444,0,4127
738,2019-08-24,2371,2158,1628,0,6157
738,2019-08-25,2662,12410,857,0,15929
738,2019-08-26,823,32125,2385,1,35334
738,2019-08-27,304,11592,1710,1,13607
738,2019-08-28,589,11874,2357,0,14820
738,2019-08-29,974,13154,1713,0,15841
738,2019-08-30,574,3062,364,2,4002
738,2019-08-31,370,54,2,0,426
738,2019-09-01,550,1219,363,0,2132
738,2019-09-02,447,19,1,0,467
738,2019-09-03,434,584,1214,0,2232
738,2019-09-04,1510,14474,2658,3,18645
738,2019-09-05,706,13683,2163,0,16552
738,2019-09-06,758,23922,1329,2,26011
738,2019-09-07,1658,9463,2449,0,13570
738,2019-09-08,572,5271,1747,0,7590
738,2019-09-09,820,7277,2293,0,10390
738,2019-09-10,1300,12294,2024,0,15618
738,2019-09-11,305,8922,2397,5,11629
738,2019-09-12,408,10332,1903,1,12644
738,2019-09-13,972,3488,2049,2,6511
738,2019-09-14,259,9783,1833,1,11876
738,2019-09-15,236,8339,3364,1,11940
738,2019-09-16,353,13061,2513,4,15931
738,2019-09-17,308,11633,2070,6,14017
738,2019-09-18,852,27769,1044,8,29673
738,2019-09-19,350,10395,1032,9,11786
738,2019-09-20,576,22822,1966,9,25373
738,2019-09-21,191,12714,2067,10,14982
738,2019-09-22,1626,8122,1392,9,11149
738,2019-09-23,309,8763,2292,11,11375
738,2019-09-24,273,12115,2002,13,14403
738,2019-09-25,1196,10746,1320,12,13274
738,2019-09-26,236,12894,2326,12,15468
738,2019-09-27,1794,10554,1862,3,14213
738,2019-09-28,353,14063,1831,3,16250
738,2019-09-29,1964,16731,2086,1,20782
738,2019-09-30,233,25331,1527,2,27093
738,2019-10-01,232,26473,1085,1,27791
738,2019-10-02,1161,12282,2081,7,15531
738,2019-10-03,232,22151,1483,12,23878
738,2019-10-04,231,20578,1221,10,22040
738,2019-10-05,233,23415,910,10,24568
738,2019-10-06,1070,15516,1848,12,18446
738,2019-10-07,349,4466,2351,12,7178
738,2019-10-08,223,10740,1805,11,12779
738,2019-10-09,1173,22211,1580,9,24973
738,2019-10-10,201,12287,1552,10,14050
738,2019-10-11,438,14182,2411,12,17043
738,2019-10-12,337,8155,2114,1,10607
738,2019-10-13,321,7390,1709,1,9421
738,2019-10-14,995,3916,2161,0,7072
738,2019-10-15,247,13196,1059,1,14503
738,2019-10-16,244,23152,1443,4,24843
738,2019-10-17,347,6675,1425,0,8447
738,2019-10-18,1164,7059,2027,0,10250
738,2019-10-19,241,3742,2684,1,6668
738,2019-10-20,265,1210,1973,0,3448
738,2019-10-21,269,14664,1832,5,16770
738,2019-10-22,527,5190,1681,1,7399
738,2019-10-23,335,7049,1425,0,8809
738,2019-10-24,246,12588,1608,1,14443
738,2019-10-25,1198,9334,1234,1,11767
738,2019-10-26,1275,11899,2268,0,15442
738,2019-10-27,780,14705,2012,1,17498
738,2019-10-28,242,12239,2441,1,14923
738,2019-10-29,604,14373,2372,0,17349
738,2019-10-30,889,7026,1411,1,9327
738,2019-10-31,1181,9337,1218,3,11739
738,2019-11-01,203,15070,1217,0,16490
738,2019-11-02,240,13082,1363,2,14687
738,2019-11-03,253,21723,1136,0,23112
738,2019-11-04,243,6323,1917,0,8483
738,2019-11-05,431,776,3404,1,4612
738,2019-11-06,888,6567,2081,2,9538
738,2019-11-07,365,20998,1864,3,23230
738,2019-11-08,341,10844,2111,0,13296
738,2019-11-09,1710,7766,1740,0,11216
738,2019-11-10,402,12209,1267,2,13880
738,2019-11-11,345,7424,1645,3,9417
738,2019-11-12,1278,8412,2564,0,12254
738,2019-11-13,1568,11785,2393,3,15749
738,2019-11-14,758,8036,2273,3,11070
738,2019-11-15,959,3732,2211,0,6902
738,2019-11-16,2003,3042,2842,1,7888
738,2019-11-17,608,3279,3476,0,7363
738,2019-11-18,1455,3388,3183,2,8028
738,2019-11-19,726,3324,2640,0,6690
738,2019-11-20,595,1380,2445,4,4424
738,2019-11-21,678,5499,1842,0,8019
738,2019-11-22,742,8510,1898,3,11153
738,2019-11-23,2320,6694,2250,0,11264
738,2019-11-24,4069,5231,1511,2,10813
738,2019-11-25,2274,6917,1939,1,11131
738,2019-11-26,999,8888,1110,1,10998
738,2019-11-27,1454,6688,1081,0,9223
738,2019-11-28,788,7086,829,0,8703
738,2019-11-29,58,639,2,0,699
738,2019-08-17,127,661,270,0,1058
738,2019-08-18,1079,231,1071,0,2381
738,2019-08-19,354,691,1442,0,2487
738,2019-08-20,684,1156,1549,0,3389
738,2019-08-21,1265,1493,2036,0,4794
738,2019-08-22,1323,2355,1884,0,5562
738,2019-08-23,1721,962,1444,0,4127
738,2019-08-24,2371,2158,1628,0,6157
738,2019-08-25,2662,12410,857,0,15929
738,2019-08-26,823,32125,2385,1,35334
738,2019-08-27,304,11592,1710,1,13607
738,2019-08-28,589,11874,2357,0,14820
738,2019-08-29,974,13154,1713,0,15841
738,2019-08-30,574,3062,364,2,4002
738,2019-08-31,370,54,2,0,426
738,2019-09-01,550,1219,363,0,2132
738,2019-09-02,447,19,1,0,467
738,2019-09-03,434,584,1214,0,2232
738,2019-09-04,1510,14474,2658,3,18645
738,2019-09-05,706,13683,2163,0,16552
738,2019-09-06,758,23922,1329,2,26011
738,2019-09-07,1658,9463,2449,0,13570
738,2019-09-08,572,5271,1747,0,7590
738,2019-09-09,820,7277,2293,0,10390
738,2019-09-10,1300,12294,2024,0,15618
738,2019-09-11,305,8922,2397,5,11629
738,2019-09-12,408,10332,1903,1,12644
738,2019-09-13,972,3488,2049,2,6511
738,2019-09-14,259,9783,1833,1,11876
738,2019-09-15,236,8339,3364,1,11940
738,2019-09-16,353,13061,2513,4,15931
738,2019-09-17,308,11633,2070,6,14017
738,2019-09-18,852,27769,1044,8,29673
738,2019-09-19,350,10395,1032,9,11786
738,2019-09-20,576,22822,1966,9,25373
738,2019-09-21,191,12714,2067,10,14982
738,2019-09-22,1626,8122,1392,9,11149
738,2019-09-23,309,8763,2292,11,11375
738,2019-09-24,273,12115,2002,13,14403
738,2019-09-25,1196,10746,1320,12,13274
738,2019-09-26,236,12894,2326,12,15468
738,2019-09-27,1794,10554,1862,3,14213
738,2019-09-28,353,14063,1831,3,16250
738,2019-09-29,1964,16731,2086,1,20782
738,2019-09-30,233,25331,1527,2,27093
738,2019-10-01,232,26473,1085,1,27791
738,2019-10-02,1161,12282,2081,7,15531
738,2019-10-03,232,22151,1483,12,23878
738,2019-10-04,231,20578,1221,10,22040
738,2019-10-05,233,23415,910,10,24568
738,2019-10-06,1070,15516,1848,12,18446
738,2019-10-07,349,4466,2351,12,7178
738,2019-10-08,223,10740,1805,11,12779
738,2019-10-09,1173,22211,1580,9,24973
738,2019-10-10,201,12287,1552,10,14050
738,2019-10-11,438,14182,2411,12,17043
738,2019-10-12,337,8155,2114,1,10607
738,2019-10-13,321,7390,1709,1,9421
738,2019-10-14,995,3916,2161,0,7072
738,2019-10-15,247,13196,1059,1,14503
738,2019-10-16,244,23152,1443,4,24843
738,2019-10-17,347,6675,1425,0,8447
738,2019-10-18,1164,7059,2027,0,10250
738,2019-10-19,241,3742,2684,1,6668
738,2019-10-20,265,1210,1973,0,3448
738,2019-10-21,269,14664,1832,5,16770
738,2019-10-22,527,5190,1681,1,7399
738,2019-10-23,335,7049,1425,0,8809
738,2019-10-24,246,12588,1608,1,14443
738,2019-10-25,1198,9334,1234,1,11767
738,2019-10-26,1275,11899,2268,0,15442
738,2019-10-27,780,14705,2012,1,17498
738,2019-10-28,242,12239,2441,1,14923
738,2019-10-29,604,14373,2372,0,17349
738,2019-10-30,889,7026,1411,1,9327
738,2019-10-31,1181,9337,1218,3,11739
738,2019-11-01,203,15070,1217,0,16490
738,2019-11-02,240,13082,1363,2,14687
738,2019-11-03,253,21723,1136,0,23112
738,2019-11-04,243,6323,1917,0,8483
738,2019-11-05,431,776,3404,1,4612
738,2019-11-06,888,6567,2081,2,9538
738,2019-11-07,365,20998,1864,3,23230
738,2019-11-08,341,10844,2111,0,13296
738,2019-11-09,1710,7766,1740,0,11216
738,2019-11-10,402,12209,1267,2,13880
738,2019-11-11,345,7424,1645,3,9417
738,2019-11-12,1278,8412,2564,0,12254
738,2019-11-13,1568,11785,2393,3,15749
738,2019-11-14,758,8036,2273,3,11070
738,2019-11-15,959,3732,2211,0,6902
738,2019-11-16,2003,3042,2842,1,7888
738,2019-11-17,608,3279,3476,0,7363
738,2019-11-18,1455,3388,3183,2,8028
738,2019-11-19,726,3324,2640,0,6690
738,2019-11-20,595,1380,2445,4,4424
738,2019-11-21,678,5499,1842,0,8019
738,2019-11-22,742,8510,1898,3,11153
738,2019-11-23,2320,6694,2250,0,11264
738,2019-11-24,4069,5231,1511,2,10813
738,2019-11-25,2274,6917,1939,1,11131
738,2019-11-26,999,8888,1110,1,10998
738,2019-11-27,1454,6688,1081,0,9223
738,2019-11-28,788,7086,829,0,8703
738,2019-11-29,58,639,2,0,699
738,2019-08-17,127,661,270,0,1058
738,2019-08-18,1079,231,1071,0,2381
738,2019-08-19,354,691,1442,0,2487
738,2019-08-20,684,1156,1549,0,3389
738,2019-08-21,1265,1493,2036,0,4794
738,2019-08-22,1323,2355,1884,0,5562
738,2019-08-23,1721,962,1444,0,4127
738,2019-08-24,2371,2158,1628,0,6157
738,2019-08-25,2662,12410,857,0,15929
738,2019-08-26,823,32125,2385,1,35334
738,2019-08-27,304,11592,1710,1,13607
738,2019-08-28,589,11874,2357,0,14820
738,2019-08-29,974,13154,1713,0,15841
738,2019-08-30,574,3062,364,2,4002
738,2019-08-31,370,54,2,0,426
738,2019-09-01,550,1219,363,0,2132
738,2019-09-02,447,19,1,0,467
738,2019-09-03,434,584,1214,0,2232
738,2019-09-04,1510,14474,2658,3,18645
738,2019-09-05,706,13683,2163,0,16552
738,2019-09-06,758,23922,1329,2,26011
738,2019-09-07,1658,9463,2449,0,13570
738,2019-09-08,572,5271,1747,0,7590
738,2019-09-09,820,7277,2293,0,10390
738,2019-09-10,1300,12294,2024,0,15618
738,2019-09-11,305,8922,2397,5,11629
738,2019-09-12,408,10332,1903,1,12644
738,2019-09-13,972,3488,2049,2,6511
738,2019-09-14,259,9783,1833,1,11876
738,2019-09-15,236,8339,3364,1,11940
738,2019-09-16,353,13061,2513,4,15931
738,2019-09-17,308,11633,2070,6,14017
738,2019-09-18,852,27769,1044,8,29673
738,2019-09-19,350,10395,1032,9,11786
738,2019-09-20,576,22822,1966,9,25373
738,2019-09-21,191,12714,2067,10,14982
738,2019-09-22,1626,8122,1392,9,11149
738,2019-09-23,309,8763,2292,11,11375
738,2019-09-24,273,12115,2002,13,14403
738,2019-09-25,1196,10746,1320,12,13274
738,2019-09-26,236,12894,2326,12,15468
738,2019-09-27,1794,10554,1862,3,14213
738,2019-09-28,353,14063,1831,3,16250
738,2019-09-29,1964,16731,2086,1,20782
738,2019-09-30,233,25331,1527,2,27093
738,2019-10-01,232,26473,1085,1,27791
738,2019-10-02,1161,12282,2081,7,15531
738,2019-10-03,232,22151,1483,12,23878
738,2019-10-04,231,20578,1221,10,22040
738,2019-10-05,233,23415,910,10,24568
738,2019-10-06,1070,15516,1848,12,18446
738,2019-10-07,349,4466,2351,12,7178
738,2019-10-08,223,10740,1805,11,12779
738,2019-10-09,1173,22211,1580,9,24973
738,2019-10-10,201,12287,1552,10,14050
738,2019-10-11,438,14182,2411,12,17043
738,2019-10-12,337,8155,2114,1,10607
738,2019-10-13,321,7390,1709,1,9421
738,2019-10-14,995,3916,2161,0,7072
738,2019-10-15,247,13196,1059,1,14503
738,2019-10-16,244,23152,1443,4,24843
738,2019-10-17,347,6675,1425,0,8447
738,2019-10-18,1164,7059,2027,0,10250
738,2019-10-19,241,3742,2684,1,6668
738,2019-10-20,265,1210,1973,0,3448
738,2019-10-21,269,14664,1832,5,16770
738,2019-10-22,527,5190,1681,1,7399
738,2019-10-23,335,7049,1425,0,8809
738,2019-10-24,246,12588,1608,1,14443
738,2019-10-25,1198,9334,1234,1,11767
738,2019-10-26,1275,11899,2268,0,15442
738,2019-10-27,780,14705,2012,1,17498
738,2019-10-28,242,12239,2441,1,14923
738,2019-10-29,604,14373,2372,0,17349
738,2019-10-30,889,7026,1411,1,9327
738,2019-10-31,1181,9337,1218,3,11739
738,2019-11-01,203,15070,1217,0,16490
738,2019-11-02,240,13082,1363,2,14687
738,2019-11-03,253,21723,1136,0,23112
738,2019-11-04,243,6323,1917,0,8483
738,2019-11-05,431,776,3404,1,4612
738,2019-11-06,888,6567,2081,2,9538
738,2019-11-07,365,20998,1864,3,23230
738,2019-11-08,341,10844,2111,0,13296
738,2019-11-09,1710,7766,1740,0,11216
738,2019-11-10,402,12209,1267,2,13880
738,2019-11-11,345,7424,1645,3,9417
738,2019-11-12,1278,8412,2564,0,12254
738,2019-11-13,1568,11785,2393,3,15749
738,2019-11-14,758,8036,2273,3,11070
738,2019-11-15,959,3732,2211,0,6902
738,2019-11-16,2003,3042,2842,1,7888
738,2019-11-17,608,3279,3476,0,7363
738,2019-11-18,1455,3388,3183,2,8028
738,2019-11-19,726,3324,2640,0,6690
738,2019-11-20,595,1380,2445,4,4424
738,2019-11-21,678,5499,1842,0,8019
738,2019-11-22,742,8510,1898,3,11153
738,2019-11-23,2320,6694,2250,0,11264
738,2019-11-24,4069,5231,1511,2,10813
738,2019-11-25,2274,6917,1939,1,11131
738,2019-11-26,999,8888,1110,1,10998
738,2019-11-27,1454,6688,1081,0,9223
738,2019-11-28,788,7086,829,0,8703
738,2019-11-29,58,639,2,0,699
738,2019-08-26,823,32125,2385,1,35334
738,2019-08-27,304,11592,1710,1,13607
738,2019-08-28,589,11874,2357,0,14820
738,2019-08-29,974,13154,1713,0,15841
738,2019-08-30,574,3062,364,2,4002
738,2019-08-31,370,54,2,0,426
738,2019-09-01,550,1219,363,0,2132
738,2019-09-02,447,19,1,0,467
738,2019-09-03,434,584,1214,0,2232
738,2019-09-04,1510,14474,2658,3,18645
738,2019-09-05,706,13683,2163,0,16552
738,2019-09-06,758,23922,1329,2,26011
738,2019-09-07,1658,9463,2449,0,13570
738,2019-09-08,572,5271,1747,0,7590
738,2019-09-09,820,7277,2293,0,10390
738,2019-09-10,1300,12294,2024,0,15618
738,2019-09-11,305,8922,2397,5,11629
738,2019-09-12,408,10332,1903,1,12644
738,2019-09-13,972,3488,2049,2,6511
738,2019-09-14,259,9783,1833,1,11876
738,2019-09-15,236,8339,3364,1,11940
738,2019-09-16,353,13061,2513,4,15931
738,2019-09-17,308,11633,2070,6,14017
738,2019-09-18,852,27769,1044,8,29673
738,2019-09-19,350,10395,1032,9,11786
738,2019-09-20,576,22822,1966,9,25373
738,2019-09-21,191,12714,2067,10,14982
738,2019-09-22,1626,8122,1392,9,11149
738,2019-09-23,309,8763,2292,11,11375
738,2019-09-24,273,12115,2002,13,14403
738,2019-09-25,1196,10746,1320,12,13274
738,2019-09-26,236,12894,2326,12,15468
738,2019-09-27,1794,10554,1862,3,14213
738,2019-09-28,353,14063,1831,3,16250
738,2019-09-29,1964,16731,2086,1,20782
738,2019-09-30,233,25331,1527,2,27093
738,2019-10-01,232,26473,1085,1,27791
738,2019-10-02,1161,12282,2081,7,15531
738,2019-10-03,232,22151,1483,12,23878
738,2019-10-04,231,20578,1221,10,22040
738,2019-10-05,233,23415,910,10,24568
738,2019-10-06,1070,15516,1848,12,18446
738,2019-10-07,349,4466,2351,12,7178
738,2019-10-08,223,10740,1805,11,12779
738,2019-10-09,1173,22211,1580,9,24973
738,2019-10-10,201,12287,1552,10,14050
738,2019-10-11,438,14182,2411,12,17043
738,2019-10-12,337,8155,2114,1,10607
738,2019-10-13,321,7390,1709,1,9421
738,2019-10-14,995,3916,2161,0,7072
738,2019-10-15,247,13196,1059,1,14503
738,2019-10-16,244,23152,1443,4,24843
738,2019-10-17,347,6675,1425,0,8447
738,2019-10-18,1164,7059,2027,0,10250
738,2019-10-19,241,3742,2684,1,6668
738,2019-10-20,265,1210,1973,0,3448
738,2019-10-21,269,14664,1832,5,16770
738,2019-10-22,527,5190,1681,1,7399
738,2019-10-23,335,7049,1425,0,8809
738,2019-10-24,246,12588,1608,1,14443
738,2019-10-25,1198,9334,1234,1,11767
738,2019-10-26,1275,11899,2268,0,15442
738,2019-10-27,780,14705,2012,1,17498
738,2019-10-28,242,12239,2441,1,14923
738,2019-10-29,604,14373,2372,0,17349
738,2019-10-30,889,7026,1411,1,9327
738,2019-10-31,1181,9337,1218,3,11739
738,2019-11-01,203,15070,1217,0,16490
738,2019-11-02,240,13082,1363,2,14687
738,2019-11-03,253,21723,1136,0,23112
738,2019-11-04,243,6323,1917,0,8483
738,2019-11-05,431,776,3404,1,4612
738,2019-11-06,888,6567,2081,2,9538
738,2019-11-07,365,20998,1864,3,23230
738,2019-11-08,341,10844,2111,0,13296
738,2019-11-09,1710,7766,1740,0,11216
738,2019-11-10,402,12209,1267,2,13880
738,2019-11-11,345,7424,1645,3,9417
738,2019-11-12,1278,8412,2564,0,12254
738,2019-11-13,1568,11785,2393,3,15749
738,2019-11-14,758,8036,2273,3,11070
738,2019-11-15,959,3732,2211,0,6902
738,2019-11-16,2003,3042,2842,1,7888
738,2019-11-17,608,3279,3476,0,7363
738,2019-11-18,1455,3388,3183,2,8028
738,2019-11-19,726,3324,2640,0,6690
738,2019-11-20,595,1380,2445,4,4424
738,2019-11-21,678,5499,1842,0,8019
738,2019-11-22,742,8510,1898,3,11153
738,2019-11-23,2320,6694,2250,0,11264
738,2019-11-24,4069,5231,1511,2,10813
738,2019-11-25,2274,6917,1939,1,11131
738,2019-11-26,999,8888,1110,1,10998
739,2019-08-17,83,1187,627,0,1897
739,2019-08-18,240,1259,1063,1,2563
739,2019-08-19,296,1046,1767,2,3111
739,2019-08-20,341,2661,1576,0,4578
739,2019-08-21,260,875,938,0,2073
739,2019-08-22,562,14350,1407,0,16319
739,2019-08-23,486,12670,1808,1,14965
739,2019-08-24,1268,3982,1260,0,6510
739,2019-08-25,534,3820,1894,1,6249
739,2019-08-26,417,1010,1260,0,2687
739,2019-08-27,268,7332,1770,1,9371
739,2019-08-28,200,12264,2040,0,14504
739,2019-08-29,204,12363,1891,3,14461
739,2019-08-30,197,2655,374,2,3228
739,2019-08-31,131,41,8,0,180
739,2019-09-01,193,173,90,0,456
739,2019-09-02,112,100,3,0,215
739,2019-09-03,145,4021,1263,1,5430
739,2019-09-04,227,8843,1587,0,10657
739,2019-09-05,245,12793,2462,1,15501
739,2019-09-06,299,10919,2610,1,13829
739,2019-09-07,224,15560,2232,0,18016
739,2019-09-08,368,5905,1326,0,7599
739,2019-09-09,213,8645,2559,0,11417
739,2019-09-10,1946,10097,2616,0,14659
739,2019-09-11,258,5887,1511,3,7659
739,2019-09-12,214,11520,2973,3,14710
739,2019-09-13,1136,7377,2798,0,11311
739,2019-09-14,998,9857,1535,1,12391
739,2019-09-15,232,10212,2079,0,12523
739,2019-09-16,258,18080,1737,0,20075
739,2019-09-17,267,11891,2100,0,14258
739,2019-09-18,271,20663,1579,0,22513
739,2019-09-19,410,4783,1504,2,6699
739,2019-09-20,1918,16097,1285,2,19302
739,2019-09-21,199,8118,1599,1,9917
739,2019-09-22,811,13408,1066,1,15286
739,2019-09-23,259,15770,1588,3,17620
739,2019-09-24,215,7397,1717,2,9331
739,2019-09-25,1110,7163,2173,2,10448
739,2019-09-26,265,13007,1132,0,14404
739,2019-09-27,201,7559,1980,1,9741
739,2019-09-28,236,24060,1808,3,26107
739,2019-09-29,927,27884,2224,1,31036
739,2019-09-30,176,19331,1480,1,20988
739,2019-10-01,983,20875,1510,0,23368
739,2019-10-02,163,12795,1880,2,14840
739,2019-10-03,163,22043,1540,2,23748
739,2019-10-04,2249,14942,2406,2,19599
739,2019-10-05,1721,20732,2142,0,24595
739,2019-10-06,3811,15628,2364,1,21804
739,2019-10-07,1998,4482,1622,2,8104
739,2019-10-08,950,16414,1174,5,18543
739,2019-10-09,268,16862,1657,1,18788
739,2019-10-10,591,9224,2708,1,12524
739,2019-10-11,544,9171,1644,2,11361
739,2019-10-12,443,6155,2691,1,9290
739,2019-10-13,1646,7290,868,3,9807
739,2019-10-14,214,6424,1477,1,8116
739,2019-10-15,219,13877,1589,1,15686
739,2019-10-16,1296,22553,2113,1,25963
739,2019-10-17,140,7201,1836,2,9179
739,2019-10-18,284,8119,1592,4,9999
739,2019-10-19,1148,3742,2348,0,7238
739,2019-10-20,237,760,2206,0,3203
739,2019-10-21,291,10493,1252,2,12038
739,2019-10-22,321,4566,2138,0,7025
739,2019-10-23,452,8079,1515,3,10049
739,2019-10-24,253,12709,1344,0,14306
739,2019-10-25,468,13954,1377,3,15802
739,2019-10-26,1168,24108,1059,1,26336
739,2019-10-27,986,18049,1343,0,20378
739,2019-10-28,1031,22101,1677,1,24810
739,2019-10-29,536,17518,2075,1,20130
739,2019-10-30,244,14466,856,0,15566
739,2019-10-31,587,18984,1427,0,20998
739,2019-11-01,208,25239,1435,0,26882
739,2019-11-02,609,15278,1361,3,17251
739,2019-11-03,233,21529,1728,1,23491
739,2019-11-04,427,6323,1220,0,7970
739,2019-11-05,416,1684,1124,0,3224
739,2019-11-06,684,13518,948,1,15151
739,2019-11-07,439,16088,1428,2,17957
739,2019-11-08,179,8929,1140,0,10248
739,2019-11-09,477,12527,1673,0,14677
739,2019-11-10,1452,22587,438,0,24477
739,2019-11-11,485,14907,1649,3,17044
739,2019-11-12,316,11442,3454,4,15216
739,2019-11-13,417,12942,2174,2,15535
739,2019-11-14,407,12413,1821,2,14643
739,2019-11-15,506,5071,2334,2,7913
739,2019-11-16,1054,2958,2438,1,6451
739,2019-11-17,832,4748,4048,4,9632
739,2019-11-18,1255,2663,3077,2,6997
739,2019-11-19,279,5214,2865,0,8358
739,2019-11-20,246,1503,2088,0,3837
739,2019-11-21,375,3694,1930,2,6001
739,2019-11-22,358,4983,1697,5,7043
739,2019-11-23,213,6102,2091,1,8407
739,2019-11-24,658,5833,1817,0,8308
739,2019-11-25,514,6721,1738,0,8973
739,2019-11-26,160,6482,1532,0,8174
739,2019-11-27,238,6402,1666,2,8308
739,2019-11-28,158,7157,512,2,7829
739,2019-11-29,299,649,4,0,952
739,2019-08-17,83,1187,627,0,1897
739,2019-08-18,240,1259,1063,1,2563
739,2019-08-19,296,1046,1767,2,3111
739,2019-08-20,341,2661,1576,0,4578
739,2019-08-21,260,875,938,0,2073
739,2019-08-22,562,14350,1407,0,16319
739,2019-08-23,486,12670,1808,1,14965
739,2019-08-24,1268,3982,1260,0,6510
739,2019-08-25,534,3820,1894,1,6249
739,2019-08-26,417,1010,1260,0,2687
739,2019-08-27,268,7332,1770,1,9371
739,2019-08-28,200,12264,2040,0,14504
739,2019-08-29,204,12363,1891,3,14461
739,2019-08-30,197,2655,374,2,3228
739,2019-08-31,131,41,8,0,180
739,2019-09-01,193,173,90,0,456
739,2019-09-02,112,100,3,0,215
739,2019-09-03,145,4021,1263,1,5430
739,2019-09-04,227,8843,1587,0,10657
739,2019-09-05,245,12793,2462,1,15501
739,2019-09-06,299,10919,2610,1,13829
739,2019-09-07,224,15560,2232,0,18016
739,2019-09-08,368,5905,1326,0,7599
739,2019-09-09,213,8645,2559,0,11417
739,2019-09-10,1946,10097,2616,0,14659
739,2019-09-11,258,5887,1511,3,7659
739,2019-09-12,214,11520,2973,3,14710
739,2019-09-13,1136,7377,2798,0,11311
739,2019-09-14,998,9857,1535,1,12391
739,2019-09-15,232,10212,2079,0,12523
739,2019-09-16,258,18080,1737,0,20075
739,2019-09-17,267,11891,2100,0,14258
739,2019-09-18,271,20663,1579,0,22513
739,2019-09-19,410,4783,1504,2,6699
739,2019-09-20,1918,16097,1285,2,19302
739,2019-09-21,199,8118,1599,1,9917
739,2019-09-22,811,13408,1066,1,15286
739,2019-09-23,259,15770,1588,3,17620
739,2019-09-24,215,7397,1717,2,9331
739,2019-09-25,1110,7163,2173,2,10448
739,2019-09-26,265,13007,1132,0,14404
739,2019-09-27,201,7559,1980,1,9741
739,2019-09-28,236,24060,1808,3,26107
739,2019-09-29,927,27884,2224,1,31036
739,2019-09-30,176,19331,1480,1,20988
739,2019-10-01,983,20875,1510,0,23368
739,2019-10-02,163,12795,1880,2,14840
739,2019-10-03,163,22043,1540,2,23748
739,2019-10-04,2249,14942,2406,2,19599
739,2019-10-05,1721,20732,2142,0,24595
739,2019-10-06,3811,15628,2364,1,21804
739,2019-10-07,1998,4482,1622,2,8104
739,2019-10-08,950,16414,1174,5,18543
739,2019-10-09,268,16862,1657,1,18788
739,2019-10-10,591,9224,2708,1,12524
739,2019-10-11,544,9171,1644,2,11361
739,2019-10-12,443,6155,2691,1,9290
739,2019-10-13,1646,7290,868,3,9807
739,2019-10-14,214,6424,1477,1,8116
739,2019-10-15,219,13877,1589,1,15686
739,2019-10-16,1296,22553,2113,1,25963
739,2019-10-17,140,7201,1836,2,9179
739,2019-10-18,284,8119,1592,4,9999
739,2019-10-19,1148,3742,2348,0,7238
739,2019-10-20,237,760,2206,0,3203
739,2019-10-21,291,10493,1252,2,12038
739,2019-10-22,321,4566,2138,0,7025
739,2019-10-23,452,8079,1515,3,10049
739,2019-10-24,253,12709,1344,0,14306
739,2019-10-25,468,13954,1377,3,15802
739,2019-10-26,1168,24108,1059,1,26336
739,2019-10-27,986,18049,1343,0,20378
739,2019-10-28,1031,22101,1677,1,24810
739,2019-10-29,536,17518,2075,1,20130
739,2019-10-30,244,14466,856,0,15566
739,2019-10-31,587,18984,1427,0,20998
739,2019-11-01,208,25239,1435,0,26882
739,2019-11-02,609,15278,1361,3,17251
739,2019-11-03,233,21529,1728,1,23491
739,2019-11-04,427,6323,1220,0,7970
739,2019-11-05,416,1684,1124,0,3224
739,2019-11-06,684,13518,948,1,15151
739,2019-11-07,439,16088,1428,2,17957
739,2019-11-08,179,8929,1140,0,10248
739,2019-11-09,477,12527,1673,0,14677
739,2019-11-10,1452,22587,438,0,24477
739,2019-11-11,485,14907,1649,3,17044
739,2019-11-12,316,11442,3454,4,15216
739,2019-11-13,417,12942,2174,2,15535
739,2019-11-14,407,12413,1821,2,14643
739,2019-11-15,506,5071,2334,2,7913
739,2019-11-16,1054,2958,2438,1,6451
739,2019-11-17,832,4748,4048,4,9632
739,2019-11-18,1255,2663,3077,2,6997
739,2019-11-19,279,5214,2865,0,8358
739,2019-11-20,246,1503,2088,0,3837
739,2019-11-21,375,3694,1930,2,6001
739,2019-11-22,358,4983,1697,5,7043
739,2019-11-23,213,6102,2091,1,8407
739,2019-11-24,658,5833,1817,0,8308
739,2019-11-25,514,6721,1738,0,8973
739,2019-11-26,160,6482,1532,0,8174
739,2019-11-27,238,6402,1666,2,8308
739,2019-11-28,158,7157,512,2,7829
739,2019-11-29,299,649,4,0,952
739,2019-08-17,83,1187,627,0,1897
739,2019-08-18,240,1259,1063,1,2563
739,2019-08-19,296,1046,1767,2,3111
739,2019-08-20,341,2661,1576,0,4578
739,2019-08-21,260,875,938,0,2073
739,2019-08-22,562,14350,1407,0,16319
739,2019-08-23,486,12670,1808,1,14965
739,2019-08-24,1268,3982,1260,0,6510
739,2019-08-25,534,3820,1894,1,6249
739,2019-08-26,417,1010,1260,0,2687
739,2019-08-27,268,7332,1770,1,9371
739,2019-08-28,200,12264,2040,0,14504
739,2019-08-29,204,12363,1891,3,14461
739,2019-08-30,197,2655,374,2,3228
739,2019-08-31,131,41,8,0,180
739,2019-09-01,193,173,90,0,456
739,2019-09-02,112,100,3,0,215
739,2019-09-03,145,4021,1263,1,5430
739,2019-09-04,227,8843,1587,0,10657
739,2019-09-05,245,12793,2462,1,15501
739,2019-09-06,299,10919,2610,1,13829
739,2019-09-07,224,15560,2232,0,18016
739,2019-09-08,368,5905,1326,0,7599
739,2019-09-09,213,8645,2559,0,11417
739,2019-09-10,1946,10097,2616,0,14659
739,2019-09-11,258,5887,1511,3,7659
739,2019-09-12,214,11520,2973,3,14710
739,2019-09-13,1136,7377,2798,0,11311
739,2019-09-14,998,9857,1535,1,12391
739,2019-09-15,232,10212,2079,0,12523
739,2019-09-16,258,18080,1737,0,20075
739,2019-09-17,267,11891,2100,0,14258
739,2019-09-18,271,20663,1579,0,22513
739,2019-09-19,410,4783,1504,2,6699
739,2019-09-20,1918,16097,1285,2,19302
739,2019-09-21,199,8118,1599,1,9917
739,2019-09-22,811,13408,1066,1,15286
739,2019-09-23,259,15770,1588,3,17620
739,2019-09-24,215,7397,1717,2,9331
739,2019-09-25,1110,7163,2173,2,10448
739,2019-09-26,265,13007,1132,0,14404
739,2019-09-27,201,7559,1980,1,9741
739,2019-09-28,236,24060,1808,3,26107
739,2019-09-29,927,27884,2224,1,31036
739,2019-09-30,176,19331,1480,1,20988
739,2019-10-01,983,20875,1510,0,23368
739,2019-10-02,163,12795,1880,2,14840
739,2019-10-03,163,22043,1540,2,23748
739,2019-10-04,2249,14942,2406,2,19599
739,2019-10-05,1721,20732,2142,0,24595
739,2019-10-06,3811,15628,2364,1,21804
739,2019-10-07,1998,4482,1622,2,8104
739,2019-10-08,950,16414,1174,5,18543
739,2019-10-09,268,16862,1657,1,18788
739,2019-10-10,591,9224,2708,1,12524
739,2019-10-11,544,9171,1644,2,11361
739,2019-10-12,443,6155,2691,1,9290
739,2019-10-13,1646,7290,868,3,9807
739,2019-10-14,214,6424,1477,1,8116
739,2019-10-15,219,13877,1589,1,15686
739,2019-10-16,1296,22553,2113,1,25963
739,2019-10-17,140,7201,1836,2,9179
739,2019-10-18,284,8119,1592,4,9999
739,2019-10-19,1148,3742,2348,0,7238
739,2019-10-20,237,760,2206,0,3203
739,2019-10-21,291,10493,1252,2,12038
739,2019-10-22,321,4566,2138,0,7025
739,2019-10-23,452,8079,1515,3,10049
739,2019-10-24,253,12709,1344,0,14306
739,2019-10-25,468,13954,1377,3,15802
739,2019-10-26,1168,24108,1059,1,26336
739,2019-10-27,986,18049,1343,0,20378
739,2019-10-28,1031,22101,1677,1,24810
739,2019-10-29,536,17518,2075,1,20130
739,2019-10-30,244,14466,856,0,15566
739,2019-10-31,587,18984,1427,0,20998
739,2019-11-01,208,25239,1435,0,26882
739,2019-11-02,609,15278,1361,3,17251
739,2019-11-03,233,21529,1728,1,23491
739,2019-11-04,427,6323,1220,0,7970
739,2019-11-05,416,1684,1124,0,3224
739,2019-11-06,684,13518,948,1,15151
739,2019-11-07,439,16088,1428,2,17957
739,2019-11-08,179,8929,1140,0,10248
739,2019-11-09,477,12527,1673,0,14677
739,2019-11-10,1452,22587,438,0,24477
739,2019-11-11,485,14907,1649,3,17044
739,2019-11-12,316,11442,3454,4,15216
739,2019-11-13,417,12942,2174,2,15535
739,2019-11-14,407,12413,1821,2,14643
739,2019-11-15,506,5071,2334,2,7913
739,2019-11-16,1054,2958,2438,1,6451
739,2019-11-17,832,4748,4048,4,9632
739,2019-11-18,1255,2663,3077,2,6997
739,2019-11-19,279,5214,2865,0,8358
739,2019-11-20,246,1503,2088,0,3837
739,2019-11-21,375,3694,1930,2,6001
739,2019-11-22,358,4983,1697,5,7043
739,2019-11-23,213,6102,2091,1,8407
739,2019-11-24,658,5833,1817,0,8308
739,2019-11-25,514,6721,1738,0,8973
739,2019-11-26,160,6482,1532,0,8174
739,2019-11-27,238,6402,1666,2,8308
739,2019-11-28,158,7157,512,2,7829
739,2019-11-29,299,649,4,0,952
739,2019-08-18,240,1259,1063,1,2563
739,2019-08-19,296,1046,1767,2,3111
739,2019-08-20,341,2661,1576,0,4578
739,2019-08-21,260,875,938,0,2073
739,2019-08-22,562,14350,1407,0,16319
739,2019-08-23,486,12670,1808,1,14965
739,2019-08-24,1268,3982,1260,0,6510
739,2019-08-25,534,3820,1894,1,6249
739,2019-08-26,417,1010,1260,0,2687
739,2019-08-27,268,7332,1770,1,9371
739,2019-08-28,200,12264,2040,0,14504
739,2019-08-29,204,12363,1891,3,14461
739,2019-08-30,197,2655,374,2,3228
739,2019-08-31,131,41,8,0,180
739,2019-09-01,193,173,90,0,456
739,2019-09-02,112,100,3,0,215
739,2019-09-03,145,4021,1263,1,5430
739,2019-09-04,227,8843,1587,0,10657
739,2019-09-05,245,12793,2462,1,15501
739,2019-09-06,299,10919,2610,1,13829
739,2019-09-07,224,15560,2232,0,18016
739,2019-09-08,368,5905,1326,0,7599
739,2019-09-09,213,8645,2559,0,11417
739,2019-09-10,1946,10097,2616,0,14659
739,2019-09-11,258,5887,1511,3,7659
739,2019-09-12,214,11520,2973,3,14710
739,2019-09-13,1136,7377,2798,0,11311
739,2019-09-14,998,9857,1535,1,12391
739,2019-09-15,232,10212,2079,0,12523
739,2019-09-16,258,18080,1737,0,20075
739,2019-09-17,267,11891,2100,0,14258
739,2019-09-18,271,20663,1579,0,22513
739,2019-09-19,410,4783,1504,2,6699
739,2019-09-20,1918,16097,1285,2,19302
739,2019-09-21,199,8118,1599,1,9917
739,2019-09-22,811,13408,1066,1,15286
739,2019-09-23,259,15770,1588,3,17620
739,2019-09-24,215,7397,1717,2,9331
739,2019-09-25,1110,7163,2173,2,10448
739,2019-09-26,265,13007,1132,0,14404
739,2019-09-27,201,7559,1980,1,9741
739,2019-09-28,236,24060,1808,3,26107
739,2019-09-29,927,27884,2224,1,31036
739,2019-09-30,176,19331,1480,1,20988
739,2019-10-01,983,20875,1510,0,23368
739,2019-10-02,163,12795,1880,2,14840
739,2019-10-03,163,22043,1540,2,23748
739,2019-10-04,2249,14942,2406,2,19599
739,2019-10-05,1721,20732,2142,0,24595
739,2019-10-06,3811,15628,2364,1,21804
739,2019-10-07,1998,4482,1622,2,8104
739,2019-10-08,950,16414,1174,5,18543
739,2019-10-09,268,16862,1657,1,18788
739,2019-10-10,591,9224,2708,1,12524
739,2019-10-11,544,9171,1644,2,11361
739,2019-10-12,443,6155,2691,1,9290
739,2019-10-13,1646,7290,868,3,9807
739,2019-10-14,214,6424,1477,1,8116
739,2019-10-15,219,13877,1589,1,15686
739,2019-10-16,1296,22553,2113,1,25963
739,2019-10-17,140,7201,1836,2,9179
739,2019-10-18,284,8119,1592,4,9999
739,2019-10-19,1148,3742,2348,0,7238
739,2019-10-20,237,760,2206,0,3203
739,2019-10-21,291,10493,1252,2,12038
739,2019-10-22,321,4566,2138,0,7025
739,2019-10-23,452,8079,1515,3,10049
739,2019-10-24,253,12709,1344,0,14306
739,2019-10-25,468,13954,1377,3,15802
739,2019-10-26,1168,24108,1059,1,26336
739,2019-10-27,986,18049,1343,0,20378
739,2019-10-28,1031,22101,1677,1,24810
739,2019-10-29,536,17518,2075,1,20130
739,2019-10-30,244,14466,856,0,15566
739,2019-10-31,587,18984,1427,0,20998
739,2019-11-01,208,25239,1435,0,26882
739,2019-11-02,609,15278,1361,3,17251
739,2019-11-03,233,21529,1728,1,23491
739,2019-11-04,427,6323,1220,0,7970
739,2019-11-05,416,1684,1124,0,3224
739,2019-11-06,684,13518,948,1,15151
739,2019-11-07,439,16088,1428,2,17957
739,2019-11-08,179,8929,1140,0,10248
739,2019-11-09,477,12527,1673,0,14677
739,2019-11-10,1452,22587,438,0,24477
739,2019-11-11,485,14907,1649,3,17044
739,2019-11-12,316,11442,3454,4,15216
739,2019-11-13,417,12942,2174,2,15535
739,2019-11-14,407,12413,1821,2,14643
739,2019-11-15,506,5071,2334,2,7913
739,2019-11-16,1054,2958,2438,1,6451
739,2019-11-17,832,4748,4048,4,9632
739,2019-11-18,1255,2663,3077,2,6997
739,2019-11-19,279,5214,2865,0,8358
739,2019-11-20,246,1503,2088,0,3837
739,2019-11-21,375,3694,1930,2,6001
739,2019-11-22,358,4983,1697,5,7043
739,2019-11-23,213,6102,2091,1,8407
739,2019-11-24,658,5833,1817,0,8308
739,2019-11-25,514,6721,1738,0,8973
739,2019-11-26,160,6482,1532,0,8174
739,2019-11-27,238,6402,1666,2,8308
739,2019-11-28,158,7157,512,2,7829
740,2019-08-18,111,1480,1110,0,2701
740,2019-08-19,756,761,916,0,2433
740,2019-08-20,111,1772,824,2,2709
740,2019-08-21,80,1260,1236,0,2576
740,2019-08-22,84,16950,1714,1,18749
740,2019-08-23,68,7123,742,0,7933
740,2019-08-24,47,3458,1822,0,5327
740,2019-08-25,94,25455,1666,0,27215
740,2019-08-26,917,35845,1260,0,38022
740,2019-08-27,61,12314,1080,1,13456
740,2019-08-28,635,12761,2584,2,15982
740,2019-08-29,109,12262,1574,0,13945
740,2019-08-30,44,2747,904,1,3696
740,2019-08-31,6,47,20,0,73
740,2019-09-01,132,560,212,0,904
740,2019-09-02,9,66,32,1,108
740,2019-09-03,74,503,577,1,1155
740,2019-09-04,88,5752,2458,0,8298
740,2019-09-05,68,8998,2187,0,11253
740,2019-09-06,81,17482,2572,0,20135
740,2019-09-07,134,11591,1958,0,13683
740,2019-09-08,1078,4712,1251,0,7041
740,2019-09-09,78,6522,2715,1,9316
740,2019-09-10,136,7605,2394,2,10137
740,2019-09-11,1039,6898,1678,4,9619
740,2019-09-12,82,8047,1750,1,9880
740,2019-09-13,76,6266,1261,1,7604
740,2019-09-14,922,11979,1986,0,14887
740,2019-09-15,39,9873,1724,0,11636
740,2019-09-16,903,9944,2028,0,12875
740,2019-09-17,67,7853,2160,1,10081
740,2019-09-18,51,11832,1391,2,13276
740,2019-09-19,267,8946,1890,0,11103
740,2019-09-20,255,9159,1836,0,11250
740,2019-09-21,58,11671,1982,0,13711
740,2019-09-22,938,13827,2080,3,16848
740,2019-09-23,1014,12812,1207,0,15033
740,2019-09-24,94,9081,1773,5,10953
740,2019-09-25,200,8497,2325,1,11023
740,2019-09-26,90,9905,2654,0,12649
740,2019-09-27,75,9623,1631,4,11333
740,2019-09-28,107,16068,1714,2,17891
740,2019-09-29,81,18940,2915,0,21936
740,2019-09-30,77,19105,2275,2,21459
740,2019-10-01,73,17710,1620,2,19405
740,2019-10-02,60,12994,1715,0,14769
740,2019-10-03,92,15727,1364,0,17183
740,2019-10-04,59,18737,2083,0,20879
740,2019-10-05,562,24431,954,0,25947
740,2019-10-06,772,17609,1179,1,19561
740,2019-10-07,949,7730,2361,3,11043
740,2019-10-08,1052,18571,943,2,20568
740,2019-10-09,963,18010,1833,1,20807
740,2019-10-10,83,13395,2635,0,16113
740,2019-10-11,57,9358,1591,2,11008
740,2019-10-12,248,7613,2724,3,10588
740,2019-10-13,47,13078,1439,1,14565
740,2019-10-14,418,6755,2441,0,9614
740,2019-10-15,657,10193,1050,0,11900
740,2019-10-16,629,23933,2275,0,26837
740,2019-10-17,72,11995,1383,5,13455
740,2019-10-18,124,14978,1278,0,16380
740,2019-10-19,945,8951,1815,1,11712
740,2019-10-20,159,3118,1617,0,4894
740,2019-10-21,551,11116,2470,1,14138
740,2019-10-22,813,6693,1713,3,9222
740,2019-10-23,391,8881,1102,0,10374
740,2019-10-24,181,14806,1436,0,16423
740,2019-10-25,81,10816,1295,2,12194
740,2019-10-26,78,17008,1964,0,19050
740,2019-10-27,200,15747,2279,0,18226
740,2019-10-28,703,23951,2407,2,27063
740,2019-10-29,113,17776,1765,708,20362
740,2019-10-30,571,16898,1573,0,19042
740,2019-10-31,47,13067,1798,1,14913
740,2019-11-01,49,26184,575,2,26810
740,2019-11-02,28,27051,2597,1,29677
740,2019-11-03,730,25645,994,1,27370
740,2019-11-04,67,14375,2030,1,16473
740,2019-11-05,677,5182,2446,0,8305
740,2019-11-06,80,14600,2211,3,16894
740,2019-11-07,391,16660,2264,2,19317
740,2019-11-08,62,10659,1779,2,12502
740,2019-11-09,62,8993,2655,2,11712
740,2019-11-10,58,24154,2140,2,26354
740,2019-11-11,989,16801,1199,6,18995
740,2019-11-12,554,17155,2630,0,20339
740,2019-11-13,968,11821,2342,2,15133
740,2019-11-14,604,13850,2060,2,16516
740,2019-11-15,61,5496,2588,0,8145
740,2019-11-16,1068,2649,2404,1,6122
740,2019-11-17,845,3553,3494,1,7893
740,2019-11-18,85,3303,2949,0,6337
740,2019-11-19,158,5175,3172,0,8505
740,2019-11-20,914,1495,2565,1,4975
740,2019-11-21,86,1462,1592,2,3142
740,2019-11-22,175,5732,1379,3,7289
740,2019-11-23,86,10219,2118,0,12423
740,2019-11-24,194,11434,1351,1,12980
740,2019-11-25,60,7703,1409,0,9172
740,2019-11-26,55,10568,1326,3,11952
740,2019-11-27,81,2582,2234,0,4897
740,2019-11-28,69,6631,680,0,7380
740,2019-11-29,14,734,2,0,750
740,2019-08-18,111,1480,1110,0,2701
740,2019-08-19,756,761,916,0,2433
740,2019-08-20,111,1772,824,2,2709
740,2019-08-21,80,1260,1236,0,2576
740,2019-08-22,84,16950,1714,1,18749
740,2019-08-23,68,7123,742,0,7933
740,2019-08-24,47,3458,1822,0,5327
740,2019-08-25,94,25455,1666,0,27215
740,2019-08-26,917,35845,1260,0,38022
740,2019-08-27,61,12314,1080,1,13456
740,2019-08-28,635,12761,2584,2,15982
740,2019-08-29,109,12262,1574,0,13945
740,2019-08-30,44,2747,904,1,3696
740,2019-08-31,6,47,20,0,73
740,2019-09-01,132,560,212,0,904
740,2019-09-02,9,66,32,1,108
740,2019-09-03,74,503,577,1,1155
740,2019-09-04,88,5752,2458,0,8298
740,2019-09-05,68,8998,2187,0,11253
740,2019-09-06,81,17482,2572,0,20135
740,2019-09-07,134,11591,1958,0,13683
740,2019-09-08,1078,4712,1251,0,7041
740,2019-09-09,78,6522,2715,1,9316
740,2019-09-10,136,7605,2394,2,10137
740,2019-09-11,1039,6898,1678,4,9619
740,2019-09-12,82,8047,1750,1,9880
740,2019-09-13,76,6266,1261,1,7604
740,2019-09-14,922,11979,1986,0,14887
740,2019-09-15,39,9873,1724,0,11636
740,2019-09-16,903,9944,2028,0,12875
740,2019-09-17,67,7853,2160,1,10081
740,2019-09-18,51,11832,1391,2,13276
740,2019-09-19,267,8946,1890,0,11103
740,2019-09-20,255,9159,1836,0,11250
740,2019-09-21,58,11671,1982,0,13711
740,2019-09-22,938,13827,2080,3,16848
740,2019-09-23,1014,12812,1207,0,15033
740,2019-09-24,94,9081,1773,5,10953
740,2019-09-25,200,8497,2325,1,11023
740,2019-09-26,90,9905,2654,0,12649
740,2019-09-27,75,9623,1631,4,11333
740,2019-09-28,107,16068,1714,2,17891
740,2019-09-29,81,18940,2915,0,21936
740,2019-09-30,77,19105,2275,2,21459
740,2019-10-01,73,17710,1620,2,19405
740,2019-10-02,60,12994,1715,0,14769
740,2019-10-03,92,15727,1364,0,17183
740,2019-10-04,59,18737,2083,0,20879
740,2019-10-05,562,24431,954,0,25947
740,2019-10-06,772,17609,1179,1,19561
740,2019-10-07,949,7730,2361,3,11043
740,2019-10-08,1052,18571,943,2,20568
740,2019-10-09,963,18010,1833,1,20807
740,2019-10-10,83,13395,2635,0,16113
740,2019-10-11,57,9358,1591,2,11008
740,2019-10-12,248,7613,2724,3,10588
740,2019-10-13,47,13078,1439,1,14565
740,2019-10-14,418,6755,2441,0,9614
740,2019-10-15,657,10193,1050,0,11900
740,2019-10-16,629,23933,2275,0,26837
740,2019-10-17,72,11995,1383,5,13455
740,2019-10-18,124,14978,1278,0,16380
740,2019-10-19,945,8951,1815,1,11712
740,2019-10-20,159,3118,1617,0,4894
740,2019-10-21,551,11116,2470,1,14138
740,2019-10-22,813,6693,1713,3,9222
740,2019-10-23,391,8881,1102,0,10374
740,2019-10-24,181,14806,1436,0,16423
740,2019-10-25,81,10816,1295,2,12194
740,2019-10-26,78,17008,1964,0,19050
740,2019-10-27,200,15747,2279,0,18226
740,2019-10-28,703,23951,2407,2,27063
740,2019-10-29,113,17776,1765,708,20362
740,2019-10-30,571,16898,1573,0,19042
740,2019-10-31,47,13067,1798,1,14913
740,2019-11-01,49,26184,575,2,26810
740,2019-11-02,28,27051,2597,1,29677
740,2019-11-03,730,25645,994,1,27370
740,2019-11-04,67,14375,2030,1,16473
740,2019-11-05,677,5182,2446,0,8305
740,2019-11-06,80,14600,2211,3,16894
740,2019-11-07,391,16660,2264,2,19317
740,2019-11-08,62,10659,1779,2,12502
740,2019-11-09,62,8993,2655,2,11712
740,2019-11-10,58,24154,2140,2,26354
740,2019-11-11,989,16801,1199,6,18995
740,2019-11-12,554,17155,2630,0,20339
740,2019-11-13,968,11821,2342,2,15133
740,2019-11-14,604,13850,2060,2,16516
740,2019-11-15,61,5496,2588,0,8145
740,2019-11-16,1068,2649,2404,1,6122
740,2019-11-17,845,3553,3494,1,7893
740,2019-11-18,85,3303,2949,0,6337
740,2019-11-19,158,5175,3172,0,8505
740,2019-11-20,914,1495,2565,1,4975
740,2019-11-21,86,1462,1592,2,3142
740,2019-11-22,175,5732,1379,3,7289
740,2019-11-23,86,10219,2118,0,12423
740,2019-11-24,194,11434,1351,1,12980
740,2019-11-25,60,7703,1409,0,9172
740,2019-11-26,55,10568,1326,3,11952
740,2019-11-27,81,2582,2234,0,4897
740,2019-11-28,69,6631,680,0,7380
740,2019-11-29,14,734,2,0,750
740,2019-08-18,111,1480,1110,0,2701
740,2019-08-19,756,761,916,0,2433
740,2019-08-20,111,1772,824,2,2709
740,2019-08-21,80,1260,1236,0,2576
740,2019-08-22,84,16950,1714,1,18749
740,2019-08-23,68,7123,742,0,7933
740,2019-08-24,47,3458,1822,0,5327
740,2019-08-25,94,25455,1666,0,27215
740,2019-08-26,917,35845,1260,0,38022
740,2019-08-27,61,12314,1080,1,13456
740,2019-08-28,635,12761,2584,2,15982
740,2019-08-29,109,12262,1574,0,13945
740,2019-08-30,44,2747,904,1,3696
740,2019-08-31,6,47,20,0,73
740,2019-09-01,132,560,212,0,904
740,2019-09-02,9,66,32,1,108
740,2019-09-03,74,503,577,1,1155
740,2019-09-04,88,5752,2458,0,8298
740,2019-09-05,68,8998,2187,0,11253
740,2019-09-06,81,17482,2572,0,20135
740,2019-09-07,134,11591,1958,0,13683
740,2019-09-08,1078,4712,1251,0,7041
740,2019-09-09,78,6522,2715,1,9316
740,2019-09-10,136,7605,2394,2,10137
740,2019-09-11,1039,6898,1678,4,9619
740,2019-09-12,82,8047,1750,1,9880
740,2019-09-13,76,6266,1261,1,7604
740,2019-09-14,922,11979,1986,0,14887
740,2019-09-15,39,9873,1724,0,11636
740,2019-09-16,903,9944,2028,0,12875
740,2019-09-17,67,7853,2160,1,10081
740,2019-09-18,51,11832,1391,2,13276
740,2019-09-19,267,8946,1890,0,11103
740,2019-09-20,255,9159,1836,0,11250
740,2019-09-21,58,11671,1982,0,13711
740,2019-09-22,938,13827,2080,3,16848
740,2019-09-23,1014,12812,1207,0,15033
740,2019-09-24,94,9081,1773,5,10953
740,2019-09-25,200,8497,2325,1,11023
740,2019-09-26,90,9905,2654,0,12649
740,2019-09-27,75,9623,1631,4,11333
740,2019-09-28,107,16068,1714,2,17891
740,2019-09-29,81,18940,2915,0,21936
740,2019-09-30,77,19105,2275,2,21459
740,2019-10-01,73,17710,1620,2,19405
740,2019-10-02,60,12994,1715,0,14769
740,2019-10-03,92,15727,1364,0,17183
740,2019-10-04,59,18737,2083,0,20879
740,2019-10-05,562,24431,954,0,25947
740,2019-10-06,772,17609,1179,1,19561
740,2019-10-07,949,7730,2361,3,11043
740,2019-10-08,1052,18571,943,2,20568
740,2019-10-09,963,18010,1833,1,20807
740,2019-10-10,83,13395,2635,0,16113
740,2019-10-11,57,9358,1591,2,11008
740,2019-10-12,248,7613,2724,3,10588
740,2019-10-13,47,13078,1439,1,14565
740,2019-10-14,418,6755,2441,0,9614
740,2019-10-15,657,10193,1050,0,11900
740,2019-10-16,629,23933,2275,0,26837
740,2019-10-17,72,11995,1383,5,13455
740,2019-10-18,124,14978,1278,0,16380
740,2019-10-19,945,8951,1815,1,11712
740,2019-10-20,159,3118,1617,0,4894
740,2019-10-21,551,11116,2470,1,14138
740,2019-10-22,813,6693,1713,3,9222
740,2019-10-23,391,8881,1102,0,10374
740,2019-10-24,181,14806,1436,0,16423
740,2019-10-25,81,10816,1295,2,12194
740,2019-10-26,78,17008,1964,0,19050
740,2019-10-27,200,15747,2279,0,18226
740,2019-10-28,703,23951,2407,2,27063
740,2019-10-29,113,17776,1765,708,20362
740,2019-10-30,571,16898,1573,0,19042
740,2019-10-31,47,13067,1798,1,14913
740,2019-11-01,49,26184,575,2,26810
740,2019-11-02,28,27051,2597,1,29677
740,2019-11-03,730,25645,994,1,27370
740,2019-11-04,67,14375,2030,1,16473
740,2019-11-05,677,5182,2446,0,8305
740,2019-11-06,80,14600,2211,3,16894
740,2019-11-07,391,16660,2264,2,19317
740,2019-11-08,62,10659,1779,2,12502
740,2019-11-09,62,8993,2655,2,11712
740,2019-11-10,58,24154,2140,2,26354
740,2019-11-11,989,16801,1199,6,18995
740,2019-11-12,554,17155,2630,0,20339
740,2019-11-13,968,11821,2342,2,15133
740,2019-11-14,604,13850,2060,2,16516
740,2019-11-15,61,5496,2588,0,8145
740,2019-11-16,1068,2649,2404,1,6122
740,2019-11-17,845,3553,3494,1,7893
740,2019-11-18,85,3303,2949,0,6337
740,2019-11-19,158,5175,3172,0,8505
740,2019-11-20,914,1495,2565,1,4975
740,2019-11-21,86,1462,1592,2,3142
740,2019-11-22,175,5732,1379,3,7289
740,2019-11-23,86,10219,2118,0,12423
740,2019-11-24,194,11434,1351,1,12980
740,2019-11-25,60,7703,1409,0,9172
740,2019-11-26,55,10568,1326,3,11952
740,2019-11-27,81,2582,2234,0,4897
740,2019-11-28,69,6631,680,0,7380
740,2019-11-29,14,734,2,0,750
740,2019-08-20,111,1772,824,2,2709
740,2019-08-21,80,1260,1236,0,2576
740,2019-08-22,84,16950,1714,1,18749
740,2019-08-23,68,7123,742,0,7933
740,2019-08-24,47,3458,1822,0,5327
740,2019-08-25,94,25455,1666,0,27215
740,2019-08-26,917,35845,1260,0,38022
740,2019-08-27,61,12314,1080,1,13456
740,2019-08-28,635,12761,2584,2,15982
740,2019-08-29,109,12262,1574,0,13945
740,2019-08-30,44,2747,904,1,3696
740,2019-08-31,6,47,20,0,73
740,2019-09-01,132,560,212,0,904
740,2019-09-02,9,66,32,1,108
740,2019-09-03,74,503,577,1,1155
740,2019-09-04,88,5752,2458,0,8298
740,2019-09-05,68,8998,2187,0,11253
740,2019-09-06,81,17482,2572,0,20135
740,2019-09-07,134,11591,1958,0,13683
740,2019-09-08,1078,4712,1251,0,7041
740,2019-09-09,78,6522,2715,1,9316
740,2019-09-10,136,7605,2394,2,10137
740,2019-09-11,1039,6898,1678,4,9619
740,2019-09-12,82,8047,1750,1,9880
740,2019-09-13,76,6266,1261,1,7604
740,2019-09-14,922,11979,1986,0,14887
740,2019-09-15,39,9873,1724,0,11636
740,2019-09-16,903,9944,2028,0,12875
740,2019-09-17,67,7853,2160,1,10081
740,2019-09-18,51,11832,1391,2,13276
740,2019-09-19,267,8946,1890,0,11103
740,2019-09-20,255,9159,1836,0,11250
740,2019-09-21,58,11671,1982,0,13711
740,2019-09-22,938,13827,2080,3,16848
740,2019-09-23,1014,12812,1207,0,15033
740,2019-09-24,94,9081,1773,5,10953
740,2019-09-25,200,8497,2325,1,11023
740,2019-09-26,90,9905,2654,0,12649
740,2019-09-27,75,9623,1631,4,11333
740,2019-09-28,107,16068,1714,2,17891
740,2019-09-29,81,18940,2915,0,21936
740,2019-09-30,77,19105,2275,2,21459
740,2019-10-01,73,17710,1620,2,19405
740,2019-10-02,60,12994,1715,0,14769
740,2019-10-03,92,15727,1364,0,17183
740,2019-10-04,59,18737,2083,0,20879
740,2019-10-05,562,24431,954,0,25947
740,2019-10-06,772,17609,1179,1,19561
740,2019-10-07,949,7730,2361,3,11043
740,2019-10-08,1052,18571,943,2,20568
740,2019-10-09,963,18010,1833,1,20807
740,2019-10-10,83,13395,2635,0,16113
740,2019-10-11,57,9358,1591,2,11008
740,2019-10-12,248,7613,2724,3,10588
740,2019-10-13,47,13078,1439,1,14565
740,2019-10-14,418,6755,2441,0,9614
740,2019-10-15,657,10193,1050,0,11900
740,2019-10-16,629,23933,2275,0,26837
740,2019-10-17,72,11995,1383,5,13455
740,2019-10-18,124,14978,1278,0,16380
740,2019-10-19,945,8951,1815,1,11712
740,2019-10-20,159,3118,1617,0,4894
740,2019-10-21,551,11116,2470,1,14138
740,2019-10-22,813,6693,1713,3,9222
740,2019-10-23,391,8881,1102,0,10374
740,2019-10-24,181,14806,1436,0,16423
740,2019-10-25,81,10816,1295,2,12194
740,2019-10-26,78,17008,1964,0,19050
740,2019-10-27,200,15747,2279,0,18226
740,2019-10-28,703,23951,2407,2,27063
740,2019-10-29,113,17776,1765,708,20362
740,2019-10-30,571,16898,1573,0,19042
740,2019-10-31,47,13067,1798,1,14913
740,2019-11-01,49,26184,575,2,26810
740,2019-11-02,28,27051,2597,1,29677
740,2019-11-03,730,25645,994,1,27370
740,2019-11-04,67,14375,2030,1,16473
740,2019-11-05,677,5182,2446,0,8305
740,2019-11-06,80,14600,2211,3,16894
740,2019-11-07,391,16660,2264,2,19317
740,2019-11-08,62,10659,1779,2,12502
740,2019-11-09,62,8993,2655,2,11712
740,2019-11-10,58,24154,2140,2,26354
740,2019-11-11,989,16801,1199,6,18995
740,2019-11-12,554,17155,2630,0,20339
740,2019-11-13,968,11821,2342,2,15133
740,2019-11-14,604,13850,2060,2,16516
740,2019-11-15,61,5496,2588,0,8145
740,2019-11-16,1068,2649,2404,1,6122
740,2019-11-17,845,3553,3494,1,7893
740,2019-11-18,85,3303,2949,0,6337
740,2019-11-19,158,5175,3172,0,8505
740,2019-11-20,914,1495,2565,1,4975
740,2019-11-21,86,1462,1592,2,3142
740,2019-11-22,175,5732,1379,3,7289
740,2019-11-23,86,10219,2118,0,12423
740,2019-11-24,194,11434,1351,1,12980
740,2019-11-25,60,7703,1409,0,9172
740,2019-11-26,55,10568,1326,3,11952
741,2019-08-18,198,1125,966,0,2289
741,2019-08-19,238,1345,751,0,2334
741,2019-08-20,435,1573,1052,1,3061
741,2019-08-21,253,1996,950,1,3200
741,2019-08-22,582,12480,1334,1,14397
741,2019-08-23,217,5278,1715,1,7211
741,2019-08-24,1083,4582,1097,1,6763
741,2019-08-25,1057,5463,1683,0,8203
741,2019-08-26,270,5384,2393,0,8047
741,2019-08-27,1007,7661,2070,0,10738
741,2019-08-28,260,4206,1530,0,5996
741,2019-08-29,415,10127,1452,1,11995
741,2019-08-30,281,2921,810,3,4015
741,2019-08-31,86,64,29,0,179
741,2019-09-01,110,98,212,0,420
741,2019-09-02,112,56,51,0,219
741,2019-09-03,126,427,1102,2,1657
741,2019-09-04,192,9716,2307,0,12215
741,2019-09-05,184,10218,1753,0,12155
741,2019-09-06,205,15374,2034,0,17613
741,2019-09-07,450,23850,1894,1,26195
741,2019-09-08,1222,7046,1949,3,10220
741,2019-09-09,212,7204,2000,0,9416
741,2019-09-10,184,12014,2055,0,14253
741,2019-09-11,235,10461,1910,3,12609
741,2019-09-12,201,13760,2293,2,16256
741,2019-09-13,1757,5421,1910,1,9089
741,2019-09-14,257,6965,2358,0,9580
741,2019-09-15,188,6547,2565,0,9300
741,2019-09-16,198,10688,2474,1,13361
741,2019-09-17,214,7383,1532,0,9129
741,2019-09-18,503,11979,1383,0,13865
741,2019-09-19,352,2450,1836,1,4639
741,2019-09-20,1940,8654,1297,138,12029
741,2019-09-21,218,6817,1781,36,8852
741,2019-09-22,208,13360,2040,1,15609
741,2019-09-23,387,12087,2135,0,14609
741,2019-09-24,257,7529,2295,3,10084
741,2019-09-25,366,8353,1571,302,10592
741,2019-09-26,199,9517,1695,0,11411
741,2019-09-27,1000,7880,2089,3,10972
741,2019-09-28,282,14716,1437,3,16438
741,2019-09-29,164,17215,1518,0,18897
741,2019-09-30,336,26620,1661,0,28617
741,2019-10-01,1878,20313,1460,1,23652
741,2019-10-02,278,10502,1743,1,12524
741,2019-10-03,545,22091,2043,1,24680
741,2019-10-04,205,13174,2032,3,15414
741,2019-10-05,1067,21642,1204,1,23914
741,2019-10-06,1423,15536,2768,0,19727
741,2019-10-07,1168,6737,2799,1,10705
741,2019-10-08,285,10683,1808,6,12782
741,2019-10-09,209,16150,2046,3,18408
741,2019-10-10,814,9330,2387,0,12531
741,2019-10-11,241,8196,2108,0,10545
741,2019-10-12,915,5750,1017,0,7682
741,2019-10-13,1908,10871,1692,4,14475
741,2019-10-14,1917,3886,1371,0,7174
741,2019-10-15,1297,6930,2217,1,10445
741,2019-10-16,192,17768,1065,1,19026
741,2019-10-17,198,7051,1357,0,8606
741,2019-10-18,1108,8334,1628,4,11074
741,2019-10-19,228,5666,2313,1,8208
741,2019-10-20,1076,643,1881,0,3600
741,2019-10-21,227,9905,1731,1,11864
741,2019-10-22,173,4928,1609,906,7616
741,2019-10-23,1326,8773,1928,4,12031
741,2019-10-24,230,13476,1589,4,15299
741,2019-10-25,158,14057,1550,2,15767
741,2019-10-26,210,23402,2051,0,25663
741,2019-10-27,898,29080,2718,0,32696
741,2019-10-28,163,17277,2147,0,19587
741,2019-10-29,596,14442,1679,0,16717
741,2019-10-30,177,15041,1534,0,16752
741,2019-10-31,1762,11515,14599,0,27876
741,2019-11-01,729,25109,1520,1,27359
741,2019-11-02,1905,25486,1096,3,28490
741,2019-11-03,763,24148,1084,0,25995
741,2019-11-04,442,8970,1209,0,10621
741,2019-11-05,785,1205,2476,0,4466
741,2019-11-06,331,13140,1780,2,15253
741,2019-11-07,247,15382,1928,0,17557
741,2019-11-08,185,13837,1740,0,15762
741,2019-11-09,406,9915,3155,0,13476
741,2019-11-10,560,12115,2321,0,14996
741,2019-11-11,736,11947,2792,0,15475
741,2019-11-12,189,10886,3039,0,14114
741,2019-11-13,147,13225,2153,0,15525
741,2019-11-14,1670,7634,1548,0,10852
741,2019-11-15,1055,2300,2714,0,6069
741,2019-11-16,160,840,2224,0,3224
741,2019-11-17,1197,2034,4204,0,7435
741,2019-11-18,226,2103,3213,0,5542
741,2019-11-19,1064,4518,3324,0,8906
741,2019-11-20,1088,1035,2175,0,4298
741,2019-11-21,201,5125,2345,2,7673
741,2019-11-22,477,4365,1502,3,6347
741,2019-11-23,341,10283,3145,1,13770
741,2019-11-24,1161,8615,1740,0,11516
741,2019-11-25,451,10397,2573,2,13423
741,2019-11-26,113,5559,0,0,5672
741,2019-11-27,60,1718,0,0,1778
741,2019-08-18,198,1125,966,0,2289
741,2019-08-19,238,1345,751,0,2334
741,2019-08-20,435,1573,1052,1,3061
741,2019-08-21,253,1996,950,1,3200
741,2019-08-22,582,12480,1334,1,14397
741,2019-08-23,217,5278,1715,1,7211
741,2019-08-24,1083,4582,1097,1,6763
741,2019-08-25,1057,5463,1683,0,8203
741,2019-08-26,270,5384,2393,0,8047
741,2019-08-27,1007,7661,2070,0,10738
741,2019-08-28,260,4206,1530,0,5996
741,2019-08-29,415,10127,1452,1,11995
741,2019-08-30,281,2921,810,3,4015
741,2019-08-31,86,64,29,0,179
741,2019-09-01,110,98,212,0,420
741,2019-09-02,112,56,51,0,219
741,2019-09-03,126,427,1102,2,1657
741,2019-09-04,192,9716,2307,0,12215
741,2019-09-05,184,10218,1753,0,12155
741,2019-09-06,205,15374,2034,0,17613
741,2019-09-07,450,23850,1894,1,26195
741,2019-09-08,1222,7046,1949,3,10220
741,2019-09-09,212,7204,2000,0,9416
741,2019-09-10,184,12014,2055,0,14253
741,2019-09-11,235,10461,1910,3,12609
741,2019-09-12,201,13760,2293,2,16256
741,2019-09-13,1757,5421,1910,1,9089
741,2019-09-14,257,6965,2358,0,9580
741,2019-09-15,188,6547,2565,0,9300
741,2019-09-16,198,10688,2474,1,13361
741,2019-09-17,214,7383,1532,0,9129
741,2019-09-18,503,11979,1383,0,13865
741,2019-09-19,352,2450,1836,1,4639
741,2019-09-20,1940,8654,1297,138,12029
741,2019-09-21,218,6817,1781,36,8852
741,2019-09-22,208,13360,2040,1,15609
741,2019-09-23,387,12087,2135,0,14609
741,2019-09-24,257,7529,2295,3,10084
741,2019-09-25,366,8353,1571,302,10592
741,2019-09-26,199,9517,1695,0,11411
741,2019-09-27,1000,7880,2089,3,10972
741,2019-09-28,282,14716,1437,3,16438
741,2019-09-29,164,17215,1518,0,18897
741,2019-09-30,336,26620,1661,0,28617
741,2019-10-01,1878,20313,1460,1,23652
741,2019-10-02,278,10502,1743,1,12524
741,2019-10-03,545,22091,2043,1,24680
741,2019-10-04,205,13174,2032,3,15414
741,2019-10-05,1067,21642,1204,1,23914
741,2019-10-06,1423,15536,2768,0,19727
741,2019-10-07,1168,6737,2799,1,10705
741,2019-10-08,285,10683,1808,6,12782
741,2019-10-09,209,16150,2046,3,18408
741,2019-10-10,814,9330,2387,0,12531
741,2019-10-11,241,8196,2108,0,10545
741,2019-10-12,915,5750,1017,0,7682
741,2019-10-13,1908,10871,1692,4,14475
741,2019-10-14,1917,3886,1371,0,7174
741,2019-10-15,1297,6930,2217,1,10445
741,2019-10-16,192,17768,1065,1,19026
741,2019-10-17,198,7051,1357,0,8606
741,2019-10-18,1108,8334,1628,4,11074
741,2019-10-19,228,5666,2313,1,8208
741,2019-10-20,1076,643,1881,0,3600
741,2019-10-21,227,9905,1731,1,11864
741,2019-10-22,173,4928,1609,906,7616
741,2019-10-23,1326,8773,1928,4,12031
741,2019-10-24,230,13476,1589,4,15299
741,2019-10-25,158,14057,1550,2,15767
741,2019-10-26,210,23402,2051,0,25663
741,2019-10-27,898,29080,2718,0,32696
741,2019-10-28,163,17277,2147,0,19587
741,2019-10-29,596,14442,1679,0,16717
741,2019-10-30,177,15041,1534,0,16752
741,2019-10-31,1762,11515,14599,0,27876
741,2019-11-01,729,25109,1520,1,27359
741,2019-11-02,1905,25486,1096,3,28490
741,2019-11-03,763,24148,1084,0,25995
741,2019-11-04,442,8970,1209,0,10621
741,2019-11-05,785,1205,2476,0,4466
741,2019-11-06,331,13140,1780,2,15253
741,2019-11-07,247,15382,1928,0,17557
741,2019-11-08,185,13837,1740,0,15762
741,2019-11-09,406,9915,3155,0,13476
741,2019-11-10,560,12115,2321,0,14996
741,2019-11-11,736,11947,2792,0,15475
741,2019-11-12,189,10886,3039,0,14114
741,2019-11-13,147,13225,2153,0,15525
741,2019-11-14,1670,7634,1548,0,10852
741,2019-11-15,1055,2300,2714,0,6069
741,2019-11-16,160,840,2224,0,3224
741,2019-11-17,1197,2034,4204,0,7435
741,2019-11-18,226,2103,3213,0,5542
741,2019-11-19,1064,4518,3324,0,8906
741,2019-11-20,1088,1035,2175,0,4298
741,2019-11-21,201,5125,2345,2,7673
741,2019-11-22,477,4365,1502,3,6347
741,2019-11-23,341,10283,3145,1,13770
741,2019-11-24,1161,8615,1740,0,11516
741,2019-11-25,451,10397,2573,2,13423
741,2019-11-26,113,5559,0,0,5672
741,2019-11-27,60,1718,0,0,1778
741,2019-08-18,198,1125,966,0,2289
741,2019-08-19,238,1345,751,0,2334
741,2019-08-20,435,1573,1052,1,3061
741,2019-08-21,253,1996,950,1,3200
741,2019-08-22,582,12480,1334,1,14397
741,2019-08-23,217,5278,1715,1,7211
741,2019-08-24,1083,4582,1097,1,6763
741,2019-08-25,1057,5463,1683,0,8203
741,2019-08-26,270,5384,2393,0,8047
741,2019-08-27,1007,7661,2070,0,10738
741,2019-08-28,260,4206,1530,0,5996
741,2019-08-29,415,10127,1452,1,11995
741,2019-08-30,281,2921,810,3,4015
741,2019-08-31,86,64,29,0,179
741,2019-09-01,110,98,212,0,420
741,2019-09-02,112,56,51,0,219
741,2019-09-03,126,427,1102,2,1657
741,2019-09-04,192,9716,2307,0,12215
741,2019-09-05,184,10218,1753,0,12155
741,2019-09-06,205,15374,2034,0,17613
741,2019-09-07,450,23850,1894,1,26195
741,2019-09-08,1222,7046,1949,3,10220
741,2019-09-09,212,7204,2000,0,9416
741,2019-09-10,184,12014,2055,0,14253
741,2019-09-11,235,10461,1910,3,12609
741,2019-09-12,201,13760,2293,2,16256
741,2019-09-13,1757,5421,1910,1,9089
741,2019-09-14,257,6965,2358,0,9580
741,2019-09-15,188,6547,2565,0,9300
741,2019-09-16,198,10688,2474,1,13361
741,2019-09-17,214,7383,1532,0,9129
741,2019-09-18,503,11979,1383,0,13865
741,2019-09-19,352,2450,1836,1,4639
741,2019-09-20,1940,8654,1297,138,12029
741,2019-09-21,218,6817,1781,36,8852
741,2019-09-22,208,13360,2040,1,15609
741,2019-09-23,387,12087,2135,0,14609
741,2019-09-24,257,7529,2295,3,10084
741,2019-09-25,366,8353,1571,302,10592
741,2019-09-26,199,9517,1695,0,11411
741,2019-09-27,1000,7880,2089,3,10972
741,2019-09-28,282,14716,1437,3,16438
741,2019-09-29,164,17215,1518,0,18897
741,2019-09-30,336,26620,1661,0,28617
741,2019-10-01,1878,20313,1460,1,23652
741,2019-10-02,278,10502,1743,1,12524
741,2019-10-03,545,22091,2043,1,24680
741,2019-10-04,205,13174,2032,3,15414
741,2019-10-05,1067,21642,1204,1,23914
741,2019-10-06,1423,15536,2768,0,19727
741,2019-10-07,1168,6737,2799,1,10705
741,2019-10-08,285,10683,1808,6,12782
741,2019-10-09,209,16150,2046,3,18408
741,2019-10-10,814,9330,2387,0,12531
741,2019-10-11,241,8196,2108,0,10545
741,2019-10-12,915,5750,1017,0,7682
741,2019-10-13,1908,10871,1692,4,14475
741,2019-10-14,1917,3886,1371,0,7174
741,2019-10-15,1297,6930,2217,1,10445
741,2019-10-16,192,17768,1065,1,19026
741,2019-10-17,198,7051,1357,0,8606
741,2019-10-18,1108,8334,1628,4,11074
741,2019-10-19,228,5666,2313,1,8208
741,2019-10-20,1076,643,1881,0,3600
741,2019-10-21,227,9905,1731,1,11864
741,2019-10-22,173,4928,1609,906,7616
741,2019-10-23,1326,8773,1928,4,12031
741,2019-10-24,230,13476,1589,4,15299
741,2019-10-25,158,14057,1550,2,15767
741,2019-10-26,210,23402,2051,0,25663
741,2019-10-27,898,29080,2718,0,32696
741,2019-10-28,163,17277,2147,0,19587
741,2019-10-29,596,14442,1679,0,16717
741,2019-10-30,177,15041,1534,0,16752
741,2019-10-31,1762,11515,14599,0,27876
741,2019-11-01,729,25109,1520,1,27359
741,2019-11-02,1905,25486,1096,3,28490
741,2019-11-03,763,24148,1084,0,25995
741,2019-11-04,442,8970,1209,0,10621
741,2019-11-05,785,1205,2476,0,4466
741,2019-11-06,331,13140,1780,2,15253
741,2019-11-07,247,15382,1928,0,17557
741,2019-11-08,185,13837,1740,0,15762
741,2019-11-09,406,9915,3155,0,13476
741,2019-11-10,560,12115,2321,0,14996
741,2019-11-11,736,11947,2792,0,15475
741,2019-11-12,189,10886,3039,0,14114
741,2019-11-13,147,13225,2153,0,15525
741,2019-11-14,1670,7634,1548,0,10852
741,2019-11-15,1055,2300,2714,0,6069
741,2019-11-16,160,840,2224,0,3224
741,2019-11-17,1197,2034,4204,0,7435
741,2019-11-18,226,2103,3213,0,5542
741,2019-11-19,1064,4518,3324,0,8906
741,2019-11-20,1088,1035,2175,0,4298
741,2019-11-21,201,5125,2345,2,7673
741,2019-11-22,477,4365,1502,3,6347
741,2019-11-23,341,10283,3145,1,13770
741,2019-11-24,1161,8615,1740,0,11516
741,2019-11-25,451,10397,2573,2,13423
741,2019-08-20,435,1573,1052,1,3061
741,2019-08-21,253,1996,950,1,3200
741,2019-08-22,582,12480,1334,1,14397
741,2019-08-23,217,5278,1715,1,7211
741,2019-08-24,1083,4582,1097,1,6763
741,2019-08-25,1057,5463,1683,0,8203
741,2019-08-26,270,5384,2393,0,8047
741,2019-08-27,1007,7661,2070,0,10738
741,2019-08-28,260,4206,1530,0,5996
741,2019-08-29,415,10127,1452,1,11995
741,2019-08-30,281,2921,810,3,4015
741,2019-08-31,86,64,29,0,179
741,2019-09-01,110,98,212,0,420
741,2019-09-02,112,56,51,0,219
741,2019-09-03,126,427,1102,2,1657
741,2019-09-04,192,9716,2307,0,12215
741,2019-09-05,184,10218,1753,0,12155
741,2019-09-06,205,15374,2034,0,17613
741,2019-09-07,450,23850,1894,1,26195
741,2019-09-08,1222,7046,1949,3,10220
741,2019-09-09,212,7204,2000,0,9416
741,2019-09-10,184,12014,2055,0,14253
741,2019-09-11,235,10461,1910,3,12609
741,2019-09-12,201,13760,2293,2,16256
741,2019-09-13,1757,5421,1910,1,9089
741,2019-09-14,257,6965,2358,0,9580
741,2019-09-15,188,6547,2565,0,9300
741,2019-09-16,198,10688,2474,1,13361
741,2019-09-17,214,7383,1532,0,9129
741,2019-09-18,503,11979,1383,0,13865
741,2019-09-19,352,2450,1836,1,4639
741,2019-09-20,1940,8654,1297,138,12029
741,2019-09-21,218,6817,1781,36,8852
741,2019-09-22,208,13360,2040,1,15609
741,2019-09-23,387,12087,2135,0,14609
741,2019-09-24,257,7529,2295,3,10084
741,2019-09-25,366,8353,1571,302,10592
741,2019-09-26,199,9517,1695,0,11411
741,2019-09-27,1000,7880,2089,3,10972
741,2019-09-28,282,14716,1437,3,16438
741,2019-09-29,164,17215,1518,0,18897
741,2019-09-30,336,26620,1661,0,28617
741,2019-10-01,1878,20313,1460,1,23652
741,2019-10-02,278,10502,1743,1,12524
741,2019-10-03,545,22091,2043,1,24680
741,2019-10-04,205,13174,2032,3,15414
741,2019-10-05,1067,21642,1204,1,23914
741,2019-10-06,1423,15536,2768,0,19727
741,2019-10-07,1168,6737,2799,1,10705
741,2019-10-08,285,10683,1808,6,12782
741,2019-10-09,209,16150,2046,3,18408
741,2019-10-10,814,9330,2387,0,12531
741,2019-10-11,241,8196,2108,0,10545
741,2019-10-12,915,5750,1017,0,7682
741,2019-10-13,1908,10871,1692,4,14475
741,2019-10-14,1917,3886,1371,0,7174
741,2019-10-15,1297,6930,2217,1,10445
741,2019-10-16,192,17768,1065,1,19026
741,2019-10-17,198,7051,1357,0,8606
741,2019-10-18,1108,8334,1628,4,11074
741,2019-10-19,228,5666,2313,1,8208
741,2019-10-20,1076,643,1881,0,3600
741,2019-10-21,227,9905,1731,1,11864
741,2019-10-22,173,4928,1609,906,7616
741,2019-10-23,1326,8773,1928,4,12031
741,2019-10-24,230,13476,1589,4,15299
741,2019-10-25,158,14057,1550,2,15767
741,2019-10-26,210,23402,2051,0,25663
741,2019-10-27,898,29080,2718,0,32696
741,2019-10-28,163,17277,2147,0,19587
741,2019-10-29,596,14442,1679,0,16717
741,2019-10-30,177,15041,1534,0,16752
741,2019-10-31,1762,11515,14599,0,27876
741,2019-11-01,729,25109,1520,1,27359
741,2019-11-02,1905,25486,1096,3,28490
741,2019-11-03,763,24148,1084,0,25995
741,2019-11-04,442,8970,1209,0,10621
741,2019-11-05,785,1205,2476,0,4466
741,2019-11-06,331,13140,1780,2,15253
741,2019-11-07,247,15382,1928,0,17557
741,2019-11-08,185,13837,1740,0,15762
741,2019-11-09,406,9915,3155,0,13476
741,2019-11-10,560,12115,2321,0,14996
741,2019-11-11,736,11947,2792,0,15475
741,2019-11-12,189,10886,3039,0,14114
741,2019-11-13,147,13225,2153,0,15525
741,2019-11-14,1670,7634,1548,0,10852
741,2019-11-15,1055,2300,2714,0,6069
741,2019-11-16,160,840,2224,0,3224
741,2019-11-17,1197,2034,4204,0,7435
741,2019-11-18,226,2103,3213,0,5542
741,2019-11-19,1064,4518,3324,0,8906
741,2019-11-20,1088,1035,2175,0,4298
741,2019-11-21,201,5125,2345,2,7673
741,2019-11-22,477,4365,1502,3,6347
741,2019-11-23,341,10283,3145,1,13770
741,2019-11-24,1161,8615,1740,0,11516
741,2019-11-25,451,10397,2573,2,13423
742,2019-08-18,384,2019,997,0,3400
742,2019-08-19,72,1594,1329,0,2995
742,2019-08-20,123,1366,2015,1,3505
742,2019-08-21,121,1639,831,0,2591
742,2019-08-22,120,5995,1393,0,7508
742,2019-08-23,151,8873,1066,2,10092
742,2019-08-24,182,1702,1710,2,3596
742,2019-08-25,158,16020,2430,1,18609
742,2019-08-26,203,24289,1980,1,26473
742,2019-08-27,145,10396,2129,0,12670
742,2019-08-28,179,3635,1980,1,5795
742,2019-08-29,437,10049,1170,2,11658
742,2019-08-30,280,2717,631,2,3630
742,2019-08-31,18,155,9,1,183
742,2019-09-01,84,1404,533,1,2022
742,2019-09-02,16,393,0,0,409
742,2019-09-03,77,4277,929,3,5286
742,2019-09-04,101,14421,1423,1,15946
742,2019-09-05,122,10128,1390,0,11640
742,2019-09-06,952,10711,2781,1,14445
742,2019-09-07,1018,13740,1654,1,16413
742,2019-09-08,213,7755,2370,1,10339
742,2019-09-09,1038,7793,1988,0,10819
742,2019-09-10,106,7204,1690,0,9000
742,2019-09-11,164,7158,1480,2,8804
742,2019-09-12,896,10620,2088,3,13607
742,2019-09-13,75,5237,1487,0,6799
742,2019-09-14,922,8753,1636,1,11312
742,2019-09-15,64,13554,2632,1,16251
742,2019-09-16,86,12764,2245,0,15095
742,2019-09-17,913,7837,1875,2,10627
742,2019-09-18,85,11720,970,1,12776
742,2019-09-19,242,4299,1264,1,5806
742,2019-09-20,1042,9773,1441,1,12257
742,2019-09-21,95,5315,1980,2,7392
742,2019-09-22,86,8671,1278,0,10035
742,2019-09-23,186,8563,1700,0,10449
742,2019-09-24,125,8352,1807,4,10288
742,2019-09-25,119,6492,1450,3,8064
742,2019-09-26,115,7668,2332,4,10119
742,2019-09-27,190,8028,1792,1,10011
742,2019-09-28,96,14433,1635,2,16166
742,2019-09-29,77,16725,2325,1,19128
742,2019-09-30,949,18405,1656,0,21010
742,2019-10-01,102,16190,1406,1,17699
742,2019-10-02,133,10689,1834,1095,13751
742,2019-10-03,177,13816,1157,0,15150
742,2019-10-04,896,11500,1933,1,14330
742,2019-10-05,969,14637,1595,1,17202
742,2019-10-06,78,11152,1501,1,12732
742,2019-10-07,1367,5447,2181,3,8998
742,2019-10-08,126,10799,2213,2,13140
742,2019-10-09,113,14771,1538,1,16423
742,2019-10-10,120,9315,1796,1,11232
742,2019-10-11,92,9961,1842,1,11896
742,2019-10-12,969,5905,1813,1,8688
742,2019-10-13,78,10995,1429,1,12503
742,2019-10-14,1269,4501,2282,0,8052
742,2019-10-15,1415,14150,1603,1,17169
742,2019-10-16,64,23142,2069,2,25277
742,2019-10-17,966,7572,1719,872,11129
742,2019-10-18,1082,7518,2064,2,10666
742,2019-10-19,970,6764,2141,1,9876
742,2019-10-20,106,1275,2236,2,3619
742,2019-10-21,191,18469,1710,3,20373
742,2019-10-22,321,8572,1264,1,10158
742,2019-10-23,952,13219,2008,1,16180
742,2019-10-24,774,25739,1715,0,28228
742,2019-10-25,735,13801,1460,3,15999
742,2019-10-26,73,13348,22759,0,36180
742,2019-10-27,1583,16372,81485,0,99440
742,2019-10-28,79,22552,898,1,23530
742,2019-10-29,126,17444,1952,0,19522
742,2019-10-30,80,23236,1382,1,24699
742,2019-10-31,942,14396,1664,3,17005
742,2019-11-01,44,24972,2020,1,27037
742,2019-11-02,181,18070,1747,0,19998
742,2019-11-03,49,22547,1232,0,23828
742,2019-11-04,525,7843,2321,1,10690
742,2019-11-05,680,1507,1528,0,3715
742,2019-11-06,80,7554,1676,0,9310
742,2019-11-07,402,13409,1113,2,14926
742,2019-11-08,77,9482,1438,1,10998
742,2019-11-09,60,13092,1258,0,14410
742,2019-11-10,69,12339,1169,2,13579
742,2019-11-11,742,8586,1623,2,10953
742,2019-11-12,102,9068,3628,0,12798
742,2019-11-13,205,11073,1801,3,13082
742,2019-11-14,69,7469,1521,2,9061
742,2019-11-15,70,2430,2586,0,5086
742,2019-11-16,90,1302,2191,0,3583
742,2019-11-17,1008,1327,3601,1,5937
742,2019-11-18,511,2200,3301,1,6013
742,2019-11-19,139,2946,2585,0,5670
742,2019-11-20,98,1170,2095,3,3366
742,2019-11-21,207,5685,1749,6685,14326
742,2019-11-22,179,4736,1948,3,6866
742,2019-11-23,80,6067,2407,0,8554
742,2019-11-24,162,5083,1396,1,6642
742,2019-11-25,120,5831,2347,0,8298
742,2019-11-26,769,9231,1213,1,11214
742,2019-11-27,990,5379,1853,0,8222
742,2019-11-28,72,10143,568,0,10783
742,2019-11-29,14,526,2,0,542
742,2019-08-18,384,2019,997,0,3400
742,2019-08-19,72,1594,1329,0,2995
742,2019-08-20,123,1366,2015,1,3505
742,2019-08-21,121,1639,831,0,2591
742,2019-08-22,120,5995,1393,0,7508
742,2019-08-23,151,8873,1066,2,10092
742,2019-08-24,182,1702,1710,2,3596
742,2019-08-25,158,16020,2430,1,18609
742,2019-08-26,203,24289,1980,1,26473
742,2019-08-27,145,10396,2129,0,12670
742,2019-08-28,179,3635,1980,1,5795
742,2019-08-29,437,10049,1170,2,11658
742,2019-08-30,280,2717,631,2,3630
742,2019-08-31,18,155,9,1,183
742,2019-09-01,84,1404,533,1,2022
742,2019-09-02,16,393,0,0,409
742,2019-09-03,77,4277,929,3,5286
742,2019-09-04,101,14421,1423,1,15946
742,2019-09-05,122,10128,1390,0,11640
742,2019-09-06,952,10711,2781,1,14445
742,2019-09-07,1018,13740,1654,1,16413
742,2019-09-08,213,7755,2370,1,10339
742,2019-09-09,1038,7793,1988,0,10819
742,2019-09-10,106,7204,1690,0,9000
742,2019-09-11,164,7158,1480,2,8804
742,2019-09-12,896,10620,2088,3,13607
742,2019-09-13,75,5237,1487,0,6799
742,2019-09-14,922,8753,1636,1,11312
742,2019-09-15,64,13554,2632,1,16251
742,2019-09-16,86,12764,2245,0,15095
742,2019-09-17,913,7837,1875,2,10627
742,2019-09-18,85,11720,970,1,12776
742,2019-09-19,242,4299,1264,1,5806
742,2019-09-20,1042,9773,1441,1,12257
742,2019-09-21,95,5315,1980,2,7392
742,2019-09-22,86,8671,1278,0,10035
742,2019-09-23,186,8563,1700,0,10449
742,2019-09-24,125,8352,1807,4,10288
742,2019-09-25,119,6492,1450,3,8064
742,2019-09-26,115,7668,2332,4,10119
742,2019-09-27,190,8028,1792,1,10011
742,2019-09-28,96,14433,1635,2,16166
742,2019-09-29,77,16725,2325,1,19128
742,2019-09-30,949,18405,1656,0,21010
742,2019-10-01,102,16190,1406,1,17699
742,2019-10-02,133,10689,1834,1095,13751
742,2019-10-03,177,13816,1157,0,15150
742,2019-10-04,896,11500,1933,1,14330
742,2019-10-05,969,14637,1595,1,17202
742,2019-10-06,78,11152,1501,1,12732
742,2019-10-07,1367,5447,2181,3,8998
742,2019-10-08,126,10799,2213,2,13140
742,2019-10-09,113,14771,1538,1,16423
742,2019-10-10,120,9315,1796,1,11232
742,2019-10-11,92,9961,1842,1,11896
742,2019-10-12,969,5905,1813,1,8688
742,2019-10-13,78,10995,1429,1,12503
742,2019-10-14,1269,4501,2282,0,8052
742,2019-10-15,1415,14150,1603,1,17169
742,2019-10-16,64,23142,2069,2,25277
742,2019-10-17,966,7572,1719,872,11129
742,2019-10-18,1082,7518,2064,2,10666
742,2019-10-19,970,6764,2141,1,9876
742,2019-10-20,106,1275,2236,2,3619
742,2019-10-21,191,18469,1710,3,20373
742,2019-10-22,321,8572,1264,1,10158
742,2019-10-23,952,13219,2008,1,16180
742,2019-10-24,774,25739,1715,0,28228
742,2019-10-25,735,13801,1460,3,15999
742,2019-10-26,73,13348,22759,0,36180
742,2019-10-27,1583,16372,81485,0,99440
742,2019-10-28,79,22552,898,1,23530
742,2019-10-29,126,17444,1952,0,19522
742,2019-10-30,80,23236,1382,1,24699
742,2019-10-31,942,14396,1664,3,17005
742,2019-11-01,44,24972,2020,1,27037
742,2019-11-02,181,18070,1747,0,19998
742,2019-11-03,49,22547,1232,0,23828
742,2019-11-04,525,7843,2321,1,10690
742,2019-11-05,680,1507,1528,0,3715
742,2019-11-06,80,7554,1676,0,9310
742,2019-11-07,402,13409,1113,2,14926
742,2019-11-08,77,9482,1438,1,10998
742,2019-11-09,60,13092,1258,0,14410
742,2019-11-10,69,12339,1169,2,13579
742,2019-11-11,742,8586,1623,2,10953
742,2019-11-12,102,9068,3628,0,12798
742,2019-11-13,205,11073,1801,3,13082
742,2019-11-14,69,7469,1521,2,9061
742,2019-11-15,70,2430,2586,0,5086
742,2019-11-16,90,1302,2191,0,3583
742,2019-11-17,1008,1327,3601,1,5937
742,2019-11-18,511,2200,3301,1,6013
742,2019-11-19,139,2946,2585,0,5670
742,2019-11-20,98,1170,2095,3,3366
742,2019-11-21,207,5685,1749,6685,14326
742,2019-11-22,179,4736,1948,3,6866
742,2019-11-23,80,6067,2407,0,8554
742,2019-11-24,162,5083,1396,1,6642
742,2019-11-25,120,5831,2347,0,8298
742,2019-11-26,769,9231,1213,1,11214
742,2019-11-27,990,5379,1853,0,8222
742,2019-11-28,72,10143,568,0,10783
742,2019-11-29,14,526,2,0,542
742,2019-08-18,384,2019,997,0,3400
742,2019-08-19,72,1594,1329,0,2995
742,2019-08-20,123,1366,2015,1,3505
742,2019-08-21,121,1639,831,0,2591
742,2019-08-22,120,5995,1393,0,7508
742,2019-08-23,151,8873,1066,2,10092
742,2019-08-24,182,1702,1710,2,3596
742,2019-08-25,158,16020,2430,1,18609
742,2019-08-26,203,24289,1980,1,26473
742,2019-08-27,145,10396,2129,0,12670
742,2019-08-28,179,3635,1980,1,5795
742,2019-08-29,437,10049,1170,2,11658
742,2019-08-30,280,2717,631,2,3630
742,2019-08-31,18,155,9,1,183
742,2019-09-01,84,1404,533,1,2022
742,2019-09-02,16,393,0,0,409
742,2019-09-03,77,4277,929,3,5286
742,2019-09-04,101,14421,1423,1,15946
742,2019-09-05,122,10128,1390,0,11640
742,2019-09-06,952,10711,2781,1,14445
742,2019-09-07,1018,13740,1654,1,16413
742,2019-09-08,213,7755,2370,1,10339
742,2019-09-09,1038,7793,1988,0,10819
742,2019-09-10,106,7204,1690,0,9000
742,2019-09-11,164,7158,1480,2,8804
742,2019-09-12,896,10620,2088,3,13607
742,2019-09-13,75,5237,1487,0,6799
742,2019-09-14,922,8753,1636,1,11312
742,2019-09-15,64,13554,2632,1,16251
742,2019-09-16,86,12764,2245,0,15095
742,2019-09-17,913,7837,1875,2,10627
742,2019-09-18,85,11720,970,1,12776
742,2019-09-19,242,4299,1264,1,5806
742,2019-09-20,1042,9773,1441,1,12257
742,2019-09-21,95,5315,1980,2,7392
742,2019-09-22,86,8671,1278,0,10035
742,2019-09-23,186,8563,1700,0,10449
742,2019-09-24,125,8352,1807,4,10288
742,2019-09-25,119,6492,1450,3,8064
742,2019-09-26,115,7668,2332,4,10119
742,2019-09-27,190,8028,1792,1,10011
742,2019-09-28,96,14433,1635,2,16166
742,2019-09-29,77,16725,2325,1,19128
742,2019-09-30,949,18405,1656,0,21010
742,2019-10-01,102,16190,1406,1,17699
742,2019-10-02,133,10689,1834,1095,13751
742,2019-10-03,177,13816,1157,0,15150
742,2019-10-04,896,11500,1933,1,14330
742,2019-10-05,969,14637,1595,1,17202
742,2019-10-06,78,11152,1501,1,12732
742,2019-10-07,1367,5447,2181,3,8998
742,2019-10-08,126,10799,2213,2,13140
742,2019-10-09,113,14771,1538,1,16423
742,2019-10-10,120,9315,1796,1,11232
742,2019-10-11,92,9961,1842,1,11896
742,2019-10-12,969,5905,1813,1,8688
742,2019-10-13,78,10995,1429,1,12503
742,2019-10-14,1269,4501,2282,0,8052
742,2019-10-15,1415,14150,1603,1,17169
742,2019-10-16,64,23142,2069,2,25277
742,2019-10-17,966,7572,1719,872,11129
742,2019-10-18,1082,7518,2064,2,10666
742,2019-10-19,970,6764,2141,1,9876
742,2019-10-20,106,1275,2236,2,3619
742,2019-10-21,191,18469,1710,3,20373
742,2019-10-22,321,8572,1264,1,10158
742,2019-10-23,952,13219,2008,1,16180
742,2019-10-24,774,25739,1715,0,28228
742,2019-10-25,735,13801,1460,3,15999
742,2019-10-26,73,13348,22759,0,36180
742,2019-10-27,1583,16372,81485,0,99440
742,2019-10-28,79,22552,898,1,23530
742,2019-10-29,126,17444,1952,0,19522
742,2019-10-30,80,23236,1382,1,24699
742,2019-10-31,942,14396,1664,3,17005
742,2019-11-01,44,24972,2020,1,27037
742,2019-11-02,181,18070,1747,0,19998
742,2019-11-03,49,22547,1232,0,23828
742,2019-11-04,525,7843,2321,1,10690
742,2019-11-05,680,1507,1528,0,3715
742,2019-11-06,80,7554,1676,0,9310
742,2019-11-07,402,13409,1113,2,14926
742,2019-11-08,77,9482,1438,1,10998
742,2019-11-09,60,13092,1258,0,14410
742,2019-11-10,69,12339,1169,2,13579
742,2019-11-11,742,8586,1623,2,10953
742,2019-11-12,102,9068,3628,0,12798
742,2019-11-13,205,11073,1801,3,13082
742,2019-11-14,69,7469,1521,2,9061
742,2019-11-15,70,2430,2586,0,5086
742,2019-11-16,90,1302,2191,0,3583
742,2019-11-17,1008,1327,3601,1,5937
742,2019-11-18,511,2200,3301,1,6013
742,2019-11-19,139,2946,2585,0,5670
742,2019-11-20,98,1170,2095,3,3366
742,2019-11-21,207,5685,1749,6685,14326
742,2019-11-22,179,4736,1948,3,6866
742,2019-11-23,80,6067,2407,0,8554
742,2019-11-24,162,5083,1396,1,6642
742,2019-11-25,120,5831,2347,0,8298
742,2019-11-26,769,9231,1213,1,11214
742,2019-11-27,990,5379,1853,0,8222
742,2019-11-28,72,10143,568,0,10783
742,2019-11-29,14,526,2,0,542
742,2019-08-20,123,1366,2015,1,3505
742,2019-08-21,121,1639,831,0,2591
742,2019-08-22,120,5995,1393,0,7508
742,2019-08-23,151,8873,1066,2,10092
742,2019-08-24,182,1702,1710,2,3596
742,2019-08-25,158,16020,2430,1,18609
742,2019-08-26,203,24289,1980,1,26473
742,2019-08-27,145,10396,2129,0,12670
742,2019-08-28,179,3635,1980,1,5795
742,2019-08-29,437,10049,1170,2,11658
742,2019-08-30,280,2717,631,2,3630
742,2019-08-31,18,155,9,1,183
742,2019-09-01,84,1404,533,1,2022
742,2019-09-02,16,393,0,0,409
742,2019-09-03,77,4277,929,3,5286
742,2019-09-04,101,14421,1423,1,15946
742,2019-09-05,122,10128,1390,0,11640
742,2019-09-06,952,10711,2781,1,14445
742,2019-09-07,1018,13740,1654,1,16413
742,2019-09-08,213,7755,2370,1,10339
742,2019-09-09,1038,7793,1988,0,10819
742,2019-09-10,106,7204,1690,0,9000
742,2019-09-11,164,7158,1480,2,8804
742,2019-09-12,896,10620,2088,3,13607
742,2019-09-13,75,5237,1487,0,6799
742,2019-09-14,922,8753,1636,1,11312
742,2019-09-15,64,13554,2632,1,16251
742,2019-09-16,86,12764,2245,0,15095
742,2019-09-17,913,7837,1875,2,10627
742,2019-09-18,85,11720,970,1,12776
742,2019-09-19,242,4299,1264,1,5806
742,2019-09-20,1042,9773,1441,1,12257
742,2019-09-21,95,5315,1980,2,7392
742,2019-09-22,86,8671,1278,0,10035
742,2019-09-23,186,8563,1700,0,10449
742,2019-09-24,125,8352,1807,4,10288
742,2019-09-25,119,6492,1450,3,8064
742,2019-09-26,115,7668,2332,4,10119
742,2019-09-27,190,8028,1792,1,10011
742,2019-09-28,96,14433,1635,2,16166
742,2019-09-29,77,16725,2325,1,19128
742,2019-09-30,949,18405,1656,0,21010
742,2019-10-01,102,16190,1406,1,17699
742,2019-10-02,133,10689,1834,1095,13751
742,2019-10-03,177,13816,1157,0,15150
742,2019-10-04,896,11500,1933,1,14330
742,2019-10-05,969,14637,1595,1,17202
742,2019-10-06,78,11152,1501,1,12732
742,2019-10-07,1367,5447,2181,3,8998
742,2019-10-08,126,10799,2213,2,13140
742,2019-10-09,113,14771,1538,1,16423
742,2019-10-10,120,9315,1796,1,11232
742,2019-10-11,92,9961,1842,1,11896
742,2019-10-12,969,5905,1813,1,8688
742,2019-10-13,78,10995,1429,1,12503
742,2019-10-14,1269,4501,2282,0,8052
742,2019-10-15,1415,14150,1603,1,17169
742,2019-10-16,64,23142,2069,2,25277
742,2019-10-17,966,7572,1719,872,11129
742,2019-10-18,1082,7518,2064,2,10666
742,2019-10-19,970,6764,2141,1,9876
742,2019-10-20,106,1275,2236,2,3619
742,2019-10-21,191,18469,1710,3,20373
742,2019-10-22,321,8572,1264,1,10158
742,2019-10-23,952,13219,2008,1,16180
742,2019-10-24,774,25739,1715,0,28228
742,2019-10-25,735,13801,1460,3,15999
742,2019-10-26,73,13348,22759,0,36180
742,2019-10-27,1583,16372,81485,0,99440
742,2019-10-28,79,22552,898,1,23530
742,2019-10-29,126,17444,1952,0,19522
742,2019-10-30,80,23236,1382,1,24699
742,2019-10-31,942,14396,1664,3,17005
742,2019-11-01,44,24972,2020,1,27037
742,2019-11-02,181,18070,1747,0,19998
742,2019-11-03,49,22547,1232,0,23828
742,2019-11-04,525,7843,2321,1,10690
742,2019-11-05,680,1507,1528,0,3715
742,2019-11-06,80,7554,1676,0,9310
742,2019-11-07,402,13409,1113,2,14926
742,2019-11-08,77,9482,1438,1,10998
742,2019-11-09,60,13092,1258,0,14410
742,2019-11-10,69,12339,1169,2,13579
742,2019-11-11,742,8586,1623,2,10953
742,2019-11-12,102,9068,3628,0,12798
742,2019-11-13,205,11073,1801,3,13082
742,2019-11-14,69,7469,1521,2,9061
742,2019-11-15,70,2430,2586,0,5086
742,2019-11-16,90,1302,2191,0,3583
742,2019-11-17,1008,1327,3601,1,5937
742,2019-11-18,511,2200,3301,1,6013
742,2019-11-19,139,2946,2585,0,5670
742,2019-11-20,98,1170,2095,3,3366
742,2019-11-21,207,5685,1749,6685,14326
742,2019-11-22,179,4736,1948,3,6866
742,2019-11-23,80,6067,2407,0,8554
742,2019-11-24,162,5083,1396,1,6642
742,2019-11-25,120,5831,2347,0,8298
742,2019-11-26,769,9231,1213,1,11214
743,2019-08-19,99,491,526,0,1116
743,2019-08-20,124,1981,1023,1,3129
743,2019-08-21,291,2421,1615,2,4329
743,2019-08-22,206,1451,1547,2,3206
743,2019-08-23,254,1897,1124,0,3275
743,2019-08-24,205,1930,1637,0,3772
743,2019-08-25,897,11880,2072,0,14849
743,2019-08-26,1795,26837,2754,1,31387
743,2019-08-27,1037,9945,1538,0,12520
743,2019-08-28,1027,5270,2070,1,8368
743,2019-08-29,872,10434,1999,2,13307
743,2019-08-30,163,9116,847,1,10127
743,2019-08-31,52,237,1,0,290
743,2019-09-01,244,504,93,0,841
743,2019-09-02,62,1023,95,0,1180
743,2019-09-03,133,882,1397,1,2413
743,2019-09-04,990,15935,1902,1,18828
743,2019-09-05,135,10462,2032,3,12632
743,2019-09-06,991,13883,1458,0,16332
743,2019-09-07,261,8999,2245,0,11505
743,2019-09-08,252,5662,2250,1,8165
743,2019-09-09,156,9481,1615,1,11253
743,2019-09-10,2684,10884,2053,1,15622
743,2019-09-11,990,6774,2242,3,10009
743,2019-09-12,2618,9178,1779,2,13577
743,2019-09-13,1790,4993,1703,0,8486
743,2019-09-14,1816,8293,2335,0,12444
743,2019-09-15,1005,13528,2212,0,16745
743,2019-09-16,210,10573,1585,4,12372
743,2019-09-17,1257,9359,1712,0,12328
743,2019-09-18,185,11924,1626,1,13736
743,2019-09-19,236,10944,939,0,12119
743,2019-09-20,289,17589,2326,1,20205
743,2019-09-21,1015,6797,2221,0,10033
743,2019-09-22,956,9330,1529,1,11816
743,2019-09-23,140,9021,2420,4,11585
743,2019-09-24,139,20685,768,2,21594
743,2019-09-25,136,24278,1420,3,25837
743,2019-09-26,170,10185,877,1,11233
743,2019-09-27,268,29703,2524,3,32498
743,2019-09-28,126,22016,999,3,23144
743,2019-09-29,956,16847,1737,2,19542
743,2019-09-30,1130,19083,1574,1,21788
743,2019-10-01,110,16426,1227,0,17763
743,2019-10-02,172,11660,1717,0,13549
743,2019-10-03,149,25300,1779,0,27228
743,2019-10-04,952,30373,1447,0,32772
743,2019-10-05,97,24132,1515,1,25745
743,2019-10-06,123,11284,1710,1,13118
743,2019-10-07,291,9479,1940,2,11712
743,2019-10-08,187,16928,1505,4,18624
743,2019-10-09,552,16133,1605,0,18290
743,2019-10-10,1924,9219,2081,1,13225
743,2019-10-11,863,10329,1521,0,12713
743,2019-10-12,132,5706,1869,1,7708
743,2019-10-13,879,7915,1367,4,10165
743,2019-10-14,251,4462,2515,1,7229
743,2019-10-15,240,8300,1617,0,10157
743,2019-10-16,869,12406,1053,2,14330
743,2019-10-17,962,4169,1704,0,6835
743,2019-10-18,229,8634,1338,6,10207
743,2019-10-19,102,4370,2629,0,7101
743,2019-10-20,175,3873,1641,1,5690
743,2019-10-21,91,10402,2018,2,12513
743,2019-10-22,68,5250,1147,0,6465
743,2019-10-23,2238,13369,1941,2,17550
743,2019-10-24,99,25488,2043,0,27630
743,2019-10-25,1131,18519,1720,2,21372
743,2019-10-26,624,16375,2543,1,19543
743,2019-10-27,110,27099,2536,0,29745
743,2019-10-28,47,16194,2567,0,18808
743,2019-10-29,543,26074,1919,1,28537
743,2019-10-30,82,29677,973,1,30733
743,2019-10-31,61,14014,1552,0,15627
743,2019-11-01,51,24029,1642,1,25723
743,2019-11-02,162,27923,2341,554,30980
743,2019-11-03,96,38336,1233,0,39665
743,2019-11-04,88,9446,1537,0,11071
743,2019-11-05,140,4339,2037,0,6516
743,2019-11-06,94,13535,2012,0,15641
743,2019-11-07,143,33304,781,0,34228
743,2019-11-08,430,13948,1131,0,15509
743,2019-11-09,198,8765,1139,0,10102
743,2019-11-10,758,14394,1240,0,16392
743,2019-11-11,92,8473,1666,0,10231
743,2019-11-12,95,9497,3349,0,12941
743,2019-11-13,66,11718,1546,0,13330
743,2019-11-14,85,12606,2360,0,15051
743,2019-11-15,201,4664,2216,0,7081
743,2019-11-16,513,1501,2171,0,4185
743,2019-11-17,221,2273,3271,0,5765
743,2019-11-18,779,1563,3575,0,5917
743,2019-11-19,143,4225,3241,0,7609
743,2019-11-20,124,1570,1706,0,3400
743,2019-11-21,1340,3515,1889,0,6744
743,2019-11-22,962,4822,1328,0,7112
743,2019-11-23,119,10191,2753,1,13064
743,2019-11-24,312,10908,1863,1,13084
743,2019-11-25,104,10443,3036,0,13583
743,2019-11-26,76,9387,1747,2,11212
743,2019-11-27,79,5758,982,2,6821
743,2019-11-28,80,6639,940,0,7659
743,2019-11-29,34,306,1,0,341
743,2019-08-19,99,491,526,0,1116
743,2019-08-20,124,1981,1023,1,3129
743,2019-08-21,291,2421,1615,2,4329
743,2019-08-22,206,1451,1547,2,3206
743,2019-08-23,254,1897,1124,0,3275
743,2019-08-24,205,1930,1637,0,3772
743,2019-08-25,897,11880,2072,0,14849
743,2019-08-26,1795,26837,2754,1,31387
743,2019-08-27,1037,9945,1538,0,12520
743,2019-08-28,1027,5270,2070,1,8368
743,2019-08-29,872,10434,1999,2,13307
743,2019-08-30,163,9116,847,1,10127
743,2019-08-31,52,237,1,0,290
743,2019-09-01,244,504,93,0,841
743,2019-09-02,62,1023,95,0,1180
743,2019-09-03,133,882,1397,1,2413
743,2019-09-04,990,15935,1902,1,18828
743,2019-09-05,135,10462,2032,3,12632
743,2019-09-06,991,13883,1458,0,16332
743,2019-09-07,261,8999,2245,0,11505
743,2019-09-08,252,5662,2250,1,8165
743,2019-09-09,156,9481,1615,1,11253
743,2019-09-10,2684,10884,2053,1,15622
743,2019-09-11,990,6774,2242,3,10009
743,2019-09-12,2618,9178,1779,2,13577
743,2019-09-13,1790,4993,1703,0,8486
743,2019-09-14,1816,8293,2335,0,12444
743,2019-09-15,1005,13528,2212,0,16745
743,2019-09-16,210,10573,1585,4,12372
743,2019-09-17,1257,9359,1712,0,12328
743,2019-09-18,185,11924,1626,1,13736
743,2019-09-19,236,10944,939,0,12119
743,2019-09-20,289,17589,2326,1,20205
743,2019-09-21,1015,6797,2221,0,10033
743,2019-09-22,956,9330,1529,1,11816
743,2019-09-23,140,9021,2420,4,11585
743,2019-09-24,139,20685,768,2,21594
743,2019-09-25,136,24278,1420,3,25837
743,2019-09-26,170,10185,877,1,11233
743,2019-09-27,268,29703,2524,3,32498
743,2019-09-28,126,22016,999,3,23144
743,2019-09-29,956,16847,1737,2,19542
743,2019-09-30,1130,19083,1574,1,21788
743,2019-10-01,110,16426,1227,0,17763
743,2019-10-02,172,11660,1717,0,13549
743,2019-10-03,149,25300,1779,0,27228
743,2019-10-04,952,30373,1447,0,32772
743,2019-10-05,97,24132,1515,1,25745
743,2019-10-06,123,11284,1710,1,13118
743,2019-10-07,291,9479,1940,2,11712
743,2019-10-08,187,16928,1505,4,18624
743,2019-10-09,552,16133,1605,0,18290
743,2019-10-10,1924,9219,2081,1,13225
743,2019-10-11,863,10329,1521,0,12713
743,2019-10-12,132,5706,1869,1,7708
743,2019-10-13,879,7915,1367,4,10165
743,2019-10-14,251,4462,2515,1,7229
743,2019-10-15,240,8300,1617,0,10157
743,2019-10-16,869,12406,1053,2,14330
743,2019-10-17,962,4169,1704,0,6835
743,2019-10-18,229,8634,1338,6,10207
743,2019-10-19,102,4370,2629,0,7101
743,2019-10-20,175,3873,1641,1,5690
743,2019-10-21,91,10402,2018,2,12513
743,2019-10-22,68,5250,1147,0,6465
743,2019-10-23,2238,13369,1941,2,17550
743,2019-10-24,99,25488,2043,0,27630
743,2019-10-25,1131,18519,1720,2,21372
743,2019-10-26,624,16375,2543,1,19543
743,2019-10-27,110,27099,2536,0,29745
743,2019-10-28,47,16194,2567,0,18808
743,2019-10-29,543,26074,1919,1,28537
743,2019-10-30,82,29677,973,1,30733
743,2019-10-31,61,14014,1552,0,15627
743,2019-11-01,51,24029,1642,1,25723
743,2019-11-02,162,27923,2341,554,30980
743,2019-11-03,96,38336,1233,0,39665
743,2019-11-04,88,9446,1537,0,11071
743,2019-11-05,140,4339,2037,0,6516
743,2019-11-06,94,13535,2012,0,15641
743,2019-11-07,143,33304,781,0,34228
743,2019-11-08,430,13948,1131,0,15509
743,2019-11-09,198,8765,1139,0,10102
743,2019-11-10,758,14394,1240,0,16392
743,2019-11-11,92,8473,1666,0,10231
743,2019-11-12,95,9497,3349,0,12941
743,2019-11-13,66,11718,1546,0,13330
743,2019-11-14,85,12606,2360,0,15051
743,2019-11-15,201,4664,2216,0,7081
743,2019-11-16,513,1501,2171,0,4185
743,2019-11-17,221,2273,3271,0,5765
743,2019-11-18,779,1563,3575,0,5917
743,2019-11-19,143,4225,3241,0,7609
743,2019-11-20,124,1570,1706,0,3400
743,2019-11-21,1340,3515,1889,0,6744
743,2019-11-22,962,4822,1328,0,7112
743,2019-11-23,119,10191,2753,1,13064
743,2019-11-24,312,10908,1863,1,13084
743,2019-11-25,104,10443,3036,0,13583
743,2019-11-26,76,9387,1747,2,11212
743,2019-11-27,79,5758,982,2,6821
743,2019-11-28,80,6639,940,0,7659
743,2019-11-29,34,306,1,0,341
743,2019-08-19,99,491,526,0,1116
743,2019-08-20,124,1981,1023,1,3129
743,2019-08-21,291,2421,1615,2,4329
743,2019-08-22,206,1451,1547,2,3206
743,2019-08-23,254,1897,1124,0,3275
743,2019-08-24,205,1930,1637,0,3772
743,2019-08-25,897,11880,2072,0,14849
743,2019-08-26,1795,26837,2754,1,31387
743,2019-08-27,1037,9945,1538,0,12520
743,2019-08-28,1027,5270,2070,1,8368
743,2019-08-29,872,10434,1999,2,13307
743,2019-08-30,163,9116,847,1,10127
743,2019-08-31,52,237,1,0,290
743,2019-09-01,244,504,93,0,841
743,2019-09-02,62,1023,95,0,1180
743,2019-09-03,133,882,1397,1,2413
743,2019-09-04,990,15935,1902,1,18828
743,2019-09-05,135,10462,2032,3,12632
743,2019-09-06,991,13883,1458,0,16332
743,2019-09-07,261,8999,2245,0,11505
743,2019-09-08,252,5662,2250,1,8165
743,2019-09-09,156,9481,1615,1,11253
743,2019-09-10,2684,10884,2053,1,15622
743,2019-09-11,990,6774,2242,3,10009
743,2019-09-12,2618,9178,1779,2,13577
743,2019-09-13,1790,4993,1703,0,8486
743,2019-09-14,1816,8293,2335,0,12444
743,2019-09-15,1005,13528,2212,0,16745
743,2019-09-16,210,10573,1585,4,12372
743,2019-09-17,1257,9359,1712,0,12328
743,2019-09-18,185,11924,1626,1,13736
743,2019-09-19,236,10944,939,0,12119
743,2019-09-20,289,17589,2326,1,20205
743,2019-09-21,1015,6797,2221,0,10033
743,2019-09-22,956,9330,1529,1,11816
743,2019-09-23,140,9021,2420,4,11585
743,2019-09-24,139,20685,768,2,21594
743,2019-09-25,136,24278,1420,3,25837
743,2019-09-26,170,10185,877,1,11233
743,2019-09-27,268,29703,2524,3,32498
743,2019-09-28,126,22016,999,3,23144
743,2019-09-29,956,16847,1737,2,19542
743,2019-09-30,1130,19083,1574,1,21788
743,2019-10-01,110,16426,1227,0,17763
743,2019-10-02,172,11660,1717,0,13549
743,2019-10-03,149,25300,1779,0,27228
743,2019-10-04,952,30373,1447,0,32772
743,2019-10-05,97,24132,1515,1,25745
743,2019-10-06,123,11284,1710,1,13118
743,2019-10-07,291,9479,1940,2,11712
743,2019-10-08,187,16928,1505,4,18624
743,2019-10-09,552,16133,1605,0,18290
743,2019-10-10,1924,9219,2081,1,13225
743,2019-10-11,863,10329,1521,0,12713
743,2019-10-12,132,5706,1869,1,7708
743,2019-10-13,879,7915,1367,4,10165
743,2019-10-14,251,4462,2515,1,7229
743,2019-10-15,240,8300,1617,0,10157
743,2019-10-16,869,12406,1053,2,14330
743,2019-10-17,962,4169,1704,0,6835
743,2019-10-18,229,8634,1338,6,10207
743,2019-10-19,102,4370,2629,0,7101
743,2019-10-20,175,3873,1641,1,5690
743,2019-10-21,91,10402,2018,2,12513
743,2019-10-22,68,5250,1147,0,6465
743,2019-10-23,2238,13369,1941,2,17550
743,2019-10-24,99,25488,2043,0,27630
743,2019-10-25,1131,18519,1720,2,21372
743,2019-10-26,624,16375,2543,1,19543
743,2019-10-27,110,27099,2536,0,29745
743,2019-10-28,47,16194,2567,0,18808
743,2019-10-29,543,26074,1919,1,28537
743,2019-10-30,82,29677,973,1,30733
743,2019-10-31,61,14014,1552,0,15627
743,2019-11-01,51,24029,1642,1,25723
743,2019-11-02,162,27923,2341,554,30980
743,2019-11-03,96,38336,1233,0,39665
743,2019-11-04,88,9446,1537,0,11071
743,2019-11-05,140,4339,2037,0,6516
743,2019-11-06,94,13535,2012,0,15641
743,2019-11-07,143,33304,781,0,34228
743,2019-11-08,430,13948,1131,0,15509
743,2019-11-09,198,8765,1139,0,10102
743,2019-11-10,758,14394,1240,0,16392
743,2019-11-11,92,8473,1666,0,10231
743,2019-11-12,95,9497,3349,0,12941
743,2019-11-13,66,11718,1546,0,13330
743,2019-11-14,85,12606,2360,0,15051
743,2019-11-15,201,4664,2216,0,7081
743,2019-11-16,513,1501,2171,0,4185
743,2019-11-17,221,2273,3271,0,5765
743,2019-11-18,779,1563,3575,0,5917
743,2019-11-19,143,4225,3241,0,7609
743,2019-11-20,124,1570,1706,0,3400
743,2019-11-21,1340,3515,1889,0,6744
743,2019-11-22,962,4822,1328,0,7112
743,2019-11-23,119,10191,2753,1,13064
743,2019-11-24,312,10908,1863,1,13084
743,2019-11-25,104,10443,3036,0,13583
743,2019-11-26,76,9387,1747,2,11212
743,2019-11-27,79,5758,982,2,6821
743,2019-11-28,80,6639,940,0,7659
743,2019-11-29,34,306,1,0,341
743,2019-08-20,124,1981,1023,1,3129
743,2019-08-21,291,2421,1615,2,4329
743,2019-08-22,206,1451,1547,2,3206
743,2019-08-23,254,1897,1124,0,3275
743,2019-08-24,205,1930,1637,0,3772
743,2019-08-25,897,11880,2072,0,14849
743,2019-08-26,1795,26837,2754,1,31387
743,2019-08-27,1037,9945,1538,0,12520
743,2019-08-28,1027,5270,2070,1,8368
743,2019-08-29,872,10434,1999,2,13307
743,2019-08-30,163,9116,847,1,10127
743,2019-08-31,52,237,1,0,290
743,2019-09-01,244,504,93,0,841
743,2019-09-02,62,1023,95,0,1180
743,2019-09-03,133,882,1397,1,2413
743,2019-09-04,990,15935,1902,1,18828
743,2019-09-05,135,10462,2032,3,12632
743,2019-09-06,991,13883,1458,0,16332
743,2019-09-07,261,8999,2245,0,11505
743,2019-09-08,252,5662,2250,1,8165
743,2019-09-09,156,9481,1615,1,11253
743,2019-09-10,2684,10884,2053,1,15622
743,2019-09-11,990,6774,2242,3,10009
743,2019-09-12,2618,9178,1779,2,13577
743,2019-09-13,1790,4993,1703,0,8486
743,2019-09-14,1816,8293,2335,0,12444
743,2019-09-15,1005,13528,2212,0,16745
743,2019-09-16,210,10573,1585,4,12372
743,2019-09-17,1257,9359,1712,0,12328
743,2019-09-18,185,11924,1626,1,13736
743,2019-09-19,236,10944,939,0,12119
743,2019-09-20,289,17589,2326,1,20205
743,2019-09-21,1015,6797,2221,0,10033
743,2019-09-22,956,9330,1529,1,11816
743,2019-09-23,140,9021,2420,4,11585
743,2019-09-24,139,20685,768,2,21594
743,2019-09-25,136,24278,1420,3,25837
743,2019-09-26,170,10185,877,1,11233
743,2019-09-27,268,29703,2524,3,32498
743,2019-09-28,126,22016,999,3,23144
743,2019-09-29,956,16847,1737,2,19542
743,2019-09-30,1130,19083,1574,1,21788
743,2019-10-01,110,16426,1227,0,17763
743,2019-10-02,172,11660,1717,0,13549
743,2019-10-03,149,25300,1779,0,27228
743,2019-10-04,952,30373,1447,0,32772
743,2019-10-05,97,24132,1515,1,25745
743,2019-10-06,123,11284,1710,1,13118
743,2019-10-07,291,9479,1940,2,11712
743,2019-10-08,187,16928,1505,4,18624
743,2019-10-09,552,16133,1605,0,18290
743,2019-10-10,1924,9219,2081,1,13225
743,2019-10-11,863,10329,1521,0,12713
743,2019-10-12,132,5706,1869,1,7708
743,2019-10-13,879,7915,1367,4,10165
743,2019-10-14,251,4462,2515,1,7229
743,2019-10-15,240,8300,1617,0,10157
743,2019-10-16,869,12406,1053,2,14330
743,2019-10-17,962,4169,1704,0,6835
743,2019-10-18,229,8634,1338,6,10207
743,2019-10-19,102,4370,2629,0,7101
743,2019-10-20,175,3873,1641,1,5690
743,2019-10-21,91,10402,2018,2,12513
743,2019-10-22,68,5250,1147,0,6465
743,2019-10-23,2238,13369,1941,2,17550
743,2019-10-24,99,25488,2043,0,27630
743,2019-10-25,1131,18519,1720,2,21372
743,2019-10-26,624,16375,2543,1,19543
743,2019-10-27,110,27099,2536,0,29745
743,2019-10-28,47,16194,2567,0,18808
743,2019-10-29,543,26074,1919,1,28537
743,2019-10-30,82,29677,973,1,30733
743,2019-10-31,61,14014,1552,0,15627
743,2019-11-01,51,24029,1642,1,25723
743,2019-11-02,162,27923,2341,554,30980
743,2019-11-03,96,38336,1233,0,39665
743,2019-11-04,88,9446,1537,0,11071
743,2019-11-05,140,4339,2037,0,6516
743,2019-11-06,94,13535,2012,0,15641
743,2019-11-07,143,33304,781,0,34228
743,2019-11-08,430,13948,1131,0,15509
743,2019-11-09,198,8765,1139,0,10102
743,2019-11-10,758,14394,1240,0,16392
743,2019-11-11,92,8473,1666,0,10231
743,2019-11-12,95,9497,3349,0,12941
743,2019-11-13,66,11718,1546,0,13330
743,2019-11-14,85,12606,2360,0,15051
743,2019-11-15,201,4664,2216,0,7081
743,2019-11-16,513,1501,2171,0,4185
743,2019-11-17,221,2273,3271,0,5765
743,2019-11-18,779,1563,3575,0,5917
743,2019-11-19,143,4225,3241,0,7609
743,2019-11-20,124,1570,1706,0,3400
743,2019-11-21,1340,3515,1889,0,6744
743,2019-11-22,962,4822,1328,0,7112
743,2019-11-23,119,10191,2753,1,13064
743,2019-11-24,312,10908,1863,1,13084
743,2019-11-25,104,10443,3036,0,13583
743,2019-11-26,76,9387,1747,2,11212
743,2019-11-27,79,5758,982,2,6821
744,2019-08-19,278,694,916,0,1888
744,2019-08-20,438,1504,910,1,2853
744,2019-08-21,474,1308,1195,1,2978
744,2019-08-22,423,3776,968,1,5168
744,2019-08-23,1202,1561,1665,1,4429
744,2019-08-24,388,2659,1388,2,4437
744,2019-08-25,500,17243,1909,1,19653
744,2019-08-26,1037,14456,1543,0,17036
744,2019-08-27,1330,10503,1710,1,13544
744,2019-08-28,394,2173,1170,3,3740
744,2019-08-29,497,9386,1083,0,10966
744,2019-08-30,408,3071,587,2,4068
744,2019-08-31,61,297,2,1,361
744,2019-09-01,125,1308,187,0,1620
744,2019-09-02,233,234,77,1,545
744,2019-09-03,164,990,1058,0,2212
744,2019-09-04,499,22277,1862,0,24638
744,2019-09-05,350,11549,2530,3,14432
744,2019-09-06,406,11745,2195,0,14346
744,2019-09-07,482,12932,1501,0,14915
744,2019-09-08,2154,6551,1692,1,10398
744,2019-09-09,386,11331,2209,0,13926
744,2019-09-10,1954,11923,2146,0,16023
744,2019-09-11,1017,6917,1397,1,9332
744,2019-09-12,221,13626,2230,3,16080
744,2019-09-13,1331,5352,2278,1,8962
744,2019-09-14,371,8819,2390,0,11580
744,2019-09-15,2027,9150,2367,0,13544
744,2019-09-16,1190,10571,2092,1,13854
744,2019-09-17,1147,8704,2223,1,12075
744,2019-09-18,442,11990,1538,1,13971
744,2019-09-19,651,10066,2200,1,12918
744,2019-09-20,1366,9944,1618,2,12930
744,2019-09-21,365,8639,810,0,9814
744,2019-09-22,1121,13966,1212,2,16301
744,2019-09-23,339,12633,3020,0,15992
744,2019-09-24,417,9210,1519,2,11148
744,2019-09-25,160,8992,1717,1,10870
744,2019-09-26,174,14217,1765,1,16157
744,2019-09-27,439,9771,2294,4,12508
744,2019-09-28,161,15401,1739,1,17302
744,2019-09-29,112,19523,914,1,20550
744,2019-09-30,140,27892,2150,1,30183
744,2019-10-01,112,23332,1507,0,24951
744,2019-10-02,464,12627,2054,0,15145
744,2019-10-03,120,14973,1728,0,16821
744,2019-10-04,124,18712,1451,1,20288
744,2019-10-05,546,24474,1756,2,26778
744,2019-10-06,122,18787,1701,1,20611
744,2019-10-07,188,7152,1734,3,9077
744,2019-10-08,300,17776,1788,1,19865
744,2019-10-09,514,25269,1468,0,27251
744,2019-10-10,264,18014,2049,1,20328
744,2019-10-11,367,11428,1490,2,13287
744,2019-10-12,243,7592,2226,1,10062
744,2019-10-13,410,9058,1318,1,10787
744,2019-10-14,220,6135,1656,1,8012
744,2019-10-15,509,13869,2112,2,16492
744,2019-10-16,217,23747,1822,3,25789
744,2019-10-17,1146,8841,2218,4,12209
744,2019-10-18,336,8802,2009,0,11147
744,2019-10-19,1772,5914,2485,1,10172
744,2019-10-20,813,3512,2574,0,6899
744,2019-10-21,276,19550,2373,2,22201
744,2019-10-22,297,11142,1700,3,13142
744,2019-10-23,1192,8922,1484,1,11599
744,2019-10-24,745,22554,1769,0,25068
744,2019-10-25,773,19031,1539,4,21347
744,2019-10-26,1445,16794,1092,1,19332
744,2019-10-27,260,16887,1748,1,18896
744,2019-10-28,1648,23653,1570,2,26873
744,2019-10-29,339,29489,1671,1,31500
744,2019-10-30,265,21085,1278,2,22630
744,2019-10-31,1172,21364,1950,2,24488
744,2019-11-01,247,27796,1339,3,29385
744,2019-11-02,940,27556,1735,0,30231
744,2019-11-03,231,25256,1518,0,27005
744,2019-11-04,546,11248,2259,0,14053
744,2019-11-05,1277,6943,1420,0,9640
744,2019-11-06,288,14826,1267,18,16399
744,2019-11-07,307,26228,1234,2,27771
744,2019-11-08,1031,12726,1270,0,15027
744,2019-11-09,260,9455,1892,0,11607
744,2019-11-10,280,15103,834,1,16218
744,2019-11-11,291,10579,1912,5,12787
744,2019-11-12,273,10683,3477,0,14433
744,2019-11-13,259,12657,2047,856,15819
744,2019-11-14,256,8781,1997,0,11034
744,2019-11-15,253,4211,2072,1,6537
744,2019-11-16,935,3101,2421,2,6459
744,2019-11-17,311,3465,3195,0,6971
744,2019-11-18,276,2923,3237,0,6436
744,2019-11-19,297,5497,3437,1,9232
744,2019-11-20,280,1822,2209,0,4311
744,2019-11-21,377,3985,1946,4,6312
744,2019-11-22,326,5296,2478,4,8104
744,2019-11-23,297,6852,2111,0,9260
744,2019-11-24,1113,6129,1676,0,8918
744,2019-11-25,324,10792,1917,0,13033
744,2019-11-26,274,9096,1290,4,10664
744,2019-11-27,332,6644,1781,1,8758
744,2019-11-28,439,11656,1113,1,13209
744,2019-11-29,106,205,3,0,314
744,2019-08-19,278,694,916,0,1888
744,2019-08-20,438,1504,910,1,2853
744,2019-08-21,474,1308,1195,1,2978
744,2019-08-22,423,3776,968,1,5168
744,2019-08-23,1202,1561,1665,1,4429
744,2019-08-24,388,2659,1388,2,4437
744,2019-08-25,500,17243,1909,1,19653
744,2019-08-26,1037,14456,1543,0,17036
744,2019-08-27,1330,10503,1710,1,13544
744,2019-08-28,394,2173,1170,3,3740
744,2019-08-29,497,9386,1083,0,10966
744,2019-08-30,408,3071,587,2,4068
744,2019-08-31,61,297,2,1,361
744,2019-09-01,125,1308,187,0,1620
744,2019-09-02,233,234,77,1,545
744,2019-09-03,164,990,1058,0,2212
744,2019-09-04,499,22277,1862,0,24638
744,2019-09-05,350,11549,2530,3,14432
744,2019-09-06,406,11745,2195,0,14346
744,2019-09-07,482,12932,1501,0,14915
744,2019-09-08,2154,6551,1692,1,10398
744,2019-09-09,386,11331,2209,0,13926
744,2019-09-10,1954,11923,2146,0,16023
744,2019-09-11,1017,6917,1397,1,9332
744,2019-09-12,221,13626,2230,3,16080
744,2019-09-13,1331,5352,2278,1,8962
744,2019-09-14,371,8819,2390,0,11580
744,2019-09-15,2027,9150,2367,0,13544
744,2019-09-16,1190,10571,2092,1,13854
744,2019-09-17,1147,8704,2223,1,12075
744,2019-09-18,442,11990,1538,1,13971
744,2019-09-19,651,10066,2200,1,12918
744,2019-09-20,1366,9944,1618,2,12930
744,2019-09-21,365,8639,810,0,9814
744,2019-09-22,1121,13966,1212,2,16301
744,2019-09-23,339,12633,3020,0,15992
744,2019-09-24,417,9210,1519,2,11148
744,2019-09-25,160,8992,1717,1,10870
744,2019-09-26,174,14217,1765,1,16157
744,2019-09-27,439,9771,2294,4,12508
744,2019-09-28,161,15401,1739,1,17302
744,2019-09-29,112,19523,914,1,20550
744,2019-09-30,140,27892,2150,1,30183
744,2019-10-01,112,23332,1507,0,24951
744,2019-10-02,464,12627,2054,0,15145
744,2019-10-03,120,14973,1728,0,16821
744,2019-10-04,124,18712,1451,1,20288
744,2019-10-05,546,24474,1756,2,26778
744,2019-10-06,122,18787,1701,1,20611
744,2019-10-07,188,7152,1734,3,9077
744,2019-10-08,300,17776,1788,1,19865
744,2019-10-09,514,25269,1468,0,27251
744,2019-10-10,264,18014,2049,1,20328
744,2019-10-11,367,11428,1490,2,13287
744,2019-10-12,243,7592,2226,1,10062
744,2019-10-13,410,9058,1318,1,10787
744,2019-10-14,220,6135,1656,1,8012
744,2019-10-15,509,13869,2112,2,16492
744,2019-10-16,217,23747,1822,3,25789
744,2019-10-17,1146,8841,2218,4,12209
744,2019-10-18,336,8802,2009,0,11147
744,2019-10-19,1772,5914,2485,1,10172
744,2019-10-20,813,3512,2574,0,6899
744,2019-10-21,276,19550,2373,2,22201
744,2019-10-22,297,11142,1700,3,13142
744,2019-10-23,1192,8922,1484,1,11599
744,2019-10-24,745,22554,1769,0,25068
744,2019-10-25,773,19031,1539,4,21347
744,2019-10-26,1445,16794,1092,1,19332
744,2019-10-27,260,16887,1748,1,18896
744,2019-10-28,1648,23653,1570,2,26873
744,2019-10-29,339,29489,1671,1,31500
744,2019-10-30,265,21085,1278,2,22630
744,2019-10-31,1172,21364,1950,2,24488
744,2019-11-01,247,27796,1339,3,29385
744,2019-11-02,940,27556,1735,0,30231
744,2019-11-03,231,25256,1518,0,27005
744,2019-11-04,546,11248,2259,0,14053
744,2019-11-05,1277,6943,1420,0,9640
744,2019-11-06,288,14826,1267,18,16399
744,2019-11-07,307,26228,1234,2,27771
744,2019-11-08,1031,12726,1270,0,15027
744,2019-11-09,260,9455,1892,0,11607
744,2019-11-10,280,15103,834,1,16218
744,2019-11-11,291,10579,1912,5,12787
744,2019-11-12,273,10683,3477,0,14433
744,2019-11-13,259,12657,2047,856,15819
744,2019-11-14,256,8781,1997,0,11034
744,2019-11-15,253,4211,2072,1,6537
744,2019-11-16,935,3101,2421,2,6459
744,2019-11-17,311,3465,3195,0,6971
744,2019-11-18,276,2923,3237,0,6436
744,2019-11-19,297,5497,3437,1,9232
744,2019-11-20,280,1822,2209,0,4311
744,2019-11-21,377,3985,1946,4,6312
744,2019-11-22,326,5296,2478,4,8104
744,2019-11-23,297,6852,2111,0,9260
744,2019-11-24,1113,6129,1676,0,8918
744,2019-11-25,324,10792,1917,0,13033
744,2019-11-26,274,9096,1290,4,10664
744,2019-11-27,332,6644,1781,1,8758
744,2019-11-28,439,11656,1113,1,13209
744,2019-11-29,106,205,3,0,314
744,2019-08-19,278,694,916,0,1888
744,2019-08-20,438,1504,910,1,2853
744,2019-08-21,474,1308,1195,1,2978
744,2019-08-22,423,3776,968,1,5168
744,2019-08-23,1202,1561,1665,1,4429
744,2019-08-24,388,2659,1388,2,4437
744,2019-08-25,500,17243,1909,1,19653
744,2019-08-26,1037,14456,1543,0,17036
744,2019-08-27,1330,10503,1710,1,13544
744,2019-08-28,394,2173,1170,3,3740
744,2019-08-29,497,9386,1083,0,10966
744,2019-08-30,408,3071,587,2,4068
744,2019-08-31,61,297,2,1,361
744,2019-09-01,125,1308,187,0,1620
744,2019-09-02,233,234,77,1,545
744,2019-09-03,164,990,1058,0,2212
744,2019-09-04,499,22277,1862,0,24638
744,2019-09-05,350,11549,2530,3,14432
744,2019-09-06,406,11745,2195,0,14346
744,2019-09-07,482,12932,1501,0,14915
744,2019-09-08,2154,6551,1692,1,10398
744,2019-09-09,386,11331,2209,0,13926
744,2019-09-10,1954,11923,2146,0,16023
744,2019-09-11,1017,6917,1397,1,9332
744,2019-09-12,221,13626,2230,3,16080
744,2019-09-13,1331,5352,2278,1,8962
744,2019-09-14,371,8819,2390,0,11580
744,2019-09-15,2027,9150,2367,0,13544
744,2019-09-16,1190,10571,2092,1,13854
744,2019-09-17,1147,8704,2223,1,12075
744,2019-09-18,442,11990,1538,1,13971
744,2019-09-19,651,10066,2200,1,12918
744,2019-09-20,1366,9944,1618,2,12930
744,2019-09-21,365,8639,810,0,9814
744,2019-09-22,1121,13966,1212,2,16301
744,2019-09-23,339,12633,3020,0,15992
744,2019-09-24,417,9210,1519,2,11148
744,2019-09-25,160,8992,1717,1,10870
744,2019-09-26,174,14217,1765,1,16157
744,2019-09-27,439,9771,2294,4,12508
744,2019-09-28,161,15401,1739,1,17302
744,2019-09-29,112,19523,914,1,20550
744,2019-09-30,140,27892,2150,1,30183
744,2019-10-01,112,23332,1507,0,24951
744,2019-10-02,464,12627,2054,0,15145
744,2019-10-03,120,14973,1728,0,16821
744,2019-10-04,124,18712,1451,1,20288
744,2019-10-05,546,24474,1756,2,26778
744,2019-10-06,122,18787,1701,1,20611
744,2019-10-07,188,7152,1734,3,9077
744,2019-10-08,300,17776,1788,1,19865
744,2019-10-09,514,25269,1468,0,27251
744,2019-10-10,264,18014,2049,1,20328
744,2019-10-11,367,11428,1490,2,13287
744,2019-10-12,243,7592,2226,1,10062
744,2019-10-13,410,9058,1318,1,10787
744,2019-10-14,220,6135,1656,1,8012
744,2019-10-15,509,13869,2112,2,16492
744,2019-10-16,217,23747,1822,3,25789
744,2019-10-17,1146,8841,2218,4,12209
744,2019-10-18,336,8802,2009,0,11147
744,2019-10-19,1772,5914,2485,1,10172
744,2019-10-20,813,3512,2574,0,6899
744,2019-10-21,276,19550,2373,2,22201
744,2019-10-22,297,11142,1700,3,13142
744,2019-10-23,1192,8922,1484,1,11599
744,2019-10-24,745,22554,1769,0,25068
744,2019-10-25,773,19031,1539,4,21347
744,2019-10-26,1445,16794,1092,1,19332
744,2019-10-27,260,16887,1748,1,18896
744,2019-10-28,1648,23653,1570,2,26873
744,2019-10-29,339,29489,1671,1,31500
744,2019-10-30,265,21085,1278,2,22630
744,2019-10-31,1172,21364,1950,2,24488
744,2019-11-01,247,27796,1339,3,29385
744,2019-11-02,940,27556,1735,0,30231
744,2019-11-03,231,25256,1518,0,27005
744,2019-11-04,546,11248,2259,0,14053
744,2019-11-05,1277,6943,1420,0,9640
744,2019-11-06,288,14826,1267,18,16399
744,2019-11-07,307,26228,1234,2,27771
744,2019-11-08,1031,12726,1270,0,15027
744,2019-11-09,260,9455,1892,0,11607
744,2019-11-10,280,15103,834,1,16218
744,2019-11-11,291,10579,1912,5,12787
744,2019-11-12,273,10683,3477,0,14433
744,2019-11-13,259,12657,2047,856,15819
744,2019-11-14,256,8781,1997,0,11034
744,2019-11-15,253,4211,2072,1,6537
744,2019-11-16,935,3101,2421,2,6459
744,2019-11-17,311,3465,3195,0,6971
744,2019-11-18,276,2923,3237,0,6436
744,2019-11-19,297,5497,3437,1,9232
744,2019-11-20,280,1822,2209,0,4311
744,2019-11-21,377,3985,1946,4,6312
744,2019-11-22,326,5296,2478,4,8104
744,2019-11-23,297,6852,2111,0,9260
744,2019-11-24,1113,6129,1676,0,8918
744,2019-11-25,324,10792,1917,0,13033
744,2019-11-26,274,9096,1290,4,10664
744,2019-11-27,332,6644,1781,1,8758
744,2019-11-28,439,11656,1113,1,13209
744,2019-11-29,106,205,3,0,314
744,2019-08-20,438,1504,910,1,2853
744,2019-08-21,474,1308,1195,1,2978
744,2019-08-22,423,3776,968,1,5168
744,2019-08-23,1202,1561,1665,1,4429
744,2019-08-24,388,2659,1388,2,4437
744,2019-08-25,500,17243,1909,1,19653
744,2019-08-26,1037,14456,1543,0,17036
744,2019-08-27,1330,10503,1710,1,13544
744,2019-08-28,394,2173,1170,3,3740
744,2019-08-29,497,9386,1083,0,10966
744,2019-08-30,408,3071,587,2,4068
744,2019-08-31,61,297,2,1,361
744,2019-09-01,125,1308,187,0,1620
744,2019-09-02,233,234,77,1,545
744,2019-09-03,164,990,1058,0,2212
744,2019-09-04,499,22277,1862,0,24638
744,2019-09-05,350,11549,2530,3,14432
744,2019-09-06,406,11745,2195,0,14346
744,2019-09-07,482,12932,1501,0,14915
744,2019-09-08,2154,6551,1692,1,10398
744,2019-09-09,386,11331,2209,0,13926
744,2019-09-10,1954,11923,2146,0,16023
744,2019-09-11,1017,6917,1397,1,9332
744,2019-09-12,221,13626,2230,3,16080
744,2019-09-13,1331,5352,2278,1,8962
744,2019-09-14,371,8819,2390,0,11580
744,2019-09-15,2027,9150,2367,0,13544
744,2019-09-16,1190,10571,2092,1,13854
744,2019-09-17,1147,8704,2223,1,12075
744,2019-09-18,442,11990,1538,1,13971
744,2019-09-19,651,10066,2200,1,12918
744,2019-09-20,1366,9944,1618,2,12930
744,2019-09-21,365,8639,810,0,9814
744,2019-09-22,1121,13966,1212,2,16301
744,2019-09-23,339,12633,3020,0,15992
744,2019-09-24,417,9210,1519,2,11148
744,2019-09-25,160,8992,1717,1,10870
744,2019-09-26,174,14217,1765,1,16157
744,2019-09-27,439,9771,2294,4,12508
744,2019-09-28,161,15401,1739,1,17302
744,2019-09-29,112,19523,914,1,20550
744,2019-09-30,140,27892,2150,1,30183
744,2019-10-01,112,23332,1507,0,24951
744,2019-10-02,464,12627,2054,0,15145
744,2019-10-03,120,14973,1728,0,16821
744,2019-10-04,124,18712,1451,1,20288
744,2019-10-05,546,24474,1756,2,26778
744,2019-10-06,122,18787,1701,1,20611
744,2019-10-07,188,7152,1734,3,9077
744,2019-10-08,300,17776,1788,1,19865
744,2019-10-09,514,25269,1468,0,27251
744,2019-10-10,264,18014,2049,1,20328
744,2019-10-11,367,11428,1490,2,13287
744,2019-10-12,243,7592,2226,1,10062
744,2019-10-13,410,9058,1318,1,10787
744,2019-10-14,220,6135,1656,1,8012
744,2019-10-15,509,13869,2112,2,16492
744,2019-10-16,217,23747,1822,3,25789
744,2019-10-17,1146,8841,2218,4,12209
744,2019-10-18,336,8802,2009,0,11147
744,2019-10-19,1772,5914,2485,1,10172
744,2019-10-20,813,3512,2574,0,6899
744,2019-10-21,276,19550,2373,2,22201
744,2019-10-22,297,11142,1700,3,13142
744,2019-10-23,1192,8922,1484,1,11599
744,2019-10-24,745,22554,1769,0,25068
744,2019-10-25,773,19031,1539,4,21347
744,2019-10-26,1445,16794,1092,1,19332
744,2019-10-27,260,16887,1748,1,18896
744,2019-10-28,1648,23653,1570,2,26873
744,2019-10-29,339,29489,1671,1,31500
744,2019-10-30,265,21085,1278,2,22630
744,2019-10-31,1172,21364,1950,2,24488
744,2019-11-01,247,27796,1339,3,29385
744,2019-11-02,940,27556,1735,0,30231
744,2019-11-03,231,25256,1518,0,27005
744,2019-11-04,546,11248,2259,0,14053
744,2019-11-05,1277,6943,1420,0,9640
744,2019-11-06,288,14826,1267,18,16399
744,2019-11-07,307,26228,1234,2,27771
744,2019-11-08,1031,12726,1270,0,15027
744,2019-11-09,260,9455,1892,0,11607
744,2019-11-10,280,15103,834,1,16218
744,2019-11-11,291,10579,1912,5,12787
744,2019-11-12,273,10683,3477,0,14433
744,2019-11-13,259,12657,2047,856,15819
744,2019-11-14,256,8781,1997,0,11034
744,2019-11-15,253,4211,2072,1,6537
744,2019-11-16,935,3101,2421,2,6459
744,2019-11-17,311,3465,3195,0,6971
744,2019-11-18,276,2923,3237,0,6436
744,2019-11-19,297,5497,3437,1,9232
744,2019-11-20,280,1822,2209,0,4311
744,2019-11-21,377,3985,1946,4,6312
744,2019-11-22,326,5296,2478,4,8104
744,2019-11-23,297,6852,2111,0,9260
744,2019-11-24,1113,6129,1676,0,8918
744,2019-11-25,324,10792,1917,0,13033
744,2019-11-26,274,9096,1290,4,10664
744,2019-11-27,332,6644,1781,1,8758
744,2019-11-28,439,11656,1113,1,13209
745,2019-08-20,6299,4295,1096,0,11690
745,2019-08-21,57939,1464,1505,1,60909
745,2019-08-22,12326,3100,1711,1626,18763
745,2019-08-23,102719,3106,1443,3241,110509
745,2019-08-24,5934,3367,1964,1,11266
745,2019-08-25,22438,14792,1553,1,38784
745,2019-08-26,92234,33360,2312,0,127906
745,2019-08-27,47983,13268,2250,717,64218
745,2019-08-28,11023,12184,1458,494,25159
745,2019-08-29,60449,15529,2521,1076,79575
745,2019-08-30,39195,3452,911,522,44080
745,2019-08-31,2229,568,2,2,2801
745,2019-09-01,17672,683,131,521,19007
745,2019-09-02,8403,263,9,11,8686
745,2019-09-03,2735,1374,1223,141,5473
745,2019-09-04,121060,12966,2364,426,136816
745,2019-09-05,415684,5531,1987,320,423522
745,2019-09-06,40309,8680,2132,540,51661
745,2019-09-07,319229,10259,2546,221,332255
745,2019-09-08,724637,7210,2057,440,734344
745,2019-09-09,38205,10192,1882,220,50499
745,2019-09-10,252864,11555,1787,1731,267937
745,2019-09-11,1214536,7859,2238,643,1225276
745,2019-09-12,142082,7500,2865,642,153089
745,2019-09-13,285867,6063,2340,321,294591
745,2019-09-14,390428,12729,1923,3562,408642
745,2019-09-15,63539,8576,1641,961,74717
745,2019-09-16,173763,9948,1829,1946,187486
745,2019-09-17,463143,9897,1813,640,475493
745,2019-09-18,40761,11446,968,324,53499
745,2019-09-19,179288,11412,1387,1622,193709
745,2019-09-20,500770,8680,2212,1,511663
745,2019-09-21,89352,11544,1440,0,102336
745,2019-09-22,141826,8475,2421,1,152723
745,2019-09-23,191807,9098,1648,1621,204174
745,2019-09-24,96749,8344,1354,5,106452
745,2019-09-25,73288,6132,1902,1,81323
745,2019-09-26,70170,10099,1327,2,81598
745,2019-09-27,113350,9028,2108,1624,126110
745,2019-09-28,89437,14942,1821,1625,107825
745,2019-09-29,44529,16316,2108,3,62956
745,2019-09-30,48942,17269,1122,1630,68963
745,2019-10-01,25164,15634,2106,0,42904
745,2019-10-02,52711,10782,2161,636,66290
745,2019-10-03,75704,12666,1546,1,89917
745,2019-10-04,31958,11189,1610,5,44762
745,2019-10-05,55885,13782,1409,0,71076
745,2019-10-06,29929,10621,1856,1,42407
745,2019-10-07,54730,6141,1981,1622,64474
745,2019-10-08,100340,11142,1915,1663,115060
745,2019-10-09,53483,14120,955,3,68561
745,2019-10-10,67673,16560,2164,0,86397
745,2019-10-11,75818,10551,1165,1626,89160
745,2019-10-12,45005,6934,1738,0,53677
745,2019-10-13,59125,7153,2258,4,68540
745,2019-10-14,158231,6908,2067,2,167208
745,2019-10-15,110159,13369,2352,0,125880
745,2019-10-16,67518,22697,1090,1,91306
745,2019-10-17,191969,7615,1526,0,201110
745,2019-10-18,221003,13245,1619,0,235867
745,2019-10-19,153080,8772,2505,1,164358
745,2019-10-20,140952,1375,1735,0,144062
745,2019-10-21,101198,9289,1056,3,111546
745,2019-10-22,94729,4932,939,4,100604
745,2019-10-23,86266,12885,1769,2,100922
745,2019-10-24,113894,24924,1330,2,140150
745,2019-10-25,61972,17947,1180,2,81101
745,2019-10-26,1238849,19014,2256,0,1260119
745,2019-10-27,47140,15234,2585,1,64960
745,2019-10-28,45548,12689,2392,0,60629
745,2019-10-29,60875,14388,2141,4,77408
745,2019-10-30,54070,22789,1281,0,78140
745,2019-10-31,105650,13891,1058,1,120600
745,2019-11-01,35759,23798,1230,1,60788
745,2019-11-02,55022,15668,1382,0,72072
745,2019-11-03,38728,21612,1106,3,61449
745,2019-11-04,42382,8594,2013,0,52989
745,2019-11-05,1781501,1782,1881,0,1785164
745,2019-11-06,45402,7615,1672,1,54690
745,2019-11-07,19849,13061,923,1,33834
745,2019-11-08,29565,9161,1443,1,40170
745,2019-11-09,45268,8146,2122,0,55536
745,2019-11-10,21428,23162,1246,1,45837
745,2019-11-11,29048,15137,1704,2,45891
745,2019-11-12,15813,16574,1911,2,34300
745,2019-11-13,19175,11843,1696,2,32716
745,2019-11-14,23320,12318,1554,0,37192
745,2019-11-15,17989,5379,2455,1,25824
745,2019-11-16,37352,5341,1702,0,44395
745,2019-11-17,70933,3990,2156,0,77079
745,2019-11-18,34254,3596,2822,5,40677
745,2019-11-19,73842,3978,2431,1,80252
745,2019-11-20,42528,2103,2282,0,46913
745,2019-11-21,38387,5576,1091,1,45055
745,2019-11-22,18379,4679,962,2,24022
745,2019-11-23,8066,6419,2552,2,17039
745,2019-11-24,19896,5535,1888,0,27319
745,2019-11-25,5821,7268,1692,0,14781
745,2019-11-26,24068,5630,1030,0,30728
745,2019-11-27,21644,6639,1358,2,29643
745,2019-11-28,1952,7255,753,4,9964
745,2019-11-29,854,665,2,0,1521
745,2019-08-20,6299,4295,1096,0,11690
745,2019-08-21,57939,1464,1505,1,60909
745,2019-08-22,12326,3100,1711,1626,18763
745,2019-08-23,102719,3106,1443,3241,110509
745,2019-08-24,5934,3367,1964,1,11266
745,2019-08-25,22438,14792,1553,1,38784
745,2019-08-26,92234,33360,2312,0,127906
745,2019-08-27,47983,13268,2250,717,64218
745,2019-08-28,11023,12184,1458,494,25159
745,2019-08-29,60449,15529,2521,1076,79575
745,2019-08-30,39195,3452,911,522,44080
745,2019-08-31,2229,568,2,2,2801
745,2019-09-01,17672,683,131,521,19007
745,2019-09-02,8403,263,9,11,8686
745,2019-09-03,2735,1374,1223,141,5473
745,2019-09-04,121060,12966,2364,426,136816
745,2019-09-05,415684,5531,1987,320,423522
745,2019-09-06,40309,8680,2132,540,51661
745,2019-09-07,319229,10259,2546,221,332255
745,2019-09-08,724637,7210,2057,440,734344
745,2019-09-09,38205,10192,1882,220,50499
745,2019-09-10,252864,11555,1787,1731,267937
745,2019-09-11,1214536,7859,2238,643,1225276
745,2019-09-12,142082,7500,2865,642,153089
745,2019-09-13,285867,6063,2340,321,294591
745,2019-09-14,390428,12729,1923,3562,408642
745,2019-09-15,63539,8576,1641,961,74717
745,2019-09-16,173763,9948,1829,1946,187486
745,2019-09-17,463143,9897,1813,640,475493
745,2019-09-18,40761,11446,968,324,53499
745,2019-09-19,179288,11412,1387,1622,193709
745,2019-09-20,500770,8680,2212,1,511663
745,2019-09-21,89352,11544,1440,0,102336
745,2019-09-22,141826,8475,2421,1,152723
745,2019-09-23,191807,9098,1648,1621,204174
745,2019-09-24,96749,8344,1354,5,106452
745,2019-09-25,73288,6132,1902,1,81323
745,2019-09-26,70170,10099,1327,2,81598
745,2019-09-27,113350,9028,2108,1624,126110
745,2019-09-28,89437,14942,1821,1625,107825
745,2019-09-29,44529,16316,2108,3,62956
745,2019-09-30,48942,17269,1122,1630,68963
745,2019-10-01,25164,15634,2106,0,42904
745,2019-10-02,52711,10782,2161,636,66290
745,2019-10-03,75704,12666,1546,1,89917
745,2019-10-04,31958,11189,1610,5,44762
745,2019-10-05,55885,13782,1409,0,71076
745,2019-10-06,29929,10621,1856,1,42407
745,2019-10-07,54730,6141,1981,1622,64474
745,2019-10-08,100340,11142,1915,1663,115060
745,2019-10-09,53483,14120,955,3,68561
745,2019-10-10,67673,16560,2164,0,86397
745,2019-10-11,75818,10551,1165,1626,89160
745,2019-10-12,45005,6934,1738,0,53677
745,2019-10-13,59125,7153,2258,4,68540
745,2019-10-14,158231,6908,2067,2,167208
745,2019-10-15,110159,13369,2352,0,125880
745,2019-10-16,67518,22697,1090,1,91306
745,2019-10-17,191969,7615,1526,0,201110
745,2019-10-18,221003,13245,1619,0,235867
745,2019-10-19,153080,8772,2505,1,164358
745,2019-10-20,140952,1375,1735,0,144062
745,2019-10-21,101198,9289,1056,3,111546
745,2019-10-22,94729,4932,939,4,100604
745,2019-10-23,86266,12885,1769,2,100922
745,2019-10-24,113894,24924,1330,2,140150
745,2019-10-25,61972,17947,1180,2,81101
745,2019-10-26,1238849,19014,2256,0,1260119
745,2019-10-27,47140,15234,2585,1,64960
745,2019-10-28,45548,12689,2392,0,60629
745,2019-10-29,60875,14388,2141,4,77408
745,2019-10-30,54070,22789,1281,0,78140
745,2019-10-31,105650,13891,1058,1,120600
745,2019-11-01,35759,23798,1230,1,60788
745,2019-11-02,55022,15668,1382,0,72072
745,2019-11-03,38728,21612,1106,3,61449
745,2019-11-04,42382,8594,2013,0,52989
745,2019-11-05,1781501,1782,1881,0,1785164
745,2019-11-06,45402,7615,1672,1,54690
745,2019-11-07,19849,13061,923,1,33834
745,2019-11-08,29565,9161,1443,1,40170
745,2019-11-09,45268,8146,2122,0,55536
745,2019-11-10,21428,23162,1246,1,45837
745,2019-11-11,29048,15137,1704,2,45891
745,2019-11-12,15813,16574,1911,2,34300
745,2019-11-13,19175,11843,1696,2,32716
745,2019-11-14,23320,12318,1554,0,37192
745,2019-11-15,17989,5379,2455,1,25824
745,2019-11-16,37352,5341,1702,0,44395
745,2019-11-17,70933,3990,2156,0,77079
745,2019-11-18,34254,3596,2822,5,40677
745,2019-11-19,73842,3978,2431,1,80252
745,2019-11-20,42528,2103,2282,0,46913
745,2019-11-21,38387,5576,1091,1,45055
745,2019-11-22,18379,4679,962,2,24022
745,2019-11-23,8066,6419,2552,2,17039
745,2019-11-24,19896,5535,1888,0,27319
745,2019-11-25,5821,7268,1692,0,14781
745,2019-11-26,24068,5630,1030,0,30728
745,2019-11-27,21644,6639,1358,2,29643
745,2019-11-28,1952,7255,753,4,9964
745,2019-11-29,854,665,2,0,1521
745,2019-08-19,0,0,90,0,90
745,2019-08-20,6299,4295,1096,0,11690
745,2019-08-21,57939,1464,1505,1,60909
745,2019-08-22,12326,3100,1711,1626,18763
745,2019-08-23,102719,3106,1443,3241,110509
745,2019-08-24,5934,3367,1964,1,11266
745,2019-08-25,22438,14792,1553,1,38784
745,2019-08-26,92234,33360,2312,0,127906
745,2019-08-27,47983,13268,2250,717,64218
745,2019-08-28,11023,12184,1458,494,25159
745,2019-08-29,60449,15529,2521,1076,79575
745,2019-08-30,39195,3452,911,522,44080
745,2019-08-31,2229,568,2,2,2801
745,2019-09-01,17672,683,131,521,19007
745,2019-09-02,8403,263,9,11,8686
745,2019-09-03,2735,1374,1223,141,5473
745,2019-09-04,121060,12966,2364,426,136816
745,2019-09-05,415684,5531,1987,320,423522
745,2019-09-06,40309,8680,2132,540,51661
745,2019-09-07,319229,10259,2546,221,332255
745,2019-09-08,724637,7210,2057,440,734344
745,2019-09-09,38205,10192,1882,220,50499
745,2019-09-10,252864,11555,1787,1731,267937
745,2019-09-11,1214536,7859,2238,643,1225276
745,2019-09-12,142082,7500,2865,642,153089
745,2019-09-13,285867,6063,2340,321,294591
745,2019-09-14,390428,12729,1923,3562,408642
745,2019-09-15,63539,8576,1641,961,74717
745,2019-09-16,173763,9948,1829,1946,187486
745,2019-09-17,463143,9897,1813,640,475493
745,2019-09-18,40761,11446,968,324,53499
745,2019-09-19,179288,11412,1387,1622,193709
745,2019-09-20,500770,8680,2212,1,511663
745,2019-09-21,89352,11544,1440,0,102336
745,2019-09-22,141826,8475,2421,1,152723
745,2019-09-23,191807,9098,1648,1621,204174
745,2019-09-24,96749,8344,1354,5,106452
745,2019-09-25,73288,6132,1902,1,81323
745,2019-09-26,70170,10099,1327,2,81598
745,2019-09-27,113350,9028,2108,1624,126110
745,2019-09-28,89437,14942,1821,1625,107825
745,2019-09-29,44529,16316,2108,3,62956
745,2019-09-30,48942,17269,1122,1630,68963
745,2019-10-01,25164,15634,2106,0,42904
745,2019-10-02,52711,10782,2161,636,66290
745,2019-10-03,75704,12666,1546,1,89917
745,2019-10-04,31958,11189,1610,5,44762
745,2019-10-05,55885,13782,1409,0,71076
745,2019-10-06,29929,10621,1856,1,42407
745,2019-10-07,54730,6141,1981,1622,64474
745,2019-10-08,100340,11142,1915,1663,115060
745,2019-10-09,53483,14120,955,3,68561
745,2019-10-10,67673,16560,2164,0,86397
745,2019-10-11,75818,10551,1165,1626,89160
745,2019-10-12,45005,6934,1738,0,53677
745,2019-10-13,59125,7153,2258,4,68540
745,2019-10-14,158231,6908,2067,2,167208
745,2019-10-15,110159,13369,2352,0,125880
745,2019-10-16,67518,22697,1090,1,91306
745,2019-10-17,191969,7615,1526,0,201110
745,2019-10-18,221003,13245,1619,0,235867
745,2019-10-19,153080,8772,2505,1,164358
745,2019-10-20,140952,1375,1735,0,144062
745,2019-10-21,101198,9289,1056,3,111546
745,2019-10-22,94729,4932,939,4,100604
745,2019-10-23,86266,12885,1769,2,100922
745,2019-10-24,113894,24924,1330,2,140150
745,2019-10-25,61972,17947,1180,2,81101
745,2019-10-26,1238849,19014,2256,0,1260119
745,2019-10-27,47140,15234,2585,1,64960
745,2019-10-28,45548,12689,2392,0,60629
745,2019-10-29,60875,14388,2141,4,77408
745,2019-10-30,54070,22789,1281,0,78140
745,2019-10-31,105650,13891,1058,1,120600
745,2019-11-01,35759,23798,1230,1,60788
745,2019-11-02,55022,15668,1382,0,72072
745,2019-11-03,38728,21612,1106,3,61449
745,2019-11-04,42382,8594,2013,0,52989
745,2019-11-05,1781501,1782,1881,0,1785164
745,2019-11-06,45402,7615,1672,1,54690
745,2019-11-07,19849,13061,923,1,33834
745,2019-11-08,29565,9161,1443,1,40170
745,2019-11-09,45268,8146,2122,0,55536
745,2019-11-10,21428,23162,1246,1,45837
745,2019-11-11,29048,15137,1704,2,45891
745,2019-11-12,15813,16574,1911,2,34300
745,2019-11-13,19175,11843,1696,2,32716
745,2019-11-14,23320,12318,1554,0,37192
745,2019-11-15,17989,5379,2455,1,25824
745,2019-11-16,37352,5341,1702,0,44395
745,2019-11-17,70933,3990,2156,0,77079
745,2019-11-18,34254,3596,2822,5,40677
745,2019-11-19,73842,3978,2431,1,80252
745,2019-11-20,42528,2103,2282,0,46913
745,2019-11-21,38387,5576,1091,1,45055
745,2019-11-22,18379,4679,962,2,24022
745,2019-11-23,8066,6419,2552,2,17039
745,2019-11-24,19896,5535,1888,0,27319
745,2019-11-25,5821,7268,1692,0,14781
745,2019-11-26,24068,5630,1030,0,30728
745,2019-11-27,21644,6639,1358,2,29643
745,2019-11-28,1952,7255,753,4,9964
745,2019-11-29,854,665,2,0,1521
745,2019-08-21,57939,1464,1505,1,60909
745,2019-08-22,12326,3100,1711,1626,18763
745,2019-08-23,102719,3106,1443,3241,110509
745,2019-08-24,5934,3367,1964,1,11266
745,2019-08-25,22438,14792,1553,1,38784
745,2019-08-26,92234,33360,2312,0,127906
745,2019-08-27,47983,13268,2250,717,64218
745,2019-08-28,11023,12184,1458,494,25159
745,2019-08-29,60449,15529,2521,1076,79575
745,2019-08-30,39195,3452,911,522,44080
745,2019-08-31,2229,568,2,2,2801
745,2019-09-01,17672,683,131,521,19007
745,2019-09-02,8403,263,9,11,8686
745,2019-09-03,2735,1374,1223,141,5473
745,2019-09-04,121060,12966,2364,426,136816
745,2019-09-05,415684,5531,1987,320,423522
745,2019-09-06,40309,8680,2132,540,51661
745,2019-09-07,319229,10259,2546,221,332255
745,2019-09-08,724637,7210,2057,440,734344
745,2019-09-09,38205,10192,1882,220,50499
745,2019-09-10,252864,11555,1787,1731,267937
745,2019-09-11,1214536,7859,2238,643,1225276
745,2019-09-12,142082,7500,2865,642,153089
745,2019-09-13,285867,6063,2340,321,294591
745,2019-09-14,390428,12729,1923,3562,408642
745,2019-09-15,63539,8576,1641,961,74717
745,2019-09-16,173763,9948,1829,1946,187486
745,2019-09-17,463143,9897,1813,640,475493
745,2019-09-18,40761,11446,968,324,53499
745,2019-09-19,179288,11412,1387,1622,193709
745,2019-09-20,500770,8680,2212,1,511663
745,2019-09-21,89352,11544,1440,0,102336
745,2019-09-22,141826,8475,2421,1,152723
745,2019-09-23,191807,9098,1648,1621,204174
745,2019-09-24,96749,8344,1354,5,106452
745,2019-09-25,73288,6132,1902,1,81323
745,2019-09-26,70170,10099,1327,2,81598
745,2019-09-27,113350,9028,2108,1624,126110
745,2019-09-28,89437,14942,1821,1625,107825
745,2019-09-29,44529,16316,2108,3,62956
745,2019-09-30,48942,17269,1122,1630,68963
745,2019-10-01,25164,15634,2106,0,42904
745,2019-10-02,52711,10782,2161,636,66290
745,2019-10-03,75704,12666,1546,1,89917
745,2019-10-04,31958,11189,1610,5,44762
745,2019-10-05,55885,13782,1409,0,71076
745,2019-10-06,29929,10621,1856,1,42407
745,2019-10-07,54730,6141,1981,1622,64474
745,2019-10-08,100340,11142,1915,1663,115060
745,2019-10-09,53483,14120,955,3,68561
745,2019-10-10,67673,16560,2164,0,86397
745,2019-10-11,75818,10551,1165,1626,89160
745,2019-10-12,45005,6934,1738,0,53677
745,2019-10-13,59125,7153,2258,4,68540
745,2019-10-14,158231,6908,2067,2,167208
745,2019-10-15,110159,13369,2352,0,125880
745,2019-10-16,67518,22697,1090,1,91306
745,2019-10-17,191969,7615,1526,0,201110
745,2019-10-18,221003,13245,1619,0,235867
745,2019-10-19,153080,8772,2505,1,164358
745,2019-10-20,140952,1375,1735,0,144062
745,2019-10-21,101198,9289,1056,3,111546
745,2019-10-22,94729,4932,939,4,100604
745,2019-10-23,86266,12885,1769,2,100922
745,2019-10-24,113894,24924,1330,2,140150
745,2019-10-25,61972,17947,1180,2,81101
745,2019-10-26,1238849,19014,2256,0,1260119
745,2019-10-27,47140,15234,2585,1,64960
745,2019-10-28,45548,12689,2392,0,60629
745,2019-10-29,60875,14388,2141,4,77408
745,2019-10-30,54070,22789,1281,0,78140
745,2019-10-31,105650,13891,1058,1,120600
745,2019-11-01,35759,23798,1230,1,60788
745,2019-11-02,55022,15668,1382,0,72072
745,2019-11-03,38728,21612,1106,3,61449
745,2019-11-04,42382,8594,2013,0,52989
745,2019-11-05,1781501,1782,1881,0,1785164
745,2019-11-06,45402,7615,1672,1,54690
745,2019-11-07,19849,13061,923,1,33834
745,2019-11-08,29565,9161,1443,1,40170
745,2019-11-09,45268,8146,2122,0,55536
745,2019-11-10,21428,23162,1246,1,45837
745,2019-11-11,29048,15137,1704,2,45891
745,2019-11-12,15813,16574,1911,2,34300
745,2019-11-13,19175,11843,1696,2,32716
745,2019-11-14,23320,12318,1554,0,37192
745,2019-11-15,17989,5379,2455,1,25824
745,2019-11-16,37352,5341,1702,0,44395
745,2019-11-17,70933,3990,2156,0,77079
745,2019-11-18,34254,3596,2822,5,40677
745,2019-11-19,73842,3978,2431,1,80252
745,2019-11-20,42528,2103,2282,0,46913
745,2019-11-21,38387,5576,1091,1,45055
745,2019-11-22,18379,4679,962,2,24022
745,2019-11-23,8066,6419,2552,2,17039
745,2019-11-24,19896,5535,1888,0,27319
745,2019-11-25,5821,7268,1692,0,14781
745,2019-11-26,24068,5630,1030,0,30728
745,2019-11-27,21644,6639,1358,2,29643
745,2019-11-28,1952,7255,753,4,9964
746,2019-08-20,384,2234,1478,0,4096
746,2019-08-21,220,2203,917,0,3340
746,2019-08-22,206,13678,1423,1,15308
746,2019-08-23,169,14488,2197,1,16855
746,2019-08-24,170,2540,1711,0,4421
746,2019-08-25,135,4645,1121,2,5903
746,2019-08-26,230,465,1627,2,2324
746,2019-08-27,263,6727,2340,1,9331
746,2019-08-28,279,1908,1613,0,3800
746,2019-08-29,185,19956,1665,1,21807
746,2019-08-30,1044,5427,360,1,6832
746,2019-08-31,38,49,2,0,89
746,2019-09-01,229,425,25,0,679
746,2019-09-02,48,774,0,1,823
746,2019-09-03,98,1596,929,1,2624
746,2019-09-04,153,11614,2566,0,14333
746,2019-09-05,188,6637,1335,1,8161
746,2019-09-06,143,11452,1756,0,13351
746,2019-09-07,245,13175,1748,0,15168
746,2019-09-08,1111,5924,1675,0,8710
746,2019-09-09,347,7259,2415,1,10022
746,2019-09-10,196,8249,1814,0,10259
746,2019-09-11,196,6462,2384,3,9045
746,2019-09-12,1825,10663,2057,1,14546
746,2019-09-13,107,3745,2076,0,5928
746,2019-09-14,1060,8067,1639,0,10766
746,2019-09-15,110,11325,1658,1,13094
746,2019-09-16,947,12341,1731,1,15020
746,2019-09-17,148,11573,2065,0,13786
746,2019-09-18,99,11933,1159,0,13191
746,2019-09-19,656,5188,2419,0,8263
746,2019-09-20,125,17343,2235,0,19703
746,2019-09-21,1488,13909,2006,0,17403
746,2019-09-22,977,9216,779,1,10973
746,2019-09-23,192,10420,1804,1,12417
746,2019-09-24,208,8834,1201,3,10246
746,2019-09-25,150,8030,1822,1,10003
746,2019-09-26,154,10177,2103,1,12435
746,2019-09-27,208,8986,1893,3,11090
746,2019-09-28,565,15761,1324,2,17652
746,2019-09-29,85,16750,1391,0,18226
746,2019-09-30,133,18202,1454,42,19831
746,2019-10-01,125,17030,1989,0,19144
746,2019-10-02,1331,12966,1857,0,16154
746,2019-10-03,2673,14363,2188,1,19225
746,2019-10-04,244,12621,1372,0,14237
746,2019-10-05,395,14709,1136,0,16240
746,2019-10-06,174,11492,1757,2,13425
746,2019-10-07,1001,7005,1959,5,9970
746,2019-10-08,250,18259,1786,1,20296
746,2019-10-09,798,17861,1823,1,20483
746,2019-10-10,1293,13970,2112,0,17375
746,2019-10-11,106,10661,1457,0,12224
746,2019-10-12,488,7409,1508,5,9410
746,2019-10-13,965,8857,1291,2,11115
746,2019-10-14,406,8557,1707,0,10670
746,2019-10-15,311,9570,1611,1,11493
746,2019-10-16,174,13397,1158,1,14730
746,2019-10-17,960,5670,1693,3,8326
746,2019-10-18,2800,8954,2225,2,13981
746,2019-10-19,117,6725,2385,0,9227
746,2019-10-20,741,4288,1476,0,6505
746,2019-10-21,896,11121,1086,2,13105
746,2019-10-22,116,6926,2152,2,9196
746,2019-10-23,970,8916,1524,10,11420
746,2019-10-24,106,20600,1468,0,22174
746,2019-10-25,113,15410,1668,1,17192
746,2019-10-26,133,21982,2946,1,25062
746,2019-10-27,947,18238,2241,2,21428
746,2019-10-28,88,14107,2686,1,16882
746,2019-10-29,1079,16017,2418,0,19514
746,2019-10-30,117,15650,961,0,16728
746,2019-10-31,1469,12900,1619,2,15990
746,2019-11-01,66,25672,1855,2,27595
746,2019-11-02,75,16850,848,0,17773
746,2019-11-03,200,22503,1400,1,24104
746,2019-11-04,116,8154,1875,1,10146
746,2019-11-05,155,3783,2176,1,6115
746,2019-11-06,1271,14365,2272,5,17913
746,2019-11-07,150,16769,2292,0,19211
746,2019-11-08,449,13388,2008,0,15845
746,2019-11-09,90,8757,2372,0,11219
746,2019-11-10,506,15066,1249,0,16821
746,2019-11-11,221,10434,2344,0,12999
746,2019-11-12,78,10788,3111,0,13977
746,2019-11-13,240,23225,1741,0,25206
746,2019-11-14,656,10334,1878,0,12868
746,2019-11-15,1038,5163,2445,0,8646
746,2019-11-16,116,2653,2140,0,4909
746,2019-11-17,470,3201,3351,0,7022
746,2019-11-18,122,3177,3107,0,6406
746,2019-11-19,140,3321,1629,0,5090
746,2019-11-20,131,1838,1655,0,3624
746,2019-11-21,117,5407,1822,0,7346
746,2019-11-22,109,4797,1702,0,6608
746,2019-11-23,548,9831,2401,0,12780
746,2019-11-24,271,6615,2053,0,8939
746,2019-11-25,179,10672,1662,0,12513
746,2019-11-26,145,9363,1720,0,11228
746,2019-11-27,105,11105,1288,0,12498
746,2019-11-28,149,13002,514,0,13665
746,2019-11-29,154,646,2,0,802
746,2019-08-20,384,2234,1478,0,4096
746,2019-08-21,220,2203,917,0,3340
746,2019-08-22,206,13678,1423,1,15308
746,2019-08-23,169,14488,2197,1,16855
746,2019-08-24,170,2540,1711,0,4421
746,2019-08-25,135,4645,1121,2,5903
746,2019-08-26,230,465,1627,2,2324
746,2019-08-27,263,6727,2340,1,9331
746,2019-08-28,279,1908,1613,0,3800
746,2019-08-29,185,19956,1665,1,21807
746,2019-08-30,1044,5427,360,1,6832
746,2019-08-31,38,49,2,0,89
746,2019-09-01,229,425,25,0,679
746,2019-09-02,48,774,0,1,823
746,2019-09-03,98,1596,929,1,2624
746,2019-09-04,153,11614,2566,0,14333
746,2019-09-05,188,6637,1335,1,8161
746,2019-09-06,143,11452,1756,0,13351
746,2019-09-07,245,13175,1748,0,15168
746,2019-09-08,1111,5924,1675,0,8710
746,2019-09-09,347,7259,2415,1,10022
746,2019-09-10,196,8249,1814,0,10259
746,2019-09-11,196,6462,2384,3,9045
746,2019-09-12,1825,10663,2057,1,14546
746,2019-09-13,107,3745,2076,0,5928
746,2019-09-14,1060,8067,1639,0,10766
746,2019-09-15,110,11325,1658,1,13094
746,2019-09-16,947,12341,1731,1,15020
746,2019-09-17,148,11573,2065,0,13786
746,2019-09-18,99,11933,1159,0,13191
746,2019-09-19,656,5188,2419,0,8263
746,2019-09-20,125,17343,2235,0,19703
746,2019-09-21,1488,13909,2006,0,17403
746,2019-09-22,977,9216,779,1,10973
746,2019-09-23,192,10420,1804,1,12417
746,2019-09-24,208,8834,1201,3,10246
746,2019-09-25,150,8030,1822,1,10003
746,2019-09-26,154,10177,2103,1,12435
746,2019-09-27,208,8986,1893,3,11090
746,2019-09-28,565,15761,1324,2,17652
746,2019-09-29,85,16750,1391,0,18226
746,2019-09-30,133,18202,1454,42,19831
746,2019-10-01,125,17030,1989,0,19144
746,2019-10-02,1331,12966,1857,0,16154
746,2019-10-03,2673,14363,2188,1,19225
746,2019-10-04,244,12621,1372,0,14237
746,2019-10-05,395,14709,1136,0,16240
746,2019-10-06,174,11492,1757,2,13425
746,2019-10-07,1001,7005,1959,5,9970
746,2019-10-08,250,18259,1786,1,20296
746,2019-10-09,798,17861,1823,1,20483
746,2019-10-10,1293,13970,2112,0,17375
746,2019-10-11,106,10661,1457,0,12224
746,2019-10-12,488,7409,1508,5,9410
746,2019-10-13,965,8857,1291,2,11115
746,2019-10-14,406,8557,1707,0,10670
746,2019-10-15,311,9570,1611,1,11493
746,2019-10-16,174,13397,1158,1,14730
746,2019-10-17,960,5670,1693,3,8326
746,2019-10-18,2800,8954,2225,2,13981
746,2019-10-19,117,6725,2385,0,9227
746,2019-10-20,741,4288,1476,0,6505
746,2019-10-21,896,11121,1086,2,13105
746,2019-10-22,116,6926,2152,2,9196
746,2019-10-23,970,8916,1524,10,11420
746,2019-10-24,106,20600,1468,0,22174
746,2019-10-25,113,15410,1668,1,17192
746,2019-10-26,133,21982,2946,1,25062
746,2019-10-27,947,18238,2241,2,21428
746,2019-10-28,88,14107,2686,1,16882
746,2019-10-29,1079,16017,2418,0,19514
746,2019-10-30,117,15650,961,0,16728
746,2019-10-31,1469,12900,1619,2,15990
746,2019-11-01,66,25672,1855,2,27595
746,2019-11-02,75,16850,848,0,17773
746,2019-11-03,200,22503,1400,1,24104
746,2019-11-04,116,8154,1875,1,10146
746,2019-11-05,155,3783,2176,1,6115
746,2019-11-06,1271,14365,2272,5,17913
746,2019-11-07,150,16769,2292,0,19211
746,2019-11-08,449,13388,2008,0,15845
746,2019-11-09,90,8757,2372,0,11219
746,2019-11-10,506,15066,1249,0,16821
746,2019-11-11,221,10434,2344,0,12999
746,2019-11-12,78,10788,3111,0,13977
746,2019-11-13,240,23225,1741,0,25206
746,2019-11-14,656,10334,1878,0,12868
746,2019-11-15,1038,5163,2445,0,8646
746,2019-11-16,116,2653,2140,0,4909
746,2019-11-17,470,3201,3351,0,7022
746,2019-11-18,122,3177,3107,0,6406
746,2019-11-19,140,3321,1629,0,5090
746,2019-11-20,131,1838,1655,0,3624
746,2019-11-21,117,5407,1822,0,7346
746,2019-11-22,109,4797,1702,0,6608
746,2019-11-23,548,9831,2401,0,12780
746,2019-11-24,271,6615,2053,0,8939
746,2019-11-25,179,10672,1662,0,12513
746,2019-11-26,145,9363,1720,0,11228
746,2019-11-27,105,11105,1288,0,12498
746,2019-11-28,149,13002,514,0,13665
746,2019-11-29,154,646,2,0,802
746,2019-08-19,0,0,310,1,311
746,2019-08-20,384,2234,1478,0,4096
746,2019-08-21,220,2203,917,0,3340
746,2019-08-22,206,13678,1423,1,15308
746,2019-08-23,169,14488,2197,1,16855
746,2019-08-24,170,2540,1711,0,4421
746,2019-08-25,135,4645,1121,2,5903
746,2019-08-26,230,465,1627,2,2324
746,2019-08-27,263,6727,2340,1,9331
746,2019-08-28,279,1908,1613,0,3800
746,2019-08-29,185,19956,1665,1,21807
746,2019-08-30,1044,5427,360,1,6832
746,2019-08-31,38,49,2,0,89
746,2019-09-01,229,425,25,0,679
746,2019-09-02,48,774,0,1,823
746,2019-09-03,98,1596,929,1,2624
746,2019-09-04,153,11614,2566,0,14333
746,2019-09-05,188,6637,1335,1,8161
746,2019-09-06,143,11452,1756,0,13351
746,2019-09-07,245,13175,1748,0,15168
746,2019-09-08,1111,5924,1675,0,8710
746,2019-09-09,347,7259,2415,1,10022
746,2019-09-10,196,8249,1814,0,10259
746,2019-09-11,196,6462,2384,3,9045
746,2019-09-12,1825,10663,2057,1,14546
746,2019-09-13,107,3745,2076,0,5928
746,2019-09-14,1060,8067,1639,0,10766
746,2019-09-15,110,11325,1658,1,13094
746,2019-09-16,947,12341,1731,1,15020
746,2019-09-17,148,11573,2065,0,13786
746,2019-09-18,99,11933,1159,0,13191
746,2019-09-19,656,5188,2419,0,8263
746,2019-09-20,125,17343,2235,0,19703
746,2019-09-21,1488,13909,2006,0,17403
746,2019-09-22,977,9216,779,1,10973
746,2019-09-23,192,10420,1804,1,12417
746,2019-09-24,208,8834,1201,3,10246
746,2019-09-25,150,8030,1822,1,10003
746,2019-09-26,154,10177,2103,1,12435
746,2019-09-27,208,8986,1893,3,11090
746,2019-09-28,565,15761,1324,2,17652
746,2019-09-29,85,16750,1391,0,18226
746,2019-09-30,133,18202,1454,42,19831
746,2019-10-01,125,17030,1989,0,19144
746,2019-10-02,1331,12966,1857,0,16154
746,2019-10-03,2673,14363,2188,1,19225
746,2019-10-04,244,12621,1372,0,14237
746,2019-10-05,395,14709,1136,0,16240
746,2019-10-06,174,11492,1757,2,13425
746,2019-10-07,1001,7005,1959,5,9970
746,2019-10-08,250,18259,1786,1,20296
746,2019-10-09,798,17861,1823,1,20483
746,2019-10-10,1293,13970,2112,0,17375
746,2019-10-11,106,10661,1457,0,12224
746,2019-10-12,488,7409,1508,5,9410
746,2019-10-13,965,8857,1291,2,11115
746,2019-10-14,406,8557,1707,0,10670
746,2019-10-15,311,9570,1611,1,11493
746,2019-10-16,174,13397,1158,1,14730
746,2019-10-17,960,5670,1693,3,8326
746,2019-10-18,2800,8954,2225,2,13981
746,2019-10-19,117,6725,2385,0,9227
746,2019-10-20,741,4288,1476,0,6505
746,2019-10-21,896,11121,1086,2,13105
746,2019-10-22,116,6926,2152,2,9196
746,2019-10-23,970,8916,1524,10,11420
746,2019-10-24,106,20600,1468,0,22174
746,2019-10-25,113,15410,1668,1,17192
746,2019-10-26,133,21982,2946,1,25062
746,2019-10-27,947,18238,2241,2,21428
746,2019-10-28,88,14107,2686,1,16882
746,2019-10-29,1079,16017,2418,0,19514
746,2019-10-30,117,15650,961,0,16728
746,2019-10-31,1469,12900,1619,2,15990
746,2019-11-01,66,25672,1855,2,27595
746,2019-11-02,75,16850,848,0,17773
746,2019-11-03,200,22503,1400,1,24104
746,2019-11-04,116,8154,1875,1,10146
746,2019-11-05,155,3783,2176,1,6115
746,2019-11-06,1271,14365,2272,5,17913
746,2019-11-07,150,16769,2292,0,19211
746,2019-11-08,449,13388,2008,0,15845
746,2019-11-09,90,8757,2372,0,11219
746,2019-11-10,506,15066,1249,0,16821
746,2019-11-11,221,10434,2344,0,12999
746,2019-11-12,78,10788,3111,0,13977
746,2019-11-13,240,23225,1741,0,25206
746,2019-11-14,656,10334,1878,0,12868
746,2019-11-15,1038,5163,2445,0,8646
746,2019-11-16,116,2653,2140,0,4909
746,2019-11-17,470,3201,3351,0,7022
746,2019-11-18,122,3177,3107,0,6406
746,2019-11-19,140,3321,1629,0,5090
746,2019-11-20,131,1838,1655,0,3624
746,2019-11-21,117,5407,1822,0,7346
746,2019-11-22,109,4797,1702,0,6608
746,2019-11-23,548,9831,2401,0,12780
746,2019-11-24,271,6615,2053,0,8939
746,2019-11-25,179,10672,1662,0,12513
746,2019-11-26,145,9363,1720,0,11228
746,2019-11-27,105,11105,1288,0,12498
746,2019-11-28,149,13002,514,0,13665
746,2019-11-29,154,646,2,0,802
746,2019-08-19,0,0,310,1,311
746,2019-08-20,384,2234,1478,0,4096
746,2019-08-21,220,2203,917,0,3340
746,2019-08-22,206,13678,1423,1,15308
746,2019-08-23,169,14488,2197,1,16855
746,2019-08-24,170,2540,1711,0,4421
746,2019-08-25,135,4645,1121,2,5903
746,2019-08-26,230,465,1627,2,2324
746,2019-08-27,263,6727,2340,1,9331
746,2019-08-28,279,1908,1613,0,3800
746,2019-08-29,185,19956,1665,1,21807
746,2019-08-30,1044,5427,360,1,6832
746,2019-08-31,38,49,2,0,89
746,2019-09-01,229,425,25,0,679
746,2019-09-02,48,774,0,1,823
746,2019-09-03,98,1596,929,1,2624
746,2019-09-04,153,11614,2566,0,14333
746,2019-09-05,188,6637,1335,1,8161
746,2019-09-06,143,11452,1756,0,13351
746,2019-09-07,245,13175,1748,0,15168
746,2019-09-08,1111,5924,1675,0,8710
746,2019-09-09,347,7259,2415,1,10022
746,2019-09-10,196,8249,1814,0,10259
746,2019-09-11,196,6462,2384,3,9045
746,2019-09-12,1825,10663,2057,1,14546
746,2019-09-13,107,3745,2076,0,5928
746,2019-09-14,1060,8067,1639,0,10766
746,2019-09-15,110,11325,1658,1,13094
746,2019-09-16,947,12341,1731,1,15020
746,2019-09-17,148,11573,2065,0,13786
746,2019-09-18,99,11933,1159,0,13191
746,2019-09-19,656,5188,2419,0,8263
746,2019-09-20,125,17343,2235,0,19703
746,2019-09-21,1488,13909,2006,0,17403
746,2019-09-22,977,9216,779,1,10973
746,2019-09-23,192,10420,1804,1,12417
746,2019-09-24,208,8834,1201,3,10246
746,2019-09-25,150,8030,1822,1,10003
746,2019-09-26,154,10177,2103,1,12435
746,2019-09-27,208,8986,1893,3,11090
746,2019-09-28,565,15761,1324,2,17652
746,2019-09-29,85,16750,1391,0,18226
746,2019-09-30,133,18202,1454,42,19831
746,2019-10-01,125,17030,1989,0,19144
746,2019-10-02,1331,12966,1857,0,16154
746,2019-10-03,2673,14363,2188,1,19225
746,2019-10-04,244,12621,1372,0,14237
746,2019-10-05,395,14709,1136,0,16240
746,2019-10-06,174,11492,1757,2,13425
746,2019-10-07,1001,7005,1959,5,9970
746,2019-10-08,250,18259,1786,1,20296
746,2019-10-09,798,17861,1823,1,20483
746,2019-10-10,1293,13970,2112,0,17375
746,2019-10-11,106,10661,1457,0,12224
746,2019-10-12,488,7409,1508,5,9410
746,2019-10-13,965,8857,1291,2,11115
746,2019-10-14,406,8557,1707,0,10670
746,2019-10-15,311,9570,1611,1,11493
746,2019-10-16,174,13397,1158,1,14730
746,2019-10-17,960,5670,1693,3,8326
746,2019-10-18,2800,8954,2225,2,13981
746,2019-10-19,117,6725,2385,0,9227
746,2019-10-20,741,4288,1476,0,6505
746,2019-10-21,896,11121,1086,2,13105
746,2019-10-22,116,6926,2152,2,9196
746,2019-10-23,970,8916,1524,10,11420
746,2019-10-24,106,20600,1468,0,22174
746,2019-10-25,113,15410,1668,1,17192
746,2019-10-26,133,21982,2946,1,25062
746,2019-10-27,947,18238,2241,2,21428
746,2019-10-28,88,14107,2686,1,16882
746,2019-10-29,1079,16017,2418,0,19514
746,2019-10-30,117,15650,961,0,16728
746,2019-10-31,1469,12900,1619,2,15990
746,2019-11-01,66,25672,1855,2,27595
746,2019-11-02,75,16850,848,0,17773
746,2019-11-03,200,22503,1400,1,24104
746,2019-11-04,116,8154,1875,1,10146
746,2019-11-05,155,3783,2176,1,6115
746,2019-11-06,1271,14365,2272,5,17913
747,2019-08-20,789,1321,1244,2,3356
747,2019-08-21,485,3449,1983,0,5917
747,2019-08-22,408,2232,1422,1,4063
747,2019-08-23,431,1513,1697,0,3641
747,2019-08-24,2077,3078,1980,1,7136
747,2019-08-25,1357,11885,1623,1,14866
747,2019-08-26,1022,23004,1186,1,25213
747,2019-08-27,807,6665,1620,1,9093
747,2019-08-28,2243,12261,1868,2,16374
747,2019-08-29,675,12885,1805,1,15366
747,2019-08-30,529,2480,677,2,3688
747,2019-08-31,121,65,0,0,186
747,2019-09-01,386,369,239,1,995
747,2019-09-02,335,99,15,0,449
747,2019-09-03,575,431,1323,0,2329
747,2019-09-04,740,16383,2257,1,19381
747,2019-09-05,659,10194,876,1,11730
747,2019-09-06,854,18630,1950,0,21434
747,2019-09-07,597,9023,1391,1,11012
747,2019-09-08,688,4706,1698,1,7093
747,2019-09-09,736,9427,1802,0,11965
747,2019-09-10,698,12321,2786,1,15806
747,2019-09-11,528,8801,1929,2,11260
747,2019-09-12,364,8615,1646,1,10626
747,2019-09-13,1390,3555,1383,1,6329
747,2019-09-14,1419,11285,1594,1,14299
747,2019-09-15,1424,5423,2126,1,8974
747,2019-09-16,537,11179,2533,1,14250
747,2019-09-17,481,11000,1746,0,13227
747,2019-09-18,887,19664,1158,0,21709
747,2019-09-19,1611,5891,1350,1,8853
747,2019-09-20,590,11032,2389,1,14012
747,2019-09-21,569,7061,1710,1,9341
747,2019-09-22,1394,8142,1749,2,11287
747,2019-09-23,3539,11904,1819,3,17265
747,2019-09-24,617,9197,2189,5,12008
747,2019-09-25,1163,8754,1581,0,11498
747,2019-09-26,231,11622,1214,0,13067
747,2019-09-27,261,8769,1999,2,11031
747,2019-09-28,254,15063,1726,2,17045
747,2019-09-29,685,15259,1476,3,17423
747,2019-09-30,894,18022,2253,1,21170
747,2019-10-01,1647,17019,1546,0,20212
747,2019-10-02,289,15531,1845,0,17665
747,2019-10-03,272,15355,1187,2,16816
747,2019-10-04,380,12441,1632,3,14456
747,2019-10-05,1638,14938,1998,2,18576
747,2019-10-06,336,12022,1622,1,13981
747,2019-10-07,679,7262,1622,0,9563
747,2019-10-08,1472,18154,1517,1,21144
747,2019-10-09,455,17382,1880,3,19720
747,2019-10-10,325,12391,1920,2,14638
747,2019-10-11,941,11161,2040,2,14144
747,2019-10-12,1078,8111,1776,1,10966
747,2019-10-13,1423,9182,1713,1,12319
747,2019-10-14,632,5851,2024,2,8509
747,2019-10-15,497,8737,1626,0,10860
747,2019-10-16,454,12856,1168,3,14481
747,2019-10-17,478,5804,1963,0,8245
747,2019-10-18,573,8984,2091,0,11648
747,2019-10-19,1534,5975,1908,1,9418
747,2019-10-20,815,3116,1350,1,5282
747,2019-10-21,521,10806,1614,1,12942
747,2019-10-22,560,6731,2092,1,9384
747,2019-10-23,653,9165,1817,0,11635
747,2019-10-24,628,20619,1015,2,22264
747,2019-10-25,1312,19071,1487,1,21871
747,2019-10-26,2216,16585,2495,1,21297
747,2019-10-27,695,16486,1969,0,19150
747,2019-10-28,606,14402,1139,1,16148
747,2019-10-29,982,27402,1106,4,29494
747,2019-10-30,630,28551,1248,1,30430
747,2019-10-31,625,14912,2130,1,17668
747,2019-11-01,812,14665,1465,1,16943
747,2019-11-02,770,14112,1803,1,16686
747,2019-11-03,676,36678,1335,0,38689
747,2019-11-04,880,10903,1343,0,13126
747,2019-11-05,640,2866,2173,0,5679
747,2019-11-06,616,14234,1829,0,16679
747,2019-11-07,1000,25009,1926,0,27935
747,2019-11-08,721,11793,2073,0,14587
747,2019-11-09,804,9009,2184,0,11997
747,2019-11-10,656,23801,2544,0,27001
747,2019-11-11,585,16090,1783,0,18458
747,2019-11-12,582,17422,3160,0,21164
747,2019-11-13,2232,21788,2144,0,26164
747,2019-11-14,627,14412,2079,0,17118
747,2019-11-15,671,5206,1816,0,7693
747,2019-11-16,1586,3033,2421,0,7040
747,2019-11-17,1113,4046,3063,0,8222
747,2019-11-18,640,2610,2570,0,5820
747,2019-11-19,1703,3161,2823,0,7687
747,2019-11-20,555,1644,1697,0,3896
747,2019-11-21,576,5226,1474,0,7276
747,2019-11-22,528,4672,1718,0,6918
747,2019-11-23,751,5993,1961,0,8705
747,2019-11-24,985,11967,1765,0,14717
747,2019-11-25,517,12113,1706,0,14336
747,2019-11-26,1020,9954,1771,0,12745
747,2019-11-27,972,10665,1426,0,13063
747,2019-11-28,1051,12676,686,0,14413
747,2019-11-29,23,491,0,0,514
747,2019-08-20,789,1321,1244,2,3356
747,2019-08-21,485,3449,1983,0,5917
747,2019-08-22,408,2232,1422,1,4063
747,2019-08-23,431,1513,1697,0,3641
747,2019-08-24,2077,3078,1980,1,7136
747,2019-08-25,1357,11885,1623,1,14866
747,2019-08-26,1022,23004,1186,1,25213
747,2019-08-27,807,6665,1620,1,9093
747,2019-08-28,2243,12261,1868,2,16374
747,2019-08-29,675,12885,1805,1,15366
747,2019-08-30,529,2480,677,2,3688
747,2019-08-31,121,65,0,0,186
747,2019-09-01,386,369,239,1,995
747,2019-09-02,335,99,15,0,449
747,2019-09-03,575,431,1323,0,2329
747,2019-09-04,740,16383,2257,1,19381
747,2019-09-05,659,10194,876,1,11730
747,2019-09-06,854,18630,1950,0,21434
747,2019-09-07,597,9023,1391,1,11012
747,2019-09-08,688,4706,1698,1,7093
747,2019-09-09,736,9427,1802,0,11965
747,2019-09-10,698,12321,2786,1,15806
747,2019-09-11,528,8801,1929,2,11260
747,2019-09-12,364,8615,1646,1,10626
747,2019-09-13,1390,3555,1383,1,6329
747,2019-09-14,1419,11285,1594,1,14299
747,2019-09-15,1424,5423,2126,1,8974
747,2019-09-16,537,11179,2533,1,14250
747,2019-09-17,481,11000,1746,0,13227
747,2019-09-18,887,19664,1158,0,21709
747,2019-09-19,1611,5891,1350,1,8853
747,2019-09-20,590,11032,2389,1,14012
747,2019-09-21,569,7061,1710,1,9341
747,2019-09-22,1394,8142,1749,2,11287
747,2019-09-23,3539,11904,1819,3,17265
747,2019-09-24,617,9197,2189,5,12008
747,2019-09-25,1163,8754,1581,0,11498
747,2019-09-26,231,11622,1214,0,13067
747,2019-09-27,261,8769,1999,2,11031
747,2019-09-28,254,15063,1726,2,17045
747,2019-09-29,685,15259,1476,3,17423
747,2019-09-30,894,18022,2253,1,21170
747,2019-10-01,1647,17019,1546,0,20212
747,2019-10-02,289,15531,1845,0,17665
747,2019-10-03,272,15355,1187,2,16816
747,2019-10-04,380,12441,1632,3,14456
747,2019-10-05,1638,14938,1998,2,18576
747,2019-10-06,336,12022,1622,1,13981
747,2019-10-07,679,7262,1622,0,9563
747,2019-10-08,1472,18154,1517,1,21144
747,2019-10-09,455,17382,1880,3,19720
747,2019-10-10,325,12391,1920,2,14638
747,2019-10-11,941,11161,2040,2,14144
747,2019-10-12,1078,8111,1776,1,10966
747,2019-10-13,1423,9182,1713,1,12319
747,2019-10-14,632,5851,2024,2,8509
747,2019-10-15,497,8737,1626,0,10860
747,2019-10-16,454,12856,1168,3,14481
747,2019-10-17,478,5804,1963,0,8245
747,2019-10-18,573,8984,2091,0,11648
747,2019-10-19,1534,5975,1908,1,9418
747,2019-10-20,815,3116,1350,1,5282
747,2019-10-21,521,10806,1614,1,12942
747,2019-10-22,560,6731,2092,1,9384
747,2019-10-23,653,9165,1817,0,11635
747,2019-10-24,628,20619,1015,2,22264
747,2019-10-25,1312,19071,1487,1,21871
747,2019-10-26,2216,16585,2495,1,21297
747,2019-10-27,695,16486,1969,0,19150
747,2019-10-28,606,14402,1139,1,16148
747,2019-10-29,982,27402,1106,4,29494
747,2019-10-30,630,28551,1248,1,30430
747,2019-10-31,625,14912,2130,1,17668
747,2019-11-01,812,14665,1465,1,16943
747,2019-11-02,770,14112,1803,1,16686
747,2019-11-03,676,36678,1335,0,38689
747,2019-11-04,880,10903,1343,0,13126
747,2019-11-05,640,2866,2173,0,5679
747,2019-11-06,616,14234,1829,0,16679
747,2019-11-07,1000,25009,1926,0,27935
747,2019-11-08,721,11793,2073,0,14587
747,2019-11-09,804,9009,2184,0,11997
747,2019-11-10,656,23801,2544,0,27001
747,2019-11-11,585,16090,1783,0,18458
747,2019-11-12,582,17422,3160,0,21164
747,2019-11-13,2232,21788,2144,0,26164
747,2019-11-14,627,14412,2079,0,17118
747,2019-11-15,671,5206,1816,0,7693
747,2019-11-16,1586,3033,2421,0,7040
747,2019-11-17,1113,4046,3063,0,8222
747,2019-11-18,640,2610,2570,0,5820
747,2019-11-19,1703,3161,2823,0,7687
747,2019-11-20,555,1644,1697,0,3896
747,2019-11-21,576,5226,1474,0,7276
747,2019-11-22,528,4672,1718,0,6918
747,2019-11-23,751,5993,1961,0,8705
747,2019-11-24,985,11967,1765,0,14717
747,2019-11-25,517,12113,1706,0,14336
747,2019-11-26,1020,9954,1771,0,12745
747,2019-11-27,972,10665,1426,0,13063
747,2019-11-28,1051,12676,686,0,14413
747,2019-11-29,23,491,0,0,514
747,2019-08-19,0,0,90,1,91
747,2019-08-20,789,1321,1244,2,3356
747,2019-08-21,485,3449,1983,0,5917
747,2019-08-22,408,2232,1422,1,4063
747,2019-08-23,431,1513,1697,0,3641
747,2019-08-24,2077,3078,1980,1,7136
747,2019-08-25,1357,11885,1623,1,14866
747,2019-08-26,1022,23004,1186,1,25213
747,2019-08-27,807,6665,1620,1,9093
747,2019-08-28,2243,12261,1868,2,16374
747,2019-08-29,675,12885,1805,1,15366
747,2019-08-30,529,2480,677,2,3688
747,2019-08-31,121,65,0,0,186
747,2019-09-01,386,369,239,1,995
747,2019-09-02,335,99,15,0,449
747,2019-09-03,575,431,1323,0,2329
747,2019-09-04,740,16383,2257,1,19381
747,2019-09-05,659,10194,876,1,11730
747,2019-09-06,854,18630,1950,0,21434
747,2019-09-07,597,9023,1391,1,11012
747,2019-09-08,688,4706,1698,1,7093
747,2019-09-09,736,9427,1802,0,11965
747,2019-09-10,698,12321,2786,1,15806
747,2019-09-11,528,8801,1929,2,11260
747,2019-09-12,364,8615,1646,1,10626
747,2019-09-13,1390,3555,1383,1,6329
747,2019-09-14,1419,11285,1594,1,14299
747,2019-09-15,1424,5423,2126,1,8974
747,2019-09-16,537,11179,2533,1,14250
747,2019-09-17,481,11000,1746,0,13227
747,2019-09-18,887,19664,1158,0,21709
747,2019-09-19,1611,5891,1350,1,8853
747,2019-09-20,590,11032,2389,1,14012
747,2019-09-21,569,7061,1710,1,9341
747,2019-09-22,1394,8142,1749,2,11287
747,2019-09-23,3539,11904,1819,3,17265
747,2019-09-24,617,9197,2189,5,12008
747,2019-09-25,1163,8754,1581,0,11498
747,2019-09-26,231,11622,1214,0,13067
747,2019-09-27,261,8769,1999,2,11031
747,2019-09-28,254,15063,1726,2,17045
747,2019-09-29,685,15259,1476,3,17423
747,2019-09-30,894,18022,2253,1,21170
747,2019-10-01,1647,17019,1546,0,20212
747,2019-10-02,289,15531,1845,0,17665
747,2019-10-03,272,15355,1187,2,16816
747,2019-10-04,380,12441,1632,3,14456
747,2019-10-05,1638,14938,1998,2,18576
747,2019-10-06,336,12022,1622,1,13981
747,2019-10-07,679,7262,1622,0,9563
747,2019-10-08,1472,18154,1517,1,21144
747,2019-10-09,455,17382,1880,3,19720
747,2019-10-10,325,12391,1920,2,14638
747,2019-10-11,941,11161,2040,2,14144
747,2019-10-12,1078,8111,1776,1,10966
747,2019-10-13,1423,9182,1713,1,12319
747,2019-10-14,632,5851,2024,2,8509
747,2019-10-15,497,8737,1626,0,10860
747,2019-10-16,454,12856,1168,3,14481
747,2019-10-17,478,5804,1963,0,8245
747,2019-10-18,573,8984,2091,0,11648
747,2019-10-19,1534,5975,1908,1,9418
747,2019-10-20,815,3116,1350,1,5282
747,2019-10-21,521,10806,1614,1,12942
747,2019-10-22,560,6731,2092,1,9384
747,2019-10-23,653,9165,1817,0,11635
747,2019-10-24,628,20619,1015,2,22264
747,2019-10-25,1312,19071,1487,1,21871
747,2019-10-26,2216,16585,2495,1,21297
747,2019-10-27,695,16486,1969,0,19150
747,2019-10-28,606,14402,1139,1,16148
747,2019-10-29,982,27402,1106,4,29494
747,2019-10-30,630,28551,1248,1,30430
747,2019-10-31,625,14912,2130,1,17668
747,2019-11-01,812,14665,1465,1,16943
747,2019-11-02,770,14112,1803,1,16686
747,2019-11-03,676,36678,1335,0,38689
747,2019-11-04,880,10903,1343,0,13126
747,2019-11-05,640,2866,2173,0,5679
747,2019-11-06,616,14234,1829,0,16679
747,2019-11-07,1000,25009,1926,0,27935
747,2019-11-08,721,11793,2073,0,14587
747,2019-11-09,804,9009,2184,0,11997
747,2019-11-10,656,23801,2544,0,27001
747,2019-11-11,585,16090,1783,0,18458
747,2019-11-12,582,17422,3160,0,21164
747,2019-11-13,2232,21788,2144,0,26164
747,2019-11-14,627,14412,2079,0,17118
747,2019-11-15,671,5206,1816,0,7693
747,2019-11-16,1586,3033,2421,0,7040
747,2019-11-17,1113,4046,3063,0,8222
747,2019-11-18,640,2610,2570,0,5820
747,2019-11-19,1703,3161,2823,0,7687
747,2019-11-20,555,1644,1697,0,3896
747,2019-11-21,576,5226,1474,0,7276
747,2019-11-22,528,4672,1718,0,6918
747,2019-11-23,751,5993,1961,0,8705
747,2019-11-24,985,11967,1765,0,14717
747,2019-11-25,517,12113,1706,0,14336
747,2019-11-26,1020,9954,1771,0,12745
747,2019-11-27,972,10665,1426,0,13063
747,2019-11-28,1051,12676,686,0,14413
747,2019-08-19,0,0,90,1,91
747,2019-08-20,789,1321,1244,2,3356
747,2019-08-21,485,3449,1983,0,5917
747,2019-08-22,408,2232,1422,1,4063
747,2019-08-23,431,1513,1697,0,3641
747,2019-08-24,2077,3078,1980,1,7136
747,2019-08-25,1357,11885,1623,1,14866
747,2019-08-26,1022,23004,1186,1,25213
747,2019-08-27,807,6665,1620,1,9093
747,2019-08-28,2243,12261,1868,2,16374
747,2019-08-29,675,12885,1805,1,15366
747,2019-08-30,529,2480,677,2,3688
747,2019-08-31,121,65,0,0,186
747,2019-09-01,386,369,239,1,995
747,2019-09-02,335,99,15,0,449
747,2019-09-03,575,431,1323,0,2329
747,2019-09-04,740,16383,2257,1,19381
747,2019-09-05,659,10194,876,1,11730
747,2019-09-06,854,18630,1950,0,21434
747,2019-09-07,597,9023,1391,1,11012
747,2019-09-08,688,4706,1698,1,7093
747,2019-09-09,736,9427,1802,0,11965
747,2019-09-10,698,12321,2786,1,15806
747,2019-09-11,528,8801,1929,2,11260
747,2019-09-12,364,8615,1646,1,10626
747,2019-09-13,1390,3555,1383,1,6329
747,2019-09-14,1419,11285,1594,1,14299
747,2019-09-15,1424,5423,2126,1,8974
747,2019-09-16,537,11179,2533,1,14250
747,2019-09-17,481,11000,1746,0,13227
747,2019-09-18,887,19664,1158,0,21709
747,2019-09-19,1611,5891,1350,1,8853
747,2019-09-20,590,11032,2389,1,14012
747,2019-09-21,569,7061,1710,1,9341
747,2019-09-22,1394,8142,1749,2,11287
747,2019-09-23,3539,11904,1819,3,17265
747,2019-09-24,617,9197,2189,5,12008
747,2019-09-25,1163,8754,1581,0,11498
747,2019-09-26,231,11622,1214,0,13067
747,2019-09-27,261,8769,1999,2,11031
747,2019-09-28,254,15063,1726,2,17045
747,2019-09-29,685,15259,1476,3,17423
747,2019-09-30,894,18022,2253,1,21170
747,2019-10-01,1647,17019,1546,0,20212
747,2019-10-02,289,15531,1845,0,17665
747,2019-10-03,272,15355,1187,2,16816
747,2019-10-04,380,12441,1632,3,14456
747,2019-10-05,1638,14938,1998,2,18576
747,2019-10-06,336,12022,1622,1,13981
747,2019-10-07,679,7262,1622,0,9563
747,2019-10-08,1472,18154,1517,1,21144
747,2019-10-09,455,17382,1880,3,19720
747,2019-10-10,325,12391,1920,2,14638
747,2019-10-11,941,11161,2040,2,14144
747,2019-10-12,1078,8111,1776,1,10966
747,2019-10-13,1423,9182,1713,1,12319
747,2019-10-14,632,5851,2024,2,8509
747,2019-10-15,497,8737,1626,0,10860
747,2019-10-16,454,12856,1168,3,14481
747,2019-10-17,478,5804,1963,0,8245
747,2019-10-18,573,8984,2091,0,11648
747,2019-10-19,1534,5975,1908,1,9418
747,2019-10-20,815,3116,1350,1,5282
747,2019-10-21,521,10806,1614,1,12942
747,2019-10-22,560,6731,2092,1,9384
747,2019-10-23,653,9165,1817,0,11635
747,2019-10-24,628,20619,1015,2,22264
747,2019-10-25,1312,19071,1487,1,21871
747,2019-10-26,2216,16585,2495,1,21297
747,2019-10-27,695,16486,1969,0,19150
747,2019-10-28,606,14402,1139,1,16148
747,2019-10-29,982,27402,1106,4,29494
747,2019-10-30,630,28551,1248,1,30430
747,2019-10-31,625,14912,2130,1,17668
747,2019-11-01,812,14665,1465,1,16943
747,2019-11-02,770,14112,1803,1,16686
748,2019-08-20,579,1161,612,0,2352
748,2019-08-21,402,2383,1178,0,3963
748,2019-08-22,640,3421,760,3,4824
748,2019-08-23,323,2573,1491,2,4389
748,2019-08-24,295,2835,1380,0,4510
748,2019-08-25,342,7330,1711,0,9383
748,2019-08-26,1124,450,812,1,2387
748,2019-08-27,409,9520,1270,2,11201
748,2019-08-28,297,3898,1620,0,5815
748,2019-08-29,283,9766,1377,0,11426
748,2019-08-30,363,2721,694,0,3778
748,2019-08-31,44,14,1,0,59
748,2019-09-01,48,1141,184,0,1373
748,2019-09-02,137,54,34,0,225
748,2019-09-03,1806,385,1816,0,4007
748,2019-09-04,291,13897,2562,1,16751
748,2019-09-05,1117,7428,2376,1,10922
748,2019-09-06,320,11838,2732,0,14890
748,2019-09-07,525,13320,2786,1,16632
748,2019-09-08,1225,5422,2007,1,8655
748,2019-09-09,1304,8386,1407,0,11097
748,2019-09-10,223,12023,1452,0,13698
748,2019-09-11,147,8804,1589,2,10542
748,2019-09-12,1025,13473,2180,1,16679
748,2019-09-13,1248,11062,2287,0,14597
748,2019-09-14,287,10410,1207,1,11905
748,2019-09-15,1001,6419,1908,0,9328
748,2019-09-16,1160,10415,2295,1,13871
748,2019-09-17,1196,9282,1895,3,12376
748,2019-09-18,713,11735,1372,2,13822
748,2019-09-19,438,5026,1673,2,7139
748,2019-09-20,373,13016,1980,1,15370
748,2019-09-21,276,7672,2340,1,10289
748,2019-09-22,1099,13123,1811,0,16033
748,2019-09-23,1187,9785,2404,1,13377
748,2019-09-24,486,10138,1777,4,12405
748,2019-09-25,957,8673,1216,5,10851
748,2019-09-26,168,9045,1638,1,10852
748,2019-09-27,106,8342,1526,2,9976
748,2019-09-28,192,14953,1842,3,16990
748,2019-09-29,536,14508,963,479,16486
748,2019-09-30,729,18793,1682,281,21485
748,2019-10-01,155,15997,1475,0,17627
748,2019-10-02,1135,10733,1628,1,13497
748,2019-10-03,198,13363,2024,2,15587
748,2019-10-04,117,11268,2152,0,13537
748,2019-10-05,654,19426,1195,1,21276
748,2019-10-06,132,17545,2247,1,19925
748,2019-10-07,146,5281,1401,0,6828
748,2019-10-08,140,17446,2442,1,20029
748,2019-10-09,988,23276,1709,2,25975
748,2019-10-10,371,11126,2100,2,13599
748,2019-10-11,433,9937,934,0,11304
748,2019-10-12,248,5456,2413,1,8118
748,2019-10-13,1132,7397,2258,2,10789
748,2019-10-14,699,3996,2151,3,6849
748,2019-10-15,437,7739,1583,2,9761
748,2019-10-16,1121,17852,1257,1,20231
748,2019-10-17,261,7751,1542,2,9556
748,2019-10-18,296,7001,1544,2,8843
748,2019-10-19,298,8223,1969,1,10491
748,2019-10-20,290,1037,2509,3,3839
748,2019-10-21,246,9865,1047,2,11160
748,2019-10-22,283,4599,2170,1,7053
748,2019-10-23,287,6988,1910,1,9186
748,2019-10-24,272,12937,1423,1,14633
748,2019-10-25,325,9693,2298,3,12319
748,2019-10-26,344,13282,1555,0,15181
748,2019-10-27,969,15528,1351,2,17850
748,2019-10-28,245,12777,2020,0,15042
748,2019-10-29,1727,15012,1898,0,18637
748,2019-10-30,1453,15075,2131,3,18662
748,2019-10-31,214,11273,1701,0,13188
748,2019-11-01,660,25302,1671,1,27634
748,2019-11-02,214,16141,1255,0,17610
748,2019-11-03,642,21738,1507,0,23887
748,2019-11-04,263,6682,1848,2,8795
748,2019-11-05,287,1526,1760,0,3573
748,2019-11-06,247,7350,664,2,8263
748,2019-11-07,335,12973,1323,1,14632
748,2019-11-08,318,8744,1421,0,10483
748,2019-11-09,2306,7693,1672,3,11674
748,2019-11-10,236,22214,1031,0,23481
748,2019-11-11,256,14987,1425,0,16668
748,2019-11-12,240,11173,2852,2,14267
748,2019-11-13,1300,17870,1802,0,20972
748,2019-11-14,241,9760,1754,0,11755
748,2019-11-15,232,3913,2600,0,6745
748,2019-11-16,230,2826,2420,0,5476
748,2019-11-17,715,3205,3460,0,7380
748,2019-11-18,248,3546,3730,0,7524
748,2019-11-19,313,3293,3141,0,6747
748,2019-11-20,293,1741,2133,0,4167
748,2019-11-21,1202,3592,1531,0,6325
748,2019-11-22,295,4834,1427,0,6556
748,2019-11-23,235,6284,2071,0,8590
748,2019-11-24,338,5052,2249,2,7641
748,2019-11-25,1033,6723,2230,1,9987
748,2019-11-26,245,6391,1602,0,8238
748,2019-11-27,237,16037,1356,1,17631
748,2019-11-28,249,7751,555,1,8556
748,2019-11-29,160,1213,62,0,1435
748,2019-08-20,579,1161,612,0,2352
748,2019-08-21,402,2383,1178,0,3963
748,2019-08-22,640,3421,760,3,4824
748,2019-08-23,323,2573,1491,2,4389
748,2019-08-24,295,2835,1380,0,4510
748,2019-08-25,342,7330,1711,0,9383
748,2019-08-26,1124,450,812,1,2387
748,2019-08-27,409,9520,1270,2,11201
748,2019-08-28,297,3898,1620,0,5815
748,2019-08-29,283,9766,1377,0,11426
748,2019-08-30,363,2721,694,0,3778
748,2019-08-31,44,14,1,0,59
748,2019-09-01,48,1141,184,0,1373
748,2019-09-02,137,54,34,0,225
748,2019-09-03,1806,385,1816,0,4007
748,2019-09-04,291,13897,2562,1,16751
748,2019-09-05,1117,7428,2376,1,10922
748,2019-09-06,320,11838,2732,0,14890
748,2019-09-07,525,13320,2786,1,16632
748,2019-09-08,1225,5422,2007,1,8655
748,2019-09-09,1304,8386,1407,0,11097
748,2019-09-10,223,12023,1452,0,13698
748,2019-09-11,147,8804,1589,2,10542
748,2019-09-12,1025,13473,2180,1,16679
748,2019-09-13,1248,11062,2287,0,14597
748,2019-09-14,287,10410,1207,1,11905
748,2019-09-15,1001,6419,1908,0,9328
748,2019-09-16,1160,10415,2295,1,13871
748,2019-09-17,1196,9282,1895,3,12376
748,2019-09-18,713,11735,1372,2,13822
748,2019-09-19,438,5026,1673,2,7139
748,2019-09-20,373,13016,1980,1,15370
748,2019-09-21,276,7672,2340,1,10289
748,2019-09-22,1099,13123,1811,0,16033
748,2019-09-23,1187,9785,2404,1,13377
748,2019-09-24,486,10138,1777,4,12405
748,2019-09-25,957,8673,1216,5,10851
748,2019-09-26,168,9045,1638,1,10852
748,2019-09-27,106,8342,1526,2,9976
748,2019-09-28,192,14953,1842,3,16990
748,2019-09-29,536,14508,963,479,16486
748,2019-09-30,729,18793,1682,281,21485
748,2019-10-01,155,15997,1475,0,17627
748,2019-10-02,1135,10733,1628,1,13497
748,2019-10-03,198,13363,2024,2,15587
748,2019-10-04,117,11268,2152,0,13537
748,2019-10-05,654,19426,1195,1,21276
748,2019-10-06,132,17545,2247,1,19925
748,2019-10-07,146,5281,1401,0,6828
748,2019-10-08,140,17446,2442,1,20029
748,2019-10-09,988,23276,1709,2,25975
748,2019-10-10,371,11126,2100,2,13599
748,2019-10-11,433,9937,934,0,11304
748,2019-10-12,248,5456,2413,1,8118
748,2019-10-13,1132,7397,2258,2,10789
748,2019-10-14,699,3996,2151,3,6849
748,2019-10-15,437,7739,1583,2,9761
748,2019-10-16,1121,17852,1257,1,20231
748,2019-10-17,261,7751,1542,2,9556
748,2019-10-18,296,7001,1544,2,8843
748,2019-10-19,298,8223,1969,1,10491
748,2019-10-20,290,1037,2509,3,3839
748,2019-10-21,246,9865,1047,2,11160
748,2019-10-22,283,4599,2170,1,7053
748,2019-10-23,287,6988,1910,1,9186
748,2019-10-24,272,12937,1423,1,14633
748,2019-10-25,325,9693,2298,3,12319
748,2019-10-26,344,13282,1555,0,15181
748,2019-10-27,969,15528,1351,2,17850
748,2019-10-28,245,12777,2020,0,15042
748,2019-10-29,1727,15012,1898,0,18637
748,2019-10-30,1453,15075,2131,3,18662
748,2019-10-31,214,11273,1701,0,13188
748,2019-11-01,660,25302,1671,1,27634
748,2019-11-02,214,16141,1255,0,17610
748,2019-11-03,642,21738,1507,0,23887
748,2019-11-04,263,6682,1848,2,8795
748,2019-11-05,287,1526,1760,0,3573
748,2019-11-06,247,7350,664,2,8263
748,2019-11-07,335,12973,1323,1,14632
748,2019-11-08,318,8744,1421,0,10483
748,2019-11-09,2306,7693,1672,3,11674
748,2019-11-10,236,22214,1031,0,23481
748,2019-11-11,256,14987,1425,0,16668
748,2019-11-12,240,11173,2852,2,14267
748,2019-11-13,1300,17870,1802,0,20972
748,2019-11-14,241,9760,1754,0,11755
748,2019-11-15,232,3913,2600,0,6745
748,2019-11-16,230,2826,2420,0,5476
748,2019-11-17,715,3205,3460,0,7380
748,2019-11-18,248,3546,3730,0,7524
748,2019-11-19,313,3293,3141,0,6747
748,2019-11-20,293,1741,2133,0,4167
748,2019-11-21,1202,3592,1531,0,6325
748,2019-11-22,295,4834,1427,0,6556
748,2019-11-23,235,6284,2071,0,8590
748,2019-11-24,338,5052,2249,2,7641
748,2019-11-25,1033,6723,2230,1,9987
748,2019-11-26,245,6391,1602,0,8238
748,2019-11-27,237,16037,1356,1,17631
748,2019-11-28,249,7751,555,1,8556
748,2019-11-29,160,1213,62,0,1435
748,2019-08-20,579,1161,612,0,2352
748,2019-08-21,402,2383,1178,0,3963
748,2019-08-22,640,3421,760,3,4824
748,2019-08-23,323,2573,1491,2,4389
748,2019-08-24,295,2835,1380,0,4510
748,2019-08-25,342,7330,1711,0,9383
748,2019-08-26,1124,450,812,1,2387
748,2019-08-27,409,9520,1270,2,11201
748,2019-08-28,297,3898,1620,0,5815
748,2019-08-29,283,9766,1377,0,11426
748,2019-08-30,363,2721,694,0,3778
748,2019-08-31,44,14,1,0,59
748,2019-09-01,48,1141,184,0,1373
748,2019-09-02,137,54,34,0,225
748,2019-09-03,1806,385,1816,0,4007
748,2019-09-04,291,13897,2562,1,16751
748,2019-09-05,1117,7428,2376,1,10922
748,2019-09-06,320,11838,2732,0,14890
748,2019-09-07,525,13320,2786,1,16632
748,2019-09-08,1225,5422,2007,1,8655
748,2019-09-09,1304,8386,1407,0,11097
748,2019-09-10,223,12023,1452,0,13698
748,2019-09-11,147,8804,1589,2,10542
748,2019-09-12,1025,13473,2180,1,16679
748,2019-09-13,1248,11062,2287,0,14597
748,2019-09-14,287,10410,1207,1,11905
748,2019-09-15,1001,6419,1908,0,9328
748,2019-09-16,1160,10415,2295,1,13871
748,2019-09-17,1196,9282,1895,3,12376
748,2019-09-18,713,11735,1372,2,13822
748,2019-09-19,438,5026,1673,2,7139
748,2019-09-20,373,13016,1980,1,15370
748,2019-09-21,276,7672,2340,1,10289
748,2019-09-22,1099,13123,1811,0,16033
748,2019-09-23,1187,9785,2404,1,13377
748,2019-09-24,486,10138,1777,4,12405
748,2019-09-25,957,8673,1216,5,10851
748,2019-09-26,168,9045,1638,1,10852
748,2019-09-27,106,8342,1526,2,9976
748,2019-09-28,192,14953,1842,3,16990
748,2019-09-29,536,14508,963,479,16486
748,2019-09-30,729,18793,1682,281,21485
748,2019-10-01,155,15997,1475,0,17627
748,2019-10-02,1135,10733,1628,1,13497
748,2019-10-03,198,13363,2024,2,15587
748,2019-10-04,117,11268,2152,0,13537
748,2019-10-05,654,19426,1195,1,21276
748,2019-10-06,132,17545,2247,1,19925
748,2019-10-07,146,5281,1401,0,6828
748,2019-10-08,140,17446,2442,1,20029
748,2019-10-09,988,23276,1709,2,25975
748,2019-10-10,371,11126,2100,2,13599
748,2019-10-11,433,9937,934,0,11304
748,2019-10-12,248,5456,2413,1,8118
748,2019-10-13,1132,7397,2258,2,10789
748,2019-10-14,699,3996,2151,3,6849
748,2019-10-15,437,7739,1583,2,9761
748,2019-10-16,1121,17852,1257,1,20231
748,2019-10-17,261,7751,1542,2,9556
748,2019-10-18,296,7001,1544,2,8843
748,2019-10-19,298,8223,1969,1,10491
748,2019-10-20,290,1037,2509,3,3839
748,2019-10-21,246,9865,1047,2,11160
748,2019-10-22,283,4599,2170,1,7053
748,2019-10-23,287,6988,1910,1,9186
748,2019-10-24,272,12937,1423,1,14633
748,2019-10-25,325,9693,2298,3,12319
748,2019-10-26,344,13282,1555,0,15181
748,2019-10-27,969,15528,1351,2,17850
748,2019-10-28,245,12777,2020,0,15042
748,2019-10-29,1727,15012,1898,0,18637
748,2019-10-30,1453,15075,2131,3,18662
748,2019-10-31,214,11273,1701,0,13188
748,2019-11-01,660,25302,1671,1,27634
748,2019-11-02,214,16141,1255,0,17610
748,2019-11-03,642,21738,1507,0,23887
748,2019-11-04,263,6682,1848,2,8795
748,2019-11-05,287,1526,1760,0,3573
748,2019-11-06,247,7350,664,2,8263
748,2019-11-07,335,12973,1323,1,14632
748,2019-11-08,318,8744,1421,0,10483
748,2019-11-09,2306,7693,1672,3,11674
748,2019-11-10,236,22214,1031,0,23481
748,2019-11-11,256,14987,1425,0,16668
748,2019-11-12,240,11173,2852,2,14267
748,2019-11-13,1300,17870,1802,0,20972
748,2019-11-14,241,9760,1754,0,11755
748,2019-11-15,232,3913,2600,0,6745
748,2019-11-16,230,2826,2420,0,5476
748,2019-11-17,715,3205,3460,0,7380
748,2019-11-18,248,3546,3730,0,7524
748,2019-11-19,313,3293,3141,0,6747
748,2019-11-20,293,1741,2133,0,4167
748,2019-11-21,1202,3592,1531,0,6325
748,2019-11-22,295,4834,1427,0,6556
748,2019-11-23,235,6284,2071,0,8590
748,2019-11-24,338,5052,2249,2,7641
748,2019-11-25,1033,6723,2230,1,9987
748,2019-11-26,245,6391,1602,0,8238
748,2019-11-27,237,16037,1356,1,17631
748,2019-11-28,249,7751,555,1,8556
748,2019-11-29,160,1213,62,0,1435
748,2019-08-22,640,3421,760,3,4824
748,2019-08-23,323,2573,1491,2,4389
748,2019-08-24,295,2835,1380,0,4510
748,2019-08-25,342,7330,1711,0,9383
748,2019-08-26,1124,450,812,1,2387
748,2019-08-27,409,9520,1270,2,11201
748,2019-08-28,297,3898,1620,0,5815
748,2019-08-29,283,9766,1377,0,11426
748,2019-08-30,363,2721,694,0,3778
748,2019-08-31,44,14,1,0,59
748,2019-09-01,48,1141,184,0,1373
748,2019-09-02,137,54,34,0,225
748,2019-09-03,1806,385,1816,0,4007
748,2019-09-04,291,13897,2562,1,16751
748,2019-09-05,1117,7428,2376,1,10922
748,2019-09-06,320,11838,2732,0,14890
748,2019-09-07,525,13320,2786,1,16632
748,2019-09-08,1225,5422,2007,1,8655
748,2019-09-09,1304,8386,1407,0,11097
748,2019-09-10,223,12023,1452,0,13698
748,2019-09-11,147,8804,1589,2,10542
748,2019-09-12,1025,13473,2180,1,16679
748,2019-09-13,1248,11062,2287,0,14597
748,2019-09-14,287,10410,1207,1,11905
748,2019-09-15,1001,6419,1908,0,9328
748,2019-09-16,1160,10415,2295,1,13871
748,2019-09-17,1196,9282,1895,3,12376
748,2019-09-18,713,11735,1372,2,13822
748,2019-09-19,438,5026,1673,2,7139
748,2019-09-20,373,13016,1980,1,15370
748,2019-09-21,276,7672,2340,1,10289
748,2019-09-22,1099,13123,1811,0,16033
748,2019-09-23,1187,9785,2404,1,13377
748,2019-09-24,486,10138,1777,4,12405
748,2019-09-25,957,8673,1216,5,10851
748,2019-09-26,168,9045,1638,1,10852
748,2019-09-27,106,8342,1526,2,9976
748,2019-09-28,192,14953,1842,3,16990
748,2019-09-29,536,14508,963,479,16486
748,2019-09-30,729,18793,1682,281,21485
748,2019-10-01,155,15997,1475,0,17627
748,2019-10-02,1135,10733,1628,1,13497
748,2019-10-03,198,13363,2024,2,15587
748,2019-10-04,117,11268,2152,0,13537
748,2019-10-05,654,19426,1195,1,21276
748,2019-10-06,132,17545,2247,1,19925
748,2019-10-07,146,5281,1401,0,6828
748,2019-10-08,140,17446,2442,1,20029
748,2019-10-09,988,23276,1709,2,25975
748,2019-10-10,371,11126,2100,2,13599
748,2019-10-11,433,9937,934,0,11304
748,2019-10-12,248,5456,2413,1,8118
748,2019-10-13,1132,7397,2258,2,10789
748,2019-10-14,699,3996,2151,3,6849
748,2019-10-15,437,7739,1583,2,9761
748,2019-10-16,1121,17852,1257,1,20231
748,2019-10-17,261,7751,1542,2,9556
748,2019-10-18,296,7001,1544,2,8843
748,2019-10-19,298,8223,1969,1,10491
748,2019-10-20,290,1037,2509,3,3839
748,2019-10-21,246,9865,1047,2,11160
748,2019-10-22,283,4599,2170,1,7053
748,2019-10-23,287,6988,1910,1,9186
748,2019-10-24,272,12937,1423,1,14633
748,2019-10-25,325,9693,2298,3,12319
748,2019-10-26,344,13282,1555,0,15181
748,2019-10-27,969,15528,1351,2,17850
748,2019-10-28,245,12777,2020,0,15042
748,2019-10-29,1727,15012,1898,0,18637
748,2019-10-30,1453,15075,2131,3,18662
748,2019-10-31,214,11273,1701,0,13188
748,2019-11-01,660,25302,1671,1,27634
748,2019-11-02,214,16141,1255,0,17610
748,2019-11-03,642,21738,1507,0,23887
748,2019-11-04,263,6682,1848,2,8795
748,2019-11-05,287,1526,1760,0,3573
748,2019-11-06,247,7350,664,2,8263
748,2019-11-07,335,12973,1323,1,14632
748,2019-11-08,318,8744,1421,0,10483
748,2019-11-09,2306,7693,1672,3,11674
748,2019-11-10,236,22214,1031,0,23481
748,2019-11-11,256,14987,1425,0,16668
748,2019-11-12,240,11173,2852,2,14267
748,2019-11-13,1300,17870,1802,0,20972
748,2019-11-14,241,9760,1754,0,11755
748,2019-11-15,232,3913,2600,0,6745
748,2019-11-16,230,2826,2420,0,5476
748,2019-11-17,715,3205,3460,0,7380
748,2019-11-18,248,3546,3730,0,7524
748,2019-11-19,313,3293,3141,0,6747
748,2019-11-20,293,1741,2133,0,4167
748,2019-11-21,1202,3592,1531,0,6325
748,2019-11-22,295,4834,1427,0,6556
748,2019-11-23,235,6284,2071,0,8590
748,2019-11-24,338,5052,2249,2,7641
748,2019-11-25,1033,6723,2230,1,9987
748,2019-11-26,245,6391,1602,0,8238
748,2019-11-27,237,16037,1356,1,17631
748,2019-11-28,249,7751,555,1,8556
750,2019-08-20,12,12,933,1,958
750,2019-08-21,183,4,1117,0,1304
750,2019-08-22,0,13,772,0,785
750,2019-08-23,0,60,1446,2,1508
750,2019-08-24,0,25,1123,0,1148
750,2019-08-25,35,8,2117,1,2161
750,2019-08-26,44,23,1529,0,1596
750,2019-08-27,12,28,39,0,79
750,2019-08-28,196,10388,2340,0,12924
750,2019-08-29,340,11999,1440,2,13781
750,2019-08-30,132,3434,552,1,4119
750,2019-08-31,53,91,0,1,145
750,2019-09-01,41,436,363,1,841
750,2019-09-02,43,207,6,1,257
750,2019-09-03,101,4158,1466,0,5725
750,2019-09-04,130,13923,3007,2,17062
750,2019-09-05,148,5590,2191,1,7930
750,2019-09-06,94,14354,1476,1,15925
750,2019-09-07,1040,12345,2878,2,16265
750,2019-09-08,235,8653,2155,1,11044
750,2019-09-09,1063,9600,1843,1,12507
750,2019-09-10,103,7511,2299,3,9916
750,2019-09-11,161,5966,2690,2,8819
750,2019-09-12,74,8616,1748,1,10439
750,2019-09-13,153,9126,2515,1,11795
750,2019-09-14,77,8136,1957,0,10170
750,2019-09-15,71,14752,1745,1,16569
750,2019-09-16,180,10513,2253,1,12947
750,2019-09-17,92,8251,1976,0,10319
750,2019-09-18,303,12135,1480,2,13920
750,2019-09-19,1086,2662,2342,1,6091
750,2019-09-20,486,8285,1867,1,10639
750,2019-09-21,1767,9187,1875,1,12830
750,2019-09-22,99,9279,2000,0,11378
750,2019-09-23,1098,11403,1721,2,14224
750,2019-09-24,137,7752,2640,3,10532
750,2019-09-25,108,6305,2276,2,8691
750,2019-09-26,1056,8609,1725,2,11392
750,2019-09-27,161,7964,1256,4,9385
750,2019-09-28,207,14451,1840,4,16502
750,2019-09-29,99,16032,1190,1,17322
750,2019-09-30,962,25725,1407,1,28095
750,2019-10-01,910,21651,2092,0,24653
750,2019-10-02,1916,11783,1713,0,15412
750,2019-10-03,868,13291,1186,260,15605
750,2019-10-04,106,11127,705,3,11941
750,2019-10-05,101,14094,1714,1,15910
750,2019-10-06,161,10355,2243,1,12760
750,2019-10-07,464,5253,1724,2,7443
750,2019-10-08,112,9110,2025,4,11251
750,2019-10-09,1001,15517,2161,0,18679
750,2019-10-10,163,10389,1757,1,12310
750,2019-10-11,981,9383,972,2,11338
750,2019-10-12,1831,5436,2229,1,9497
750,2019-10-13,105,5605,2103,3,7816
750,2019-10-14,1527,6912,1252,2,9693
750,2019-10-15,628,7575,1239,2,9444
750,2019-10-16,95,17455,1692,2,19244
750,2019-10-17,618,7628,1849,0,10095
750,2019-10-18,137,7719,1696,2,9554
750,2019-10-19,111,4501,2265,1,6878
750,2019-10-20,91,4456,2388,0,6935
750,2019-10-21,204,9486,1684,2,11376
750,2019-10-22,127,4842,1196,2,6167
750,2019-10-23,76,12620,2504,3,15203
750,2019-10-24,1210,18772,1030,0,21012
750,2019-10-25,338,14341,976,1,15656
750,2019-10-26,147,16182,2066,0,18395
750,2019-10-27,1186,15790,1478,0,18454
750,2019-10-28,79,13205,1355,0,14639
750,2019-10-29,562,26041,1527,0,28130
750,2019-10-30,1003,19415,1629,1,22048
750,2019-10-31,95,11832,1392,0,13319
750,2019-11-01,374,24768,1018,1,26161
750,2019-11-02,76,16217,1815,2,18110
750,2019-11-03,106,22107,1637,0,23850
750,2019-11-04,142,9328,1483,2,10955
750,2019-11-05,1060,1419,1875,1,4355
750,2019-11-06,664,7347,1926,0,9937
750,2019-11-07,270,13385,1683,3,15341
750,2019-11-08,489,14377,1254,2,16122
750,2019-11-09,196,14965,1693,0,16854
750,2019-11-10,81,22682,1016,1,23780
750,2019-11-11,565,15226,1439,2,17232
750,2019-11-12,127,16444,3048,2,19621
750,2019-11-13,99,22372,2333,1,24805
750,2019-11-14,85,14822,1779,0,16686
750,2019-11-15,1024,4800,1935,1,7760
750,2019-11-16,191,3185,2662,1,6039
750,2019-11-17,301,3031,3157,2,6491
750,2019-11-18,130,3295,2906,0,6331
750,2019-11-19,144,5252,2552,3,7951
750,2019-11-20,114,1599,1988,0,3701
750,2019-11-21,1106,3589,1675,1,6371
750,2019-11-22,95,8268,1450,3,9816
750,2019-11-23,159,7140,1695,2,8996
750,2019-11-24,772,5131,1787,5,7695
750,2019-11-25,104,7081,1896,0,9081
750,2019-11-26,1132,6496,1679,0,9307
750,2019-11-27,80,6665,1569,0,8314
750,2019-11-28,718,7357,764,0,8839
750,2019-11-29,24,346,2,0,372
750,2019-08-20,12,12,933,1,958
750,2019-08-21,183,4,1117,0,1304
750,2019-08-22,0,13,772,0,785
750,2019-08-23,0,60,1446,2,1508
750,2019-08-24,0,25,1123,0,1148
750,2019-08-25,35,8,2117,1,2161
750,2019-08-26,44,23,1529,0,1596
750,2019-08-27,12,28,39,0,79
750,2019-08-28,196,10388,2340,0,12924
750,2019-08-29,340,11999,1440,2,13781
750,2019-08-30,132,3434,552,1,4119
750,2019-08-31,53,91,0,1,145
750,2019-09-01,41,436,363,1,841
750,2019-09-02,43,207,6,1,257
750,2019-09-03,101,4158,1466,0,5725
750,2019-09-04,130,13923,3007,2,17062
750,2019-09-05,148,5590,2191,1,7930
750,2019-09-06,94,14354,1476,1,15925
750,2019-09-07,1040,12345,2878,2,16265
750,2019-09-08,235,8653,2155,1,11044
750,2019-09-09,1063,9600,1843,1,12507
750,2019-09-10,103,7511,2299,3,9916
750,2019-09-11,161,5966,2690,2,8819
750,2019-09-12,74,8616,1748,1,10439
750,2019-09-13,153,9126,2515,1,11795
750,2019-09-14,77,8136,1957,0,10170
750,2019-09-15,71,14752,1745,1,16569
750,2019-09-16,180,10513,2253,1,12947
750,2019-09-17,92,8251,1976,0,10319
750,2019-09-18,303,12135,1480,2,13920
750,2019-09-19,1086,2662,2342,1,6091
750,2019-09-20,486,8285,1867,1,10639
750,2019-09-21,1767,9187,1875,1,12830
750,2019-09-22,99,9279,2000,0,11378
750,2019-09-23,1098,11403,1721,2,14224
750,2019-09-24,137,7752,2640,3,10532
750,2019-09-25,108,6305,2276,2,8691
750,2019-09-26,1056,8609,1725,2,11392
750,2019-09-27,161,7964,1256,4,9385
750,2019-09-28,207,14451,1840,4,16502
750,2019-09-29,99,16032,1190,1,17322
750,2019-09-30,962,25725,1407,1,28095
750,2019-10-01,910,21651,2092,0,24653
750,2019-10-02,1916,11783,1713,0,15412
750,2019-10-03,868,13291,1186,260,15605
750,2019-10-04,106,11127,705,3,11941
750,2019-10-05,101,14094,1714,1,15910
750,2019-10-06,161,10355,2243,1,12760
750,2019-10-07,464,5253,1724,2,7443
750,2019-10-08,112,9110,2025,4,11251
750,2019-10-09,1001,15517,2161,0,18679
750,2019-10-10,163,10389,1757,1,12310
750,2019-10-11,981,9383,972,2,11338
750,2019-10-12,1831,5436,2229,1,9497
750,2019-10-13,105,5605,2103,3,7816
750,2019-10-14,1527,6912,1252,2,9693
750,2019-10-15,628,7575,1239,2,9444
750,2019-10-16,95,17455,1692,2,19244
750,2019-10-17,618,7628,1849,0,10095
750,2019-10-18,137,7719,1696,2,9554
750,2019-10-19,111,4501,2265,1,6878
750,2019-10-20,91,4456,2388,0,6935
750,2019-10-21,204,9486,1684,2,11376
750,2019-10-22,127,4842,1196,2,6167
750,2019-10-23,76,12620,2504,3,15203
750,2019-10-24,1210,18772,1030,0,21012
750,2019-10-25,338,14341,976,1,15656
750,2019-10-26,147,16182,2066,0,18395
750,2019-10-27,1186,15790,1478,0,18454
750,2019-10-28,79,13205,1355,0,14639
750,2019-10-29,562,26041,1527,0,28130
750,2019-10-30,1003,19415,1629,1,22048
750,2019-10-31,95,11832,1392,0,13319
750,2019-11-01,374,24768,1018,1,26161
750,2019-11-02,76,16217,1815,2,18110
750,2019-11-03,106,22107,1637,0,23850
750,2019-11-04,142,9328,1483,2,10955
750,2019-11-05,1060,1419,1875,1,4355
750,2019-11-06,664,7347,1926,0,9937
750,2019-11-07,270,13385,1683,3,15341
750,2019-11-08,489,14377,1254,2,16122
750,2019-11-09,196,14965,1693,0,16854
750,2019-11-10,81,22682,1016,1,23780
750,2019-11-11,565,15226,1439,2,17232
750,2019-11-12,127,16444,3048,2,19621
750,2019-11-13,99,22372,2333,1,24805
750,2019-11-14,85,14822,1779,0,16686
750,2019-11-15,1024,4800,1935,1,7760
750,2019-11-16,191,3185,2662,1,6039
750,2019-11-17,301,3031,3157,2,6491
750,2019-11-18,130,3295,2906,0,6331
750,2019-11-19,144,5252,2552,3,7951
750,2019-11-20,114,1599,1988,0,3701
750,2019-11-21,1106,3589,1675,1,6371
750,2019-11-22,95,8268,1450,3,9816
750,2019-11-23,159,7140,1695,2,8996
750,2019-11-24,772,5131,1787,5,7695
750,2019-11-25,104,7081,1896,0,9081
750,2019-11-26,1132,6496,1679,0,9307
750,2019-11-27,80,6665,1569,0,8314
750,2019-11-28,718,7357,764,0,8839
750,2019-11-29,24,346,2,0,372
750,2019-08-20,12,12,933,1,958
750,2019-08-21,183,4,1117,0,1304
750,2019-08-22,0,13,772,0,785
750,2019-08-23,0,60,1446,2,1508
750,2019-08-24,0,25,1123,0,1148
750,2019-08-25,35,8,2117,1,2161
750,2019-08-26,44,23,1529,0,1596
750,2019-08-27,12,28,39,0,79
750,2019-08-28,196,10388,2340,0,12924
750,2019-08-29,340,11999,1440,2,13781
750,2019-08-30,132,3434,552,1,4119
750,2019-08-31,53,91,0,1,145
750,2019-09-01,41,436,363,1,841
750,2019-09-02,43,207,6,1,257
750,2019-09-03,101,4158,1466,0,5725
750,2019-09-04,130,13923,3007,2,17062
750,2019-09-05,148,5590,2191,1,7930
750,2019-09-06,94,14354,1476,1,15925
750,2019-09-07,1040,12345,2878,2,16265
750,2019-09-08,235,8653,2155,1,11044
750,2019-09-09,1063,9600,1843,1,12507
750,2019-09-10,103,7511,2299,3,9916
750,2019-09-11,161,5966,2690,2,8819
750,2019-09-12,74,8616,1748,1,10439
750,2019-09-13,153,9126,2515,1,11795
750,2019-09-14,77,8136,1957,0,10170
750,2019-09-15,71,14752,1745,1,16569
750,2019-09-16,180,10513,2253,1,12947
750,2019-09-17,92,8251,1976,0,10319
750,2019-09-18,303,12135,1480,2,13920
750,2019-09-19,1086,2662,2342,1,6091
750,2019-09-20,486,8285,1867,1,10639
750,2019-09-21,1767,9187,1875,1,12830
750,2019-09-22,99,9279,2000,0,11378
750,2019-09-23,1098,11403,1721,2,14224
750,2019-09-24,137,7752,2640,3,10532
750,2019-09-25,108,6305,2276,2,8691
750,2019-09-26,1056,8609,1725,2,11392
750,2019-09-27,161,7964,1256,4,9385
750,2019-09-28,207,14451,1840,4,16502
750,2019-09-29,99,16032,1190,1,17322
750,2019-09-30,962,25725,1407,1,28095
750,2019-10-01,910,21651,2092,0,24653
750,2019-10-02,1916,11783,1713,0,15412
750,2019-10-03,868,13291,1186,260,15605
750,2019-10-04,106,11127,705,3,11941
750,2019-10-05,101,14094,1714,1,15910
750,2019-10-06,161,10355,2243,1,12760
750,2019-10-07,464,5253,1724,2,7443
750,2019-10-08,112,9110,2025,4,11251
750,2019-10-09,1001,15517,2161,0,18679
750,2019-10-10,163,10389,1757,1,12310
750,2019-10-11,981,9383,972,2,11338
750,2019-10-12,1831,5436,2229,1,9497
750,2019-10-13,105,5605,2103,3,7816
750,2019-10-14,1527,6912,1252,2,9693
750,2019-10-15,628,7575,1239,2,9444
750,2019-10-16,95,17455,1692,2,19244
750,2019-10-17,618,7628,1849,0,10095
750,2019-10-18,137,7719,1696,2,9554
750,2019-10-19,111,4501,2265,1,6878
750,2019-10-20,91,4456,2388,0,6935
750,2019-10-21,204,9486,1684,2,11376
750,2019-10-22,127,4842,1196,2,6167
750,2019-10-23,76,12620,2504,3,15203
750,2019-10-24,1210,18772,1030,0,21012
750,2019-10-25,338,14341,976,1,15656
750,2019-10-26,147,16182,2066,0,18395
750,2019-10-27,1186,15790,1478,0,18454
750,2019-10-28,79,13205,1355,0,14639
750,2019-10-29,562,26041,1527,0,28130
750,2019-10-30,1003,19415,1629,1,22048
750,2019-10-31,95,11832,1392,0,13319
750,2019-11-01,374,24768,1018,1,26161
750,2019-11-02,76,16217,1815,2,18110
750,2019-11-03,106,22107,1637,0,23850
750,2019-11-04,142,9328,1483,2,10955
750,2019-11-05,1060,1419,1875,1,4355
750,2019-11-06,664,7347,1926,0,9937
750,2019-11-07,270,13385,1683,3,15341
750,2019-11-08,489,14377,1254,2,16122
750,2019-11-09,196,14965,1693,0,16854
750,2019-11-10,81,22682,1016,1,23780
750,2019-11-11,565,15226,1439,2,17232
750,2019-11-12,127,16444,3048,2,19621
750,2019-11-13,99,22372,2333,1,24805
750,2019-11-14,85,14822,1779,0,16686
750,2019-11-15,1024,4800,1935,1,7760
750,2019-11-16,191,3185,2662,1,6039
750,2019-11-17,301,3031,3157,2,6491
750,2019-11-18,130,3295,2906,0,6331
750,2019-11-19,144,5252,2552,3,7951
750,2019-11-20,114,1599,1988,0,3701
750,2019-11-21,1106,3589,1675,1,6371
750,2019-11-22,95,8268,1450,3,9816
750,2019-11-23,159,7140,1695,2,8996
750,2019-11-24,772,5131,1787,5,7695
750,2019-11-25,104,7081,1896,0,9081
750,2019-11-26,1132,6496,1679,0,9307
750,2019-11-27,80,6665,1569,0,8314
750,2019-11-28,718,7357,764,0,8839
750,2019-11-29,24,346,2,0,372
750,2019-08-20,12,12,933,1,958
750,2019-08-21,183,4,1117,0,1304
750,2019-08-22,0,13,772,0,785
750,2019-08-23,0,60,1446,2,1508
750,2019-08-24,0,25,1123,0,1148
750,2019-08-25,35,8,2117,1,2161
750,2019-08-26,44,23,1529,0,1596
750,2019-08-27,12,28,39,0,79
750,2019-08-28,196,10388,2340,0,12924
750,2019-08-29,340,11999,1440,2,13781
750,2019-08-30,132,3434,552,1,4119
750,2019-08-31,53,91,0,1,145
750,2019-09-01,41,436,363,1,841
750,2019-09-02,43,207,6,1,257
750,2019-09-03,101,4158,1466,0,5725
750,2019-09-04,130,13923,3007,2,17062
750,2019-09-05,148,5590,2191,1,7930
750,2019-09-06,94,14354,1476,1,15925
750,2019-09-07,1040,12345,2878,2,16265
750,2019-09-08,235,8653,2155,1,11044
750,2019-09-09,1063,9600,1843,1,12507
750,2019-09-10,103,7511,2299,3,9916
750,2019-09-11,161,5966,2690,2,8819
750,2019-09-12,74,8616,1748,1,10439
750,2019-09-13,153,9126,2515,1,11795
750,2019-09-14,77,8136,1957,0,10170
750,2019-09-15,71,14752,1745,1,16569
750,2019-09-16,180,10513,2253,1,12947
750,2019-09-17,92,8251,1976,0,10319
750,2019-09-18,303,12135,1480,2,13920
750,2019-09-19,1086,2662,2342,1,6091
750,2019-09-20,486,8285,1867,1,10639
750,2019-09-21,1767,9187,1875,1,12830
750,2019-09-22,99,9279,2000,0,11378
750,2019-09-23,1098,11403,1721,2,14224
750,2019-09-24,137,7752,2640,3,10532
750,2019-09-25,108,6305,2276,2,8691
750,2019-09-26,1056,8609,1725,2,11392
750,2019-09-27,161,7964,1256,4,9385
750,2019-09-28,207,14451,1840,4,16502
750,2019-09-29,99,16032,1190,1,17322
750,2019-09-30,962,25725,1407,1,28095
750,2019-10-01,910,21651,2092,0,24653
750,2019-10-02,1916,11783,1713,0,15412
750,2019-10-03,868,13291,1186,260,15605
750,2019-10-04,106,11127,705,3,11941
750,2019-10-05,101,14094,1714,1,15910
750,2019-10-06,161,10355,2243,1,12760
750,2019-10-07,464,5253,1724,2,7443
750,2019-10-08,112,9110,2025,4,11251
750,2019-10-09,1001,15517,2161,0,18679
750,2019-10-10,163,10389,1757,1,12310
750,2019-10-11,981,9383,972,2,11338
750,2019-10-12,1831,5436,2229,1,9497
750,2019-10-13,105,5605,2103,3,7816
750,2019-10-14,1527,6912,1252,2,9693
750,2019-10-15,628,7575,1239,2,9444
750,2019-10-16,95,17455,1692,2,19244
750,2019-10-17,618,7628,1849,0,10095
750,2019-10-18,137,7719,1696,2,9554
750,2019-10-19,111,4501,2265,1,6878
750,2019-10-20,91,4456,2388,0,6935
750,2019-10-21,204,9486,1684,2,11376
750,2019-10-22,127,4842,1196,2,6167
750,2019-10-23,76,12620,2504,3,15203
750,2019-10-24,1210,18772,1030,0,21012
750,2019-10-25,338,14341,976,1,15656
750,2019-10-26,147,16182,2066,0,18395
750,2019-10-27,1186,15790,1478,0,18454
750,2019-10-28,79,13205,1355,0,14639
750,2019-10-29,562,26041,1527,0,28130
750,2019-10-30,1003,19415,1629,1,22048
750,2019-10-31,95,11832,1392,0,13319
750,2019-11-01,374,24768,1018,1,26161
750,2019-11-02,76,16217,1815,2,18110
750,2019-11-03,106,22107,1637,0,23850
750,2019-11-04,142,9328,1483,2,10955
750,2019-11-05,1060,1419,1875,1,4355
750,2019-11-06,664,7347,1926,0,9937
750,2019-11-07,270,13385,1683,3,15341
750,2019-11-08,489,14377,1254,2,16122
750,2019-11-09,196,14965,1693,0,16854
750,2019-11-10,81,22682,1016,1,23780
750,2019-11-11,565,15226,1439,2,17232
750,2019-11-12,127,16444,3048,2,19621
750,2019-11-13,99,22372,2333,1,24805
750,2019-11-14,85,14822,1779,0,16686
750,2019-11-15,1024,4800,1935,1,7760
750,2019-11-16,191,3185,2662,1,6039
750,2019-11-17,301,3031,3157,2,6491
750,2019-11-18,130,3295,2906,0,6331
750,2019-11-19,144,5252,2552,3,7951
750,2019-11-20,114,1599,1988,0,3701
750,2019-11-21,1106,3589,1675,1,6371
750,2019-11-22,95,8268,1450,3,9816
750,2019-11-23,159,7140,1695,2,8996
750,2019-11-24,772,5131,1787,5,7695
751,2019-08-21,112,897,1299,2,2310
751,2019-08-22,237,4123,1522,2,5884
751,2019-08-23,289,13297,1510,1,15097
751,2019-08-24,219,4225,1440,0,5884
751,2019-08-25,265,16388,1260,1,17914
751,2019-08-26,250,45940,1835,0,48025
751,2019-08-27,941,10389,1980,2,13312
751,2019-08-28,181,2623,2070,1,4875
751,2019-08-29,190,10019,2527,1,12737
751,2019-08-30,180,2608,696,1,3485
751,2019-08-31,60,48,1,1,110
751,2019-09-01,99,341,345,0,785
751,2019-09-02,70,124,9,1,204
751,2019-09-03,112,1143,1246,0,2501
751,2019-09-04,229,14362,1755,1,16347
751,2019-09-05,166,7895,1830,0,9891
751,2019-09-06,161,10195,2484,0,12840
751,2019-09-07,247,15863,2304,0,18414
751,2019-09-08,258,6038,2114,2,8412
751,2019-09-09,220,8934,1622,0,10776
751,2019-09-10,194,11725,2228,0,14147
751,2019-09-11,190,10021,2491,2,12704
751,2019-09-12,1000,9042,2627,1,12670
751,2019-09-13,114,3401,1458,2,4975
751,2019-09-14,1064,6454,1913,0,9431
751,2019-09-15,1030,9598,1586,2,12216
751,2019-09-16,227,11718,2383,0,14328
751,2019-09-17,1017,9143,1739,2,11901
751,2019-09-18,129,11042,1260,1,12432
751,2019-09-19,1130,5833,1350,0,8313
751,2019-09-20,233,8080,1967,1,10281
751,2019-09-21,145,6638,2092,0,8875
751,2019-09-22,1843,10990,2600,2,15435
751,2019-09-23,272,9462,1706,1,11441
751,2019-09-24,246,8943,2141,3,11333
751,2019-09-25,249,10849,2179,1,13278
751,2019-09-26,529,10429,2018,2,12978
751,2019-09-27,176,8753,1351,3,10283
751,2019-09-28,207,16324,1398,764,18693
751,2019-09-29,126,17079,1733,1,18939
751,2019-09-30,122,17891,2079,0,20092
751,2019-10-01,129,16825,1660,0,18614
751,2019-10-02,253,11845,1765,2,13865
751,2019-10-03,984,14417,1905,0,17306
751,2019-10-04,624,12566,1647,0,14837
751,2019-10-05,433,15114,1307,1,16855
751,2019-10-06,854,11837,2096,0,14787
751,2019-10-07,1166,6822,2272,3,10263
751,2019-10-08,1882,12188,1257,1,15328
751,2019-10-09,1778,15175,1498,0,18451
751,2019-10-10,1053,12137,1711,0,14901
751,2019-10-11,241,9170,1113,0,10524
751,2019-10-12,150,7127,1594,2,8873
751,2019-10-13,720,7337,1700,3,9760
751,2019-10-14,1500,6021,2130,2,9653
751,2019-10-15,162,8756,1650,0,10568
751,2019-10-16,148,18172,1528,3,19851
751,2019-10-17,155,8946,1578,2,10681
751,2019-10-18,261,8822,1893,0,10976
751,2019-10-19,249,6043,2506,0,8798
751,2019-10-20,182,3057,1836,0,5075
751,2019-10-21,1602,10864,1086,834,14386
751,2019-10-22,992,6778,1979,5,9754
751,2019-10-23,660,14809,2670,2,18141
751,2019-10-24,136,19552,1225,1,20914
751,2019-10-25,1926,15574,1642,2,19144
751,2019-10-26,1036,17142,1624,0,19802
751,2019-10-27,143,16786,1341,0,18270
751,2019-10-28,589,14332,1866,2,16789
751,2019-10-29,234,27268,1224,0,28726
751,2019-10-30,135,28750,1779,1,30665
751,2019-10-31,1001,19112,1458,48,21619
751,2019-11-01,937,25145,976,2,27060
751,2019-11-02,433,26393,1303,0,28129
751,2019-11-03,195,24794,1252,0,26241
751,2019-11-04,182,8063,2151,0,10396
751,2019-11-05,201,3498,1934,0,5633
751,2019-11-06,1055,15181,1198,2,17436
751,2019-11-07,198,17037,1744,1,18980
751,2019-11-08,156,13073,972,1,14202
751,2019-11-09,670,13665,1995,0,16330
751,2019-11-10,1949,27074,1188,0,30211
751,2019-11-11,654,16829,1963,4,19450
751,2019-11-12,1104,17980,3719,0,22803
751,2019-11-13,154,21321,1967,2,23444
751,2019-11-14,163,10751,2251,0,13165
751,2019-11-15,129,3822,3919,1,7871
751,2019-11-16,122,2877,2527,1,5527
751,2019-11-17,116,4140,3808,1,8065
751,2019-11-18,667,3387,3156,1,7211
751,2019-11-19,953,5125,2677,0,8755
751,2019-11-20,135,1442,2631,0,4208
751,2019-11-21,186,5950,1849,0,7985
751,2019-11-22,157,8233,1464,0,9854
751,2019-11-23,178,7163,2071,0,9412
751,2019-11-24,242,6460,2500,0,9202
751,2019-11-25,980,10687,2031,0,13698
751,2019-11-26,149,9737,1060,0,10946
751,2019-11-27,145,6884,1466,0,8495
751,2019-11-28,458,7041,762,0,8261
751,2019-08-21,112,897,1299,2,2310
751,2019-08-22,237,4123,1522,2,5884
751,2019-08-23,289,13297,1510,1,15097
751,2019-08-24,219,4225,1440,0,5884
751,2019-08-25,265,16388,1260,1,17914
751,2019-08-26,250,45940,1835,0,48025
751,2019-08-27,941,10389,1980,2,13312
751,2019-08-28,181,2623,2070,1,4875
751,2019-08-29,190,10019,2527,1,12737
751,2019-08-30,180,2608,696,1,3485
751,2019-08-31,60,48,1,1,110
751,2019-09-01,99,341,345,0,785
751,2019-09-02,70,124,9,1,204
751,2019-09-03,112,1143,1246,0,2501
751,2019-09-04,229,14362,1755,1,16347
751,2019-09-05,166,7895,1830,0,9891
751,2019-09-06,161,10195,2484,0,12840
751,2019-09-07,247,15863,2304,0,18414
751,2019-09-08,258,6038,2114,2,8412
751,2019-09-09,220,8934,1622,0,10776
751,2019-09-10,194,11725,2228,0,14147
751,2019-09-11,190,10021,2491,2,12704
751,2019-09-12,1000,9042,2627,1,12670
751,2019-09-13,114,3401,1458,2,4975
751,2019-09-14,1064,6454,1913,0,9431
751,2019-09-15,1030,9598,1586,2,12216
751,2019-09-16,227,11718,2383,0,14328
751,2019-09-17,1017,9143,1739,2,11901
751,2019-09-18,129,11042,1260,1,12432
751,2019-09-19,1130,5833,1350,0,8313
751,2019-09-20,233,8080,1967,1,10281
751,2019-09-21,145,6638,2092,0,8875
751,2019-09-22,1843,10990,2600,2,15435
751,2019-09-23,272,9462,1706,1,11441
751,2019-09-24,246,8943,2141,3,11333
751,2019-09-25,249,10849,2179,1,13278
751,2019-09-26,529,10429,2018,2,12978
751,2019-09-27,176,8753,1351,3,10283
751,2019-09-28,207,16324,1398,764,18693
751,2019-09-29,126,17079,1733,1,18939
751,2019-09-30,122,17891,2079,0,20092
751,2019-10-01,129,16825,1660,0,18614
751,2019-10-02,253,11845,1765,2,13865
751,2019-10-03,984,14417,1905,0,17306
751,2019-10-04,624,12566,1647,0,14837
751,2019-10-05,433,15114,1307,1,16855
751,2019-10-06,854,11837,2096,0,14787
751,2019-10-07,1166,6822,2272,3,10263
751,2019-10-08,1882,12188,1257,1,15328
751,2019-10-09,1778,15175,1498,0,18451
751,2019-10-10,1053,12137,1711,0,14901
751,2019-10-11,241,9170,1113,0,10524
751,2019-10-12,150,7127,1594,2,8873
751,2019-10-13,720,7337,1700,3,9760
751,2019-10-14,1500,6021,2130,2,9653
751,2019-10-15,162,8756,1650,0,10568
751,2019-10-16,148,18172,1528,3,19851
751,2019-10-17,155,8946,1578,2,10681
751,2019-10-18,261,8822,1893,0,10976
751,2019-10-19,249,6043,2506,0,8798
751,2019-10-20,182,3057,1836,0,5075
751,2019-10-21,1602,10864,1086,834,14386
751,2019-10-22,992,6778,1979,5,9754
751,2019-10-23,660,14809,2670,2,18141
751,2019-10-24,136,19552,1225,1,20914
751,2019-10-25,1926,15574,1642,2,19144
751,2019-10-26,1036,17142,1624,0,19802
751,2019-10-27,143,16786,1341,0,18270
751,2019-10-28,589,14332,1866,2,16789
751,2019-10-29,234,27268,1224,0,28726
751,2019-10-30,135,28750,1779,1,30665
751,2019-10-31,1001,19112,1458,48,21619
751,2019-11-01,937,25145,976,2,27060
751,2019-11-02,433,26393,1303,0,28129
751,2019-11-03,195,24794,1252,0,26241
751,2019-11-04,182,8063,2151,0,10396
751,2019-11-05,201,3498,1934,0,5633
751,2019-11-06,1055,15181,1198,2,17436
751,2019-11-07,198,17037,1744,1,18980
751,2019-11-08,156,13073,972,1,14202
751,2019-11-09,670,13665,1995,0,16330
751,2019-11-10,1949,27074,1188,0,30211
751,2019-11-11,654,16829,1963,4,19450
751,2019-11-12,1104,17980,3719,0,22803
751,2019-11-13,154,21321,1967,2,23444
751,2019-11-14,163,10751,2251,0,13165
751,2019-11-15,129,3822,3919,1,7871
751,2019-11-16,122,2877,2527,1,5527
751,2019-11-17,116,4140,3808,1,8065
751,2019-11-18,667,3387,3156,1,7211
751,2019-11-19,953,5125,2677,0,8755
751,2019-11-20,135,1442,2631,0,4208
751,2019-11-21,186,5950,1849,0,7985
751,2019-11-22,157,8233,1464,0,9854
751,2019-11-23,178,7163,2071,0,9412
751,2019-11-24,242,6460,2500,0,9202
751,2019-11-25,980,10687,2031,0,13698
751,2019-11-26,149,9737,1060,0,10946
751,2019-11-27,145,6884,1466,0,8495
751,2019-11-28,458,7041,762,0,8261
751,2019-11-29,0,556,0,0,556
751,2019-08-20,0,0,198,0,198
751,2019-08-21,112,897,1299,2,2310
751,2019-08-22,237,4123,1522,2,5884
751,2019-08-23,289,13297,1510,1,15097
751,2019-08-24,219,4225,1440,0,5884
751,2019-08-25,265,16388,1260,1,17914
751,2019-08-26,250,45940,1835,0,48025
751,2019-08-27,941,10389,1980,2,13312
751,2019-08-28,181,2623,2070,1,4875
751,2019-08-29,190,10019,2527,1,12737
751,2019-08-30,180,2608,696,1,3485
751,2019-08-31,60,48,1,1,110
751,2019-09-01,99,341,345,0,785
751,2019-09-02,70,124,9,1,204
751,2019-09-03,112,1143,1246,0,2501
751,2019-09-04,229,14362,1755,1,16347
751,2019-09-05,166,7895,1830,0,9891
751,2019-09-06,161,10195,2484,0,12840
751,2019-09-07,247,15863,2304,0,18414
751,2019-09-08,258,6038,2114,2,8412
751,2019-09-09,220,8934,1622,0,10776
751,2019-09-10,194,11725,2228,0,14147
751,2019-09-11,190,10021,2491,2,12704
751,2019-09-12,1000,9042,2627,1,12670
751,2019-09-13,114,3401,1458,2,4975
751,2019-09-14,1064,6454,1913,0,9431
751,2019-09-15,1030,9598,1586,2,12216
751,2019-09-16,227,11718,2383,0,14328
751,2019-09-17,1017,9143,1739,2,11901
751,2019-09-18,129,11042,1260,1,12432
751,2019-09-19,1130,5833,1350,0,8313
751,2019-09-20,233,8080,1967,1,10281
751,2019-09-21,145,6638,2092,0,8875
751,2019-09-22,1843,10990,2600,2,15435
751,2019-09-23,272,9462,1706,1,11441
751,2019-09-24,246,8943,2141,3,11333
751,2019-09-25,249,10849,2179,1,13278
751,2019-09-26,529,10429,2018,2,12978
751,2019-09-27,176,8753,1351,3,10283
751,2019-09-28,207,16324,1398,764,18693
751,2019-09-29,126,17079,1733,1,18939
751,2019-09-30,122,17891,2079,0,20092
751,2019-10-01,129,16825,1660,0,18614
751,2019-10-02,253,11845,1765,2,13865
751,2019-10-03,984,14417,1905,0,17306
751,2019-10-04,624,12566,1647,0,14837
751,2019-10-05,433,15114,1307,1,16855
751,2019-10-06,854,11837,2096,0,14787
751,2019-10-07,1166,6822,2272,3,10263
751,2019-10-08,1882,12188,1257,1,15328
751,2019-10-09,1778,15175,1498,0,18451
751,2019-10-10,1053,12137,1711,0,14901
751,2019-10-11,241,9170,1113,0,10524
751,2019-10-12,150,7127,1594,2,8873
751,2019-10-13,720,7337,1700,3,9760
751,2019-10-14,1500,6021,2130,2,9653
751,2019-10-15,162,8756,1650,0,10568
751,2019-10-16,148,18172,1528,3,19851
751,2019-10-17,155,8946,1578,2,10681
751,2019-10-18,261,8822,1893,0,10976
751,2019-10-19,249,6043,2506,0,8798
751,2019-10-20,182,3057,1836,0,5075
751,2019-10-21,1602,10864,1086,834,14386
751,2019-10-22,992,6778,1979,5,9754
751,2019-10-23,660,14809,2670,2,18141
751,2019-10-24,136,19552,1225,1,20914
751,2019-10-25,1926,15574,1642,2,19144
751,2019-10-26,1036,17142,1624,0,19802
751,2019-10-27,143,16786,1341,0,18270
751,2019-10-28,589,14332,1866,2,16789
751,2019-10-29,234,27268,1224,0,28726
751,2019-10-30,135,28750,1779,1,30665
751,2019-10-31,1001,19112,1458,48,21619
751,2019-11-01,937,25145,976,2,27060
751,2019-11-02,433,26393,1303,0,28129
751,2019-11-03,195,24794,1252,0,26241
751,2019-11-04,182,8063,2151,0,10396
751,2019-11-05,201,3498,1934,0,5633
751,2019-11-06,1055,15181,1198,2,17436
751,2019-11-07,198,17037,1744,1,18980
751,2019-11-08,156,13073,972,1,14202
751,2019-11-09,670,13665,1995,0,16330
751,2019-11-10,1949,27074,1188,0,30211
751,2019-11-11,654,16829,1963,4,19450
751,2019-11-12,1104,17980,3719,0,22803
751,2019-11-13,154,21321,1967,2,23444
751,2019-11-14,163,10751,2251,0,13165
751,2019-11-15,129,3822,3919,1,7871
751,2019-11-16,122,2877,2527,1,5527
751,2019-11-17,116,4140,3808,1,8065
751,2019-11-18,667,3387,3156,1,7211
751,2019-11-19,953,5125,2677,0,8755
751,2019-11-20,135,1442,2631,0,4208
751,2019-11-21,186,5950,1849,0,7985
751,2019-11-22,157,8233,1464,0,9854
751,2019-11-23,178,7163,2071,0,9412
751,2019-11-24,242,6460,2500,0,9202
751,2019-11-25,980,10687,2031,0,13698
751,2019-11-26,149,9737,1060,0,10946
751,2019-11-27,145,6884,1466,0,8495
751,2019-11-28,458,7041,762,0,8261
751,2019-08-21,112,897,1299,2,2310
751,2019-08-22,237,4123,1522,2,5884
751,2019-08-23,289,13297,1510,1,15097
751,2019-08-24,219,4225,1440,0,5884
751,2019-08-25,265,16388,1260,1,17914
751,2019-08-26,250,45940,1835,0,48025
751,2019-08-27,941,10389,1980,2,13312
751,2019-08-28,181,2623,2070,1,4875
751,2019-08-29,190,10019,2527,1,12737
751,2019-08-30,180,2608,696,1,3485
751,2019-08-31,60,48,1,1,110
751,2019-09-01,99,341,345,0,785
751,2019-09-02,70,124,9,1,204
751,2019-09-03,112,1143,1246,0,2501
751,2019-09-04,229,14362,1755,1,16347
751,2019-09-05,166,7895,1830,0,9891
751,2019-09-06,161,10195,2484,0,12840
751,2019-09-07,247,15863,2304,0,18414
751,2019-09-08,258,6038,2114,2,8412
751,2019-09-09,220,8934,1622,0,10776
751,2019-09-10,194,11725,2228,0,14147
751,2019-09-11,190,10021,2491,2,12704
751,2019-09-12,1000,9042,2627,1,12670
751,2019-09-13,114,3401,1458,2,4975
751,2019-09-14,1064,6454,1913,0,9431
751,2019-09-15,1030,9598,1586,2,12216
751,2019-09-16,227,11718,2383,0,14328
751,2019-09-17,1017,9143,1739,2,11901
751,2019-09-18,129,11042,1260,1,12432
751,2019-09-19,1130,5833,1350,0,8313
751,2019-09-20,233,8080,1967,1,10281
751,2019-09-21,145,6638,2092,0,8875
751,2019-09-22,1843,10990,2600,2,15435
751,2019-09-23,272,9462,1706,1,11441
751,2019-09-24,246,8943,2141,3,11333
751,2019-09-25,249,10849,2179,1,13278
751,2019-09-26,529,10429,2018,2,12978
751,2019-09-27,176,8753,1351,3,10283
751,2019-09-28,207,16324,1398,764,18693
751,2019-09-29,126,17079,1733,1,18939
751,2019-09-30,122,17891,2079,0,20092
751,2019-10-01,129,16825,1660,0,18614
751,2019-10-02,253,11845,1765,2,13865
751,2019-10-03,984,14417,1905,0,17306
751,2019-10-04,624,12566,1647,0,14837
751,2019-10-05,433,15114,1307,1,16855
751,2019-10-06,854,11837,2096,0,14787
751,2019-10-07,1166,6822,2272,3,10263
751,2019-10-08,1882,12188,1257,1,15328
751,2019-10-09,1778,15175,1498,0,18451
751,2019-10-10,1053,12137,1711,0,14901
751,2019-10-11,241,9170,1113,0,10524
751,2019-10-12,150,7127,1594,2,8873
751,2019-10-13,720,7337,1700,3,9760
751,2019-10-14,1500,6021,2130,2,9653
751,2019-10-15,162,8756,1650,0,10568
751,2019-10-16,148,18172,1528,3,19851
751,2019-10-17,155,8946,1578,2,10681
751,2019-10-18,261,8822,1893,0,10976
751,2019-10-19,249,6043,2506,0,8798
751,2019-10-20,182,3057,1836,0,5075
751,2019-10-21,1602,10864,1086,834,14386
751,2019-10-22,992,6778,1979,5,9754
751,2019-10-23,660,14809,2670,2,18141
751,2019-10-24,136,19552,1225,1,20914
751,2019-10-25,1926,15574,1642,2,19144
751,2019-10-26,1036,17142,1624,0,19802
751,2019-10-27,143,16786,1341,0,18270
751,2019-10-28,589,14332,1866,2,16789
751,2019-10-29,234,27268,1224,0,28726
751,2019-10-30,135,28750,1779,1,30665
751,2019-10-31,1001,19112,1458,48,21619
751,2019-11-01,937,25145,976,2,27060
751,2019-11-02,433,26393,1303,0,28129
751,2019-11-03,195,24794,1252,0,26241
751,2019-11-04,182,8063,2151,0,10396
751,2019-11-05,201,3498,1934,0,5633
751,2019-11-06,1055,15181,1198,2,17436
751,2019-11-07,198,17037,1744,1,18980
751,2019-11-08,156,13073,972,1,14202
751,2019-11-09,670,13665,1995,0,16330
751,2019-11-10,1949,27074,1188,0,30211
751,2019-11-11,654,16829,1963,4,19450
751,2019-11-12,1104,17980,3719,0,22803
751,2019-11-13,154,21321,1967,2,23444
751,2019-11-14,163,10751,2251,0,13165
751,2019-11-15,129,3822,3919,1,7871
751,2019-11-16,122,2877,2527,1,5527
751,2019-11-17,116,4140,3808,1,8065
751,2019-11-18,667,3387,3156,1,7211
752,2019-08-21,783,1706,1602,0,4091
752,2019-08-22,972,1435,1597,1,4005
752,2019-08-23,677,1413,1275,1,3366
752,2019-08-24,645,1999,1620,0,4264
752,2019-08-25,560,3121,2430,2,6113
752,2019-08-26,573,791,1890,2,3256
752,2019-08-27,549,6165,2164,2,8880
752,2019-08-28,423,5628,1893,0,7944
752,2019-08-29,609,9546,2051,0,12206
752,2019-08-30,447,4880,661,1,5989
752,2019-08-31,67,109,1,0,177
752,2019-09-01,131,496,276,0,903
752,2019-09-02,58,237,56,0,351
752,2019-09-03,138,809,2024,2,2973
752,2019-09-04,576,13518,2391,1,16486
752,2019-09-05,402,11800,1807,1,14010
752,2019-09-06,1415,13245,1375,0,16035
752,2019-09-07,631,20425,1859,1,22916
752,2019-09-08,638,7160,1760,2,9560
752,2019-09-09,1380,11739,2049,1,15169
752,2019-09-10,511,7710,2168,1,10390
752,2019-09-11,218,6254,1787,2,8261
752,2019-09-12,1977,10830,2165,1,14973
752,2019-09-13,790,4004,2094,1,6889
752,2019-09-14,465,7986,2617,1,11069
752,2019-09-15,444,11737,2369,0,14550
752,2019-09-16,562,14582,2021,1,17166
752,2019-09-17,461,6582,2159,1,9203
752,2019-09-18,592,11619,1728,0,13939
752,2019-09-19,775,4693,1914,0,7382
752,2019-09-20,1445,10526,1615,1,13587
752,2019-09-21,499,9052,2316,3,11870
752,2019-09-22,1774,9378,2693,1,13846
752,2019-09-23,515,7851,2127,0,10493
752,2019-09-24,903,5722,1701,3,8329
752,2019-09-25,284,9465,1122,1,10872
752,2019-09-26,220,7960,1792,3,9975
752,2019-09-27,187,12739,1613,3,14542
752,2019-09-28,279,14747,1846,1,16873
752,2019-09-29,197,15730,1645,0,17572
752,2019-09-30,2268,17214,1806,1,21289
752,2019-10-01,200,16550,1346,1,18097
752,2019-10-02,268,9975,2385,1,12629
752,2019-10-03,1074,13474,1595,1,16144
752,2019-10-04,831,11480,1624,0,13935
752,2019-10-05,652,14810,1208,0,16670
752,2019-10-06,201,10802,1214,4,12221
752,2019-10-07,195,5042,1317,1,6555
752,2019-10-08,2009,10408,2073,1,14491
752,2019-10-09,685,14081,1443,1,16210
752,2019-10-10,428,11010,1945,2,13385
752,2019-10-11,1752,8614,1874,5,12245
752,2019-10-12,404,5605,1817,0,7826
752,2019-10-13,1243,6702,2446,1,10392
752,2019-10-14,3053,3497,1780,0,8330
752,2019-10-15,1088,7804,1392,0,10284
752,2019-10-16,433,17581,1461,3,19478
752,2019-10-17,441,7232,1633,0,9306
752,2019-10-18,500,7300,1399,0,9199
752,2019-10-19,1407,3626,1242,0,6275
752,2019-10-20,864,746,1464,0,3074
752,2019-10-21,540,10219,1512,3,12274
752,2019-10-22,544,4739,2177,0,7460
752,2019-10-23,419,13400,1456,0,15275
752,2019-10-24,539,21788,1606,0,23933
752,2019-10-25,943,14492,1898,2,17335
752,2019-10-26,414,16777,1673,0,18864
752,2019-10-27,497,16349,1365,2,18213
752,2019-10-28,441,13569,1328,0,15338
752,2019-10-29,1163,26101,1856,0,29120
752,2019-10-30,467,21246,1549,1,23263
752,2019-10-31,916,11261,1298,3,13478
752,2019-11-01,398,24561,1530,0,26489
752,2019-11-02,814,16312,1093,0,18219
752,2019-11-03,1261,21674,1621,3,24559
752,2019-11-04,1223,6492,2019,0,9734
752,2019-11-05,444,2219,1281,2,3946
752,2019-11-06,720,13478,884,3,15085
752,2019-11-07,792,16383,1046,1,18222
752,2019-11-08,574,12014,1533,1,14122
752,2019-11-09,1054,8134,2163,0,11351
752,2019-11-10,397,12483,1289,3,14172
752,2019-11-11,452,8100,1005,1,9558
752,2019-11-12,529,9126,3116,0,12771
752,2019-11-13,905,10530,1673,0,13108
752,2019-11-14,431,8564,1770,0,10765
752,2019-11-15,429,2764,3876,0,7069
752,2019-11-16,537,883,2481,0,3901
752,2019-11-17,558,1524,3445,0,5527
752,2019-11-18,1316,1330,3763,0,6409
752,2019-11-19,544,4888,2709,0,8141
752,2019-11-20,496,1473,2100,0,4069
752,2019-11-21,467,5058,2022,0,7547
752,2019-11-22,512,7637,1640,1,9790
752,2019-11-23,478,7196,2595,1,10270
752,2019-11-24,861,6257,1679,1,8798
752,2019-11-25,1337,5499,1776,2,8614
752,2019-11-26,1038,9263,2211,1,12513
752,2019-11-27,430,5414,1408,0,7252
752,2019-11-28,414,5838,659,0,6911
752,2019-11-29,131,266,0,0,397
752,2019-08-21,783,1706,1602,0,4091
752,2019-08-22,972,1435,1597,1,4005
752,2019-08-23,677,1413,1275,1,3366
752,2019-08-24,645,1999,1620,0,4264
752,2019-08-25,560,3121,2430,2,6113
752,2019-08-26,573,791,1890,2,3256
752,2019-08-27,549,6165,2164,2,8880
752,2019-08-28,423,5628,1893,0,7944
752,2019-08-29,609,9546,2051,0,12206
752,2019-08-30,447,4880,661,1,5989
752,2019-08-31,67,109,1,0,177
752,2019-09-01,131,496,276,0,903
752,2019-09-02,58,237,56,0,351
752,2019-09-03,138,809,2024,2,2973
752,2019-09-04,576,13518,2391,1,16486
752,2019-09-05,402,11800,1807,1,14010
752,2019-09-06,1415,13245,1375,0,16035
752,2019-09-07,631,20425,1859,1,22916
752,2019-09-08,638,7160,1760,2,9560
752,2019-09-09,1380,11739,2049,1,15169
752,2019-09-10,511,7710,2168,1,10390
752,2019-09-11,218,6254,1787,2,8261
752,2019-09-12,1977,10830,2165,1,14973
752,2019-09-13,790,4004,2094,1,6889
752,2019-09-14,465,7986,2617,1,11069
752,2019-09-15,444,11737,2369,0,14550
752,2019-09-16,562,14582,2021,1,17166
752,2019-09-17,461,6582,2159,1,9203
752,2019-09-18,592,11619,1728,0,13939
752,2019-09-19,775,4693,1914,0,7382
752,2019-09-20,1445,10526,1615,1,13587
752,2019-09-21,499,9052,2316,3,11870
752,2019-09-22,1774,9378,2693,1,13846
752,2019-09-23,515,7851,2127,0,10493
752,2019-09-24,903,5722,1701,3,8329
752,2019-09-25,284,9465,1122,1,10872
752,2019-09-26,220,7960,1792,3,9975
752,2019-09-27,187,12739,1613,3,14542
752,2019-09-28,279,14747,1846,1,16873
752,2019-09-29,197,15730,1645,0,17572
752,2019-09-30,2268,17214,1806,1,21289
752,2019-10-01,200,16550,1346,1,18097
752,2019-10-02,268,9975,2385,1,12629
752,2019-10-03,1074,13474,1595,1,16144
752,2019-10-04,831,11480,1624,0,13935
752,2019-10-05,652,14810,1208,0,16670
752,2019-10-06,201,10802,1214,4,12221
752,2019-10-07,195,5042,1317,1,6555
752,2019-10-08,2009,10408,2073,1,14491
752,2019-10-09,685,14081,1443,1,16210
752,2019-10-10,428,11010,1945,2,13385
752,2019-10-11,1752,8614,1874,5,12245
752,2019-10-12,404,5605,1817,0,7826
752,2019-10-13,1243,6702,2446,1,10392
752,2019-10-14,3053,3497,1780,0,8330
752,2019-10-15,1088,7804,1392,0,10284
752,2019-10-16,433,17581,1461,3,19478
752,2019-10-17,441,7232,1633,0,9306
752,2019-10-18,500,7300,1399,0,9199
752,2019-10-19,1407,3626,1242,0,6275
752,2019-10-20,864,746,1464,0,3074
752,2019-10-21,540,10219,1512,3,12274
752,2019-10-22,544,4739,2177,0,7460
752,2019-10-23,419,13400,1456,0,15275
752,2019-10-24,539,21788,1606,0,23933
752,2019-10-25,943,14492,1898,2,17335
752,2019-10-26,414,16777,1673,0,18864
752,2019-10-27,497,16349,1365,2,18213
752,2019-10-28,441,13569,1328,0,15338
752,2019-10-29,1163,26101,1856,0,29120
752,2019-10-30,467,21246,1549,1,23263
752,2019-10-31,916,11261,1298,3,13478
752,2019-11-01,398,24561,1530,0,26489
752,2019-11-02,814,16312,1093,0,18219
752,2019-11-03,1261,21674,1621,3,24559
752,2019-11-04,1223,6492,2019,0,9734
752,2019-11-05,444,2219,1281,2,3946
752,2019-11-06,720,13478,884,3,15085
752,2019-11-07,792,16383,1046,1,18222
752,2019-11-08,574,12014,1533,1,14122
752,2019-11-09,1054,8134,2163,0,11351
752,2019-11-10,397,12483,1289,3,14172
752,2019-11-11,452,8100,1005,1,9558
752,2019-11-12,529,9126,3116,0,12771
752,2019-11-13,905,10530,1673,0,13108
752,2019-11-14,431,8564,1770,0,10765
752,2019-11-15,429,2764,3876,0,7069
752,2019-11-16,537,883,2481,0,3901
752,2019-11-17,558,1524,3445,0,5527
752,2019-11-18,1316,1330,3763,0,6409
752,2019-11-19,544,4888,2709,0,8141
752,2019-11-20,496,1473,2100,0,4069
752,2019-11-21,467,5058,2022,0,7547
752,2019-11-22,512,7637,1640,1,9790
752,2019-11-23,478,7196,2595,1,10270
752,2019-11-24,861,6257,1679,1,8798
752,2019-11-25,1337,5499,1776,2,8614
752,2019-11-26,1038,9263,2211,1,12513
752,2019-11-27,430,5414,1408,0,7252
752,2019-11-28,414,5838,659,0,6911
752,2019-11-29,131,266,0,0,397
752,2019-08-20,0,0,242,1,243
752,2019-08-21,783,1706,1602,0,4091
752,2019-08-22,972,1435,1597,1,4005
752,2019-08-23,677,1413,1275,1,3366
752,2019-08-24,645,1999,1620,0,4264
752,2019-08-25,560,3121,2430,2,6113
752,2019-08-26,573,791,1890,2,3256
752,2019-08-27,549,6165,2164,2,8880
752,2019-08-28,423,5628,1893,0,7944
752,2019-08-29,609,9546,2051,0,12206
752,2019-08-30,447,4880,661,1,5989
752,2019-08-31,67,109,1,0,177
752,2019-09-01,131,496,276,0,903
752,2019-09-02,58,237,56,0,351
752,2019-09-03,138,809,2024,2,2973
752,2019-09-04,576,13518,2391,1,16486
752,2019-09-05,402,11800,1807,1,14010
752,2019-09-06,1415,13245,1375,0,16035
752,2019-09-07,631,20425,1859,1,22916
752,2019-09-08,638,7160,1760,2,9560
752,2019-09-09,1380,11739,2049,1,15169
752,2019-09-10,511,7710,2168,1,10390
752,2019-09-11,218,6254,1787,2,8261
752,2019-09-12,1977,10830,2165,1,14973
752,2019-09-13,790,4004,2094,1,6889
752,2019-09-14,465,7986,2617,1,11069
752,2019-09-15,444,11737,2369,0,14550
752,2019-09-16,562,14582,2021,1,17166
752,2019-09-17,461,6582,2159,1,9203
752,2019-09-18,592,11619,1728,0,13939
752,2019-09-19,775,4693,1914,0,7382
752,2019-09-20,1445,10526,1615,1,13587
752,2019-09-21,499,9052,2316,3,11870
752,2019-09-22,1774,9378,2693,1,13846
752,2019-09-23,515,7851,2127,0,10493
752,2019-09-24,903,5722,1701,3,8329
752,2019-09-25,284,9465,1122,1,10872
752,2019-09-26,220,7960,1792,3,9975
752,2019-09-27,187,12739,1613,3,14542
752,2019-09-28,279,14747,1846,1,16873
752,2019-09-29,197,15730,1645,0,17572
752,2019-09-30,2268,17214,1806,1,21289
752,2019-10-01,200,16550,1346,1,18097
752,2019-10-02,268,9975,2385,1,12629
752,2019-10-03,1074,13474,1595,1,16144
752,2019-10-04,831,11480,1624,0,13935
752,2019-10-05,652,14810,1208,0,16670
752,2019-10-06,201,10802,1214,4,12221
752,2019-10-07,195,5042,1317,1,6555
752,2019-10-08,2009,10408,2073,1,14491
752,2019-10-09,685,14081,1443,1,16210
752,2019-10-10,428,11010,1945,2,13385
752,2019-10-11,1752,8614,1874,5,12245
752,2019-10-12,404,5605,1817,0,7826
752,2019-10-13,1243,6702,2446,1,10392
752,2019-10-14,3053,3497,1780,0,8330
752,2019-10-15,1088,7804,1392,0,10284
752,2019-10-16,433,17581,1461,3,19478
752,2019-10-17,441,7232,1633,0,9306
752,2019-10-18,500,7300,1399,0,9199
752,2019-10-19,1407,3626,1242,0,6275
752,2019-10-20,864,746,1464,0,3074
752,2019-10-21,540,10219,1512,3,12274
752,2019-10-22,544,4739,2177,0,7460
752,2019-10-23,419,13400,1456,0,15275
752,2019-10-24,539,21788,1606,0,23933
752,2019-10-25,943,14492,1898,2,17335
752,2019-10-26,414,16777,1673,0,18864
752,2019-10-27,497,16349,1365,2,18213
752,2019-10-28,441,13569,1328,0,15338
752,2019-10-29,1163,26101,1856,0,29120
752,2019-10-30,467,21246,1549,1,23263
752,2019-10-31,916,11261,1298,3,13478
752,2019-11-01,398,24561,1530,0,26489
752,2019-11-02,814,16312,1093,0,18219
752,2019-11-03,1261,21674,1621,3,24559
752,2019-11-04,1223,6492,2019,0,9734
752,2019-11-05,444,2219,1281,2,3946
752,2019-11-06,720,13478,884,3,15085
752,2019-11-07,792,16383,1046,1,18222
752,2019-11-08,574,12014,1533,1,14122
752,2019-11-09,1054,8134,2163,0,11351
752,2019-11-10,397,12483,1289,3,14172
752,2019-11-11,452,8100,1005,1,9558
752,2019-11-12,529,9126,3116,0,12771
752,2019-11-13,905,10530,1673,0,13108
752,2019-11-14,431,8564,1770,0,10765
752,2019-11-15,429,2764,3876,0,7069
752,2019-11-16,537,883,2481,0,3901
752,2019-11-17,558,1524,3445,0,5527
752,2019-11-18,1316,1330,3763,0,6409
752,2019-11-19,544,4888,2709,0,8141
752,2019-11-20,496,1473,2100,0,4069
752,2019-11-21,467,5058,2022,0,7547
752,2019-11-22,512,7637,1640,1,9790
752,2019-11-23,478,7196,2595,1,10270
752,2019-11-24,861,6257,1679,1,8798
752,2019-11-25,1337,5499,1776,2,8614
752,2019-11-26,1038,9263,2211,1,12513
752,2019-11-27,430,5414,1408,0,7252
752,2019-11-28,414,5838,659,0,6911
752,2019-08-20,0,0,242,1,243
752,2019-08-21,783,1706,1602,0,4091
752,2019-08-22,972,1435,1597,1,4005
752,2019-08-23,677,1413,1275,1,3366
752,2019-08-24,645,1999,1620,0,4264
752,2019-08-25,560,3121,2430,2,6113
752,2019-08-26,573,791,1890,2,3256
752,2019-08-27,549,6165,2164,2,8880
752,2019-08-28,423,5628,1893,0,7944
752,2019-08-29,609,9546,2051,0,12206
752,2019-08-30,447,4880,661,1,5989
752,2019-08-31,67,109,1,0,177
752,2019-09-01,131,496,276,0,903
752,2019-09-02,58,237,56,0,351
752,2019-09-03,138,809,2024,2,2973
752,2019-09-04,576,13518,2391,1,16486
752,2019-09-05,402,11800,1807,1,14010
752,2019-09-06,1415,13245,1375,0,16035
752,2019-09-07,631,20425,1859,1,22916
752,2019-09-08,638,7160,1760,2,9560
752,2019-09-09,1380,11739,2049,1,15169
752,2019-09-10,511,7710,2168,1,10390
752,2019-09-11,218,6254,1787,2,8261
752,2019-09-12,1977,10830,2165,1,14973
752,2019-09-13,790,4004,2094,1,6889
752,2019-09-14,465,7986,2617,1,11069
752,2019-09-15,444,11737,2369,0,14550
752,2019-09-16,562,14582,2021,1,17166
752,2019-09-17,461,6582,2159,1,9203
752,2019-09-18,592,11619,1728,0,13939
752,2019-09-19,775,4693,1914,0,7382
752,2019-09-20,1445,10526,1615,1,13587
752,2019-09-21,499,9052,2316,3,11870
752,2019-09-22,1774,9378,2693,1,13846
752,2019-09-23,515,7851,2127,0,10493
752,2019-09-24,903,5722,1701,3,8329
752,2019-09-25,284,9465,1122,1,10872
752,2019-09-26,220,7960,1792,3,9975
752,2019-09-27,187,12739,1613,3,14542
752,2019-09-28,279,14747,1846,1,16873
752,2019-09-29,197,15730,1645,0,17572
752,2019-09-30,2268,17214,1806,1,21289
752,2019-10-01,200,16550,1346,1,18097
752,2019-10-02,268,9975,2385,1,12629
752,2019-10-03,1074,13474,1595,1,16144
752,2019-10-04,831,11480,1624,0,13935
752,2019-10-05,652,14810,1208,0,16670
752,2019-10-06,201,10802,1214,4,12221
752,2019-10-07,195,5042,1317,1,6555
752,2019-10-08,2009,10408,2073,1,14491
752,2019-10-09,685,14081,1443,1,16210
752,2019-10-10,428,11010,1945,2,13385
752,2019-10-11,1752,8614,1874,5,12245
752,2019-10-12,404,5605,1817,0,7826
752,2019-10-13,1243,6702,2446,1,10392
752,2019-10-14,3053,3497,1780,0,8330
752,2019-10-15,1088,7804,1392,0,10284
752,2019-10-16,433,17581,1461,3,19478
752,2019-10-17,441,7232,1633,0,9306
752,2019-10-18,500,7300,1399,0,9199
752,2019-10-19,1407,3626,1242,0,6275
752,2019-10-20,864,746,1464,0,3074
752,2019-10-21,540,10219,1512,3,12274
752,2019-10-22,544,4739,2177,0,7460
752,2019-10-23,419,13400,1456,0,15275
752,2019-10-24,539,21788,1606,0,23933
752,2019-10-25,943,14492,1898,2,17335
752,2019-10-26,414,16777,1673,0,18864
752,2019-10-27,497,16349,1365,2,18213
752,2019-10-28,441,13569,1328,0,15338
752,2019-10-29,1163,26101,1856,0,29120
752,2019-10-30,467,21246,1549,1,23263
752,2019-10-31,916,11261,1298,3,13478
752,2019-11-01,398,24561,1530,0,26489
752,2019-11-02,814,16312,1093,0,18219
752,2019-11-03,1261,21674,1621,3,24559
752,2019-11-04,1223,6492,2019,0,9734
752,2019-11-05,444,2219,1281,2,3946
752,2019-11-06,720,13478,884,3,15085
752,2019-11-07,792,16383,1046,1,18222
752,2019-11-08,574,12014,1533,1,14122
752,2019-11-09,1054,8134,2163,0,11351
752,2019-11-10,397,12483,1289,3,14172
752,2019-11-11,452,8100,1005,1,9558
752,2019-11-12,529,9126,3116,0,12771
752,2019-11-13,905,10530,1673,0,13108
752,2019-11-14,431,8564,1770,0,10765
752,2019-11-15,429,2764,3876,0,7069
752,2019-11-16,537,883,2481,0,3901
752,2019-11-17,558,1524,3445,0,5527
752,2019-11-18,1316,1330,3763,0,6409
752,2019-11-19,544,4888,2709,0,8141
752,2019-11-20,496,1473,2100,0,4069
752,2019-11-21,467,5058,2022,0,7547
752,2019-11-22,512,7637,1640,1,9790
752,2019-11-23,478,7196,2595,1,10270
752,2019-11-24,861,6257,1679,1,8798
752,2019-11-25,1337,5499,1776,2,8614
752,2019-11-26,1038,9263,2211,1,12513
753,2019-08-21,318,2020,1064,0,3402
753,2019-08-22,70,3897,1820,1,5788
753,2019-08-23,173,1548,1575,3,3299
753,2019-08-24,197,2833,1991,4,5025
753,2019-08-25,183,14336,1444,1,15964
753,2019-08-26,976,14447,1530,0,16953
753,2019-08-27,1030,8571,1629,0,11230
753,2019-08-28,638,2449,2250,2,5339
753,2019-08-29,700,9941,1353,3,11997
753,2019-08-30,126,3243,309,1,3679
753,2019-08-31,61,120,28,0,209
753,2019-09-01,32,979,92,0,1103
753,2019-09-02,45,722,23,0,790
753,2019-09-03,85,256,1261,2,1604
753,2019-09-04,912,16339,1633,1,18885
753,2019-09-05,127,6238,2869,3,9237
753,2019-09-06,1796,10963,1591,0,14350
753,2019-09-07,270,10417,1393,0,12080
753,2019-09-08,1008,8662,2373,0,12043
753,2019-09-09,94,9532,2049,2,11677
753,2019-09-10,75,9575,1726,0,11376
753,2019-09-11,125,6813,2740,2,9680
753,2019-09-12,71,9474,1623,2,11170
753,2019-09-13,132,6306,2646,0,9084
753,2019-09-14,85,7299,1775,1,9160
753,2019-09-15,908,6379,1629,0,8916
753,2019-09-16,99,12857,3025,0,15981
753,2019-09-17,162,7195,1959,0,9316
753,2019-09-18,214,11259,1494,2,12969
753,2019-09-19,213,3104,1786,1,5104
753,2019-09-20,292,11809,2048,0,14149
753,2019-09-21,904,9946,1350,0,12200
753,2019-09-22,956,8674,1609,1,11240
753,2019-09-23,157,13787,1621,1,15566
753,2019-09-24,903,8849,1739,2,11493
753,2019-09-25,974,10802,1940,1,13717
753,2019-09-26,113,11731,1459,2,13305
753,2019-09-27,942,8655,1518,1,11116
753,2019-09-28,93,15487,1897,3,17480
753,2019-09-29,914,19512,1505,1,21932
753,2019-09-30,643,21383,1784,1,23811
753,2019-10-01,77,17058,1378,0,18513
753,2019-10-02,144,11522,1892,0,13558
753,2019-10-03,917,14630,1597,0,17144
753,2019-10-04,72,12989,1701,38,14800
753,2019-10-05,75,14617,1841,59,16592
753,2019-10-06,159,10016,2229,0,12404
753,2019-10-07,945,6418,1576,1,8940
753,2019-10-08,351,12391,1697,7,14446
753,2019-10-09,692,15659,1124,0,17475
753,2019-10-10,127,12592,1914,3,14636
753,2019-10-11,111,11033,2471,1,13616
753,2019-10-12,181,7476,2366,1,10024
753,2019-10-13,76,8670,2391,3,11140
753,2019-10-14,1360,5696,2243,1,9300
753,2019-10-15,70,8154,1642,2,9868
753,2019-10-16,569,12714,1300,3,14586
753,2019-10-17,1040,5980,2030,3,9053
753,2019-10-18,675,8723,1658,3,11059
753,2019-10-19,404,6987,946,1,8338
753,2019-10-20,948,3284,1488,0,5720
753,2019-10-21,679,11172,1746,0,13597
753,2019-10-22,81,6963,1859,1,8904
753,2019-10-23,1609,8636,1767,5,12017
753,2019-10-24,115,21053,1755,1,22924
753,2019-10-25,108,19151,1502,2,20763
753,2019-10-26,1476,17156,1225,1,19858
753,2019-10-27,1128,16783,1514,0,19425
753,2019-10-28,1406,24142,1773,1,27322
753,2019-10-29,129,20442,2002,0,22573
753,2019-10-30,78,15838,1252,0,17168
753,2019-10-31,872,20886,2583,0,24341
753,2019-11-01,63,27638,1287,0,28988
753,2019-11-02,68,17363,836,3,18270
753,2019-11-03,981,23034,823,0,24838
753,2019-11-04,875,10767,1301,1,12944
753,2019-11-05,141,3597,1052,0,4790
753,2019-11-06,99,15189,1747,2,17037
753,2019-11-07,244,17237,750,1,18232
753,2019-11-08,142,10493,1022,0,11657
753,2019-11-09,53,9424,1590,0,11067
753,2019-11-10,67,14505,1458,0,16030
753,2019-11-11,1151,10518,1931,1,13601
753,2019-11-12,98,11525,2454,4,14081
753,2019-11-13,195,20689,1853,1,22738
753,2019-11-14,67,12369,2546,0,14982
753,2019-11-15,95,3842,2448,0,6385
753,2019-11-16,181,2891,1703,0,4775
753,2019-11-17,1072,5051,2765,4,8892
753,2019-11-18,105,3523,3122,0,6750
753,2019-11-19,110,3339,1910,0,5359
753,2019-11-20,114,1498,2744,0,4356
753,2019-11-21,211,3611,2118,1,5941
753,2019-11-22,128,4935,1340,7,6410
753,2019-11-23,109,9769,2233,3,12114
753,2019-11-24,188,8792,1738,4,10722
753,2019-11-25,117,8254,1293,0,9664
753,2019-11-26,63,7884,1241,0,9188
753,2019-11-27,57,11196,1029,0,12282
753,2019-11-28,62,8298,363,0,8723
753,2019-08-21,318,2020,1064,0,3402
753,2019-08-22,70,3897,1820,1,5788
753,2019-08-23,173,1548,1575,3,3299
753,2019-08-24,197,2833,1991,4,5025
753,2019-08-25,183,14336,1444,1,15964
753,2019-08-26,976,14447,1530,0,16953
753,2019-08-27,1030,8571,1629,0,11230
753,2019-08-28,638,2449,2250,2,5339
753,2019-08-29,700,9941,1353,3,11997
753,2019-08-30,126,3243,309,1,3679
753,2019-08-31,61,120,28,0,209
753,2019-09-01,32,979,92,0,1103
753,2019-09-02,45,722,23,0,790
753,2019-09-03,85,256,1261,2,1604
753,2019-09-04,912,16339,1633,1,18885
753,2019-09-05,127,6238,2869,3,9237
753,2019-09-06,1796,10963,1591,0,14350
753,2019-09-07,270,10417,1393,0,12080
753,2019-09-08,1008,8662,2373,0,12043
753,2019-09-09,94,9532,2049,2,11677
753,2019-09-10,75,9575,1726,0,11376
753,2019-09-11,125,6813,2740,2,9680
753,2019-09-12,71,9474,1623,2,11170
753,2019-09-13,132,6306,2646,0,9084
753,2019-09-14,85,7299,1775,1,9160
753,2019-09-15,908,6379,1629,0,8916
753,2019-09-16,99,12857,3025,0,15981
753,2019-09-17,162,7195,1959,0,9316
753,2019-09-18,214,11259,1494,2,12969
753,2019-09-19,213,3104,1786,1,5104
753,2019-09-20,292,11809,2048,0,14149
753,2019-09-21,904,9946,1350,0,12200
753,2019-09-22,956,8674,1609,1,11240
753,2019-09-23,157,13787,1621,1,15566
753,2019-09-24,903,8849,1739,2,11493
753,2019-09-25,974,10802,1940,1,13717
753,2019-09-26,113,11731,1459,2,13305
753,2019-09-27,942,8655,1518,1,11116
753,2019-09-28,93,15487,1897,3,17480
753,2019-09-29,914,19512,1505,1,21932
753,2019-09-30,643,21383,1784,1,23811
753,2019-10-01,77,17058,1378,0,18513
753,2019-10-02,144,11522,1892,0,13558
753,2019-10-03,917,14630,1597,0,17144
753,2019-10-04,72,12989,1701,38,14800
753,2019-10-05,75,14617,1841,59,16592
753,2019-10-06,159,10016,2229,0,12404
753,2019-10-07,945,6418,1576,1,8940
753,2019-10-08,351,12391,1697,7,14446
753,2019-10-09,692,15659,1124,0,17475
753,2019-10-10,127,12592,1914,3,14636
753,2019-10-11,111,11033,2471,1,13616
753,2019-10-12,181,7476,2366,1,10024
753,2019-10-13,76,8670,2391,3,11140
753,2019-10-14,1360,5696,2243,1,9300
753,2019-10-15,70,8154,1642,2,9868
753,2019-10-16,569,12714,1300,3,14586
753,2019-10-17,1040,5980,2030,3,9053
753,2019-10-18,675,8723,1658,3,11059
753,2019-10-19,404,6987,946,1,8338
753,2019-10-20,948,3284,1488,0,5720
753,2019-10-21,679,11172,1746,0,13597
753,2019-10-22,81,6963,1859,1,8904
753,2019-10-23,1609,8636,1767,5,12017
753,2019-10-24,115,21053,1755,1,22924
753,2019-10-25,108,19151,1502,2,20763
753,2019-10-26,1476,17156,1225,1,19858
753,2019-10-27,1128,16783,1514,0,19425
753,2019-10-28,1406,24142,1773,1,27322
753,2019-10-29,129,20442,2002,0,22573
753,2019-10-30,78,15838,1252,0,17168
753,2019-10-31,872,20886,2583,0,24341
753,2019-11-01,63,27638,1287,0,28988
753,2019-11-02,68,17363,836,3,18270
753,2019-11-03,981,23034,823,0,24838
753,2019-11-04,875,10767,1301,1,12944
753,2019-11-05,141,3597,1052,0,4790
753,2019-11-06,99,15189,1747,2,17037
753,2019-11-07,244,17237,750,1,18232
753,2019-11-08,142,10493,1022,0,11657
753,2019-11-09,53,9424,1590,0,11067
753,2019-11-10,67,14505,1458,0,16030
753,2019-11-11,1151,10518,1931,1,13601
753,2019-11-12,98,11525,2454,4,14081
753,2019-11-13,195,20689,1853,1,22738
753,2019-11-14,67,12369,2546,0,14982
753,2019-11-15,95,3842,2448,0,6385
753,2019-11-16,181,2891,1703,0,4775
753,2019-11-17,1072,5051,2765,4,8892
753,2019-11-18,105,3523,3122,0,6750
753,2019-11-19,110,3339,1910,0,5359
753,2019-11-20,114,1498,2744,0,4356
753,2019-11-21,211,3611,2118,1,5941
753,2019-11-22,128,4935,1340,7,6410
753,2019-11-23,109,9769,2233,3,12114
753,2019-11-24,188,8792,1738,4,10722
753,2019-11-25,117,8254,1293,0,9664
753,2019-11-26,63,7884,1241,0,9188
753,2019-11-27,57,11196,1029,0,12282
753,2019-11-28,62,8298,363,0,8723
753,2019-11-29,0,479,0,0,479
753,2019-08-20,0,0,11,0,11
753,2019-08-21,318,2020,1064,0,3402
753,2019-08-22,70,3897,1820,1,5788
753,2019-08-23,173,1548,1575,3,3299
753,2019-08-24,197,2833,1991,4,5025
753,2019-08-25,183,14336,1444,1,15964
753,2019-08-26,976,14447,1530,0,16953
753,2019-08-27,1030,8571,1629,0,11230
753,2019-08-28,638,2449,2250,2,5339
753,2019-08-29,700,9941,1353,3,11997
753,2019-08-30,126,3243,309,1,3679
753,2019-08-31,61,120,28,0,209
753,2019-09-01,32,979,92,0,1103
753,2019-09-02,45,722,23,0,790
753,2019-09-03,85,256,1261,2,1604
753,2019-09-04,912,16339,1633,1,18885
753,2019-09-05,127,6238,2869,3,9237
753,2019-09-06,1796,10963,1591,0,14350
753,2019-09-07,270,10417,1393,0,12080
753,2019-09-08,1008,8662,2373,0,12043
753,2019-09-09,94,9532,2049,2,11677
753,2019-09-10,75,9575,1726,0,11376
753,2019-09-11,125,6813,2740,2,9680
753,2019-09-12,71,9474,1623,2,11170
753,2019-09-13,132,6306,2646,0,9084
753,2019-09-14,85,7299,1775,1,9160
753,2019-09-15,908,6379,1629,0,8916
753,2019-09-16,99,12857,3025,0,15981
753,2019-09-17,162,7195,1959,0,9316
753,2019-09-18,214,11259,1494,2,12969
753,2019-09-19,213,3104,1786,1,5104
753,2019-09-20,292,11809,2048,0,14149
753,2019-09-21,904,9946,1350,0,12200
753,2019-09-22,956,8674,1609,1,11240
753,2019-09-23,157,13787,1621,1,15566
753,2019-09-24,903,8849,1739,2,11493
753,2019-09-25,974,10802,1940,1,13717
753,2019-09-26,113,11731,1459,2,13305
753,2019-09-27,942,8655,1518,1,11116
753,2019-09-28,93,15487,1897,3,17480
753,2019-09-29,914,19512,1505,1,21932
753,2019-09-30,643,21383,1784,1,23811
753,2019-10-01,77,17058,1378,0,18513
753,2019-10-02,144,11522,1892,0,13558
753,2019-10-03,917,14630,1597,0,17144
753,2019-10-04,72,12989,1701,38,14800
753,2019-10-05,75,14617,1841,59,16592
753,2019-10-06,159,10016,2229,0,12404
753,2019-10-07,945,6418,1576,1,8940
753,2019-10-08,351,12391,1697,7,14446
753,2019-10-09,692,15659,1124,0,17475
753,2019-10-10,127,12592,1914,3,14636
753,2019-10-11,111,11033,2471,1,13616
753,2019-10-12,181,7476,2366,1,10024
753,2019-10-13,76,8670,2391,3,11140
753,2019-10-14,1360,5696,2243,1,9300
753,2019-10-15,70,8154,1642,2,9868
753,2019-10-16,569,12714,1300,3,14586
753,2019-10-17,1040,5980,2030,3,9053
753,2019-10-18,675,8723,1658,3,11059
753,2019-10-19,404,6987,946,1,8338
753,2019-10-20,948,3284,1488,0,5720
753,2019-10-21,679,11172,1746,0,13597
753,2019-10-22,81,6963,1859,1,8904
753,2019-10-23,1609,8636,1767,5,12017
753,2019-10-24,115,21053,1755,1,22924
753,2019-10-25,108,19151,1502,2,20763
753,2019-10-26,1476,17156,1225,1,19858
753,2019-10-27,1128,16783,1514,0,19425
753,2019-10-28,1406,24142,1773,1,27322
753,2019-10-29,129,20442,2002,0,22573
753,2019-10-30,78,15838,1252,0,17168
753,2019-10-31,872,20886,2583,0,24341
753,2019-11-01,63,27638,1287,0,28988
753,2019-11-02,68,17363,836,3,18270
753,2019-11-03,981,23034,823,0,24838
753,2019-11-04,875,10767,1301,1,12944
753,2019-11-05,141,3597,1052,0,4790
753,2019-11-06,99,15189,1747,2,17037
753,2019-11-07,244,17237,750,1,18232
753,2019-11-08,142,10493,1022,0,11657
753,2019-11-09,53,9424,1590,0,11067
753,2019-11-10,67,14505,1458,0,16030
753,2019-11-11,1151,10518,1931,1,13601
753,2019-11-12,98,11525,2454,4,14081
753,2019-11-13,195,20689,1853,1,22738
753,2019-11-14,67,12369,2546,0,14982
753,2019-11-15,95,3842,2448,0,6385
753,2019-11-16,181,2891,1703,0,4775
753,2019-11-17,1072,5051,2765,4,8892
753,2019-11-18,105,3523,3122,0,6750
753,2019-11-19,110,3339,1910,0,5359
753,2019-11-20,114,1498,2744,0,4356
753,2019-11-21,211,3611,2118,1,5941
753,2019-11-22,128,4935,1340,7,6410
753,2019-11-23,109,9769,2233,3,12114
753,2019-11-24,188,8792,1738,4,10722
753,2019-11-25,117,8254,1293,0,9664
753,2019-11-26,63,7884,1241,0,9188
753,2019-11-27,57,11196,1029,0,12282
753,2019-11-28,62,8298,363,0,8723
753,2019-08-22,70,3897,1820,1,5788
753,2019-08-23,173,1548,1575,3,3299
753,2019-08-24,197,2833,1991,4,5025
753,2019-08-25,183,14336,1444,1,15964
753,2019-08-26,976,14447,1530,0,16953
753,2019-08-27,1030,8571,1629,0,11230
753,2019-08-28,638,2449,2250,2,5339
753,2019-08-29,700,9941,1353,3,11997
753,2019-08-30,126,3243,309,1,3679
753,2019-08-31,61,120,28,0,209
753,2019-09-01,32,979,92,0,1103
753,2019-09-02,45,722,23,0,790
753,2019-09-03,85,256,1261,2,1604
753,2019-09-04,912,16339,1633,1,18885
753,2019-09-05,127,6238,2869,3,9237
753,2019-09-06,1796,10963,1591,0,14350
753,2019-09-07,270,10417,1393,0,12080
753,2019-09-08,1008,8662,2373,0,12043
753,2019-09-09,94,9532,2049,2,11677
753,2019-09-10,75,9575,1726,0,11376
753,2019-09-11,125,6813,2740,2,9680
753,2019-09-12,71,9474,1623,2,11170
753,2019-09-13,132,6306,2646,0,9084
753,2019-09-14,85,7299,1775,1,9160
753,2019-09-15,908,6379,1629,0,8916
753,2019-09-16,99,12857,3025,0,15981
753,2019-09-17,162,7195,1959,0,9316
753,2019-09-18,214,11259,1494,2,12969
753,2019-09-19,213,3104,1786,1,5104
753,2019-09-20,292,11809,2048,0,14149
753,2019-09-21,904,9946,1350,0,12200
753,2019-09-22,956,8674,1609,1,11240
753,2019-09-23,157,13787,1621,1,15566
753,2019-09-24,903,8849,1739,2,11493
753,2019-09-25,974,10802,1940,1,13717
753,2019-09-26,113,11731,1459,2,13305
753,2019-09-27,942,8655,1518,1,11116
753,2019-09-28,93,15487,1897,3,17480
753,2019-09-29,914,19512,1505,1,21932
753,2019-09-30,643,21383,1784,1,23811
753,2019-10-01,77,17058,1378,0,18513
753,2019-10-02,144,11522,1892,0,13558
753,2019-10-03,917,14630,1597,0,17144
753,2019-10-04,72,12989,1701,38,14800
753,2019-10-05,75,14617,1841,59,16592
753,2019-10-06,159,10016,2229,0,12404
753,2019-10-07,945,6418,1576,1,8940
753,2019-10-08,351,12391,1697,7,14446
753,2019-10-09,692,15659,1124,0,17475
753,2019-10-10,127,12592,1914,3,14636
753,2019-10-11,111,11033,2471,1,13616
753,2019-10-12,181,7476,2366,1,10024
753,2019-10-13,76,8670,2391,3,11140
753,2019-10-14,1360,5696,2243,1,9300
753,2019-10-15,70,8154,1642,2,9868
753,2019-10-16,569,12714,1300,3,14586
753,2019-10-17,1040,5980,2030,3,9053
753,2019-10-18,675,8723,1658,3,11059
753,2019-10-19,404,6987,946,1,8338
753,2019-10-20,948,3284,1488,0,5720
753,2019-10-21,679,11172,1746,0,13597
753,2019-10-22,81,6963,1859,1,8904
753,2019-10-23,1609,8636,1767,5,12017
753,2019-10-24,115,21053,1755,1,22924
753,2019-10-25,108,19151,1502,2,20763
753,2019-10-26,1476,17156,1225,1,19858
753,2019-10-27,1128,16783,1514,0,19425
753,2019-10-28,1406,24142,1773,1,27322
753,2019-10-29,129,20442,2002,0,22573
753,2019-10-30,78,15838,1252,0,17168
753,2019-10-31,872,20886,2583,0,24341
753,2019-11-01,63,27638,1287,0,28988
753,2019-11-02,68,17363,836,3,18270
753,2019-11-03,981,23034,823,0,24838
753,2019-11-04,875,10767,1301,1,12944
753,2019-11-05,141,3597,1052,0,4790
753,2019-11-06,99,15189,1747,2,17037
753,2019-11-07,244,17237,750,1,18232
753,2019-11-08,142,10493,1022,0,11657
753,2019-11-09,53,9424,1590,0,11067
753,2019-11-10,67,14505,1458,0,16030
753,2019-11-11,1151,10518,1931,1,13601
753,2019-11-12,98,11525,2454,4,14081
753,2019-11-13,195,20689,1853,1,22738
753,2019-11-14,67,12369,2546,0,14982
753,2019-11-15,95,3842,2448,0,6385
753,2019-11-16,181,2891,1703,0,4775
753,2019-11-17,1072,5051,2765,4,8892
753,2019-11-18,105,3523,3122,0,6750
753,2019-11-19,110,3339,1910,0,5359
753,2019-11-20,114,1498,2744,0,4356
753,2019-11-21,211,3611,2118,1,5941
753,2019-11-22,128,4935,1340,7,6410
753,2019-11-23,109,9769,2233,3,12114
753,2019-11-24,188,8792,1738,4,10722
756,2019-08-22,4,12,1298,0,1314
756,2019-08-23,1538,868,1547,0,3953
756,2019-08-24,1592,1518,1532,0,4642
756,2019-08-25,1418,4318,1710,1,7447
756,2019-08-26,1262,1677,1741,0,4680
756,2019-08-27,1892,1772,2007,1,5672
756,2019-08-28,1829,11734,1710,0,15273
756,2019-08-29,1905,13515,2430,1,17851
756,2019-08-30,1689,3633,1033,0,6355
756,2019-08-31,1337,78,4,0,1419
756,2019-09-01,1633,315,705,0,2653
756,2019-09-02,1070,250,11,0,1331
756,2019-09-03,2645,4067,1088,1,7801
756,2019-09-04,3602,12185,2442,0,18229
756,2019-09-05,2128,11531,1555,3,15217
756,2019-09-06,4880,11563,2318,0,18761
756,2019-09-07,4801,9626,2030,2,16459
756,2019-09-08,6234,4737,2256,0,13227
756,2019-09-09,7681,5404,1678,1,14764
756,2019-09-10,5005,8043,2115,1,15164
756,2019-09-11,3471,5834,1507,2,10814
756,2019-09-12,1549,7547,1519,2,10617
756,2019-09-13,1290,3265,1610,1,6166
756,2019-09-14,1361,6475,1840,0,9676
756,2019-09-15,2040,6649,1792,0,10481
756,2019-09-16,2212,9119,1631,1,12963
756,2019-09-17,3438,6084,2955,2,12479
756,2019-09-18,2569,11431,1397,1,15398
756,2019-09-19,2890,3182,1530,0,7602
756,2019-09-20,2224,8500,1779,2,12505
756,2019-09-21,3384,8772,1440,1,13597
756,2019-09-22,2256,9245,1210,0,12711
756,2019-09-23,830,10208,1763,0,12801
756,2019-09-24,1638,9356,2342,2,13338
756,2019-09-25,2180,7832,2265,5,12282
756,2019-09-26,687,9481,1291,0,11459
756,2019-09-27,1235,8789,1528,2,11554
756,2019-09-28,1931,16687,945,1,19564
756,2019-09-29,1904,16968,2022,1,20895
756,2019-09-30,407,26791,1400,2,28600
756,2019-10-01,2070,23177,1457,0,26704
756,2019-10-02,1098,15047,1711,0,17856
756,2019-10-03,1089,15093,1453,0,17635
756,2019-10-04,3796,14194,2395,1,20386
756,2019-10-05,2251,15548,1047,1,18847
756,2019-10-06,3761,8763,1998,1,14523
756,2019-10-07,1101,8034,2555,1,11691
756,2019-10-08,1471,12628,1785,2,15886
756,2019-10-09,1155,23126,1576,1,25858
756,2019-10-10,505,13987,2358,2,16852
756,2019-10-11,633,11328,1355,1,13317
756,2019-10-12,662,5650,2529,0,8841
756,2019-10-13,2253,9661,1454,1,13369
756,2019-10-14,1906,8266,1710,927,12809
756,2019-10-15,1719,3654,2252,3,7628
756,2019-10-16,2266,8789,1694,1,12750
756,2019-10-17,1664,5547,2005,5,9221
756,2019-10-18,2723,8647,1824,1,13195
756,2019-10-19,1726,5974,1783,2,9485
756,2019-10-20,839,3161,1491,3,5494
756,2019-10-21,803,11624,1372,2,13801
756,2019-10-22,1762,6647,1879,0,10288
756,2019-10-23,940,15439,1771,0,18150
756,2019-10-24,931,25690,1508,0,28129
756,2019-10-25,806,14844,1521,3,17174
756,2019-10-26,1441,14264,1664,0,17369
756,2019-10-27,4205,17023,1759,0,22987
756,2019-10-28,1299,15598,1380,0,18277
756,2019-10-29,2024,16152,1077,1,19254
756,2019-10-30,3891,15447,986,2,20326
756,2019-10-31,10123,12432,1740,1,24296
756,2019-11-01,3780,25229,1658,0,30667
756,2019-11-02,4326,26054,2093,1,32474
756,2019-11-03,1106,27608,1415,0,30129
756,2019-11-04,903,8236,1012,3,10154
756,2019-11-05,2381,3403,1604,0,7388
756,2019-11-06,4680,14625,1349,2,20656
756,2019-11-07,502,16785,1051,2,18340
756,2019-11-08,2162,10137,874,449,13622
756,2019-11-09,1603,13262,1773,0,16638
756,2019-11-10,1640,15090,1596,0,18326
756,2019-11-11,2041,9732,1800,0,13573
756,2019-11-12,3342,10410,2405,0,16157
756,2019-11-13,1238,14314,2032,0,17584
756,2019-11-14,1703,13317,1652,0,16672
756,2019-11-15,1818,4962,1955,0,8735
756,2019-11-16,3651,2767,2161,0,8579
756,2019-11-17,2311,3304,3273,0,8888
756,2019-11-18,2350,2351,2810,0,7511
756,2019-11-19,1947,5048,3171,0,10166
756,2019-11-20,669,1420,1619,0,3708
756,2019-11-21,749,5356,1811,0,7916
756,2019-11-22,1255,4655,1568,1,7479
756,2019-11-23,1312,6305,2742,1,10360
756,2019-11-24,1782,4637,1863,1,8283
756,2019-11-25,1763,6868,1740,0,10371
756,2019-11-26,1852,6177,1331,0,9360
756,2019-11-27,2824,6546,997,0,10367
756,2019-11-28,2036,6752,504,1,9293
756,2019-11-29,80,868,15,0,963
756,2019-08-21,0,15,789,0,804
756,2019-08-22,4,12,1298,0,1314
756,2019-08-23,1538,868,1547,0,3953
756,2019-08-24,1592,1518,1532,0,4642
756,2019-08-25,1418,4318,1710,1,7447
756,2019-08-26,1262,1677,1741,0,4680
756,2019-08-27,1892,1772,2007,1,5672
756,2019-08-28,1829,11734,1710,0,15273
756,2019-08-29,1905,13515,2430,1,17851
756,2019-08-30,1689,3633,1033,0,6355
756,2019-08-31,1337,78,4,0,1419
756,2019-09-01,1633,315,705,0,2653
756,2019-09-02,1070,250,11,0,1331
756,2019-09-03,2645,4067,1088,1,7801
756,2019-09-04,3602,12185,2442,0,18229
756,2019-09-05,2128,11531,1555,3,15217
756,2019-09-06,4880,11563,2318,0,18761
756,2019-09-07,4801,9626,2030,2,16459
756,2019-09-08,6234,4737,2256,0,13227
756,2019-09-09,7681,5404,1678,1,14764
756,2019-09-10,5005,8043,2115,1,15164
756,2019-09-11,3471,5834,1507,2,10814
756,2019-09-12,1549,7547,1519,2,10617
756,2019-09-13,1290,3265,1610,1,6166
756,2019-09-14,1361,6475,1840,0,9676
756,2019-09-15,2040,6649,1792,0,10481
756,2019-09-16,2212,9119,1631,1,12963
756,2019-09-17,3438,6084,2955,2,12479
756,2019-09-18,2569,11431,1397,1,15398
756,2019-09-19,2890,3182,1530,0,7602
756,2019-09-20,2224,8500,1779,2,12505
756,2019-09-21,3384,8772,1440,1,13597
756,2019-09-22,2256,9245,1210,0,12711
756,2019-09-23,830,10208,1763,0,12801
756,2019-09-24,1638,9356,2342,2,13338
756,2019-09-25,2180,7832,2265,5,12282
756,2019-09-26,687,9481,1291,0,11459
756,2019-09-27,1235,8789,1528,2,11554
756,2019-09-28,1931,16687,945,1,19564
756,2019-09-29,1904,16968,2022,1,20895
756,2019-09-30,407,26791,1400,2,28600
756,2019-10-01,2070,23177,1457,0,26704
756,2019-10-02,1098,15047,1711,0,17856
756,2019-10-03,1089,15093,1453,0,17635
756,2019-10-04,3796,14194,2395,1,20386
756,2019-10-05,2251,15548,1047,1,18847
756,2019-10-06,3761,8763,1998,1,14523
756,2019-10-07,1101,8034,2555,1,11691
756,2019-10-08,1471,12628,1785,2,15886
756,2019-10-09,1155,23126,1576,1,25858
756,2019-10-10,505,13987,2358,2,16852
756,2019-10-11,633,11328,1355,1,13317
756,2019-10-12,662,5650,2529,0,8841
756,2019-10-13,2253,9661,1454,1,13369
756,2019-10-14,1906,8266,1710,927,12809
756,2019-10-15,1719,3654,2252,3,7628
756,2019-10-16,2266,8789,1694,1,12750
756,2019-10-17,1664,5547,2005,5,9221
756,2019-10-18,2723,8647,1824,1,13195
756,2019-10-19,1726,5974,1783,2,9485
756,2019-10-20,839,3161,1491,3,5494
756,2019-10-21,803,11624,1372,2,13801
756,2019-10-22,1762,6647,1879,0,10288
756,2019-10-23,940,15439,1771,0,18150
756,2019-10-24,931,25690,1508,0,28129
756,2019-10-25,806,14844,1521,3,17174
756,2019-10-26,1441,14264,1664,0,17369
756,2019-10-27,4205,17023,1759,0,22987
756,2019-10-28,1299,15598,1380,0,18277
756,2019-10-29,2024,16152,1077,1,19254
756,2019-10-30,3891,15447,986,2,20326
756,2019-10-31,10123,12432,1740,1,24296
756,2019-11-01,3780,25229,1658,0,30667
756,2019-11-02,4326,26054,2093,1,32474
756,2019-11-03,1106,27608,1415,0,30129
756,2019-11-04,903,8236,1012,3,10154
756,2019-11-05,2381,3403,1604,0,7388
756,2019-11-06,4680,14625,1349,2,20656
756,2019-11-07,502,16785,1051,2,18340
756,2019-11-08,2162,10137,874,449,13622
756,2019-11-09,1603,13262,1773,0,16638
756,2019-11-10,1640,15090,1596,0,18326
756,2019-11-11,2041,9732,1800,0,13573
756,2019-11-12,3342,10410,2405,0,16157
756,2019-11-13,1238,14314,2032,0,17584
756,2019-11-14,1703,13317,1652,0,16672
756,2019-11-15,1818,4962,1955,0,8735
756,2019-11-16,3651,2767,2161,0,8579
756,2019-11-17,2311,3304,3273,0,8888
756,2019-11-18,2350,2351,2810,0,7511
756,2019-11-19,1947,5048,3171,0,10166
756,2019-11-20,669,1420,1619,0,3708
756,2019-11-21,749,5356,1811,0,7916
756,2019-11-22,1255,4655,1568,1,7479
756,2019-11-23,1312,6305,2742,1,10360
756,2019-11-24,1782,4637,1863,1,8283
756,2019-11-25,1763,6868,1740,0,10371
756,2019-11-26,1852,6177,1331,0,9360
756,2019-11-27,2824,6546,997,0,10367
756,2019-11-28,2036,6752,504,1,9293
756,2019-11-29,80,868,15,0,963
756,2019-08-21,0,15,789,0,804
756,2019-08-22,4,12,1298,0,1314
756,2019-08-23,1538,868,1547,0,3953
756,2019-08-24,1592,1518,1532,0,4642
756,2019-08-25,1418,4318,1710,1,7447
756,2019-08-26,1262,1677,1741,0,4680
756,2019-08-27,1892,1772,2007,1,5672
756,2019-08-28,1829,11734,1710,0,15273
756,2019-08-29,1905,13515,2430,1,17851
756,2019-08-30,1689,3633,1033,0,6355
756,2019-08-31,1337,78,4,0,1419
756,2019-09-01,1633,315,705,0,2653
756,2019-09-02,1070,250,11,0,1331
756,2019-09-03,2645,4067,1088,1,7801
756,2019-09-04,3602,12185,2442,0,18229
756,2019-09-05,2128,11531,1555,3,15217
756,2019-09-06,4880,11563,2318,0,18761
756,2019-09-07,4801,9626,2030,2,16459
756,2019-09-08,6234,4737,2256,0,13227
756,2019-09-09,7681,5404,1678,1,14764
756,2019-09-10,5005,8043,2115,1,15164
756,2019-09-11,3471,5834,1507,2,10814
756,2019-09-12,1549,7547,1519,2,10617
756,2019-09-13,1290,3265,1610,1,6166
756,2019-09-14,1361,6475,1840,0,9676
756,2019-09-15,2040,6649,1792,0,10481
756,2019-09-16,2212,9119,1631,1,12963
756,2019-09-17,3438,6084,2955,2,12479
756,2019-09-18,2569,11431,1397,1,15398
756,2019-09-19,2890,3182,1530,0,7602
756,2019-09-20,2224,8500,1779,2,12505
756,2019-09-21,3384,8772,1440,1,13597
756,2019-09-22,2256,9245,1210,0,12711
756,2019-09-23,830,10208,1763,0,12801
756,2019-09-24,1638,9356,2342,2,13338
756,2019-09-25,2180,7832,2265,5,12282
756,2019-09-26,687,9481,1291,0,11459
756,2019-09-27,1235,8789,1528,2,11554
756,2019-09-28,1931,16687,945,1,19564
756,2019-09-29,1904,16968,2022,1,20895
756,2019-09-30,407,26791,1400,2,28600
756,2019-10-01,2070,23177,1457,0,26704
756,2019-10-02,1098,15047,1711,0,17856
756,2019-10-03,1089,15093,1453,0,17635
756,2019-10-04,3796,14194,2395,1,20386
756,2019-10-05,2251,15548,1047,1,18847
756,2019-10-06,3761,8763,1998,1,14523
756,2019-10-07,1101,8034,2555,1,11691
756,2019-10-08,1471,12628,1785,2,15886
756,2019-10-09,1155,23126,1576,1,25858
756,2019-10-10,505,13987,2358,2,16852
756,2019-10-11,633,11328,1355,1,13317
756,2019-10-12,662,5650,2529,0,8841
756,2019-10-13,2253,9661,1454,1,13369
756,2019-10-14,1906,8266,1710,927,12809
756,2019-10-15,1719,3654,2252,3,7628
756,2019-10-16,2266,8789,1694,1,12750
756,2019-10-17,1664,5547,2005,5,9221
756,2019-10-18,2723,8647,1824,1,13195
756,2019-10-19,1726,5974,1783,2,9485
756,2019-10-20,839,3161,1491,3,5494
756,2019-10-21,803,11624,1372,2,13801
756,2019-10-22,1762,6647,1879,0,10288
756,2019-10-23,940,15439,1771,0,18150
756,2019-10-24,931,25690,1508,0,28129
756,2019-10-25,806,14844,1521,3,17174
756,2019-10-26,1441,14264,1664,0,17369
756,2019-10-27,4205,17023,1759,0,22987
756,2019-10-28,1299,15598,1380,0,18277
756,2019-10-29,2024,16152,1077,1,19254
756,2019-10-30,3891,15447,986,2,20326
756,2019-10-31,10123,12432,1740,1,24296
756,2019-11-01,3780,25229,1658,0,30667
756,2019-11-02,4326,26054,2093,1,32474
756,2019-11-03,1106,27608,1415,0,30129
756,2019-11-04,903,8236,1012,3,10154
756,2019-11-05,2381,3403,1604,0,7388
756,2019-11-06,4680,14625,1349,2,20656
756,2019-11-07,502,16785,1051,2,18340
756,2019-11-08,2162,10137,874,449,13622
756,2019-11-09,1603,13262,1773,0,16638
756,2019-11-10,1640,15090,1596,0,18326
756,2019-11-11,2041,9732,1800,0,13573
756,2019-11-12,3342,10410,2405,0,16157
756,2019-11-13,1238,14314,2032,0,17584
756,2019-11-14,1703,13317,1652,0,16672
756,2019-11-15,1818,4962,1955,0,8735
756,2019-11-16,3651,2767,2161,0,8579
756,2019-11-17,2311,3304,3273,0,8888
756,2019-11-18,2350,2351,2810,0,7511
756,2019-11-19,1947,5048,3171,0,10166
756,2019-11-20,669,1420,1619,0,3708
756,2019-11-21,749,5356,1811,0,7916
756,2019-11-22,1255,4655,1568,1,7479
756,2019-11-23,1312,6305,2742,1,10360
756,2019-11-24,1782,4637,1863,1,8283
756,2019-11-25,1763,6868,1740,0,10371
756,2019-11-26,1852,6177,1331,0,9360
756,2019-11-27,2824,6546,997,0,10367
756,2019-11-28,2036,6752,504,1,9293
756,2019-11-29,80,868,15,0,963
756,2019-08-25,1418,4318,1710,1,7447
756,2019-08-26,1262,1677,1741,0,4680
756,2019-08-27,1892,1772,2007,1,5672
756,2019-08-28,1829,11734,1710,0,15273
756,2019-08-29,1905,13515,2430,1,17851
756,2019-08-30,1689,3633,1033,0,6355
756,2019-08-31,1337,78,4,0,1419
756,2019-09-01,1633,315,705,0,2653
756,2019-09-02,1070,250,11,0,1331
756,2019-09-03,2645,4067,1088,1,7801
756,2019-09-04,3602,12185,2442,0,18229
756,2019-09-05,2128,11531,1555,3,15217
756,2019-09-06,4880,11563,2318,0,18761
756,2019-09-07,4801,9626,2030,2,16459
756,2019-09-08,6234,4737,2256,0,13227
756,2019-09-09,7681,5404,1678,1,14764
756,2019-09-10,5005,8043,2115,1,15164
756,2019-09-11,3471,5834,1507,2,10814
756,2019-09-12,1549,7547,1519,2,10617
756,2019-09-13,1290,3265,1610,1,6166
756,2019-09-14,1361,6475,1840,0,9676
756,2019-09-15,2040,6649,1792,0,10481
756,2019-09-16,2212,9119,1631,1,12963
756,2019-09-17,3438,6084,2955,2,12479
756,2019-09-18,2569,11431,1397,1,15398
756,2019-09-19,2890,3182,1530,0,7602
756,2019-09-20,2224,8500,1779,2,12505
756,2019-09-21,3384,8772,1440,1,13597
756,2019-09-22,2256,9245,1210,0,12711
756,2019-09-23,830,10208,1763,0,12801
756,2019-09-24,1638,9356,2342,2,13338
756,2019-09-25,2180,7832,2265,5,12282
756,2019-09-26,687,9481,1291,0,11459
756,2019-09-27,1235,8789,1528,2,11554
756,2019-09-28,1931,16687,945,1,19564
756,2019-09-29,1904,16968,2022,1,20895
756,2019-09-30,407,26791,1400,2,28600
756,2019-10-01,2070,23177,1457,0,26704
756,2019-10-02,1098,15047,1711,0,17856
756,2019-10-03,1089,15093,1453,0,17635
756,2019-10-04,3796,14194,2395,1,20386
756,2019-10-05,2251,15548,1047,1,18847
756,2019-10-06,3761,8763,1998,1,14523
756,2019-10-07,1101,8034,2555,1,11691
756,2019-10-08,1471,12628,1785,2,15886
756,2019-10-09,1155,23126,1576,1,25858
756,2019-10-10,505,13987,2358,2,16852
756,2019-10-11,633,11328,1355,1,13317
756,2019-10-12,662,5650,2529,0,8841
756,2019-10-13,2253,9661,1454,1,13369
756,2019-10-14,1906,8266,1710,927,12809
756,2019-10-15,1719,3654,2252,3,7628
756,2019-10-16,2266,8789,1694,1,12750
756,2019-10-17,1664,5547,2005,5,9221
756,2019-10-18,2723,8647,1824,1,13195
756,2019-10-19,1726,5974,1783,2,9485
756,2019-10-20,839,3161,1491,3,5494
756,2019-10-21,803,11624,1372,2,13801
756,2019-10-22,1762,6647,1879,0,10288
756,2019-10-23,940,15439,1771,0,18150
756,2019-10-24,931,25690,1508,0,28129
756,2019-10-25,806,14844,1521,3,17174
756,2019-10-26,1441,14264,1664,0,17369
756,2019-10-27,4205,17023,1759,0,22987
756,2019-10-28,1299,15598,1380,0,18277
756,2019-10-29,2024,16152,1077,1,19254
756,2019-10-30,3891,15447,986,2,20326
756,2019-10-31,10123,12432,1740,1,24296
756,2019-11-01,3780,25229,1658,0,30667
756,2019-11-02,4326,26054,2093,1,32474
756,2019-11-03,1106,27608,1415,0,30129
756,2019-11-04,903,8236,1012,3,10154
756,2019-11-05,2381,3403,1604,0,7388
756,2019-11-06,4680,14625,1349,2,20656
756,2019-11-07,502,16785,1051,2,18340
756,2019-11-08,2162,10137,874,449,13622
756,2019-11-09,1603,13262,1773,0,16638
756,2019-11-10,1640,15090,1596,0,18326
756,2019-11-11,2041,9732,1800,0,13573
756,2019-11-12,3342,10410,2405,0,16157
756,2019-11-13,1238,14314,2032,0,17584
756,2019-11-14,1703,13317,1652,0,16672
756,2019-11-15,1818,4962,1955,0,8735
756,2019-11-16,3651,2767,2161,0,8579
756,2019-11-17,2311,3304,3273,0,8888
756,2019-11-18,2350,2351,2810,0,7511
756,2019-11-19,1947,5048,3171,0,10166
756,2019-11-20,669,1420,1619,0,3708
756,2019-11-21,749,5356,1811,0,7916
756,2019-11-22,1255,4655,1568,1,7479
756,2019-11-23,1312,6305,2742,1,10360
756,2019-11-24,1782,4637,1863,1,8283
756,2019-11-25,1763,6868,1740,0,10371
756,2019-11-26,1852,6177,1331,0,9360
756,2019-11-27,2824,6546,997,0,10367
756,2019-11-28,2036,6752,504,1,9293
757,2019-08-22,237,10,1086,1,1334
757,2019-08-23,258,2003,920,0,3181
757,2019-08-24,281,2418,1836,0,4535
757,2019-08-25,357,14882,2072,1,17312
757,2019-08-26,253,23490,1413,4,25160
757,2019-08-27,253,10260,1930,0,12443
757,2019-08-28,1110,2982,1331,1,5424
757,2019-08-29,294,9023,1533,1,10851
757,2019-08-30,283,2779,1032,1,4095
757,2019-08-31,31,37,20,0,88
757,2019-09-01,65,1451,180,1,1697
757,2019-09-02,50,31,10,1,92
757,2019-09-03,99,3778,760,0,4637
757,2019-09-04,1221,14144,2045,0,17410
757,2019-09-05,414,8617,1565,7,10603
757,2019-09-06,344,9506,2368,1,12219
757,2019-09-07,1276,14973,2262,2,18513
757,2019-09-08,402,6388,1413,1,8204
757,2019-09-09,469,13572,2004,0,16045
757,2019-09-10,1407,11104,2190,0,14701
757,2019-09-11,1770,5866,2385,13,10034
757,2019-09-12,311,7510,1713,10,9544
757,2019-09-13,438,6514,2263,2,9217
757,2019-09-14,264,7886,1712,2,9864
757,2019-09-15,244,10950,2338,0,13532
757,2019-09-16,237,16123,1813,4,18177
757,2019-09-17,522,10297,1695,7,12521
757,2019-09-18,1128,19937,671,9,21745
757,2019-09-19,508,4111,1632,10,6261
757,2019-09-20,1219,14295,1944,10,17468
757,2019-09-21,1150,8837,1080,10,11077
757,2019-09-22,229,13790,1709,8,15736
757,2019-09-23,259,11107,1236,10,12612
757,2019-09-24,399,34390,1268,14,36071
757,2019-09-25,203,21093,1352,13,22661
757,2019-09-26,165,10463,1360,10,11998
757,2019-09-27,133,18403,1330,3,19869
757,2019-09-28,1322,37451,1496,3,40272
757,2019-09-29,173,33229,1334,1,34737
757,2019-09-30,1001,27467,1997,2,30467
757,2019-10-01,128,22928,1287,0,24343
757,2019-10-02,289,12454,1372,7,14122
757,2019-10-03,134,32208,1708,10,34060
757,2019-10-04,1405,21027,1365,10,23807
757,2019-10-05,124,24098,1968,10,26200
757,2019-10-06,130,18984,1949,12,21075
757,2019-10-07,191,8647,1081,9,9928
757,2019-10-08,135,18488,1681,12,20316
757,2019-10-09,138,24866,1620,12,26636
757,2019-10-10,251,35181,1830,12,37274
757,2019-10-11,325,31167,1971,700,34163
757,2019-10-12,239,30257,1130,1,31627
757,2019-10-13,1099,23304,1678,1,26082
757,2019-10-14,735,18082,2685,1,21503
757,2019-10-15,342,26274,1688,3,28307
757,2019-10-16,247,27933,1230,0,29410
757,2019-10-17,261,16223,1650,2,18136
757,2019-10-18,1212,19954,1215,0,22381
757,2019-10-19,294,16967,2625,0,19886
757,2019-10-20,325,32740,1156,2,34223
757,2019-10-21,1085,20930,1381,1,23397
757,2019-10-22,248,17380,1842,3,19473
757,2019-10-23,226,19154,2053,0,21433
757,2019-10-24,368,23775,1655,0,25798
757,2019-10-25,322,21253,1109,3,22687
757,2019-10-26,780,23999,1839,0,26618
757,2019-10-27,964,26869,1562,1,29396
757,2019-10-28,709,23715,1496,0,25920
757,2019-10-29,743,37962,1603,1,40309
757,2019-10-30,1743,40179,1634,2,43558
757,2019-10-31,262,27941,1867,1,30071
757,2019-11-01,1148,36953,1546,0,39647
757,2019-11-02,229,28007,1332,0,29568
757,2019-11-03,234,48254,1338,0,49826
757,2019-11-04,244,25026,1110,2,26382
757,2019-11-05,297,13935,2152,2,16386
757,2019-11-06,250,25028,1347,3,26628
757,2019-11-07,327,31004,647,0,31978
757,2019-11-08,545,20615,936,0,22096
757,2019-11-09,659,24745,1145,3,26552
757,2019-11-10,1144,27725,706,0,29575
757,2019-11-11,260,17148,1101,2,18511
757,2019-11-12,244,17573,2966,1,20784
757,2019-11-13,252,20707,1426,1,22386
757,2019-11-14,278,15057,2005,4,17344
757,2019-11-15,259,5350,3665,0,9274
757,2019-11-16,258,2494,3098,0,5850
757,2019-11-17,1237,2976,3600,0,7813
757,2019-11-18,318,3424,2817,1,6560
757,2019-11-19,309,3203,2428,5,5945
757,2019-11-20,287,1556,1977,1,3821
757,2019-11-21,261,5823,1739,3,7826
757,2019-11-22,1104,5529,1277,1,7911
757,2019-11-23,353,10660,1615,1,12629
757,2019-11-24,1259,9224,1862,1,12346
757,2019-11-25,253,7695,1635,0,9583
757,2019-11-26,253,9027,1494,0,10774
757,2019-11-27,240,6544,2125,2,8911
757,2019-11-28,279,10996,923,0,12198
757,2019-11-29,104,1147,2,0,1253
757,2019-08-21,0,2,1080,0,1082
757,2019-08-22,237,10,1086,1,1334
757,2019-08-23,258,2003,920,0,3181
757,2019-08-24,281,2418,1836,0,4535
757,2019-08-25,357,14882,2072,1,17312
757,2019-08-26,253,23490,1413,4,25160
757,2019-08-27,253,10260,1930,0,12443
757,2019-08-28,1110,2982,1331,1,5424
757,2019-08-29,294,9023,1533,1,10851
757,2019-08-30,283,2779,1032,1,4095
757,2019-08-31,31,37,20,0,88
757,2019-09-01,65,1451,180,1,1697
757,2019-09-02,50,31,10,1,92
757,2019-09-03,99,3778,760,0,4637
757,2019-09-04,1221,14144,2045,0,17410
757,2019-09-05,414,8617,1565,7,10603
757,2019-09-06,344,9506,2368,1,12219
757,2019-09-07,1276,14973,2262,2,18513
757,2019-09-08,402,6388,1413,1,8204
757,2019-09-09,469,13572,2004,0,16045
757,2019-09-10,1407,11104,2190,0,14701
757,2019-09-11,1770,5866,2385,13,10034
757,2019-09-12,311,7510,1713,10,9544
757,2019-09-13,438,6514,2263,2,9217
757,2019-09-14,264,7886,1712,2,9864
757,2019-09-15,244,10950,2338,0,13532
757,2019-09-16,237,16123,1813,4,18177
757,2019-09-17,522,10297,1695,7,12521
757,2019-09-18,1128,19937,671,9,21745
757,2019-09-19,508,4111,1632,10,6261
757,2019-09-20,1219,14295,1944,10,17468
757,2019-09-21,1150,8837,1080,10,11077
757,2019-09-22,229,13790,1709,8,15736
757,2019-09-23,259,11107,1236,10,12612
757,2019-09-24,399,34390,1268,14,36071
757,2019-09-25,203,21093,1352,13,22661
757,2019-09-26,165,10463,1360,10,11998
757,2019-09-27,133,18403,1330,3,19869
757,2019-09-28,1322,37451,1496,3,40272
757,2019-09-29,173,33229,1334,1,34737
757,2019-09-30,1001,27467,1997,2,30467
757,2019-10-01,128,22928,1287,0,24343
757,2019-10-02,289,12454,1372,7,14122
757,2019-10-03,134,32208,1708,10,34060
757,2019-10-04,1405,21027,1365,10,23807
757,2019-10-05,124,24098,1968,10,26200
757,2019-10-06,130,18984,1949,12,21075
757,2019-10-07,191,8647,1081,9,9928
757,2019-10-08,135,18488,1681,12,20316
757,2019-10-09,138,24866,1620,12,26636
757,2019-10-10,251,35181,1830,12,37274
757,2019-10-11,325,31167,1971,700,34163
757,2019-10-12,239,30257,1130,1,31627
757,2019-10-13,1099,23304,1678,1,26082
757,2019-10-14,735,18082,2685,1,21503
757,2019-10-15,342,26274,1688,3,28307
757,2019-10-16,247,27933,1230,0,29410
757,2019-10-17,261,16223,1650,2,18136
757,2019-10-18,1212,19954,1215,0,22381
757,2019-10-19,294,16967,2625,0,19886
757,2019-10-20,325,32740,1156,2,34223
757,2019-10-21,1085,20930,1381,1,23397
757,2019-10-22,248,17380,1842,3,19473
757,2019-10-23,226,19154,2053,0,21433
757,2019-10-24,368,23775,1655,0,25798
757,2019-10-25,322,21253,1109,3,22687
757,2019-10-26,780,23999,1839,0,26618
757,2019-10-27,964,26869,1562,1,29396
757,2019-10-28,709,23715,1496,0,25920
757,2019-10-29,743,37962,1603,1,40309
757,2019-10-30,1743,40179,1634,2,43558
757,2019-10-31,262,27941,1867,1,30071
757,2019-11-01,1148,36953,1546,0,39647
757,2019-11-02,229,28007,1332,0,29568
757,2019-11-03,234,48254,1338,0,49826
757,2019-11-04,244,25026,1110,2,26382
757,2019-11-05,297,13935,2152,2,16386
757,2019-11-06,250,25028,1347,3,26628
757,2019-11-07,327,31004,647,0,31978
757,2019-11-08,545,20615,936,0,22096
757,2019-11-09,659,24745,1145,3,26552
757,2019-11-10,1144,27725,706,0,29575
757,2019-11-11,260,17148,1101,2,18511
757,2019-11-12,244,17573,2966,1,20784
757,2019-11-13,252,20707,1426,1,22386
757,2019-11-14,278,15057,2005,4,17344
757,2019-11-15,259,5350,3665,0,9274
757,2019-11-16,258,2494,3098,0,5850
757,2019-11-17,1237,2976,3600,0,7813
757,2019-11-18,318,3424,2817,1,6560
757,2019-11-19,309,3203,2428,5,5945
757,2019-11-20,287,1556,1977,1,3821
757,2019-11-21,261,5823,1739,3,7826
757,2019-11-22,1104,5529,1277,1,7911
757,2019-11-23,353,10660,1615,1,12629
757,2019-11-24,1259,9224,1862,1,12346
757,2019-11-25,253,7695,1635,0,9583
757,2019-11-26,253,9027,1494,0,10774
757,2019-11-27,240,6544,2125,2,8911
757,2019-11-28,279,10996,923,0,12198
757,2019-11-29,104,1147,2,0,1253
757,2019-08-21,0,2,1080,0,1082
757,2019-08-22,237,10,1086,1,1334
757,2019-08-23,258,2003,920,0,3181
757,2019-08-24,281,2418,1836,0,4535
757,2019-08-25,357,14882,2072,1,17312
757,2019-08-26,253,23490,1413,4,25160
757,2019-08-27,253,10260,1930,0,12443
757,2019-08-28,1110,2982,1331,1,5424
757,2019-08-29,294,9023,1533,1,10851
757,2019-08-30,283,2779,1032,1,4095
757,2019-08-31,31,37,20,0,88
757,2019-09-01,65,1451,180,1,1697
757,2019-09-02,50,31,10,1,92
757,2019-09-03,99,3778,760,0,4637
757,2019-09-04,1221,14144,2045,0,17410
757,2019-09-05,414,8617,1565,7,10603
757,2019-09-06,344,9506,2368,1,12219
757,2019-09-07,1276,14973,2262,2,18513
757,2019-09-08,402,6388,1413,1,8204
757,2019-09-09,469,13572,2004,0,16045
757,2019-09-10,1407,11104,2190,0,14701
757,2019-09-11,1770,5866,2385,13,10034
757,2019-09-12,311,7510,1713,10,9544
757,2019-09-13,438,6514,2263,2,9217
757,2019-09-14,264,7886,1712,2,9864
757,2019-09-15,244,10950,2338,0,13532
757,2019-09-16,237,16123,1813,4,18177
757,2019-09-17,522,10297,1695,7,12521
757,2019-09-18,1128,19937,671,9,21745
757,2019-09-19,508,4111,1632,10,6261
757,2019-09-20,1219,14295,1944,10,17468
757,2019-09-21,1150,8837,1080,10,11077
757,2019-09-22,229,13790,1709,8,15736
757,2019-09-23,259,11107,1236,10,12612
757,2019-09-24,399,34390,1268,14,36071
757,2019-09-25,203,21093,1352,13,22661
757,2019-09-26,165,10463,1360,10,11998
757,2019-09-27,133,18403,1330,3,19869
757,2019-09-28,1322,37451,1496,3,40272
757,2019-09-29,173,33229,1334,1,34737
757,2019-09-30,1001,27467,1997,2,30467
757,2019-10-01,128,22928,1287,0,24343
757,2019-10-02,289,12454,1372,7,14122
757,2019-10-03,134,32208,1708,10,34060
757,2019-10-04,1405,21027,1365,10,23807
757,2019-10-05,124,24098,1968,10,26200
757,2019-10-06,130,18984,1949,12,21075
757,2019-10-07,191,8647,1081,9,9928
757,2019-10-08,135,18488,1681,12,20316
757,2019-10-09,138,24866,1620,12,26636
757,2019-10-10,251,35181,1830,12,37274
757,2019-10-11,325,31167,1971,700,34163
757,2019-10-12,239,30257,1130,1,31627
757,2019-10-13,1099,23304,1678,1,26082
757,2019-10-14,735,18082,2685,1,21503
757,2019-10-15,342,26274,1688,3,28307
757,2019-10-16,247,27933,1230,0,29410
757,2019-10-17,261,16223,1650,2,18136
757,2019-10-18,1212,19954,1215,0,22381
757,2019-10-19,294,16967,2625,0,19886
757,2019-10-20,325,32740,1156,2,34223
757,2019-10-21,1085,20930,1381,1,23397
757,2019-10-22,248,17380,1842,3,19473
757,2019-10-23,226,19154,2053,0,21433
757,2019-10-24,368,23775,1655,0,25798
757,2019-10-25,322,21253,1109,3,22687
757,2019-10-26,780,23999,1839,0,26618
757,2019-10-27,964,26869,1562,1,29396
757,2019-10-28,709,23715,1496,0,25920
757,2019-10-29,743,37962,1603,1,40309
757,2019-10-30,1743,40179,1634,2,43558
757,2019-10-31,262,27941,1867,1,30071
757,2019-11-01,1148,36953,1546,0,39647
757,2019-11-02,229,28007,1332,0,29568
757,2019-11-03,234,48254,1338,0,49826
757,2019-11-04,244,25026,1110,2,26382
757,2019-11-05,297,13935,2152,2,16386
757,2019-11-06,250,25028,1347,3,26628
757,2019-11-07,327,31004,647,0,31978
757,2019-11-08,545,20615,936,0,22096
757,2019-11-09,659,24745,1145,3,26552
757,2019-11-10,1144,27725,706,0,29575
757,2019-11-11,260,17148,1101,2,18511
757,2019-11-12,244,17573,2966,1,20784
757,2019-11-13,252,20707,1426,1,22386
757,2019-11-14,278,15057,2005,4,17344
757,2019-11-15,259,5350,3665,0,9274
757,2019-11-16,258,2494,3098,0,5850
757,2019-11-17,1237,2976,3600,0,7813
757,2019-11-18,318,3424,2817,1,6560
757,2019-11-19,309,3203,2428,5,5945
757,2019-11-20,287,1556,1977,1,3821
757,2019-11-21,261,5823,1739,3,7826
757,2019-11-22,1104,5529,1277,1,7911
757,2019-11-23,353,10660,1615,1,12629
757,2019-11-24,1259,9224,1862,1,12346
757,2019-11-25,253,7695,1635,0,9583
757,2019-11-26,253,9027,1494,0,10774
757,2019-11-27,240,6544,2125,2,8911
757,2019-11-28,279,10996,923,0,12198
757,2019-11-29,104,1147,2,0,1253
757,2019-08-22,237,10,1086,1,1334
757,2019-08-23,258,2003,920,0,3181
757,2019-08-24,281,2418,1836,0,4535
757,2019-08-25,357,14882,2072,1,17312
757,2019-08-26,253,23490,1413,4,25160
757,2019-08-27,253,10260,1930,0,12443
757,2019-08-28,1110,2982,1331,1,5424
757,2019-08-29,294,9023,1533,1,10851
757,2019-08-30,283,2779,1032,1,4095
757,2019-08-31,31,37,20,0,88
757,2019-09-01,65,1451,180,1,1697
757,2019-09-02,50,31,10,1,92
757,2019-09-03,99,3778,760,0,4637
757,2019-09-04,1221,14144,2045,0,17410
757,2019-09-05,414,8617,1565,7,10603
757,2019-09-06,344,9506,2368,1,12219
757,2019-09-07,1276,14973,2262,2,18513
757,2019-09-08,402,6388,1413,1,8204
757,2019-09-09,469,13572,2004,0,16045
757,2019-09-10,1407,11104,2190,0,14701
757,2019-09-11,1770,5866,2385,13,10034
757,2019-09-12,311,7510,1713,10,9544
757,2019-09-13,438,6514,2263,2,9217
757,2019-09-14,264,7886,1712,2,9864
757,2019-09-15,244,10950,2338,0,13532
757,2019-09-16,237,16123,1813,4,18177
757,2019-09-17,522,10297,1695,7,12521
757,2019-09-18,1128,19937,671,9,21745
757,2019-09-19,508,4111,1632,10,6261
757,2019-09-20,1219,14295,1944,10,17468
757,2019-09-21,1150,8837,1080,10,11077
757,2019-09-22,229,13790,1709,8,15736
757,2019-09-23,259,11107,1236,10,12612
757,2019-09-24,399,34390,1268,14,36071
757,2019-09-25,203,21093,1352,13,22661
757,2019-09-26,165,10463,1360,10,11998
757,2019-09-27,133,18403,1330,3,19869
757,2019-09-28,1322,37451,1496,3,40272
757,2019-09-29,173,33229,1334,1,34737
757,2019-09-30,1001,27467,1997,2,30467
757,2019-10-01,128,22928,1287,0,24343
757,2019-10-02,289,12454,1372,7,14122
757,2019-10-03,134,32208,1708,10,34060
757,2019-10-04,1405,21027,1365,10,23807
757,2019-10-05,124,24098,1968,10,26200
757,2019-10-06,130,18984,1949,12,21075
757,2019-10-07,191,8647,1081,9,9928
757,2019-10-08,135,18488,1681,12,20316
757,2019-10-09,138,24866,1620,12,26636
757,2019-10-10,251,35181,1830,12,37274
757,2019-10-11,325,31167,1971,700,34163
757,2019-10-12,239,30257,1130,1,31627
757,2019-10-13,1099,23304,1678,1,26082
757,2019-10-14,735,18082,2685,1,21503
757,2019-10-15,342,26274,1688,3,28307
757,2019-10-16,247,27933,1230,0,29410
757,2019-10-17,261,16223,1650,2,18136
757,2019-10-18,1212,19954,1215,0,22381
757,2019-10-19,294,16967,2625,0,19886
757,2019-10-20,325,32740,1156,2,34223
757,2019-10-21,1085,20930,1381,1,23397
757,2019-10-22,248,17380,1842,3,19473
757,2019-10-23,226,19154,2053,0,21433
757,2019-10-24,368,23775,1655,0,25798
757,2019-10-25,322,21253,1109,3,22687
757,2019-10-26,780,23999,1839,0,26618
757,2019-10-27,964,26869,1562,1,29396
757,2019-10-28,709,23715,1496,0,25920
757,2019-10-29,743,37962,1603,1,40309
757,2019-10-30,1743,40179,1634,2,43558
757,2019-10-31,262,27941,1867,1,30071
757,2019-11-01,1148,36953,1546,0,39647
757,2019-11-02,229,28007,1332,0,29568
757,2019-11-03,234,48254,1338,0,49826
757,2019-11-04,244,25026,1110,2,26382
757,2019-11-05,297,13935,2152,2,16386
757,2019-11-06,250,25028,1347,3,26628
757,2019-11-07,327,31004,647,0,31978
757,2019-11-08,545,20615,936,0,22096
757,2019-11-09,659,24745,1145,3,26552
757,2019-11-10,1144,27725,706,0,29575
757,2019-11-11,260,17148,1101,2,18511
757,2019-11-12,244,17573,2966,1,20784
757,2019-11-13,252,20707,1426,1,22386
757,2019-11-14,278,15057,2005,4,17344
757,2019-11-15,259,5350,3665,0,9274
757,2019-11-16,258,2494,3098,0,5850
757,2019-11-17,1237,2976,3600,0,7813
757,2019-11-18,318,3424,2817,1,6560
757,2019-11-19,309,3203,2428,5,5945
757,2019-11-20,287,1556,1977,1,3821
757,2019-11-21,261,5823,1739,3,7826
757,2019-11-22,1104,5529,1277,1,7911
757,2019-11-23,353,10660,1615,1,12629
757,2019-11-24,1259,9224,1862,1,12346
757,2019-11-25,253,7695,1635,0,9583
757,2019-11-26,253,9027,1494,0,10774
757,2019-11-27,240,6544,2125,2,8911
758,2019-08-22,10,2,1356,1,1369
758,2019-08-23,260,914,1277,1,2452
758,2019-08-24,347,4511,1154,1,6013
758,2019-08-25,821,2712,1950,1,5484
758,2019-08-26,318,2249,1591,0,4158
758,2019-08-27,1116,6439,1260,3,8818
758,2019-08-28,253,3185,1935,1,5374
758,2019-08-29,381,9624,1713,0,11718
758,2019-08-30,273,2727,749,1,3750
758,2019-08-31,54,46,1,0,101
758,2019-09-01,62,542,375,0,979
758,2019-09-02,61,111,58,0,230
758,2019-09-03,948,3224,2332,0,6504
758,2019-09-04,278,13751,2401,0,16430
758,2019-09-05,309,8233,2082,2,10626
758,2019-09-06,1206,17019,1546,0,19771
758,2019-09-07,434,22299,1237,1,23971
758,2019-09-08,1250,5344,1440,0,8034
758,2019-09-09,321,8918,1493,1,10733
758,2019-09-10,351,13853,1543,0,15747
758,2019-09-11,223,5848,1872,2,7945
758,2019-09-12,240,12362,1201,1,13804
758,2019-09-13,426,5035,1736,0,7197
758,2019-09-14,254,7716,1444,0,9414
758,2019-09-15,1192,6348,1746,1,9287
758,2019-09-16,259,11679,2528,0,14466
758,2019-09-17,259,8696,2070,0,11025
758,2019-09-18,339,12039,980,1,13359
758,2019-09-19,574,4132,1260,0,5966
758,2019-09-20,1140,7516,1405,1,10062
758,2019-09-21,1147,8548,1080,2,10777
758,2019-09-22,1208,13891,2033,0,17132
758,2019-09-23,1159,15800,3034,4,19997
758,2019-09-24,1237,22473,1642,1,25353
758,2019-09-25,188,15616,1569,3,17376
758,2019-09-26,151,10507,2172,1,12831
758,2019-09-27,210,20129,1996,3,22338
758,2019-09-28,129,20995,1156,2,22282
758,2019-09-29,144,25428,1630,2,27204
758,2019-09-30,124,20990,1479,1,22594
758,2019-10-01,1006,20735,1216,0,22957
758,2019-10-02,1926,12758,1564,1,16249
758,2019-10-03,1040,13202,1499,0,15741
758,2019-10-04,477,24558,1571,0,26606
758,2019-10-05,119,31919,2257,2,34297
758,2019-10-06,996,10460,1741,1,13198
758,2019-10-07,121,6515,1697,2,8335
758,2019-10-08,271,17486,1471,4,19232
758,2019-10-09,474,24752,1616,0,26842
758,2019-10-10,363,32628,1994,1,34986
758,2019-10-11,394,21251,1489,0,23134
758,2019-10-12,231,5676,1930,3,7840
758,2019-10-13,1108,11039,1892,5,14044
758,2019-10-14,214,4040,2219,0,6473
758,2019-10-15,421,13686,2287,1,16395
758,2019-10-16,231,23056,1094,2,24383
758,2019-10-17,256,8321,1682,0,10259
758,2019-10-18,1316,13420,1653,2,16391
758,2019-10-19,318,6536,2953,0,9807
758,2019-10-20,250,12199,2088,3,14540
758,2019-10-21,591,22980,1610,4,25185
758,2019-10-22,367,8124,1256,1,9748
758,2019-10-23,223,8647,1462,4,10336
758,2019-10-24,245,19575,1329,0,21149
758,2019-10-25,256,18380,1014,2,19652
758,2019-10-26,302,24147,2084,1,26534
758,2019-10-27,242,26375,891,1,27509
758,2019-10-28,698,29892,1534,2,32126
758,2019-10-29,319,20837,1329,0,22485
758,2019-10-30,736,16457,1837,1,19031
758,2019-10-31,1765,19257,1777,0,22799
758,2019-11-01,720,26139,1753,0,28612
758,2019-11-02,1709,15534,1264,3,18510
758,2019-11-03,223,21485,1838,0,23546
758,2019-11-04,235,6443,1176,0,7854
758,2019-11-05,288,1268,1582,1,3139
758,2019-11-06,245,13492,1171,0,14908
758,2019-11-07,313,16073,1035,3,17424
758,2019-11-08,2407,8779,1832,1,13019
758,2019-11-09,923,16915,1551,0,19389
758,2019-11-10,982,12734,890,0,14606
758,2019-11-11,259,7766,1646,3,9674
758,2019-11-12,1510,8384,2803,4,12701
758,2019-11-13,1242,18355,1577,1,21175
758,2019-11-14,296,8912,1935,1,11144
758,2019-11-15,704,2057,2494,1,5256
758,2019-11-16,1278,4094,1914,0,7286
758,2019-11-17,386,1357,3701,6,5450
758,2019-11-18,266,1229,3436,1,4932
758,2019-11-19,338,2767,3047,888,7040
758,2019-11-20,280,878,2677,0,3835
758,2019-11-21,360,4786,2027,0,7173
758,2019-11-22,271,7491,1265,0,9027
758,2019-11-23,1176,6597,2633,0,10406
758,2019-11-24,331,5428,1815,0,7574
758,2019-11-25,596,5804,1826,0,8226
758,2019-11-26,236,9303,1770,0,11309
758,2019-11-27,1070,5287,1854,0,8211
758,2019-11-28,255,10876,424,0,11555
758,2019-11-29,130,921,4,0,1055
758,2019-08-22,10,2,1356,1,1369
758,2019-08-23,260,914,1277,1,2452
758,2019-08-24,347,4511,1154,1,6013
758,2019-08-25,821,2712,1950,1,5484
758,2019-08-26,318,2249,1591,0,4158
758,2019-08-27,1116,6439,1260,3,8818
758,2019-08-28,253,3185,1935,1,5374
758,2019-08-29,381,9624,1713,0,11718
758,2019-08-30,273,2727,749,1,3750
758,2019-08-31,54,46,1,0,101
758,2019-09-01,62,542,375,0,979
758,2019-09-02,61,111,58,0,230
758,2019-09-03,948,3224,2332,0,6504
758,2019-09-04,278,13751,2401,0,16430
758,2019-09-05,309,8233,2082,2,10626
758,2019-09-06,1206,17019,1546,0,19771
758,2019-09-07,434,22299,1237,1,23971
758,2019-09-08,1250,5344,1440,0,8034
758,2019-09-09,321,8918,1493,1,10733
758,2019-09-10,351,13853,1543,0,15747
758,2019-09-11,223,5848,1872,2,7945
758,2019-09-12,240,12362,1201,1,13804
758,2019-09-13,426,5035,1736,0,7197
758,2019-09-14,254,7716,1444,0,9414
758,2019-09-15,1192,6348,1746,1,9287
758,2019-09-16,259,11679,2528,0,14466
758,2019-09-17,259,8696,2070,0,11025
758,2019-09-18,339,12039,980,1,13359
758,2019-09-19,574,4132,1260,0,5966
758,2019-09-20,1140,7516,1405,1,10062
758,2019-09-21,1147,8548,1080,2,10777
758,2019-09-22,1208,13891,2033,0,17132
758,2019-09-23,1159,15800,3034,4,19997
758,2019-09-24,1237,22473,1642,1,25353
758,2019-09-25,188,15616,1569,3,17376
758,2019-09-26,151,10507,2172,1,12831
758,2019-09-27,210,20129,1996,3,22338
758,2019-09-28,129,20995,1156,2,22282
758,2019-09-29,144,25428,1630,2,27204
758,2019-09-30,124,20990,1479,1,22594
758,2019-10-01,1006,20735,1216,0,22957
758,2019-10-02,1926,12758,1564,1,16249
758,2019-10-03,1040,13202,1499,0,15741
758,2019-10-04,477,24558,1571,0,26606
758,2019-10-05,119,31919,2257,2,34297
758,2019-10-06,996,10460,1741,1,13198
758,2019-10-07,121,6515,1697,2,8335
758,2019-10-08,271,17486,1471,4,19232
758,2019-10-09,474,24752,1616,0,26842
758,2019-10-10,363,32628,1994,1,34986
758,2019-10-11,394,21251,1489,0,23134
758,2019-10-12,231,5676,1930,3,7840
758,2019-10-13,1108,11039,1892,5,14044
758,2019-10-14,214,4040,2219,0,6473
758,2019-10-15,421,13686,2287,1,16395
758,2019-10-16,231,23056,1094,2,24383
758,2019-10-17,256,8321,1682,0,10259
758,2019-10-18,1316,13420,1653,2,16391
758,2019-10-19,318,6536,2953,0,9807
758,2019-10-20,250,12199,2088,3,14540
758,2019-10-21,591,22980,1610,4,25185
758,2019-10-22,367,8124,1256,1,9748
758,2019-10-23,223,8647,1462,4,10336
758,2019-10-24,245,19575,1329,0,21149
758,2019-10-25,256,18380,1014,2,19652
758,2019-10-26,302,24147,2084,1,26534
758,2019-10-27,242,26375,891,1,27509
758,2019-10-28,698,29892,1534,2,32126
758,2019-10-29,319,20837,1329,0,22485
758,2019-10-30,736,16457,1837,1,19031
758,2019-10-31,1765,19257,1777,0,22799
758,2019-11-01,720,26139,1753,0,28612
758,2019-11-02,1709,15534,1264,3,18510
758,2019-11-03,223,21485,1838,0,23546
758,2019-11-04,235,6443,1176,0,7854
758,2019-11-05,288,1268,1582,1,3139
758,2019-11-06,245,13492,1171,0,14908
758,2019-11-07,313,16073,1035,3,17424
758,2019-11-08,2407,8779,1832,1,13019
758,2019-11-09,923,16915,1551,0,19389
758,2019-11-10,982,12734,890,0,14606
758,2019-11-11,259,7766,1646,3,9674
758,2019-11-12,1510,8384,2803,4,12701
758,2019-11-13,1242,18355,1577,1,21175
758,2019-11-14,296,8912,1935,1,11144
758,2019-11-15,704,2057,2494,1,5256
758,2019-11-16,1278,4094,1914,0,7286
758,2019-11-17,386,1357,3701,6,5450
758,2019-11-18,266,1229,3436,1,4932
758,2019-11-19,338,2767,3047,888,7040
758,2019-11-20,280,878,2677,0,3835
758,2019-11-21,360,4786,2027,0,7173
758,2019-11-22,271,7491,1265,0,9027
758,2019-11-23,1176,6597,2633,0,10406
758,2019-11-24,331,5428,1815,0,7574
758,2019-11-25,596,5804,1826,0,8226
758,2019-11-26,236,9303,1770,0,11309
758,2019-11-27,1070,5287,1854,0,8211
758,2019-11-28,255,10876,424,0,11555
758,2019-11-29,130,921,4,0,1055
758,2019-08-21,0,0,540,0,540
758,2019-08-22,10,2,1356,1,1369
758,2019-08-23,260,914,1277,1,2452
758,2019-08-24,347,4511,1154,1,6013
758,2019-08-25,821,2712,1950,1,5484
758,2019-08-26,318,2249,1591,0,4158
758,2019-08-27,1116,6439,1260,3,8818
758,2019-08-28,253,3185,1935,1,5374
758,2019-08-29,381,9624,1713,0,11718
758,2019-08-30,273,2727,749,1,3750
758,2019-08-31,54,46,1,0,101
758,2019-09-01,62,542,375,0,979
758,2019-09-02,61,111,58,0,230
758,2019-09-03,948,3224,2332,0,6504
758,2019-09-04,278,13751,2401,0,16430
758,2019-09-05,309,8233,2082,2,10626
758,2019-09-06,1206,17019,1546,0,19771
758,2019-09-07,434,22299,1237,1,23971
758,2019-09-08,1250,5344,1440,0,8034
758,2019-09-09,321,8918,1493,1,10733
758,2019-09-10,351,13853,1543,0,15747
758,2019-09-11,223,5848,1872,2,7945
758,2019-09-12,240,12362,1201,1,13804
758,2019-09-13,426,5035,1736,0,7197
758,2019-09-14,254,7716,1444,0,9414
758,2019-09-15,1192,6348,1746,1,9287
758,2019-09-16,259,11679,2528,0,14466
758,2019-09-17,259,8696,2070,0,11025
758,2019-09-18,339,12039,980,1,13359
758,2019-09-19,574,4132,1260,0,5966
758,2019-09-20,1140,7516,1405,1,10062
758,2019-09-21,1147,8548,1080,2,10777
758,2019-09-22,1208,13891,2033,0,17132
758,2019-09-23,1159,15800,3034,4,19997
758,2019-09-24,1237,22473,1642,1,25353
758,2019-09-25,188,15616,1569,3,17376
758,2019-09-26,151,10507,2172,1,12831
758,2019-09-27,210,20129,1996,3,22338
758,2019-09-28,129,20995,1156,2,22282
758,2019-09-29,144,25428,1630,2,27204
758,2019-09-30,124,20990,1479,1,22594
758,2019-10-01,1006,20735,1216,0,22957
758,2019-10-02,1926,12758,1564,1,16249
758,2019-10-03,1040,13202,1499,0,15741
758,2019-10-04,477,24558,1571,0,26606
758,2019-10-05,119,31919,2257,2,34297
758,2019-10-06,996,10460,1741,1,13198
758,2019-10-07,121,6515,1697,2,8335
758,2019-10-08,271,17486,1471,4,19232
758,2019-10-09,474,24752,1616,0,26842
758,2019-10-10,363,32628,1994,1,34986
758,2019-10-11,394,21251,1489,0,23134
758,2019-10-12,231,5676,1930,3,7840
758,2019-10-13,1108,11039,1892,5,14044
758,2019-10-14,214,4040,2219,0,6473
758,2019-10-15,421,13686,2287,1,16395
758,2019-10-16,231,23056,1094,2,24383
758,2019-10-17,256,8321,1682,0,10259
758,2019-10-18,1316,13420,1653,2,16391
758,2019-10-19,318,6536,2953,0,9807
758,2019-10-20,250,12199,2088,3,14540
758,2019-10-21,591,22980,1610,4,25185
758,2019-10-22,367,8124,1256,1,9748
758,2019-10-23,223,8647,1462,4,10336
758,2019-10-24,245,19575,1329,0,21149
758,2019-10-25,256,18380,1014,2,19652
758,2019-10-26,302,24147,2084,1,26534
758,2019-10-27,242,26375,891,1,27509
758,2019-10-28,698,29892,1534,2,32126
758,2019-10-29,319,20837,1329,0,22485
758,2019-10-30,736,16457,1837,1,19031
758,2019-10-31,1765,19257,1777,0,22799
758,2019-11-01,720,26139,1753,0,28612
758,2019-11-02,1709,15534,1264,3,18510
758,2019-11-03,223,21485,1838,0,23546
758,2019-11-04,235,6443,1176,0,7854
758,2019-11-05,288,1268,1582,1,3139
758,2019-11-06,245,13492,1171,0,14908
758,2019-11-07,313,16073,1035,3,17424
758,2019-11-08,2407,8779,1832,1,13019
758,2019-11-09,923,16915,1551,0,19389
758,2019-11-10,982,12734,890,0,14606
758,2019-11-11,259,7766,1646,3,9674
758,2019-11-12,1510,8384,2803,4,12701
758,2019-11-13,1242,18355,1577,1,21175
758,2019-11-14,296,8912,1935,1,11144
758,2019-11-15,704,2057,2494,1,5256
758,2019-11-16,1278,4094,1914,0,7286
758,2019-11-17,386,1357,3701,6,5450
758,2019-11-18,266,1229,3436,1,4932
758,2019-11-19,338,2767,3047,888,7040
758,2019-11-20,280,878,2677,0,3835
758,2019-11-21,360,4786,2027,0,7173
758,2019-11-22,271,7491,1265,0,9027
758,2019-11-23,1176,6597,2633,0,10406
758,2019-11-24,331,5428,1815,0,7574
758,2019-11-25,596,5804,1826,0,8226
758,2019-11-26,236,9303,1770,0,11309
758,2019-11-27,1070,5287,1854,0,8211
758,2019-11-28,255,10876,424,0,11555
758,2019-11-29,130,921,4,0,1055
758,2019-08-22,10,2,1356,1,1369
758,2019-08-23,260,914,1277,1,2452
758,2019-08-24,347,4511,1154,1,6013
758,2019-08-25,821,2712,1950,1,5484
758,2019-08-26,318,2249,1591,0,4158
758,2019-08-27,1116,6439,1260,3,8818
758,2019-08-28,253,3185,1935,1,5374
758,2019-08-29,381,9624,1713,0,11718
758,2019-08-30,273,2727,749,1,3750
758,2019-08-31,54,46,1,0,101
758,2019-09-01,62,542,375,0,979
758,2019-09-02,61,111,58,0,230
758,2019-09-03,948,3224,2332,0,6504
758,2019-09-04,278,13751,2401,0,16430
758,2019-09-05,309,8233,2082,2,10626
758,2019-09-06,1206,17019,1546,0,19771
758,2019-09-07,434,22299,1237,1,23971
758,2019-09-08,1250,5344,1440,0,8034
758,2019-09-09,321,8918,1493,1,10733
758,2019-09-10,351,13853,1543,0,15747
758,2019-09-11,223,5848,1872,2,7945
758,2019-09-12,240,12362,1201,1,13804
758,2019-09-13,426,5035,1736,0,7197
758,2019-09-14,254,7716,1444,0,9414
758,2019-09-15,1192,6348,1746,1,9287
758,2019-09-16,259,11679,2528,0,14466
758,2019-09-17,259,8696,2070,0,11025
758,2019-09-18,339,12039,980,1,13359
758,2019-09-19,574,4132,1260,0,5966
758,2019-09-20,1140,7516,1405,1,10062
758,2019-09-21,1147,8548,1080,2,10777
758,2019-09-22,1208,13891,2033,0,17132
758,2019-09-23,1159,15800,3034,4,19997
758,2019-09-24,1237,22473,1642,1,25353
758,2019-09-25,188,15616,1569,3,17376
758,2019-09-26,151,10507,2172,1,12831
758,2019-09-27,210,20129,1996,3,22338
758,2019-09-28,129,20995,1156,2,22282
758,2019-09-29,144,25428,1630,2,27204
758,2019-09-30,124,20990,1479,1,22594
758,2019-10-01,1006,20735,1216,0,22957
758,2019-10-02,1926,12758,1564,1,16249
758,2019-10-03,1040,13202,1499,0,15741
758,2019-10-04,477,24558,1571,0,26606
758,2019-10-05,119,31919,2257,2,34297
758,2019-10-06,996,10460,1741,1,13198
758,2019-10-07,121,6515,1697,2,8335
758,2019-10-08,271,17486,1471,4,19232
758,2019-10-09,474,24752,1616,0,26842
758,2019-10-10,363,32628,1994,1,34986
758,2019-10-11,394,21251,1489,0,23134
758,2019-10-12,231,5676,1930,3,7840
758,2019-10-13,1108,11039,1892,5,14044
758,2019-10-14,214,4040,2219,0,6473
758,2019-10-15,421,13686,2287,1,16395
758,2019-10-16,231,23056,1094,2,24383
758,2019-10-17,256,8321,1682,0,10259
758,2019-10-18,1316,13420,1653,2,16391
758,2019-10-19,318,6536,2953,0,9807
758,2019-10-20,250,12199,2088,3,14540
758,2019-10-21,591,22980,1610,4,25185
758,2019-10-22,367,8124,1256,1,9748
758,2019-10-23,223,8647,1462,4,10336
758,2019-10-24,245,19575,1329,0,21149
758,2019-10-25,256,18380,1014,2,19652
758,2019-10-26,302,24147,2084,1,26534
758,2019-10-27,242,26375,891,1,27509
758,2019-10-28,698,29892,1534,2,32126
758,2019-10-29,319,20837,1329,0,22485
758,2019-10-30,736,16457,1837,1,19031
758,2019-10-31,1765,19257,1777,0,22799
758,2019-11-01,720,26139,1753,0,28612
758,2019-11-02,1709,15534,1264,3,18510
758,2019-11-03,223,21485,1838,0,23546
758,2019-11-04,235,6443,1176,0,7854
758,2019-11-05,288,1268,1582,1,3139
758,2019-11-06,245,13492,1171,0,14908
758,2019-11-07,313,16073,1035,3,17424
758,2019-11-08,2407,8779,1832,1,13019
758,2019-11-09,923,16915,1551,0,19389
758,2019-11-10,982,12734,890,0,14606
758,2019-11-11,259,7766,1646,3,9674
758,2019-11-12,1510,8384,2803,4,12701
758,2019-11-13,1242,18355,1577,1,21175
758,2019-11-14,296,8912,1935,1,11144
758,2019-11-15,704,2057,2494,1,5256
758,2019-11-16,1278,4094,1914,0,7286
758,2019-11-17,386,1357,3701,6,5450
758,2019-11-18,266,1229,3436,1,4932
758,2019-11-19,338,2767,3047,888,7040
759,2019-08-22,11,0,1445,1,1457
759,2019-08-23,247,1240,2438,0,3925
759,2019-08-24,362,2440,1187,0,3989
759,2019-08-25,405,1897,2345,1,4648
759,2019-08-26,288,4216,2056,1,6561
759,2019-08-27,297,6729,1375,0,8401
759,2019-08-28,276,2150,2073,0,4499
759,2019-08-29,289,16631,1766,0,18686
759,2019-08-30,276,5318,586,1,6181
759,2019-08-31,39,198,5,0,242
759,2019-09-01,111,1408,246,0,1765
759,2019-09-02,40,427,92,0,559
759,2019-09-03,124,707,1643,0,2474
759,2019-09-04,421,8531,2144,0,11096
759,2019-09-05,259,9021,1578,2,10860
759,2019-09-06,317,6919,1691,0,8927
759,2019-09-07,433,11839,2552,1,14825
759,2019-09-08,403,4331,1621,0,6355
759,2019-09-09,511,10266,941,1,11719
759,2019-09-10,1222,12552,2651,0,16425
759,2019-09-11,176,6552,1146,2,7876
759,2019-09-12,1031,15601,2284,2,18918
759,2019-09-13,397,8035,1935,1,10368
759,2019-09-14,258,7455,1522,3,9238
759,2019-09-15,351,8562,1955,0,10868
759,2019-09-16,220,5829,1662,1,7712
759,2019-09-17,370,9896,2370,1,12637
759,2019-09-18,301,12427,2045,0,14773
759,2019-09-19,437,2877,1748,0,5062
759,2019-09-20,360,7844,1419,0,9623
759,2019-09-21,1210,6181,1860,0,9251
759,2019-09-22,261,8591,2213,1,11066
759,2019-09-23,270,7358,2286,1,9915
759,2019-09-24,352,7291,1700,2,9345
759,2019-09-25,772,6246,1440,0,8458
759,2019-09-26,155,8583,1746,4,10488
759,2019-09-27,123,8222,2189,1,10535
759,2019-09-28,135,14712,1888,0,16735
759,2019-09-29,131,15743,2416,3,18293
759,2019-09-30,117,16517,1825,0,18459
759,2019-10-01,140,15682,1653,2,17477
759,2019-10-02,1072,10583,2024,1,13680
759,2019-10-03,863,12980,1215,0,15058
759,2019-10-04,113,10952,2344,0,13409
759,2019-10-05,313,13361,1408,3,15085
759,2019-10-06,146,10260,1888,3,12297
759,2019-10-07,139,4638,1713,0,6490
759,2019-10-08,794,11903,1629,2,14328
759,2019-10-09,1179,12702,1934,1,15816
759,2019-10-10,1259,10203,1975,1,13438
759,2019-10-11,353,10075,1739,3,12170
759,2019-10-12,1012,3773,1789,1,6575
759,2019-10-13,223,7179,2243,2,9647
759,2019-10-14,281,4042,3069,2,7394
759,2019-10-15,324,6840,1184,1,8349
759,2019-10-16,287,11733,964,3,12987
759,2019-10-17,286,4102,1462,0,5850
759,2019-10-18,290,7346,2123,0,9759
759,2019-10-19,295,3823,1673,1,5792
759,2019-10-20,275,1602,1736,0,3613
759,2019-10-21,832,9817,2148,5,12802
759,2019-10-22,288,4676,2040,1,7005
759,2019-10-23,931,7156,1856,3,9946
759,2019-10-24,271,12672,2104,1,15048
759,2019-10-25,309,10211,1573,4,12097
759,2019-10-26,321,12633,2125,0,15079
759,2019-10-27,1070,15523,992,0,17585
759,2019-10-28,265,22195,1767,0,24227
759,2019-10-29,306,17052,897,0,18255
759,2019-10-30,277,15809,1115,0,17201
759,2019-10-31,260,11389,1786,0,13435
759,2019-11-01,1017,13315,1120,0,15452
759,2019-11-02,241,13142,1577,0,14960
759,2019-11-03,997,21586,1833,0,24416
759,2019-11-04,1950,6458,1463,0,9871
759,2019-11-05,269,1059,2083,0,3411
759,2019-11-06,338,7263,881,0,8482
759,2019-11-07,327,12928,1685,0,14940
759,2019-11-08,731,8626,723,0,10080
759,2019-11-09,247,7928,1916,0,10091
759,2019-11-10,1779,11569,1503,0,14851
759,2019-11-11,715,8062,1642,0,10419
759,2019-11-12,255,8674,2959,0,11888
759,2019-11-13,236,10991,1997,0,13224
759,2019-11-14,1151,7747,1506,0,10404
759,2019-11-15,1149,4388,3819,0,9356
759,2019-11-16,245,2672,2910,0,5827
759,2019-11-17,364,3363,3507,0,7234
759,2019-11-18,249,3236,3958,0,7443
759,2019-11-19,344,3394,2582,0,6320
759,2019-11-20,1206,1952,2162,0,5320
759,2019-11-21,355,6031,1814,0,8200
759,2019-11-22,286,8267,1340,0,9893
759,2019-11-23,245,7067,2426,0,9738
759,2019-11-24,335,7753,1851,0,9939
759,2019-11-25,762,7057,1835,0,9654
759,2019-11-26,229,6413,1877,0,8519
759,2019-11-27,254,6521,1098,0,7873
759,2019-11-28,260,7790,358,0,8408
759,2019-11-29,81,1148,0,0,1229
759,2019-08-23,247,1240,2438,0,3925
759,2019-08-24,362,2440,1187,0,3989
759,2019-08-25,405,1897,2345,1,4648
759,2019-08-26,288,4216,2056,1,6561
759,2019-08-27,297,6729,1375,0,8401
759,2019-08-28,276,2150,2073,0,4499
759,2019-08-29,289,16631,1766,0,18686
759,2019-08-30,276,5318,586,1,6181
759,2019-08-31,39,198,5,0,242
759,2019-09-01,111,1408,246,0,1765
759,2019-09-02,40,427,92,0,559
759,2019-09-03,124,707,1643,0,2474
759,2019-09-04,421,8531,2144,0,11096
759,2019-09-05,259,9021,1578,2,10860
759,2019-09-06,317,6919,1691,0,8927
759,2019-09-07,433,11839,2552,1,14825
759,2019-09-08,403,4331,1621,0,6355
759,2019-09-09,511,10266,941,1,11719
759,2019-09-10,1222,12552,2651,0,16425
759,2019-09-11,176,6552,1146,2,7876
759,2019-09-12,1031,15601,2284,2,18918
759,2019-09-13,397,8035,1935,1,10368
759,2019-09-14,258,7455,1522,3,9238
759,2019-09-15,351,8562,1955,0,10868
759,2019-09-16,220,5829,1662,1,7712
759,2019-09-17,370,9896,2370,1,12637
759,2019-09-18,301,12427,2045,0,14773
759,2019-09-19,437,2877,1748,0,5062
759,2019-09-20,360,7844,1419,0,9623
759,2019-09-21,1210,6181,1860,0,9251
759,2019-09-22,261,8591,2213,1,11066
759,2019-09-23,270,7358,2286,1,9915
759,2019-09-24,352,7291,1700,2,9345
759,2019-09-25,772,6246,1440,0,8458
759,2019-09-26,155,8583,1746,4,10488
759,2019-09-27,123,8222,2189,1,10535
759,2019-09-28,135,14712,1888,0,16735
759,2019-09-29,131,15743,2416,3,18293
759,2019-09-30,117,16517,1825,0,18459
759,2019-10-01,140,15682,1653,2,17477
759,2019-10-02,1072,10583,2024,1,13680
759,2019-10-03,863,12980,1215,0,15058
759,2019-10-04,113,10952,2344,0,13409
759,2019-10-05,313,13361,1408,3,15085
759,2019-10-06,146,10260,1888,3,12297
759,2019-10-07,139,4638,1713,0,6490
759,2019-10-08,794,11903,1629,2,14328
759,2019-10-09,1179,12702,1934,1,15816
759,2019-10-10,1259,10203,1975,1,13438
759,2019-10-11,353,10075,1739,3,12170
759,2019-10-12,1012,3773,1789,1,6575
759,2019-10-13,223,7179,2243,2,9647
759,2019-10-14,281,4042,3069,2,7394
759,2019-10-15,324,6840,1184,1,8349
759,2019-10-16,287,11733,964,3,12987
759,2019-10-17,286,4102,1462,0,5850
759,2019-10-18,290,7346,2123,0,9759
759,2019-10-19,295,3823,1673,1,5792
759,2019-10-20,275,1602,1736,0,3613
759,2019-10-21,832,9817,2148,5,12802
759,2019-10-22,288,4676,2040,1,7005
759,2019-10-23,931,7156,1856,3,9946
759,2019-10-24,271,12672,2104,1,15048
759,2019-10-25,309,10211,1573,4,12097
759,2019-10-26,321,12633,2125,0,15079
759,2019-10-27,1070,15523,992,0,17585
759,2019-10-28,265,22195,1767,0,24227
759,2019-10-29,306,17052,897,0,18255
759,2019-10-30,277,15809,1115,0,17201
759,2019-10-31,260,11389,1786,0,13435
759,2019-11-01,1017,13315,1120,0,15452
759,2019-11-02,241,13142,1577,0,14960
759,2019-11-03,997,21586,1833,0,24416
759,2019-11-04,1950,6458,1463,0,9871
759,2019-11-05,269,1059,2083,0,3411
759,2019-11-06,338,7263,881,0,8482
759,2019-11-07,327,12928,1685,0,14940
759,2019-11-08,731,8626,723,0,10080
759,2019-11-09,247,7928,1916,0,10091
759,2019-11-10,1779,11569,1503,0,14851
759,2019-11-11,715,8062,1642,0,10419
759,2019-11-12,255,8674,2959,0,11888
759,2019-11-13,236,10991,1997,0,13224
759,2019-11-14,1151,7747,1506,0,10404
759,2019-11-15,1149,4388,3819,0,9356
759,2019-11-16,245,2672,2910,0,5827
759,2019-11-17,364,3363,3507,0,7234
759,2019-11-18,249,3236,3958,0,7443
759,2019-11-19,344,3394,2582,0,6320
759,2019-11-20,1206,1952,2162,0,5320
759,2019-11-21,355,6031,1814,0,8200
759,2019-11-22,286,8267,1340,0,9893
759,2019-11-23,245,7067,2426,0,9738
759,2019-11-24,335,7753,1851,0,9939
759,2019-11-25,762,7057,1835,0,9654
759,2019-11-26,229,6413,1877,0,8519
759,2019-11-27,254,6521,1098,0,7873
759,2019-11-28,260,7790,358,0,8408
759,2019-11-29,81,1148,0,0,1229
759,2019-08-21,0,0,614,0,614
759,2019-08-22,11,0,1445,1,1457
759,2019-08-23,247,1240,2438,0,3925
759,2019-08-24,362,2440,1187,0,3989
759,2019-08-25,405,1897,2345,1,4648
759,2019-08-26,288,4216,2056,1,6561
759,2019-08-27,297,6729,1375,0,8401
759,2019-08-28,276,2150,2073,0,4499
759,2019-08-29,289,16631,1766,0,18686
759,2019-08-30,276,5318,586,1,6181
759,2019-08-31,39,198,5,0,242
759,2019-09-01,111,1408,246,0,1765
759,2019-09-02,40,427,92,0,559
759,2019-09-03,124,707,1643,0,2474
759,2019-09-04,421,8531,2144,0,11096
759,2019-09-05,259,9021,1578,2,10860
759,2019-09-06,317,6919,1691,0,8927
759,2019-09-07,433,11839,2552,1,14825
759,2019-09-08,403,4331,1621,0,6355
759,2019-09-09,511,10266,941,1,11719
759,2019-09-10,1222,12552,2651,0,16425
759,2019-09-11,176,6552,1146,2,7876
759,2019-09-12,1031,15601,2284,2,18918
759,2019-09-13,397,8035,1935,1,10368
759,2019-09-14,258,7455,1522,3,9238
759,2019-09-15,351,8562,1955,0,10868
759,2019-09-16,220,5829,1662,1,7712
759,2019-09-17,370,9896,2370,1,12637
759,2019-09-18,301,12427,2045,0,14773
759,2019-09-19,437,2877,1748,0,5062
759,2019-09-20,360,7844,1419,0,9623
759,2019-09-21,1210,6181,1860,0,9251
759,2019-09-22,261,8591,2213,1,11066
759,2019-09-23,270,7358,2286,1,9915
759,2019-09-24,352,7291,1700,2,9345
759,2019-09-25,772,6246,1440,0,8458
759,2019-09-26,155,8583,1746,4,10488
759,2019-09-27,123,8222,2189,1,10535
759,2019-09-28,135,14712,1888,0,16735
759,2019-09-29,131,15743,2416,3,18293
759,2019-09-30,117,16517,1825,0,18459
759,2019-10-01,140,15682,1653,2,17477
759,2019-10-02,1072,10583,2024,1,13680
759,2019-10-03,863,12980,1215,0,15058
759,2019-10-04,113,10952,2344,0,13409
759,2019-10-05,313,13361,1408,3,15085
759,2019-10-06,146,10260,1888,3,12297
759,2019-10-07,139,4638,1713,0,6490
759,2019-10-08,794,11903,1629,2,14328
759,2019-10-09,1179,12702,1934,1,15816
759,2019-10-10,1259,10203,1975,1,13438
759,2019-10-11,353,10075,1739,3,12170
759,2019-10-12,1012,3773,1789,1,6575
759,2019-10-13,223,7179,2243,2,9647
759,2019-10-14,281,4042,3069,2,7394
759,2019-10-15,324,6840,1184,1,8349
759,2019-10-16,287,11733,964,3,12987
759,2019-10-17,286,4102,1462,0,5850
759,2019-10-18,290,7346,2123,0,9759
759,2019-10-19,295,3823,1673,1,5792
759,2019-10-20,275,1602,1736,0,3613
759,2019-10-21,832,9817,2148,5,12802
759,2019-10-22,288,4676,2040,1,7005
759,2019-10-23,931,7156,1856,3,9946
759,2019-10-24,271,12672,2104,1,15048
759,2019-10-25,309,10211,1573,4,12097
759,2019-10-26,321,12633,2125,0,15079
759,2019-10-27,1070,15523,992,0,17585
759,2019-10-28,265,22195,1767,0,24227
759,2019-10-29,306,17052,897,0,18255
759,2019-10-30,277,15809,1115,0,17201
759,2019-10-31,260,11389,1786,0,13435
759,2019-11-01,1017,13315,1120,0,15452
759,2019-11-02,241,13142,1577,0,14960
759,2019-11-03,997,21586,1833,0,24416
759,2019-11-04,1950,6458,1463,0,9871
759,2019-11-05,269,1059,2083,0,3411
759,2019-11-06,338,7263,881,0,8482
759,2019-11-07,327,12928,1685,0,14940
759,2019-11-08,731,8626,723,0,10080
759,2019-11-09,247,7928,1916,0,10091
759,2019-11-10,1779,11569,1503,0,14851
759,2019-11-11,715,8062,1642,0,10419
759,2019-11-12,255,8674,2959,0,11888
759,2019-11-13,236,10991,1997,0,13224
759,2019-11-14,1151,7747,1506,0,10404
759,2019-11-15,1149,4388,3819,0,9356
759,2019-11-16,245,2672,2910,0,5827
759,2019-11-17,364,3363,3507,0,7234
759,2019-11-18,249,3236,3958,0,7443
759,2019-11-19,344,3394,2582,0,6320
759,2019-11-20,1206,1952,2162,0,5320
759,2019-11-21,355,6031,1814,0,8200
759,2019-11-22,286,8267,1340,0,9893
759,2019-11-23,245,7067,2426,0,9738
759,2019-11-24,335,7753,1851,0,9939
759,2019-11-25,762,7057,1835,0,9654
759,2019-11-26,229,6413,1877,0,8519
759,2019-11-27,254,6521,1098,0,7873
759,2019-11-28,260,7790,358,0,8408
759,2019-08-22,11,0,1445,1,1457
759,2019-08-23,247,1240,2438,0,3925
759,2019-08-24,362,2440,1187,0,3989
759,2019-08-25,405,1897,2345,1,4648
759,2019-08-26,288,4216,2056,1,6561
759,2019-08-27,297,6729,1375,0,8401
759,2019-08-28,276,2150,2073,0,4499
759,2019-08-29,289,16631,1766,0,18686
759,2019-08-30,276,5318,586,1,6181
759,2019-08-31,39,198,5,0,242
759,2019-09-01,111,1408,246,0,1765
759,2019-09-02,40,427,92,0,559
759,2019-09-03,124,707,1643,0,2474
759,2019-09-04,421,8531,2144,0,11096
759,2019-09-05,259,9021,1578,2,10860
759,2019-09-06,317,6919,1691,0,8927
759,2019-09-07,433,11839,2552,1,14825
759,2019-09-08,403,4331,1621,0,6355
759,2019-09-09,511,10266,941,1,11719
759,2019-09-10,1222,12552,2651,0,16425
759,2019-09-11,176,6552,1146,2,7876
759,2019-09-12,1031,15601,2284,2,18918
759,2019-09-13,397,8035,1935,1,10368
759,2019-09-14,258,7455,1522,3,9238
759,2019-09-15,351,8562,1955,0,10868
759,2019-09-16,220,5829,1662,1,7712
759,2019-09-17,370,9896,2370,1,12637
759,2019-09-18,301,12427,2045,0,14773
759,2019-09-19,437,2877,1748,0,5062
759,2019-09-20,360,7844,1419,0,9623
759,2019-09-21,1210,6181,1860,0,9251
759,2019-09-22,261,8591,2213,1,11066
759,2019-09-23,270,7358,2286,1,9915
759,2019-09-24,352,7291,1700,2,9345
759,2019-09-25,772,6246,1440,0,8458
759,2019-09-26,155,8583,1746,4,10488
759,2019-09-27,123,8222,2189,1,10535
759,2019-09-28,135,14712,1888,0,16735
759,2019-09-29,131,15743,2416,3,18293
759,2019-09-30,117,16517,1825,0,18459
759,2019-10-01,140,15682,1653,2,17477
759,2019-10-02,1072,10583,2024,1,13680
759,2019-10-03,863,12980,1215,0,15058
759,2019-10-04,113,10952,2344,0,13409
759,2019-10-05,313,13361,1408,3,15085
759,2019-10-06,146,10260,1888,3,12297
759,2019-10-07,139,4638,1713,0,6490
759,2019-10-08,794,11903,1629,2,14328
759,2019-10-09,1179,12702,1934,1,15816
759,2019-10-10,1259,10203,1975,1,13438
759,2019-10-11,353,10075,1739,3,12170
759,2019-10-12,1012,3773,1789,1,6575
759,2019-10-13,223,7179,2243,2,9647
759,2019-10-14,281,4042,3069,2,7394
759,2019-10-15,324,6840,1184,1,8349
759,2019-10-16,287,11733,964,3,12987
759,2019-10-17,286,4102,1462,0,5850
759,2019-10-18,290,7346,2123,0,9759
759,2019-10-19,295,3823,1673,1,5792
759,2019-10-20,275,1602,1736,0,3613
759,2019-10-21,832,9817,2148,5,12802
759,2019-10-22,288,4676,2040,1,7005
759,2019-10-23,931,7156,1856,3,9946
759,2019-10-24,271,12672,2104,1,15048
759,2019-10-25,309,10211,1573,4,12097
760,2019-08-22,370,8,1708,0,2086
760,2019-08-23,282,1109,760,0,2151
760,2019-08-24,1110,2224,2008,1,5343
760,2019-08-25,1618,12757,1262,2,15639
760,2019-08-26,354,14032,1350,1,15737
760,2019-08-27,269,8398,1800,0,10467
760,2019-08-28,511,11383,2071,2,13967
760,2019-08-29,1127,12347,1620,3,15097
760,2019-08-30,323,3643,639,1,4606
760,2019-08-31,38,93,0,0,131
760,2019-09-01,45,438,97,0,580
760,2019-09-02,50,772,36,0,858
760,2019-09-03,87,3867,1333,1,5288
760,2019-09-04,1142,16598,2012,4,19756
760,2019-09-05,259,8422,1867,1,10549
760,2019-09-06,354,12478,1758,0,14590
760,2019-09-07,423,8379,2080,0,10882
760,2019-09-08,376,8915,2160,0,11451
760,2019-09-09,1245,13626,1540,0,16411
760,2019-09-10,236,9194,2811,1,12242
760,2019-09-11,147,6322,1741,1,8211
760,2019-09-12,1048,13125,2228,1,16402
760,2019-09-13,385,4871,2366,0,7622
760,2019-09-14,1123,7746,1887,0,10756
760,2019-09-15,1084,13510,2354,1,16949
760,2019-09-16,1043,5860,2276,1,9180
760,2019-09-17,224,7492,1251,0,8967
760,2019-09-18,288,12187,1980,0,14455
760,2019-09-19,450,2861,1803,0,5114
760,2019-09-20,1307,11294,1890,0,14491
760,2019-09-21,1152,5117,1803,2,8074
760,2019-09-22,230,8378,1697,0,10305
760,2019-09-23,354,12647,2880,2,15883
760,2019-09-24,375,17853,1219,2,19449
760,2019-09-25,153,18176,1391,3,19723
760,2019-09-26,991,8885,2044,0,11920
760,2019-09-27,173,10871,1550,2,12596
760,2019-09-28,145,14629,1197,4,15975
760,2019-09-29,149,15858,1354,2,17363
760,2019-09-30,121,15369,2006,2,17498
760,2019-10-01,1018,15442,1231,0,17691
760,2019-10-02,129,11373,1605,0,13107
760,2019-10-03,155,11642,1362,1,13160
760,2019-10-04,482,15859,2202,3,18546
760,2019-10-05,494,36448,1510,1,38453
760,2019-10-06,845,16223,1819,1,18888
760,2019-10-07,1036,4309,2062,2,7409
760,2019-10-08,141,10923,1598,4,12666
760,2019-10-09,167,13737,1530,1,15435
760,2019-10-10,263,9570,1748,0,11581
760,2019-10-11,315,12938,2059,2,15314
760,2019-10-12,276,3698,874,1,4849
760,2019-10-13,210,7287,1508,4,9009
760,2019-10-14,249,3851,2184,0,6284
760,2019-10-15,1220,6860,1341,0,9421
760,2019-10-16,278,12023,1327,0,13628
760,2019-10-17,1152,3774,2265,2,7193
760,2019-10-18,303,6928,1294,2,8527
760,2019-10-19,802,3671,1725,1,6199
760,2019-10-20,501,800,2095,0,3396
760,2019-10-21,245,9639,1133,1,11018
760,2019-10-22,1156,4690,1374,2,7222
760,2019-10-23,918,6843,1383,6,9150
760,2019-10-24,275,19707,1153,3,21138
760,2019-10-25,652,18228,1359,1,20240
760,2019-10-26,1504,18116,1363,1,20984
760,2019-10-27,667,15951,1305,0,17923
760,2019-10-28,860,13699,1727,2,16288
760,2019-10-29,401,25263,1537,0,27201
760,2019-10-30,259,22977,1654,0,24890
760,2019-10-31,215,15153,1275,0,16643
760,2019-11-01,1099,13499,669,0,15267
760,2019-11-02,203,22475,1783,2,24463
760,2019-11-03,207,38277,1165,0,39649
760,2019-11-04,226,9298,1403,0,10927
760,2019-11-05,398,1337,1220,1,2956
760,2019-11-06,246,14794,1290,1,16331
760,2019-11-07,407,15971,1205,4,17587
760,2019-11-08,231,14516,1048,0,15795
760,2019-11-09,707,14712,1559,0,16978
760,2019-11-10,214,12989,1583,0,14786
760,2019-11-11,586,8207,1381,0,10174
760,2019-11-12,1126,9013,2815,0,12954
760,2019-11-13,223,20300,1976,0,22499
760,2019-11-14,1084,13741,1701,0,16526
760,2019-11-15,1921,3096,2804,0,7821
760,2019-11-16,253,1693,3392,0,5338
760,2019-11-17,379,1099,4036,0,5514
760,2019-11-18,234,1272,3318,0,4824
760,2019-11-19,308,2985,2512,0,5805
760,2019-11-20,270,916,2121,0,3307
760,2019-11-21,241,4816,1366,0,6423
760,2019-11-22,281,7632,1806,4,9723
760,2019-11-23,248,6624,1716,1,8589
760,2019-11-24,307,6826,2104,1,9238
760,2019-11-25,622,5533,2047,0,8202
760,2019-11-26,1496,5167,1425,0,8088
760,2019-11-27,226,5706,1414,3,7349
760,2019-11-28,251,6780,442,0,7473
760,2019-11-29,125,708,2,0,835
760,2019-08-22,370,8,1708,0,2086
760,2019-08-23,282,1109,760,0,2151
760,2019-08-24,1110,2224,2008,1,5343
760,2019-08-25,1618,12757,1262,2,15639
760,2019-08-26,354,14032,1350,1,15737
760,2019-08-27,269,8398,1800,0,10467
760,2019-08-28,511,11383,2071,2,13967
760,2019-08-29,1127,12347,1620,3,15097
760,2019-08-30,323,3643,639,1,4606
760,2019-08-31,38,93,0,0,131
760,2019-09-01,45,438,97,0,580
760,2019-09-02,50,772,36,0,858
760,2019-09-03,87,3867,1333,1,5288
760,2019-09-04,1142,16598,2012,4,19756
760,2019-09-05,259,8422,1867,1,10549
760,2019-09-06,354,12478,1758,0,14590
760,2019-09-07,423,8379,2080,0,10882
760,2019-09-08,376,8915,2160,0,11451
760,2019-09-09,1245,13626,1540,0,16411
760,2019-09-10,236,9194,2811,1,12242
760,2019-09-11,147,6322,1741,1,8211
760,2019-09-12,1048,13125,2228,1,16402
760,2019-09-13,385,4871,2366,0,7622
760,2019-09-14,1123,7746,1887,0,10756
760,2019-09-15,1084,13510,2354,1,16949
760,2019-09-16,1043,5860,2276,1,9180
760,2019-09-17,224,7492,1251,0,8967
760,2019-09-18,288,12187,1980,0,14455
760,2019-09-19,450,2861,1803,0,5114
760,2019-09-20,1307,11294,1890,0,14491
760,2019-09-21,1152,5117,1803,2,8074
760,2019-09-22,230,8378,1697,0,10305
760,2019-09-23,354,12647,2880,2,15883
760,2019-09-24,375,17853,1219,2,19449
760,2019-09-25,153,18176,1391,3,19723
760,2019-09-26,991,8885,2044,0,11920
760,2019-09-27,173,10871,1550,2,12596
760,2019-09-28,145,14629,1197,4,15975
760,2019-09-29,149,15858,1354,2,17363
760,2019-09-30,121,15369,2006,2,17498
760,2019-10-01,1018,15442,1231,0,17691
760,2019-10-02,129,11373,1605,0,13107
760,2019-10-03,155,11642,1362,1,13160
760,2019-10-04,482,15859,2202,3,18546
760,2019-10-05,494,36448,1510,1,38453
760,2019-10-06,845,16223,1819,1,18888
760,2019-10-07,1036,4309,2062,2,7409
760,2019-10-08,141,10923,1598,4,12666
760,2019-10-09,167,13737,1530,1,15435
760,2019-10-10,263,9570,1748,0,11581
760,2019-10-11,315,12938,2059,2,15314
760,2019-10-12,276,3698,874,1,4849
760,2019-10-13,210,7287,1508,4,9009
760,2019-10-14,249,3851,2184,0,6284
760,2019-10-15,1220,6860,1341,0,9421
760,2019-10-16,278,12023,1327,0,13628
760,2019-10-17,1152,3774,2265,2,7193
760,2019-10-18,303,6928,1294,2,8527
760,2019-10-19,802,3671,1725,1,6199
760,2019-10-20,501,800,2095,0,3396
760,2019-10-21,245,9639,1133,1,11018
760,2019-10-22,1156,4690,1374,2,7222
760,2019-10-23,918,6843,1383,6,9150
760,2019-10-24,275,19707,1153,3,21138
760,2019-10-25,652,18228,1359,1,20240
760,2019-10-26,1504,18116,1363,1,20984
760,2019-10-27,667,15951,1305,0,17923
760,2019-10-28,860,13699,1727,2,16288
760,2019-10-29,401,25263,1537,0,27201
760,2019-10-30,259,22977,1654,0,24890
760,2019-10-31,215,15153,1275,0,16643
760,2019-11-01,1099,13499,669,0,15267
760,2019-11-02,203,22475,1783,2,24463
760,2019-11-03,207,38277,1165,0,39649
760,2019-11-04,226,9298,1403,0,10927
760,2019-11-05,398,1337,1220,1,2956
760,2019-11-06,246,14794,1290,1,16331
760,2019-11-07,407,15971,1205,4,17587
760,2019-11-08,231,14516,1048,0,15795
760,2019-11-09,707,14712,1559,0,16978
760,2019-11-10,214,12989,1583,0,14786
760,2019-11-11,586,8207,1381,0,10174
760,2019-11-12,1126,9013,2815,0,12954
760,2019-11-13,223,20300,1976,0,22499
760,2019-11-14,1084,13741,1701,0,16526
760,2019-11-15,1921,3096,2804,0,7821
760,2019-11-16,253,1693,3392,0,5338
760,2019-11-17,379,1099,4036,0,5514
760,2019-11-18,234,1272,3318,0,4824
760,2019-11-19,308,2985,2512,0,5805
760,2019-11-20,270,916,2121,0,3307
760,2019-11-21,241,4816,1366,0,6423
760,2019-11-22,281,7632,1806,4,9723
760,2019-11-23,248,6624,1716,1,8589
760,2019-11-24,307,6826,2104,1,9238
760,2019-11-25,622,5533,2047,0,8202
760,2019-11-26,1496,5167,1425,0,8088
760,2019-11-27,226,5706,1414,3,7349
760,2019-11-28,251,6780,442,0,7473
760,2019-11-29,125,708,2,0,835
760,2019-08-21,0,0,522,0,522
760,2019-08-22,370,8,1708,0,2086
760,2019-08-23,282,1109,760,0,2151
760,2019-08-24,1110,2224,2008,1,5343
760,2019-08-25,1618,12757,1262,2,15639
760,2019-08-26,354,14032,1350,1,15737
760,2019-08-27,269,8398,1800,0,10467
760,2019-08-28,511,11383,2071,2,13967
760,2019-08-29,1127,12347,1620,3,15097
760,2019-08-30,323,3643,639,1,4606
760,2019-08-31,38,93,0,0,131
760,2019-09-01,45,438,97,0,580
760,2019-09-02,50,772,36,0,858
760,2019-09-03,87,3867,1333,1,5288
760,2019-09-04,1142,16598,2012,4,19756
760,2019-09-05,259,8422,1867,1,10549
760,2019-09-06,354,12478,1758,0,14590
760,2019-09-07,423,8379,2080,0,10882
760,2019-09-08,376,8915,2160,0,11451
760,2019-09-09,1245,13626,1540,0,16411
760,2019-09-10,236,9194,2811,1,12242
760,2019-09-11,147,6322,1741,1,8211
760,2019-09-12,1048,13125,2228,1,16402
760,2019-09-13,385,4871,2366,0,7622
760,2019-09-14,1123,7746,1887,0,10756
760,2019-09-15,1084,13510,2354,1,16949
760,2019-09-16,1043,5860,2276,1,9180
760,2019-09-17,224,7492,1251,0,8967
760,2019-09-18,288,12187,1980,0,14455
760,2019-09-19,450,2861,1803,0,5114
760,2019-09-20,1307,11294,1890,0,14491
760,2019-09-21,1152,5117,1803,2,8074
760,2019-09-22,230,8378,1697,0,10305
760,2019-09-23,354,12647,2880,2,15883
760,2019-09-24,375,17853,1219,2,19449
760,2019-09-25,153,18176,1391,3,19723
760,2019-09-26,991,8885,2044,0,11920
760,2019-09-27,173,10871,1550,2,12596
760,2019-09-28,145,14629,1197,4,15975
760,2019-09-29,149,15858,1354,2,17363
760,2019-09-30,121,15369,2006,2,17498
760,2019-10-01,1018,15442,1231,0,17691
760,2019-10-02,129,11373,1605,0,13107
760,2019-10-03,155,11642,1362,1,13160
760,2019-10-04,482,15859,2202,3,18546
760,2019-10-05,494,36448,1510,1,38453
760,2019-10-06,845,16223,1819,1,18888
760,2019-10-07,1036,4309,2062,2,7409
760,2019-10-08,141,10923,1598,4,12666
760,2019-10-09,167,13737,1530,1,15435
760,2019-10-10,263,9570,1748,0,11581
760,2019-10-11,315,12938,2059,2,15314
760,2019-10-12,276,3698,874,1,4849
760,2019-10-13,210,7287,1508,4,9009
760,2019-10-14,249,3851,2184,0,6284
760,2019-10-15,1220,6860,1341,0,9421
760,2019-10-16,278,12023,1327,0,13628
760,2019-10-17,1152,3774,2265,2,7193
760,2019-10-18,303,6928,1294,2,8527
760,2019-10-19,802,3671,1725,1,6199
760,2019-10-20,501,800,2095,0,3396
760,2019-10-21,245,9639,1133,1,11018
760,2019-10-22,1156,4690,1374,2,7222
760,2019-10-23,918,6843,1383,6,9150
760,2019-10-24,275,19707,1153,3,21138
760,2019-10-25,652,18228,1359,1,20240
760,2019-10-26,1504,18116,1363,1,20984
760,2019-10-27,667,15951,1305,0,17923
760,2019-10-28,860,13699,1727,2,16288
760,2019-10-29,401,25263,1537,0,27201
760,2019-10-30,259,22977,1654,0,24890
760,2019-10-31,215,15153,1275,0,16643
760,2019-11-01,1099,13499,669,0,15267
760,2019-11-02,203,22475,1783,2,24463
760,2019-11-03,207,38277,1165,0,39649
760,2019-11-04,226,9298,1403,0,10927
760,2019-11-05,398,1337,1220,1,2956
760,2019-11-06,246,14794,1290,1,16331
760,2019-11-07,407,15971,1205,4,17587
760,2019-11-08,231,14516,1048,0,15795
760,2019-11-09,707,14712,1559,0,16978
760,2019-11-10,214,12989,1583,0,14786
760,2019-11-11,586,8207,1381,0,10174
760,2019-11-12,1126,9013,2815,0,12954
760,2019-11-13,223,20300,1976,0,22499
760,2019-11-14,1084,13741,1701,0,16526
760,2019-11-15,1921,3096,2804,0,7821
760,2019-11-16,253,1693,3392,0,5338
760,2019-11-17,379,1099,4036,0,5514
760,2019-11-18,234,1272,3318,0,4824
760,2019-11-19,308,2985,2512,0,5805
760,2019-11-20,270,916,2121,0,3307
760,2019-11-21,241,4816,1366,0,6423
760,2019-11-22,281,7632,1806,4,9723
760,2019-11-23,248,6624,1716,1,8589
760,2019-11-24,307,6826,2104,1,9238
760,2019-11-25,622,5533,2047,0,8202
760,2019-11-26,1496,5167,1425,0,8088
760,2019-11-27,226,5706,1414,3,7349
760,2019-11-28,251,6780,442,0,7473
760,2019-11-29,125,708,2,0,835
760,2019-08-24,1110,2224,2008,1,5343
760,2019-08-25,1618,12757,1262,2,15639
760,2019-08-26,354,14032,1350,1,15737
760,2019-08-27,269,8398,1800,0,10467
760,2019-08-28,511,11383,2071,2,13967
760,2019-08-29,1127,12347,1620,3,15097
760,2019-08-30,323,3643,639,1,4606
760,2019-08-31,38,93,0,0,131
760,2019-09-01,45,438,97,0,580
760,2019-09-02,50,772,36,0,858
760,2019-09-03,87,3867,1333,1,5288
760,2019-09-04,1142,16598,2012,4,19756
760,2019-09-05,259,8422,1867,1,10549
760,2019-09-06,354,12478,1758,0,14590
760,2019-09-07,423,8379,2080,0,10882
760,2019-09-08,376,8915,2160,0,11451
760,2019-09-09,1245,13626,1540,0,16411
760,2019-09-10,236,9194,2811,1,12242
760,2019-09-11,147,6322,1741,1,8211
760,2019-09-12,1048,13125,2228,1,16402
760,2019-09-13,385,4871,2366,0,7622
760,2019-09-14,1123,7746,1887,0,10756
760,2019-09-15,1084,13510,2354,1,16949
760,2019-09-16,1043,5860,2276,1,9180
760,2019-09-17,224,7492,1251,0,8967
760,2019-09-18,288,12187,1980,0,14455
760,2019-09-19,450,2861,1803,0,5114
760,2019-09-20,1307,11294,1890,0,14491
760,2019-09-21,1152,5117,1803,2,8074
760,2019-09-22,230,8378,1697,0,10305
760,2019-09-23,354,12647,2880,2,15883
760,2019-09-24,375,17853,1219,2,19449
760,2019-09-25,153,18176,1391,3,19723
760,2019-09-26,991,8885,2044,0,11920
760,2019-09-27,173,10871,1550,2,12596
760,2019-09-28,145,14629,1197,4,15975
760,2019-09-29,149,15858,1354,2,17363
760,2019-09-30,121,15369,2006,2,17498
760,2019-10-01,1018,15442,1231,0,17691
760,2019-10-02,129,11373,1605,0,13107
760,2019-10-03,155,11642,1362,1,13160
760,2019-10-04,482,15859,2202,3,18546
760,2019-10-05,494,36448,1510,1,38453
760,2019-10-06,845,16223,1819,1,18888
760,2019-10-07,1036,4309,2062,2,7409
760,2019-10-08,141,10923,1598,4,12666
760,2019-10-09,167,13737,1530,1,15435
760,2019-10-10,263,9570,1748,0,11581
760,2019-10-11,315,12938,2059,2,15314
760,2019-10-12,276,3698,874,1,4849
760,2019-10-13,210,7287,1508,4,9009
760,2019-10-14,249,3851,2184,0,6284
760,2019-10-15,1220,6860,1341,0,9421
760,2019-10-16,278,12023,1327,0,13628
760,2019-10-17,1152,3774,2265,2,7193
760,2019-10-18,303,6928,1294,2,8527
760,2019-10-19,802,3671,1725,1,6199
760,2019-10-20,501,800,2095,0,3396
760,2019-10-21,245,9639,1133,1,11018
760,2019-10-22,1156,4690,1374,2,7222
760,2019-10-23,918,6843,1383,6,9150
760,2019-10-24,275,19707,1153,3,21138
760,2019-10-25,652,18228,1359,1,20240
760,2019-10-26,1504,18116,1363,1,20984
760,2019-10-27,667,15951,1305,0,17923
760,2019-10-28,860,13699,1727,2,16288
760,2019-10-29,401,25263,1537,0,27201
760,2019-10-30,259,22977,1654,0,24890
760,2019-10-31,215,15153,1275,0,16643
760,2019-11-01,1099,13499,669,0,15267
760,2019-11-02,203,22475,1783,2,24463
760,2019-11-03,207,38277,1165,0,39649
760,2019-11-04,226,9298,1403,0,10927
760,2019-11-05,398,1337,1220,1,2956
760,2019-11-06,246,14794,1290,1,16331
760,2019-11-07,407,15971,1205,4,17587
760,2019-11-08,231,14516,1048,0,15795
760,2019-11-09,707,14712,1559,0,16978
760,2019-11-10,214,12989,1583,0,14786
760,2019-11-11,586,8207,1381,0,10174
760,2019-11-12,1126,9013,2815,0,12954
760,2019-11-13,223,20300,1976,0,22499
760,2019-11-14,1084,13741,1701,0,16526
760,2019-11-15,1921,3096,2804,0,7821
760,2019-11-16,253,1693,3392,0,5338
760,2019-11-17,379,1099,4036,0,5514
760,2019-11-18,234,1272,3318,0,4824
760,2019-11-19,308,2985,2512,0,5805
760,2019-11-20,270,916,2121,0,3307
760,2019-11-21,241,4816,1366,0,6423
760,2019-11-22,281,7632,1806,4,9723
760,2019-11-23,248,6624,1716,1,8589
760,2019-11-24,307,6826,2104,1,9238
760,2019-11-25,622,5533,2047,0,8202
760,2019-11-26,1496,5167,1425,0,8088
760,2019-11-27,226,5706,1414,3,7349
761,2019-08-22,4,13,1194,0,1211
761,2019-08-23,948,1919,939,0,3806
761,2019-08-24,99,1986,1341,0,3426
761,2019-08-25,1272,15670,2211,1,19154
761,2019-08-26,76,23395,1624,1,25096
761,2019-08-27,77,10098,1681,1,11857
761,2019-08-28,934,11277,2116,1,14328
761,2019-08-29,137,12656,2255,1,15049
761,2019-08-30,444,2942,556,1,3943
761,2019-08-31,388,44,5,0,437
761,2019-09-01,99,1259,353,0,1711
761,2019-09-02,62,80,102,0,244
761,2019-09-03,879,3250,1360,1,5490
761,2019-09-04,441,13627,1867,0,15935
761,2019-09-05,158,18083,1439,0,19680
761,2019-09-06,129,14767,1476,2,16374
761,2019-09-07,321,12689,2332,1,15343
761,2019-09-08,323,4985,2168,0,7476
761,2019-09-09,1321,7703,2560,1,11585
761,2019-09-10,295,7250,1615,2,9162
761,2019-09-11,246,6013,1952,1,8212
761,2019-09-12,2053,7134,2439,1,11627
761,2019-09-13,118,3391,1847,0,5356
761,2019-09-14,946,8199,1839,1,10985
761,2019-09-15,1197,6957,2147,0,10301
761,2019-09-16,1106,6400,1472,1,8979
761,2019-09-17,81,11715,1328,0,13124
761,2019-09-18,2834,11916,1691,1,16442
761,2019-09-19,299,5090,1800,1,7190
761,2019-09-20,222,14182,2224,2,16630
761,2019-09-21,1513,7364,1953,1,10831
761,2019-09-22,91,8837,1262,0,10190
761,2019-09-23,473,10268,1475,0,12216
761,2019-09-24,132,9133,1990,1,11256
761,2019-09-25,988,8702,1555,3,11248
761,2019-09-26,101,11451,2196,3,13751
761,2019-09-27,93,9303,2002,1,11399
761,2019-09-28,878,13358,1224,2,15462
761,2019-09-29,80,19416,1712,1,21209
761,2019-09-30,93,18656,1240,0,19989
761,2019-10-01,1306,16819,1576,2,19703
761,2019-10-02,190,12513,1678,0,14381
761,2019-10-03,932,14831,1530,1,17294
761,2019-10-04,1187,12795,1474,1,15457
761,2019-10-05,95,14615,1742,1,16453
761,2019-10-06,140,12051,1269,2,13462
761,2019-10-07,2188,7065,1734,2,10989
761,2019-10-08,83,13003,1733,1,14820
761,2019-10-09,200,15293,1851,0,17344
761,2019-10-10,1883,11928,1790,1,15602
761,2019-10-11,1924,10715,1766,3,14408
761,2019-10-12,101,8163,1306,0,9570
761,2019-10-13,1180,8810,1776,1,11767
761,2019-10-14,952,6226,1890,0,9068
761,2019-10-15,2027,8550,1836,1,12414
761,2019-10-16,2040,12779,1068,3,15890
761,2019-10-17,96,5575,1213,0,6884
761,2019-10-18,110,8757,1987,1,10855
761,2019-10-19,2106,5733,1945,1,9785
761,2019-10-20,1795,4769,1643,2,8209
761,2019-10-21,803,10869,1329,5,13006
761,2019-10-22,1193,6706,1708,1,9608
761,2019-10-23,60,8991,2427,2,11480
761,2019-10-24,170,20406,1279,0,21855
761,2019-10-25,1687,14926,1009,1,17623
761,2019-10-26,915,13808,1197,0,15920
761,2019-10-27,103,16738,1059,0,17900
761,2019-10-28,2028,13624,1519,39,17210
761,2019-10-29,162,16209,1711,0,18082
761,2019-10-30,210,15644,944,0,16798
761,2019-10-31,1176,12723,1450,3,15352
761,2019-11-01,852,25189,1301,0,27342
761,2019-11-02,196,17165,1458,0,18819
761,2019-11-03,783,36940,1299,0,39022
761,2019-11-04,1428,11388,1281,1,14098
761,2019-11-05,159,3412,1663,0,5234
761,2019-11-06,748,14701,1440,4,16893
761,2019-11-07,169,16959,1690,0,18818
761,2019-11-08,100,10258,1157,1,11516
761,2019-11-09,757,13781,940,0,15478
761,2019-11-10,352,15900,1020,2,17274
761,2019-11-11,125,14363,1690,2,16180
761,2019-11-12,716,10644,3029,0,14389
761,2019-11-13,500,19406,1551,4,21461
761,2019-11-14,1342,10558,1718,1,13619
761,2019-11-15,977,3835,3005,0,7817
761,2019-11-16,370,2803,2906,0,6079
761,2019-11-17,1456,2992,2814,0,7262
761,2019-11-18,973,2654,2712,0,6339
761,2019-11-19,1262,3305,2630,0,7197
761,2019-11-20,118,1511,2127,0,3756
761,2019-11-21,399,3640,1665,0,5704
761,2019-11-22,1252,4731,1254,0,7237
761,2019-11-23,103,6346,3255,0,9704
761,2019-11-24,126,7151,1794,0,9071
761,2019-11-25,596,6947,1733,0,9276
761,2019-11-26,76,9242,1110,0,10428
761,2019-11-27,81,6602,1716,0,8399
761,2019-11-28,727,11062,639,0,12428
761,2019-11-29,17,322,0,0,339
761,2019-08-22,4,13,1194,0,1211
761,2019-08-23,948,1919,939,0,3806
761,2019-08-24,99,1986,1341,0,3426
761,2019-08-25,1272,15670,2211,1,19154
761,2019-08-26,76,23395,1624,1,25096
761,2019-08-27,77,10098,1681,1,11857
761,2019-08-28,934,11277,2116,1,14328
761,2019-08-29,137,12656,2255,1,15049
761,2019-08-30,444,2942,556,1,3943
761,2019-08-31,388,44,5,0,437
761,2019-09-01,99,1259,353,0,1711
761,2019-09-02,62,80,102,0,244
761,2019-09-03,879,3250,1360,1,5490
761,2019-09-04,441,13627,1867,0,15935
761,2019-09-05,158,18083,1439,0,19680
761,2019-09-06,129,14767,1476,2,16374
761,2019-09-07,321,12689,2332,1,15343
761,2019-09-08,323,4985,2168,0,7476
761,2019-09-09,1321,7703,2560,1,11585
761,2019-09-10,295,7250,1615,2,9162
761,2019-09-11,246,6013,1952,1,8212
761,2019-09-12,2053,7134,2439,1,11627
761,2019-09-13,118,3391,1847,0,5356
761,2019-09-14,946,8199,1839,1,10985
761,2019-09-15,1197,6957,2147,0,10301
761,2019-09-16,1106,6400,1472,1,8979
761,2019-09-17,81,11715,1328,0,13124
761,2019-09-18,2834,11916,1691,1,16442
761,2019-09-19,299,5090,1800,1,7190
761,2019-09-20,222,14182,2224,2,16630
761,2019-09-21,1513,7364,1953,1,10831
761,2019-09-22,91,8837,1262,0,10190
761,2019-09-23,473,10268,1475,0,12216
761,2019-09-24,132,9133,1990,1,11256
761,2019-09-25,988,8702,1555,3,11248
761,2019-09-26,101,11451,2196,3,13751
761,2019-09-27,93,9303,2002,1,11399
761,2019-09-28,878,13358,1224,2,15462
761,2019-09-29,80,19416,1712,1,21209
761,2019-09-30,93,18656,1240,0,19989
761,2019-10-01,1306,16819,1576,2,19703
761,2019-10-02,190,12513,1678,0,14381
761,2019-10-03,932,14831,1530,1,17294
761,2019-10-04,1187,12795,1474,1,15457
761,2019-10-05,95,14615,1742,1,16453
761,2019-10-06,140,12051,1269,2,13462
761,2019-10-07,2188,7065,1734,2,10989
761,2019-10-08,83,13003,1733,1,14820
761,2019-10-09,200,15293,1851,0,17344
761,2019-10-10,1883,11928,1790,1,15602
761,2019-10-11,1924,10715,1766,3,14408
761,2019-10-12,101,8163,1306,0,9570
761,2019-10-13,1180,8810,1776,1,11767
761,2019-10-14,952,6226,1890,0,9068
761,2019-10-15,2027,8550,1836,1,12414
761,2019-10-16,2040,12779,1068,3,15890
761,2019-10-17,96,5575,1213,0,6884
761,2019-10-18,110,8757,1987,1,10855
761,2019-10-19,2106,5733,1945,1,9785
761,2019-10-20,1795,4769,1643,2,8209
761,2019-10-21,803,10869,1329,5,13006
761,2019-10-22,1193,6706,1708,1,9608
761,2019-10-23,60,8991,2427,2,11480
761,2019-10-24,170,20406,1279,0,21855
761,2019-10-25,1687,14926,1009,1,17623
761,2019-10-26,915,13808,1197,0,15920
761,2019-10-27,103,16738,1059,0,17900
761,2019-10-28,2028,13624,1519,39,17210
761,2019-10-29,162,16209,1711,0,18082
761,2019-10-30,210,15644,944,0,16798
761,2019-10-31,1176,12723,1450,3,15352
761,2019-11-01,852,25189,1301,0,27342
761,2019-11-02,196,17165,1458,0,18819
761,2019-11-03,783,36940,1299,0,39022
761,2019-11-04,1428,11388,1281,1,14098
761,2019-11-05,159,3412,1663,0,5234
761,2019-11-06,748,14701,1440,4,16893
761,2019-11-07,169,16959,1690,0,18818
761,2019-11-08,100,10258,1157,1,11516
761,2019-11-09,757,13781,940,0,15478
761,2019-11-10,352,15900,1020,2,17274
761,2019-11-11,125,14363,1690,2,16180
761,2019-11-12,716,10644,3029,0,14389
761,2019-11-13,500,19406,1551,4,21461
761,2019-11-14,1342,10558,1718,1,13619
761,2019-11-15,977,3835,3005,0,7817
761,2019-11-16,370,2803,2906,0,6079
761,2019-11-17,1456,2992,2814,0,7262
761,2019-11-18,973,2654,2712,0,6339
761,2019-11-19,1262,3305,2630,0,7197
761,2019-11-20,118,1511,2127,0,3756
761,2019-11-21,399,3640,1665,0,5704
761,2019-11-22,1252,4731,1254,0,7237
761,2019-11-23,103,6346,3255,0,9704
761,2019-11-24,126,7151,1794,0,9071
761,2019-11-25,596,6947,1733,0,9276
761,2019-11-26,76,9242,1110,0,10428
761,2019-11-27,81,6602,1716,0,8399
761,2019-11-28,727,11062,639,0,12428
761,2019-11-29,17,322,0,0,339
761,2019-08-21,0,0,367,0,367
761,2019-08-22,4,13,1194,0,1211
761,2019-08-23,948,1919,939,0,3806
761,2019-08-24,99,1986,1341,0,3426
761,2019-08-25,1272,15670,2211,1,19154
761,2019-08-26,76,23395,1624,1,25096
761,2019-08-27,77,10098,1681,1,11857
761,2019-08-28,934,11277,2116,1,14328
761,2019-08-29,137,12656,2255,1,15049
761,2019-08-30,444,2942,556,1,3943
761,2019-08-31,388,44,5,0,437
761,2019-09-01,99,1259,353,0,1711
761,2019-09-02,62,80,102,0,244
761,2019-09-03,879,3250,1360,1,5490
761,2019-09-04,441,13627,1867,0,15935
761,2019-09-05,158,18083,1439,0,19680
761,2019-09-06,129,14767,1476,2,16374
761,2019-09-07,321,12689,2332,1,15343
761,2019-09-08,323,4985,2168,0,7476
761,2019-09-09,1321,7703,2560,1,11585
761,2019-09-10,295,7250,1615,2,9162
761,2019-09-11,246,6013,1952,1,8212
761,2019-09-12,2053,7134,2439,1,11627
761,2019-09-13,118,3391,1847,0,5356
761,2019-09-14,946,8199,1839,1,10985
761,2019-09-15,1197,6957,2147,0,10301
761,2019-09-16,1106,6400,1472,1,8979
761,2019-09-17,81,11715,1328,0,13124
761,2019-09-18,2834,11916,1691,1,16442
761,2019-09-19,299,5090,1800,1,7190
761,2019-09-20,222,14182,2224,2,16630
761,2019-09-21,1513,7364,1953,1,10831
761,2019-09-22,91,8837,1262,0,10190
761,2019-09-23,473,10268,1475,0,12216
761,2019-09-24,132,9133,1990,1,11256
761,2019-09-25,988,8702,1555,3,11248
761,2019-09-26,101,11451,2196,3,13751
761,2019-09-27,93,9303,2002,1,11399
761,2019-09-28,878,13358,1224,2,15462
761,2019-09-29,80,19416,1712,1,21209
761,2019-09-30,93,18656,1240,0,19989
761,2019-10-01,1306,16819,1576,2,19703
761,2019-10-02,190,12513,1678,0,14381
761,2019-10-03,932,14831,1530,1,17294
761,2019-10-04,1187,12795,1474,1,15457
761,2019-10-05,95,14615,1742,1,16453
761,2019-10-06,140,12051,1269,2,13462
761,2019-10-07,2188,7065,1734,2,10989
761,2019-10-08,83,13003,1733,1,14820
761,2019-10-09,200,15293,1851,0,17344
761,2019-10-10,1883,11928,1790,1,15602
761,2019-10-11,1924,10715,1766,3,14408
761,2019-10-12,101,8163,1306,0,9570
761,2019-10-13,1180,8810,1776,1,11767
761,2019-10-14,952,6226,1890,0,9068
761,2019-10-15,2027,8550,1836,1,12414
761,2019-10-16,2040,12779,1068,3,15890
761,2019-10-17,96,5575,1213,0,6884
761,2019-10-18,110,8757,1987,1,10855
761,2019-10-19,2106,5733,1945,1,9785
761,2019-10-20,1795,4769,1643,2,8209
761,2019-10-21,803,10869,1329,5,13006
761,2019-10-22,1193,6706,1708,1,9608
761,2019-10-23,60,8991,2427,2,11480
761,2019-10-24,170,20406,1279,0,21855
761,2019-10-25,1687,14926,1009,1,17623
761,2019-10-26,915,13808,1197,0,15920
761,2019-10-27,103,16738,1059,0,17900
761,2019-10-28,2028,13624,1519,39,17210
761,2019-10-29,162,16209,1711,0,18082
761,2019-10-30,210,15644,944,0,16798
761,2019-10-31,1176,12723,1450,3,15352
761,2019-11-01,852,25189,1301,0,27342
761,2019-11-02,196,17165,1458,0,18819
761,2019-11-03,783,36940,1299,0,39022
761,2019-11-04,1428,11388,1281,1,14098
761,2019-11-05,159,3412,1663,0,5234
761,2019-11-06,748,14701,1440,4,16893
761,2019-11-07,169,16959,1690,0,18818
761,2019-11-08,100,10258,1157,1,11516
761,2019-11-09,757,13781,940,0,15478
761,2019-11-10,352,15900,1020,2,17274
761,2019-11-11,125,14363,1690,2,16180
761,2019-11-12,716,10644,3029,0,14389
761,2019-11-13,500,19406,1551,4,21461
761,2019-11-14,1342,10558,1718,1,13619
761,2019-11-15,977,3835,3005,0,7817
761,2019-11-16,370,2803,2906,0,6079
761,2019-11-17,1456,2992,2814,0,7262
761,2019-11-18,973,2654,2712,0,6339
761,2019-11-19,1262,3305,2630,0,7197
761,2019-11-20,118,1511,2127,0,3756
761,2019-11-21,399,3640,1665,0,5704
761,2019-11-22,1252,4731,1254,0,7237
761,2019-11-23,103,6346,3255,0,9704
761,2019-11-24,126,7151,1794,0,9071
761,2019-11-25,596,6947,1733,0,9276
761,2019-11-26,76,9242,1110,0,10428
761,2019-11-27,81,6602,1716,0,8399
761,2019-11-28,727,11062,639,0,12428
761,2019-08-25,1272,15670,2211,1,19154
761,2019-08-26,76,23395,1624,1,25096
761,2019-08-27,77,10098,1681,1,11857
761,2019-08-28,934,11277,2116,1,14328
761,2019-08-29,137,12656,2255,1,15049
761,2019-08-30,444,2942,556,1,3943
761,2019-08-31,388,44,5,0,437
761,2019-09-01,99,1259,353,0,1711
761,2019-09-02,62,80,102,0,244
761,2019-09-03,879,3250,1360,1,5490
761,2019-09-04,441,13627,1867,0,15935
761,2019-09-05,158,18083,1439,0,19680
761,2019-09-06,129,14767,1476,2,16374
761,2019-09-07,321,12689,2332,1,15343
761,2019-09-08,323,4985,2168,0,7476
761,2019-09-09,1321,7703,2560,1,11585
761,2019-09-10,295,7250,1615,2,9162
761,2019-09-11,246,6013,1952,1,8212
761,2019-09-12,2053,7134,2439,1,11627
761,2019-09-13,118,3391,1847,0,5356
761,2019-09-14,946,8199,1839,1,10985
761,2019-09-15,1197,6957,2147,0,10301
761,2019-09-16,1106,6400,1472,1,8979
761,2019-09-17,81,11715,1328,0,13124
761,2019-09-18,2834,11916,1691,1,16442
761,2019-09-19,299,5090,1800,1,7190
761,2019-09-20,222,14182,2224,2,16630
761,2019-09-21,1513,7364,1953,1,10831
761,2019-09-22,91,8837,1262,0,10190
761,2019-09-23,473,10268,1475,0,12216
761,2019-09-24,132,9133,1990,1,11256
761,2019-09-25,988,8702,1555,3,11248
761,2019-09-26,101,11451,2196,3,13751
761,2019-09-27,93,9303,2002,1,11399
761,2019-09-28,878,13358,1224,2,15462
761,2019-09-29,80,19416,1712,1,21209
761,2019-09-30,93,18656,1240,0,19989
761,2019-10-01,1306,16819,1576,2,19703
761,2019-10-02,190,12513,1678,0,14381
761,2019-10-03,932,14831,1530,1,17294
761,2019-10-04,1187,12795,1474,1,15457
761,2019-10-05,95,14615,1742,1,16453
761,2019-10-06,140,12051,1269,2,13462
761,2019-10-07,2188,7065,1734,2,10989
761,2019-10-08,83,13003,1733,1,14820
761,2019-10-09,200,15293,1851,0,17344
761,2019-10-10,1883,11928,1790,1,15602
761,2019-10-11,1924,10715,1766,3,14408
761,2019-10-12,101,8163,1306,0,9570
761,2019-10-13,1180,8810,1776,1,11767
761,2019-10-14,952,6226,1890,0,9068
761,2019-10-15,2027,8550,1836,1,12414
761,2019-10-16,2040,12779,1068,3,15890
761,2019-10-17,96,5575,1213,0,6884
761,2019-10-18,110,8757,1987,1,10855
761,2019-10-19,2106,5733,1945,1,9785
761,2019-10-20,1795,4769,1643,2,8209
761,2019-10-21,803,10869,1329,5,13006
761,2019-10-22,1193,6706,1708,1,9608
761,2019-10-23,60,8991,2427,2,11480
761,2019-10-24,170,20406,1279,0,21855
761,2019-10-25,1687,14926,1009,1,17623
761,2019-10-26,915,13808,1197,0,15920
761,2019-10-27,103,16738,1059,0,17900
761,2019-10-28,2028,13624,1519,39,17210
761,2019-10-29,162,16209,1711,0,18082
761,2019-10-30,210,15644,944,0,16798
761,2019-10-31,1176,12723,1450,3,15352
761,2019-11-01,852,25189,1301,0,27342
761,2019-11-02,196,17165,1458,0,18819
761,2019-11-03,783,36940,1299,0,39022
761,2019-11-04,1428,11388,1281,1,14098
761,2019-11-05,159,3412,1663,0,5234
761,2019-11-06,748,14701,1440,4,16893
761,2019-11-07,169,16959,1690,0,18818
761,2019-11-08,100,10258,1157,1,11516
761,2019-11-09,757,13781,940,0,15478
761,2019-11-10,352,15900,1020,2,17274
761,2019-11-11,125,14363,1690,2,16180
761,2019-11-12,716,10644,3029,0,14389
761,2019-11-13,500,19406,1551,4,21461
761,2019-11-14,1342,10558,1718,1,13619
762,2019-08-22,18,2,961,2,983
762,2019-08-23,438,1468,1834,0,3740
762,2019-08-24,483,4283,1264,0,6030
762,2019-08-25,345,13755,1551,0,15651
762,2019-08-26,855,13301,1885,0,16041
762,2019-08-27,311,9394,1465,1,11171
762,2019-08-28,1193,4808,1880,1,7882
762,2019-08-29,417,10491,1568,1,12477
762,2019-08-30,202,3072,1109,1,4384
762,2019-08-31,81,13,3,0,97
762,2019-09-01,307,390,453,0,1150
762,2019-09-02,405,177,0,0,582
762,2019-09-03,369,535,661,1,1566
762,2019-09-04,747,11872,2503,1,15123
762,2019-09-05,637,5282,1763,0,7682
762,2019-09-06,531,8219,2107,0,10857
762,2019-09-07,358,12845,1947,0,15150
762,2019-09-08,432,17457,1469,1,19359
762,2019-09-09,379,6853,3118,0,10350
762,2019-09-10,1163,11389,2252,0,14804
762,2019-09-11,1275,6238,1672,2,9187
762,2019-09-12,290,11041,1841,0,13172
762,2019-09-13,449,6596,2039,1,9085
762,2019-09-14,1760,10591,1479,0,13830
762,2019-09-15,352,12220,1742,0,14314
762,2019-09-16,335,6068,2231,0,8634
762,2019-09-17,1008,8800,1248,0,11056
762,2019-09-18,1184,11816,1403,0,14403
762,2019-09-19,1377,2843,1657,3,5880
762,2019-09-20,438,9131,2439,1,12009
762,2019-09-21,386,8190,1893,1,10470
762,2019-09-22,276,8603,2020,0,10899
762,2019-09-23,1196,8396,1838,0,11430
762,2019-09-24,1274,7116,1699,3,10092
762,2019-09-25,1906,6703,1944,0,10553
762,2019-09-26,814,9112,1769,0,11695
762,2019-09-27,425,5311,2194,4,7934
762,2019-09-28,579,12283,1335,2,14199
762,2019-09-29,1869,15375,1259,2,18505
762,2019-09-30,179,15351,1345,2,16877
762,2019-10-01,1901,15536,1513,0,18950
762,2019-10-02,1061,11815,2341,0,15217
762,2019-10-03,213,13031,1603,1,14848
762,2019-10-04,263,11233,1608,1,13105
762,2019-10-05,273,13700,1173,0,15146
762,2019-10-06,159,10056,2242,2,12459
762,2019-10-07,2685,4950,1801,1,9437
762,2019-10-08,177,10525,1698,1,12401
762,2019-10-09,1435,14653,1142,1,17231
762,2019-10-10,2091,9845,2149,0,14085
762,2019-10-11,830,9441,1700,3,11974
762,2019-10-12,1764,3883,1765,0,7412
762,2019-10-13,313,7302,1735,1,9351
762,2019-10-14,1282,5164,2159,1,8606
762,2019-10-15,527,7522,1625,1,9675
762,2019-10-16,296,12109,712,5,13122
762,2019-10-17,756,3787,1971,0,6514
762,2019-10-18,339,6765,2663,1,9768
762,2019-10-19,340,3849,2153,0,6342
762,2019-10-20,410,864,2282,0,3556
762,2019-10-21,485,10314,1318,3,12120
762,2019-10-22,1156,4534,1620,2,7312
762,2019-10-23,458,8471,1150,1,10080
762,2019-10-24,440,12971,1898,2,15311
762,2019-10-25,431,9560,2038,2,12031
762,2019-10-26,749,20306,1658,3,22716
762,2019-10-27,319,17859,1629,0,19807
762,2019-10-28,327,13159,1295,0,14781
762,2019-10-29,363,14987,1165,1,16516
762,2019-10-30,464,14793,2125,1,17383
762,2019-10-31,285,19457,1901,2,21645
762,2019-11-01,612,26454,1109,0,28175
762,2019-11-02,283,15854,1280,0,17417
762,2019-11-03,300,21976,1589,0,23865
762,2019-11-04,325,6643,2002,0,8970
762,2019-11-05,797,1363,1889,36,4085
762,2019-11-06,401,13389,1519,2,15311
762,2019-11-07,434,15741,1028,1,17204
762,2019-11-08,333,8731,1479,0,10543
762,2019-11-09,371,7998,604,0,8973
762,2019-11-10,312,12478,1687,3,14480
762,2019-11-11,431,10207,1851,4,12493
762,2019-11-12,648,10777,2987,0,14412
762,2019-11-13,350,12051,1900,285,14586
762,2019-11-14,716,7255,2590,1,10562
762,2019-11-15,306,1696,3499,1,5502
762,2019-11-16,280,673,2964,3,3920
762,2019-11-17,353,2277,3276,0,5906
762,2019-11-18,302,1981,2932,1,5216
762,2019-11-19,641,2551,3118,0,6310
762,2019-11-20,324,1268,1815,4,3411
762,2019-11-21,1189,2987,2456,1,6633
762,2019-11-22,1155,7554,1713,1,10423
762,2019-11-23,316,6274,2654,2,9246
762,2019-11-24,384,4936,1805,1,7126
762,2019-11-25,604,5549,2378,1,8532
762,2019-11-26,311,4694,2017,1,7023
762,2019-11-27,624,5222,1469,0,7315
762,2019-11-28,641,9931,902,0,11474
762,2019-11-29,64,614,2,0,680
762,2019-08-22,18,2,961,2,983
762,2019-08-23,438,1468,1834,0,3740
762,2019-08-24,483,4283,1264,0,6030
762,2019-08-25,345,13755,1551,0,15651
762,2019-08-26,855,13301,1885,0,16041
762,2019-08-27,311,9394,1465,1,11171
762,2019-08-28,1193,4808,1880,1,7882
762,2019-08-29,417,10491,1568,1,12477
762,2019-08-30,202,3072,1109,1,4384
762,2019-08-31,81,13,3,0,97
762,2019-09-01,307,390,453,0,1150
762,2019-09-02,405,177,0,0,582
762,2019-09-03,369,535,661,1,1566
762,2019-09-04,747,11872,2503,1,15123
762,2019-09-05,637,5282,1763,0,7682
762,2019-09-06,531,8219,2107,0,10857
762,2019-09-07,358,12845,1947,0,15150
762,2019-09-08,432,17457,1469,1,19359
762,2019-09-09,379,6853,3118,0,10350
762,2019-09-10,1163,11389,2252,0,14804
762,2019-09-11,1275,6238,1672,2,9187
762,2019-09-12,290,11041,1841,0,13172
762,2019-09-13,449,6596,2039,1,9085
762,2019-09-14,1760,10591,1479,0,13830
762,2019-09-15,352,12220,1742,0,14314
762,2019-09-16,335,6068,2231,0,8634
762,2019-09-17,1008,8800,1248,0,11056
762,2019-09-18,1184,11816,1403,0,14403
762,2019-09-19,1377,2843,1657,3,5880
762,2019-09-20,438,9131,2439,1,12009
762,2019-09-21,386,8190,1893,1,10470
762,2019-09-22,276,8603,2020,0,10899
762,2019-09-23,1196,8396,1838,0,11430
762,2019-09-24,1274,7116,1699,3,10092
762,2019-09-25,1906,6703,1944,0,10553
762,2019-09-26,814,9112,1769,0,11695
762,2019-09-27,425,5311,2194,4,7934
762,2019-09-28,579,12283,1335,2,14199
762,2019-09-29,1869,15375,1259,2,18505
762,2019-09-30,179,15351,1345,2,16877
762,2019-10-01,1901,15536,1513,0,18950
762,2019-10-02,1061,11815,2341,0,15217
762,2019-10-03,213,13031,1603,1,14848
762,2019-10-04,263,11233,1608,1,13105
762,2019-10-05,273,13700,1173,0,15146
762,2019-10-06,159,10056,2242,2,12459
762,2019-10-07,2685,4950,1801,1,9437
762,2019-10-08,177,10525,1698,1,12401
762,2019-10-09,1435,14653,1142,1,17231
762,2019-10-10,2091,9845,2149,0,14085
762,2019-10-11,830,9441,1700,3,11974
762,2019-10-12,1764,3883,1765,0,7412
762,2019-10-13,313,7302,1735,1,9351
762,2019-10-14,1282,5164,2159,1,8606
762,2019-10-15,527,7522,1625,1,9675
762,2019-10-16,296,12109,712,5,13122
762,2019-10-17,756,3787,1971,0,6514
762,2019-10-18,339,6765,2663,1,9768
762,2019-10-19,340,3849,2153,0,6342
762,2019-10-20,410,864,2282,0,3556
762,2019-10-21,485,10314,1318,3,12120
762,2019-10-22,1156,4534,1620,2,7312
762,2019-10-23,458,8471,1150,1,10080
762,2019-10-24,440,12971,1898,2,15311
762,2019-10-25,431,9560,2038,2,12031
762,2019-10-26,749,20306,1658,3,22716
762,2019-10-27,319,17859,1629,0,19807
762,2019-10-28,327,13159,1295,0,14781
762,2019-10-29,363,14987,1165,1,16516
762,2019-10-30,464,14793,2125,1,17383
762,2019-10-31,285,19457,1901,2,21645
762,2019-11-01,612,26454,1109,0,28175
762,2019-11-02,283,15854,1280,0,17417
762,2019-11-03,300,21976,1589,0,23865
762,2019-11-04,325,6643,2002,0,8970
762,2019-11-05,797,1363,1889,36,4085
762,2019-11-06,401,13389,1519,2,15311
762,2019-11-07,434,15741,1028,1,17204
762,2019-11-08,333,8731,1479,0,10543
762,2019-11-09,371,7998,604,0,8973
762,2019-11-10,312,12478,1687,3,14480
762,2019-11-11,431,10207,1851,4,12493
762,2019-11-12,648,10777,2987,0,14412
762,2019-11-13,350,12051,1900,285,14586
762,2019-11-14,716,7255,2590,1,10562
762,2019-11-15,306,1696,3499,1,5502
762,2019-11-16,280,673,2964,3,3920
762,2019-11-17,353,2277,3276,0,5906
762,2019-11-18,302,1981,2932,1,5216
762,2019-11-19,641,2551,3118,0,6310
762,2019-11-20,324,1268,1815,4,3411
762,2019-11-21,1189,2987,2456,1,6633
762,2019-11-22,1155,7554,1713,1,10423
762,2019-11-23,316,6274,2654,2,9246
762,2019-11-24,384,4936,1805,1,7126
762,2019-11-25,604,5549,2378,1,8532
762,2019-11-26,311,4694,2017,1,7023
762,2019-11-27,624,5222,1469,0,7315
762,2019-11-28,641,9931,902,0,11474
762,2019-11-29,64,614,2,0,680
762,2019-08-21,0,0,951,0,951
762,2019-08-22,18,2,961,2,983
762,2019-08-23,438,1468,1834,0,3740
762,2019-08-24,483,4283,1264,0,6030
762,2019-08-25,345,13755,1551,0,15651
762,2019-08-26,855,13301,1885,0,16041
762,2019-08-27,311,9394,1465,1,11171
762,2019-08-28,1193,4808,1880,1,7882
762,2019-08-29,417,10491,1568,1,12477
762,2019-08-30,202,3072,1109,1,4384
762,2019-08-31,81,13,3,0,97
762,2019-09-01,307,390,453,0,1150
762,2019-09-02,405,177,0,0,582
762,2019-09-03,369,535,661,1,1566
762,2019-09-04,747,11872,2503,1,15123
762,2019-09-05,637,5282,1763,0,7682
762,2019-09-06,531,8219,2107,0,10857
762,2019-09-07,358,12845,1947,0,15150
762,2019-09-08,432,17457,1469,1,19359
762,2019-09-09,379,6853,3118,0,10350
762,2019-09-10,1163,11389,2252,0,14804
762,2019-09-11,1275,6238,1672,2,9187
762,2019-09-12,290,11041,1841,0,13172
762,2019-09-13,449,6596,2039,1,9085
762,2019-09-14,1760,10591,1479,0,13830
762,2019-09-15,352,12220,1742,0,14314
762,2019-09-16,335,6068,2231,0,8634
762,2019-09-17,1008,8800,1248,0,11056
762,2019-09-18,1184,11816,1403,0,14403
762,2019-09-19,1377,2843,1657,3,5880
762,2019-09-20,438,9131,2439,1,12009
762,2019-09-21,386,8190,1893,1,10470
762,2019-09-22,276,8603,2020,0,10899
762,2019-09-23,1196,8396,1838,0,11430
762,2019-09-24,1274,7116,1699,3,10092
762,2019-09-25,1906,6703,1944,0,10553
762,2019-09-26,814,9112,1769,0,11695
762,2019-09-27,425,5311,2194,4,7934
762,2019-09-28,579,12283,1335,2,14199
762,2019-09-29,1869,15375,1259,2,18505
762,2019-09-30,179,15351,1345,2,16877
762,2019-10-01,1901,15536,1513,0,18950
762,2019-10-02,1061,11815,2341,0,15217
762,2019-10-03,213,13031,1603,1,14848
762,2019-10-04,263,11233,1608,1,13105
762,2019-10-05,273,13700,1173,0,15146
762,2019-10-06,159,10056,2242,2,12459
762,2019-10-07,2685,4950,1801,1,9437
762,2019-10-08,177,10525,1698,1,12401
762,2019-10-09,1435,14653,1142,1,17231
762,2019-10-10,2091,9845,2149,0,14085
762,2019-10-11,830,9441,1700,3,11974
762,2019-10-12,1764,3883,1765,0,7412
762,2019-10-13,313,7302,1735,1,9351
762,2019-10-14,1282,5164,2159,1,8606
762,2019-10-15,527,7522,1625,1,9675
762,2019-10-16,296,12109,712,5,13122
762,2019-10-17,756,3787,1971,0,6514
762,2019-10-18,339,6765,2663,1,9768
762,2019-10-19,340,3849,2153,0,6342
762,2019-10-20,410,864,2282,0,3556
762,2019-10-21,485,10314,1318,3,12120
762,2019-10-22,1156,4534,1620,2,7312
762,2019-10-23,458,8471,1150,1,10080
762,2019-10-24,440,12971,1898,2,15311
762,2019-10-25,431,9560,2038,2,12031
762,2019-10-26,749,20306,1658,3,22716
762,2019-10-27,319,17859,1629,0,19807
762,2019-10-28,327,13159,1295,0,14781
762,2019-10-29,363,14987,1165,1,16516
762,2019-10-30,464,14793,2125,1,17383
762,2019-10-31,285,19457,1901,2,21645
762,2019-11-01,612,26454,1109,0,28175
762,2019-11-02,283,15854,1280,0,17417
762,2019-11-03,300,21976,1589,0,23865
762,2019-11-04,325,6643,2002,0,8970
762,2019-11-05,797,1363,1889,36,4085
762,2019-11-06,401,13389,1519,2,15311
762,2019-11-07,434,15741,1028,1,17204
762,2019-11-08,333,8731,1479,0,10543
762,2019-11-09,371,7998,604,0,8973
762,2019-11-10,312,12478,1687,3,14480
762,2019-11-11,431,10207,1851,4,12493
762,2019-11-12,648,10777,2987,0,14412
762,2019-11-13,350,12051,1900,285,14586
762,2019-11-14,716,7255,2590,1,10562
762,2019-11-15,306,1696,3499,1,5502
762,2019-11-16,280,673,2964,3,3920
762,2019-11-17,353,2277,3276,0,5906
762,2019-11-18,302,1981,2932,1,5216
762,2019-11-19,641,2551,3118,0,6310
762,2019-11-20,324,1268,1815,4,3411
762,2019-11-21,1189,2987,2456,1,6633
762,2019-11-22,1155,7554,1713,1,10423
762,2019-11-23,316,6274,2654,2,9246
762,2019-11-24,384,4936,1805,1,7126
762,2019-11-25,604,5549,2378,1,8532
762,2019-11-26,311,4694,2017,1,7023
762,2019-11-27,624,5222,1469,0,7315
762,2019-11-28,641,9931,902,0,11474
762,2019-11-29,64,614,2,0,680
762,2019-08-22,18,2,961,2,983
762,2019-08-23,438,1468,1834,0,3740
762,2019-08-24,483,4283,1264,0,6030
762,2019-08-25,345,13755,1551,0,15651
762,2019-08-26,855,13301,1885,0,16041
762,2019-08-27,311,9394,1465,1,11171
762,2019-08-28,1193,4808,1880,1,7882
762,2019-08-29,417,10491,1568,1,12477
762,2019-08-30,202,3072,1109,1,4384
762,2019-08-31,81,13,3,0,97
762,2019-09-01,307,390,453,0,1150
762,2019-09-02,405,177,0,0,582
762,2019-09-03,369,535,661,1,1566
762,2019-09-04,747,11872,2503,1,15123
762,2019-09-05,637,5282,1763,0,7682
762,2019-09-06,531,8219,2107,0,10857
762,2019-09-07,358,12845,1947,0,15150
762,2019-09-08,432,17457,1469,1,19359
762,2019-09-09,379,6853,3118,0,10350
762,2019-09-10,1163,11389,2252,0,14804
762,2019-09-11,1275,6238,1672,2,9187
762,2019-09-12,290,11041,1841,0,13172
762,2019-09-13,449,6596,2039,1,9085
762,2019-09-14,1760,10591,1479,0,13830
762,2019-09-15,352,12220,1742,0,14314
762,2019-09-16,335,6068,2231,0,8634
762,2019-09-17,1008,8800,1248,0,11056
762,2019-09-18,1184,11816,1403,0,14403
762,2019-09-19,1377,2843,1657,3,5880
762,2019-09-20,438,9131,2439,1,12009
762,2019-09-21,386,8190,1893,1,10470
762,2019-09-22,276,8603,2020,0,10899
762,2019-09-23,1196,8396,1838,0,11430
762,2019-09-24,1274,7116,1699,3,10092
762,2019-09-25,1906,6703,1944,0,10553
762,2019-09-26,814,9112,1769,0,11695
762,2019-09-27,425,5311,2194,4,7934
762,2019-09-28,579,12283,1335,2,14199
762,2019-09-29,1869,15375,1259,2,18505
762,2019-09-30,179,15351,1345,2,16877
762,2019-10-01,1901,15536,1513,0,18950
762,2019-10-02,1061,11815,2341,0,15217
762,2019-10-03,213,13031,1603,1,14848
762,2019-10-04,263,11233,1608,1,13105
762,2019-10-05,273,13700,1173,0,15146
762,2019-10-06,159,10056,2242,2,12459
762,2019-10-07,2685,4950,1801,1,9437
762,2019-10-08,177,10525,1698,1,12401
762,2019-10-09,1435,14653,1142,1,17231
762,2019-10-10,2091,9845,2149,0,14085
762,2019-10-11,830,9441,1700,3,11974
762,2019-10-12,1764,3883,1765,0,7412
762,2019-10-13,313,7302,1735,1,9351
762,2019-10-14,1282,5164,2159,1,8606
762,2019-10-15,527,7522,1625,1,9675
762,2019-10-16,296,12109,712,5,13122
762,2019-10-17,756,3787,1971,0,6514
762,2019-10-18,339,6765,2663,1,9768
762,2019-10-19,340,3849,2153,0,6342
762,2019-10-20,410,864,2282,0,3556
762,2019-10-21,485,10314,1318,3,12120
762,2019-10-22,1156,4534,1620,2,7312
762,2019-10-23,458,8471,1150,1,10080
762,2019-10-24,440,12971,1898,2,15311
762,2019-10-25,431,9560,2038,2,12031
762,2019-10-26,749,20306,1658,3,22716
762,2019-10-27,319,17859,1629,0,19807
762,2019-10-28,327,13159,1295,0,14781
762,2019-10-29,363,14987,1165,1,16516
762,2019-10-30,464,14793,2125,1,17383
762,2019-10-31,285,19457,1901,2,21645
762,2019-11-01,612,26454,1109,0,28175
762,2019-11-02,283,15854,1280,0,17417
762,2019-11-03,300,21976,1589,0,23865
762,2019-11-04,325,6643,2002,0,8970
762,2019-11-05,797,1363,1889,36,4085
762,2019-11-06,401,13389,1519,2,15311
762,2019-11-07,434,15741,1028,1,17204
762,2019-11-08,333,8731,1479,0,10543
762,2019-11-09,371,7998,604,0,8973
762,2019-11-10,312,12478,1687,3,14480
762,2019-11-11,431,10207,1851,4,12493
762,2019-11-12,648,10777,2987,0,14412
762,2019-11-13,350,12051,1900,285,14586
762,2019-11-14,716,7255,2590,1,10562
762,2019-11-15,306,1696,3499,1,5502
762,2019-11-16,280,673,2964,3,3920
762,2019-11-17,353,2277,3276,0,5906
762,2019-11-18,302,1981,2932,1,5216
762,2019-11-19,641,2551,3118,0,6310
762,2019-11-20,324,1268,1815,4,3411
762,2019-11-21,1189,2987,2456,1,6633
762,2019-11-22,1155,7554,1713,1,10423
762,2019-11-23,316,6274,2654,2,9246
762,2019-11-24,384,4936,1805,1,7126
762,2019-11-25,604,5549,2378,1,8532
762,2019-11-26,311,4694,2017,1,7023
763,2019-08-22,11,15,1997,1,2024
763,2019-08-23,542,414,1116,0,2072
763,2019-08-24,347,4079,1554,0,5980
763,2019-08-25,368,14740,1441,2,16551
763,2019-08-26,518,13170,1719,1,15408
763,2019-08-27,1695,7857,1318,0,10870
763,2019-08-28,1101,3148,2430,0,6679
763,2019-08-29,1231,8579,1710,0,11520
763,2019-08-30,1012,2904,822,2,4740
763,2019-08-31,983,104,20,0,1107
763,2019-09-01,1129,714,149,1,1993
763,2019-09-02,537,416,17,0,970
763,2019-09-03,426,440,1017,0,1883
763,2019-09-04,1926,12941,1803,1,16671
763,2019-09-05,1061,10148,1731,1,12941
763,2019-09-06,1162,9274,1414,0,11850
763,2019-09-07,1198,8051,2501,1,11751
763,2019-09-08,1074,4913,2325,0,8312
763,2019-09-09,2484,12196,2344,0,17024
763,2019-09-10,645,8230,2256,1,11132
763,2019-09-11,1653,5787,2265,3,9708
763,2019-09-12,1474,7969,2492,1,11936
763,2019-09-13,996,4279,2229,2,7506
763,2019-09-14,1739,10054,1988,0,13781
763,2019-09-15,747,12023,2212,1,14983
763,2019-09-16,3234,6998,2317,1,12550
763,2019-09-17,749,7783,2447,1,10980
763,2019-09-18,1049,12259,1405,0,14713
763,2019-09-19,1078,11006,1161,3,13248
763,2019-09-20,1017,12997,1685,1,15700
763,2019-09-21,1602,5731,2073,1,9407
763,2019-09-22,1033,8563,2255,2,11853
763,2019-09-23,1082,8352,2059,2,11495
763,2019-09-24,1734,8832,2306,5,12877
763,2019-09-25,1116,8546,1199,0,10861
763,2019-09-26,1354,9288,2245,1,12888
763,2019-09-27,456,11490,1788,2,13736
763,2019-09-28,711,14268,1528,2,16509
763,2019-09-29,971,15630,1707,2,18310
763,2019-09-30,629,17004,1454,0,19087
763,2019-10-01,510,15385,2887,0,18782
763,2019-10-02,599,9313,1357,2,11271
763,2019-10-03,533,12786,1475,1,14795
763,2019-10-04,993,12634,1972,2,15601
763,2019-10-05,833,13785,1124,0,15742
763,2019-10-06,396,8529,1564,1,10490
763,2019-10-07,466,7528,1739,0,9733
763,2019-10-08,447,10629,946,2,12024
763,2019-10-09,1785,14077,2505,3,18370
763,2019-10-10,2352,9965,1631,0,13948
763,2019-10-11,1039,9356,1747,1,12143
763,2019-10-12,1081,3825,1747,1,6654
763,2019-10-13,528,7319,1515,3,9365
763,2019-10-14,1341,9436,2149,0,12926
763,2019-10-15,1472,7579,1591,1,10643
763,2019-10-16,483,18594,1612,1,20690
763,2019-10-17,542,7102,1696,0,9340
763,2019-10-18,953,7036,1352,2,9343
763,2019-10-19,1038,3709,1306,0,6053
763,2019-10-20,2011,658,1798,0,4467
763,2019-10-21,1502,9479,1528,1,12510
763,2019-10-22,739,4627,1663,2,7031
763,2019-10-23,1618,7095,695,1,9409
763,2019-10-24,1600,20817,1452,1,23870
763,2019-10-25,629,13308,1562,3,15502
763,2019-10-26,689,12713,1919,0,15321
763,2019-10-27,1072,15641,2260,1,18974
763,2019-10-28,725,13454,1019,0,15198
763,2019-10-29,638,14784,1741,4,17167
763,2019-10-30,544,22719,1581,1,24845
763,2019-10-31,639,13521,1427,0,15587
763,2019-11-01,1472,24414,1266,1,27153
763,2019-11-02,478,25273,2121,0,27872
763,2019-11-03,1404,37986,1677,4,41071
763,2019-11-04,987,9335,1356,1,11679
763,2019-11-05,629,1097,2119,1,3846
763,2019-11-06,654,13555,1517,2,15728
763,2019-11-07,627,16033,1343,0,18003
763,2019-11-08,644,8810,1679,0,11133
763,2019-11-09,592,7857,1465,0,9914
763,2019-11-10,478,12072,1309,0,13859
763,2019-11-11,595,7918,1378,1,9892
763,2019-11-12,693,8985,3153,2,12833
763,2019-11-13,503,12489,1928,1,14921
763,2019-11-14,517,7241,1628,1,9387
763,2019-11-15,466,2797,3268,1,6532
763,2019-11-16,1513,848,4100,1,6462
763,2019-11-17,1295,3139,4097,0,8531
763,2019-11-18,788,1920,4020,4,6732
763,2019-11-19,999,2696,2427,1,6123
763,2019-11-20,699,1373,1995,0,4067
763,2019-11-21,491,2705,1475,1,4672
763,2019-11-22,1658,7497,1951,7,11113
763,2019-11-23,483,10330,1872,1,12686
763,2019-11-24,496,10799,2319,0,13614
763,2019-11-25,869,6375,2485,0,9729
763,2019-11-26,1292,7776,1612,0,10680
763,2019-11-27,474,9563,1278,0,11315
763,2019-11-28,807,10148,812,0,11767
763,2019-11-29,284,376,2,0,662
763,2019-08-22,11,15,1997,1,2024
763,2019-08-23,542,414,1116,0,2072
763,2019-08-24,347,4079,1554,0,5980
763,2019-08-25,368,14740,1441,2,16551
763,2019-08-26,518,13170,1719,1,15408
763,2019-08-27,1695,7857,1318,0,10870
763,2019-08-28,1101,3148,2430,0,6679
763,2019-08-29,1231,8579,1710,0,11520
763,2019-08-30,1012,2904,822,2,4740
763,2019-08-31,983,104,20,0,1107
763,2019-09-01,1129,714,149,1,1993
763,2019-09-02,537,416,17,0,970
763,2019-09-03,426,440,1017,0,1883
763,2019-09-04,1926,12941,1803,1,16671
763,2019-09-05,1061,10148,1731,1,12941
763,2019-09-06,1162,9274,1414,0,11850
763,2019-09-07,1198,8051,2501,1,11751
763,2019-09-08,1074,4913,2325,0,8312
763,2019-09-09,2484,12196,2344,0,17024
763,2019-09-10,645,8230,2256,1,11132
763,2019-09-11,1653,5787,2265,3,9708
763,2019-09-12,1474,7969,2492,1,11936
763,2019-09-13,996,4279,2229,2,7506
763,2019-09-14,1739,10054,1988,0,13781
763,2019-09-15,747,12023,2212,1,14983
763,2019-09-16,3234,6998,2317,1,12550
763,2019-09-17,749,7783,2447,1,10980
763,2019-09-18,1049,12259,1405,0,14713
763,2019-09-19,1078,11006,1161,3,13248
763,2019-09-20,1017,12997,1685,1,15700
763,2019-09-21,1602,5731,2073,1,9407
763,2019-09-22,1033,8563,2255,2,11853
763,2019-09-23,1082,8352,2059,2,11495
763,2019-09-24,1734,8832,2306,5,12877
763,2019-09-25,1116,8546,1199,0,10861
763,2019-09-26,1354,9288,2245,1,12888
763,2019-09-27,456,11490,1788,2,13736
763,2019-09-28,711,14268,1528,2,16509
763,2019-09-29,971,15630,1707,2,18310
763,2019-09-30,629,17004,1454,0,19087
763,2019-10-01,510,15385,2887,0,18782
763,2019-10-02,599,9313,1357,2,11271
763,2019-10-03,533,12786,1475,1,14795
763,2019-10-04,993,12634,1972,2,15601
763,2019-10-05,833,13785,1124,0,15742
763,2019-10-06,396,8529,1564,1,10490
763,2019-10-07,466,7528,1739,0,9733
763,2019-10-08,447,10629,946,2,12024
763,2019-10-09,1785,14077,2505,3,18370
763,2019-10-10,2352,9965,1631,0,13948
763,2019-10-11,1039,9356,1747,1,12143
763,2019-10-12,1081,3825,1747,1,6654
763,2019-10-13,528,7319,1515,3,9365
763,2019-10-14,1341,9436,2149,0,12926
763,2019-10-15,1472,7579,1591,1,10643
763,2019-10-16,483,18594,1612,1,20690
763,2019-10-17,542,7102,1696,0,9340
763,2019-10-18,953,7036,1352,2,9343
763,2019-10-19,1038,3709,1306,0,6053
763,2019-10-20,2011,658,1798,0,4467
763,2019-10-21,1502,9479,1528,1,12510
763,2019-10-22,739,4627,1663,2,7031
763,2019-10-23,1618,7095,695,1,9409
763,2019-10-24,1600,20817,1452,1,23870
763,2019-10-25,629,13308,1562,3,15502
763,2019-10-26,689,12713,1919,0,15321
763,2019-10-27,1072,15641,2260,1,18974
763,2019-10-28,725,13454,1019,0,15198
763,2019-10-29,638,14784,1741,4,17167
763,2019-10-30,544,22719,1581,1,24845
763,2019-10-31,639,13521,1427,0,15587
763,2019-11-01,1472,24414,1266,1,27153
763,2019-11-02,478,25273,2121,0,27872
763,2019-11-03,1404,37986,1677,4,41071
763,2019-11-04,987,9335,1356,1,11679
763,2019-11-05,629,1097,2119,1,3846
763,2019-11-06,654,13555,1517,2,15728
763,2019-11-07,627,16033,1343,0,18003
763,2019-11-08,644,8810,1679,0,11133
763,2019-11-09,592,7857,1465,0,9914
763,2019-11-10,478,12072,1309,0,13859
763,2019-11-11,595,7918,1378,1,9892
763,2019-11-12,693,8985,3153,2,12833
763,2019-11-13,503,12489,1928,1,14921
763,2019-11-14,517,7241,1628,1,9387
763,2019-11-15,466,2797,3268,1,6532
763,2019-11-16,1513,848,4100,1,6462
763,2019-11-17,1295,3139,4097,0,8531
763,2019-11-18,788,1920,4020,4,6732
763,2019-11-19,999,2696,2427,1,6123
763,2019-11-20,699,1373,1995,0,4067
763,2019-11-21,491,2705,1475,1,4672
763,2019-11-22,1658,7497,1951,7,11113
763,2019-11-23,483,10330,1872,1,12686
763,2019-11-24,496,10799,2319,0,13614
763,2019-11-25,869,6375,2485,0,9729
763,2019-11-26,1292,7776,1612,0,10680
763,2019-11-27,474,9563,1278,0,11315
763,2019-11-28,807,10148,812,0,11767
763,2019-11-29,284,376,2,0,662
763,2019-08-22,11,15,1997,1,2024
763,2019-08-23,542,414,1116,0,2072
763,2019-08-24,347,4079,1554,0,5980
763,2019-08-25,368,14740,1441,2,16551
763,2019-08-26,518,13170,1719,1,15408
763,2019-08-27,1695,7857,1318,0,10870
763,2019-08-28,1101,3148,2430,0,6679
763,2019-08-29,1231,8579,1710,0,11520
763,2019-08-30,1012,2904,822,2,4740
763,2019-08-31,983,104,20,0,1107
763,2019-09-01,1129,714,149,1,1993
763,2019-09-02,537,416,17,0,970
763,2019-09-03,426,440,1017,0,1883
763,2019-09-04,1926,12941,1803,1,16671
763,2019-09-05,1061,10148,1731,1,12941
763,2019-09-06,1162,9274,1414,0,11850
763,2019-09-07,1198,8051,2501,1,11751
763,2019-09-08,1074,4913,2325,0,8312
763,2019-09-09,2484,12196,2344,0,17024
763,2019-09-10,645,8230,2256,1,11132
763,2019-09-11,1653,5787,2265,3,9708
763,2019-09-12,1474,7969,2492,1,11936
763,2019-09-13,996,4279,2229,2,7506
763,2019-09-14,1739,10054,1988,0,13781
763,2019-09-15,747,12023,2212,1,14983
763,2019-09-16,3234,6998,2317,1,12550
763,2019-09-17,749,7783,2447,1,10980
763,2019-09-18,1049,12259,1405,0,14713
763,2019-09-19,1078,11006,1161,3,13248
763,2019-09-20,1017,12997,1685,1,15700
763,2019-09-21,1602,5731,2073,1,9407
763,2019-09-22,1033,8563,2255,2,11853
763,2019-09-23,1082,8352,2059,2,11495
763,2019-09-24,1734,8832,2306,5,12877
763,2019-09-25,1116,8546,1199,0,10861
763,2019-09-26,1354,9288,2245,1,12888
763,2019-09-27,456,11490,1788,2,13736
763,2019-09-28,711,14268,1528,2,16509
763,2019-09-29,971,15630,1707,2,18310
763,2019-09-30,629,17004,1454,0,19087
763,2019-10-01,510,15385,2887,0,18782
763,2019-10-02,599,9313,1357,2,11271
763,2019-10-03,533,12786,1475,1,14795
763,2019-10-04,993,12634,1972,2,15601
763,2019-10-05,833,13785,1124,0,15742
763,2019-10-06,396,8529,1564,1,10490
763,2019-10-07,466,7528,1739,0,9733
763,2019-10-08,447,10629,946,2,12024
763,2019-10-09,1785,14077,2505,3,18370
763,2019-10-10,2352,9965,1631,0,13948
763,2019-10-11,1039,9356,1747,1,12143
763,2019-10-12,1081,3825,1747,1,6654
763,2019-10-13,528,7319,1515,3,9365
763,2019-10-14,1341,9436,2149,0,12926
763,2019-10-15,1472,7579,1591,1,10643
763,2019-10-16,483,18594,1612,1,20690
763,2019-10-17,542,7102,1696,0,9340
763,2019-10-18,953,7036,1352,2,9343
763,2019-10-19,1038,3709,1306,0,6053
763,2019-10-20,2011,658,1798,0,4467
763,2019-10-21,1502,9479,1528,1,12510
763,2019-10-22,739,4627,1663,2,7031
763,2019-10-23,1618,7095,695,1,9409
763,2019-10-24,1600,20817,1452,1,23870
763,2019-10-25,629,13308,1562,3,15502
763,2019-10-26,689,12713,1919,0,15321
763,2019-10-27,1072,15641,2260,1,18974
763,2019-10-28,725,13454,1019,0,15198
763,2019-10-29,638,14784,1741,4,17167
763,2019-10-30,544,22719,1581,1,24845
763,2019-10-31,639,13521,1427,0,15587
763,2019-11-01,1472,24414,1266,1,27153
763,2019-11-02,478,25273,2121,0,27872
763,2019-11-03,1404,37986,1677,4,41071
763,2019-11-04,987,9335,1356,1,11679
763,2019-11-05,629,1097,2119,1,3846
763,2019-11-06,654,13555,1517,2,15728
763,2019-11-07,627,16033,1343,0,18003
763,2019-11-08,644,8810,1679,0,11133
763,2019-11-09,592,7857,1465,0,9914
763,2019-11-10,478,12072,1309,0,13859
763,2019-11-11,595,7918,1378,1,9892
763,2019-11-12,693,8985,3153,2,12833
763,2019-11-13,503,12489,1928,1,14921
763,2019-11-14,517,7241,1628,1,9387
763,2019-11-15,466,2797,3268,1,6532
763,2019-11-16,1513,848,4100,1,6462
763,2019-11-17,1295,3139,4097,0,8531
763,2019-11-18,788,1920,4020,4,6732
763,2019-11-19,999,2696,2427,1,6123
763,2019-11-20,699,1373,1995,0,4067
763,2019-11-21,491,2705,1475,1,4672
763,2019-11-22,1658,7497,1951,7,11113
763,2019-11-23,483,10330,1872,1,12686
763,2019-11-24,496,10799,2319,0,13614
763,2019-11-25,869,6375,2485,0,9729
763,2019-11-26,1292,7776,1612,0,10680
763,2019-11-27,474,9563,1278,0,11315
763,2019-11-28,807,10148,812,0,11767
763,2019-11-29,284,376,2,0,662
763,2019-08-22,11,15,1997,1,2024
763,2019-08-23,542,414,1116,0,2072
763,2019-08-24,347,4079,1554,0,5980
763,2019-08-25,368,14740,1441,2,16551
763,2019-08-26,518,13170,1719,1,15408
763,2019-08-27,1695,7857,1318,0,10870
763,2019-08-28,1101,3148,2430,0,6679
763,2019-08-29,1231,8579,1710,0,11520
763,2019-08-30,1012,2904,822,2,4740
763,2019-08-31,983,104,20,0,1107
763,2019-09-01,1129,714,149,1,1993
763,2019-09-02,537,416,17,0,970
763,2019-09-03,426,440,1017,0,1883
763,2019-09-04,1926,12941,1803,1,16671
763,2019-09-05,1061,10148,1731,1,12941
763,2019-09-06,1162,9274,1414,0,11850
763,2019-09-07,1198,8051,2501,1,11751
763,2019-09-08,1074,4913,2325,0,8312
763,2019-09-09,2484,12196,2344,0,17024
763,2019-09-10,645,8230,2256,1,11132
763,2019-09-11,1653,5787,2265,3,9708
763,2019-09-12,1474,7969,2492,1,11936
763,2019-09-13,996,4279,2229,2,7506
763,2019-09-14,1739,10054,1988,0,13781
763,2019-09-15,747,12023,2212,1,14983
763,2019-09-16,3234,6998,2317,1,12550
763,2019-09-17,749,7783,2447,1,10980
763,2019-09-18,1049,12259,1405,0,14713
763,2019-09-19,1078,11006,1161,3,13248
763,2019-09-20,1017,12997,1685,1,15700
763,2019-09-21,1602,5731,2073,1,9407
763,2019-09-22,1033,8563,2255,2,11853
763,2019-09-23,1082,8352,2059,2,11495
763,2019-09-24,1734,8832,2306,5,12877
763,2019-09-25,1116,8546,1199,0,10861
763,2019-09-26,1354,9288,2245,1,12888
763,2019-09-27,456,11490,1788,2,13736
763,2019-09-28,711,14268,1528,2,16509
763,2019-09-29,971,15630,1707,2,18310
763,2019-09-30,629,17004,1454,0,19087
763,2019-10-01,510,15385,2887,0,18782
763,2019-10-02,599,9313,1357,2,11271
763,2019-10-03,533,12786,1475,1,14795
763,2019-10-04,993,12634,1972,2,15601
763,2019-10-05,833,13785,1124,0,15742
763,2019-10-06,396,8529,1564,1,10490
763,2019-10-07,466,7528,1739,0,9733
763,2019-10-08,447,10629,946,2,12024
763,2019-10-09,1785,14077,2505,3,18370
763,2019-10-10,2352,9965,1631,0,13948
763,2019-10-11,1039,9356,1747,1,12143
763,2019-10-12,1081,3825,1747,1,6654
763,2019-10-13,528,7319,1515,3,9365
763,2019-10-14,1341,9436,2149,0,12926
763,2019-10-15,1472,7579,1591,1,10643
763,2019-10-16,483,18594,1612,1,20690
763,2019-10-17,542,7102,1696,0,9340
763,2019-10-18,953,7036,1352,2,9343
763,2019-10-19,1038,3709,1306,0,6053
763,2019-10-20,2011,658,1798,0,4467
763,2019-10-21,1502,9479,1528,1,12510
763,2019-10-22,739,4627,1663,2,7031
763,2019-10-23,1618,7095,695,1,9409
763,2019-10-24,1600,20817,1452,1,23870
763,2019-10-25,629,13308,1562,3,15502
763,2019-10-26,689,12713,1919,0,15321
763,2019-10-27,1072,15641,2260,1,18974
763,2019-10-28,725,13454,1019,0,15198
763,2019-10-29,638,14784,1741,4,17167
763,2019-10-30,544,22719,1581,1,24845
763,2019-10-31,639,13521,1427,0,15587
763,2019-11-01,1472,24414,1266,1,27153
763,2019-11-02,478,25273,2121,0,27872
763,2019-11-03,1404,37986,1677,4,41071
763,2019-11-04,987,9335,1356,1,11679
763,2019-11-05,629,1097,2119,1,3846
763,2019-11-06,654,13555,1517,2,15728
763,2019-11-07,627,16033,1343,0,18003
763,2019-11-08,644,8810,1679,0,11133
763,2019-11-09,592,7857,1465,0,9914
763,2019-11-10,478,12072,1309,0,13859
763,2019-11-11,595,7918,1378,1,9892
763,2019-11-12,693,8985,3153,2,12833
763,2019-11-13,503,12489,1928,1,14921
763,2019-11-14,517,7241,1628,1,9387
763,2019-11-15,466,2797,3268,1,6532
763,2019-11-16,1513,848,4100,1,6462
763,2019-11-17,1295,3139,4097,0,8531
763,2019-11-18,788,1920,4020,4,6732
763,2019-11-19,999,2696,2427,1,6123
763,2019-11-20,699,1373,1995,0,4067
763,2019-11-21,491,2705,1475,1,4672
763,2019-11-22,1658,7497,1951,7,11113
763,2019-11-23,483,10330,1872,1,12686
765,2019-08-23,2551,3211,2546,2,8310
765,2019-08-24,23489,2145,1832,1,27467
765,2019-08-25,25823,15364,1846,2,43035
765,2019-08-26,13124,24244,1980,1,39349
765,2019-08-27,2047,17536,1856,2,21441
765,2019-08-28,1024,12551,1980,0,15555
765,2019-08-29,6858,12693,1595,1,21147
765,2019-08-30,3241,2751,1080,3,7075
765,2019-08-31,2072,37,0,0,2109
765,2019-09-01,9472,1169,180,1,10822
765,2019-09-02,8853,935,0,0,9788
765,2019-09-03,17721,441,931,0,19093
765,2019-09-04,40209,10961,1742,3,52915
765,2019-09-05,30672,6113,1796,0,38581
765,2019-09-06,28528,11487,1917,0,41932
765,2019-09-07,28550,9534,2405,3,40492
765,2019-09-08,22216,4504,2171,0,28891
765,2019-09-09,10811,6605,2019,1,19436
765,2019-09-10,8747,6372,2636,0,17755
765,2019-09-11,5448,5968,2685,3,14104
765,2019-09-12,2865,9986,2162,3,15016
765,2019-09-13,3334,6201,1393,2,10930
765,2019-09-14,2717,9731,1747,2,14197
765,2019-09-15,2537,6095,1785,0,10417
765,2019-09-16,3127,7503,1869,3,12502
765,2019-09-17,3799,7223,2154,8,13184
765,2019-09-18,3042,11481,1528,9,16060
765,2019-09-19,2983,3332,1710,10,8035
765,2019-09-20,2689,7874,1590,9,12162
765,2019-09-21,4967,5737,1349,10,12063
765,2019-09-22,4486,11018,1869,8,17381
765,2019-09-23,4453,11658,2160,12,18283
765,2019-09-24,1871,8736,1709,14,12330
765,2019-09-25,2574,7049,1871,12,11506
765,2019-09-26,2813,10242,2135,10,15200
765,2019-09-27,4186,8080,2129,4,14399
765,2019-09-28,5514,13855,2177,3,21549
765,2019-09-29,6250,15735,1780,3,23768
765,2019-09-30,4518,16563,1769,0,22850
765,2019-10-01,4970,16004,1385,0,22359
765,2019-10-02,5707,13729,2030,6,21472
765,2019-10-03,5919,14119,1868,9,21915
765,2019-10-04,3949,18344,1563,12,23868
765,2019-10-05,4021,16516,2438,11,22986
765,2019-10-06,4670,13010,2620,11,20311
765,2019-10-07,5353,6500,1914,10,13777
765,2019-10-08,4598,12506,1685,12,18801
765,2019-10-09,8002,22965,2098,12,33077
765,2019-10-10,9181,17396,1893,10,28480
765,2019-10-11,9217,8171,926,9,18323
765,2019-10-12,10891,6715,2526,1,20133
765,2019-10-13,11207,12828,2777,2,26814
765,2019-10-14,10274,5502,1703,2,17481
765,2019-10-15,5090,8457,1350,0,14897
765,2019-10-16,1834,18112,1281,1,21228
765,2019-10-17,2425,8412,1724,0,12561
765,2019-10-18,2375,13970,1598,0,17943
765,2019-10-19,2853,8471,1908,0,13232
765,2019-10-20,3878,2887,1463,2,8230
765,2019-10-21,4909,11245,1226,1,17381
765,2019-10-22,4925,7360,1357,0,13642
765,2019-10-23,4389,8304,1496,1,14190
765,2019-10-24,4133,20582,1964,2,26681
765,2019-10-25,2613,18697,1764,4,23078
765,2019-10-26,3033,24715,1999,0,29747
765,2019-10-27,3670,18358,1770,703,24501
765,2019-10-28,3378,22817,1346,1,27542
765,2019-10-29,3833,16868,1725,3,22429
765,2019-10-30,4094,15216,1529,0,20839
765,2019-10-31,4125,19993,1527,501,26146
765,2019-11-01,5669,26790,1827,1,34287
765,2019-11-02,5294,17537,1949,0,24780
765,2019-11-03,5142,21848,848,3,27841
765,2019-11-04,6142,7369,1783,1,15295
765,2019-11-05,6598,6603,2069,0,15270
765,2019-11-06,4320,14113,1539,3,19975
765,2019-11-07,5282,24593,1137,2,31014
765,2019-11-08,5602,12647,1201,1,19451
765,2019-11-09,4126,13443,1139,0,18708
765,2019-11-10,3210,25410,994,0,29614
765,2019-11-11,2224,16419,1515,1,20159
765,2019-11-12,1670,12940,2089,1,16700
765,2019-11-13,1747,22558,1989,4,26298
765,2019-11-14,2779,11046,1021,1,14847
765,2019-11-15,2243,4505,1442,2,8192
765,2019-11-16,2474,2615,1641,0,6730
765,2019-11-17,2765,4194,2674,1,9634
765,2019-11-18,2302,3186,2914,5,8407
765,2019-11-19,2891,5427,2044,1,10363
765,2019-11-20,2368,2018,1599,0,5985
765,2019-11-21,2733,5539,1561,1,9834
765,2019-11-22,2950,4221,980,4,8155
765,2019-11-23,2153,6999,1551,2,10705
765,2019-11-24,1480,7078,1371,1,9930
765,2019-11-25,1906,10569,1810,0,14285
765,2019-11-26,1502,10449,1398,0,13349
765,2019-11-27,1867,6173,1487,0,9527
765,2019-11-28,1642,11768,522,1,13933
765,2019-11-29,249,1000,2,0,1251
765,2019-08-23,2551,3211,2546,2,8310
765,2019-08-24,23489,2145,1832,1,27467
765,2019-08-25,25823,15364,1846,2,43035
765,2019-08-26,13124,24244,1980,1,39349
765,2019-08-27,2047,17536,1856,2,21441
765,2019-08-28,1024,12551,1980,0,15555
765,2019-08-29,6858,12693,1595,1,21147
765,2019-08-30,3241,2751,1080,3,7075
765,2019-08-31,2072,37,0,0,2109
765,2019-09-01,9472,1169,180,1,10822
765,2019-09-02,8853,935,0,0,9788
765,2019-09-03,17721,441,931,0,19093
765,2019-09-04,40209,10961,1742,3,52915
765,2019-09-05,30672,6113,1796,0,38581
765,2019-09-06,28528,11487,1917,0,41932
765,2019-09-07,28550,9534,2405,3,40492
765,2019-09-08,22216,4504,2171,0,28891
765,2019-09-09,10811,6605,2019,1,19436
765,2019-09-10,8747,6372,2636,0,17755
765,2019-09-11,5448,5968,2685,3,14104
765,2019-09-12,2865,9986,2162,3,15016
765,2019-09-13,3334,6201,1393,2,10930
765,2019-09-14,2717,9731,1747,2,14197
765,2019-09-15,2537,6095,1785,0,10417
765,2019-09-16,3127,7503,1869,3,12502
765,2019-09-17,3799,7223,2154,8,13184
765,2019-09-18,3042,11481,1528,9,16060
765,2019-09-19,2983,3332,1710,10,8035
765,2019-09-20,2689,7874,1590,9,12162
765,2019-09-21,4967,5737,1349,10,12063
765,2019-09-22,4486,11018,1869,8,17381
765,2019-09-23,4453,11658,2160,12,18283
765,2019-09-24,1871,8736,1709,14,12330
765,2019-09-25,2574,7049,1871,12,11506
765,2019-09-26,2813,10242,2135,10,15200
765,2019-09-27,4186,8080,2129,4,14399
765,2019-09-28,5514,13855,2177,3,21549
765,2019-09-29,6250,15735,1780,3,23768
765,2019-09-30,4518,16563,1769,0,22850
765,2019-10-01,4970,16004,1385,0,22359
765,2019-10-02,5707,13729,2030,6,21472
765,2019-10-03,5919,14119,1868,9,21915
765,2019-10-04,3949,18344,1563,12,23868
765,2019-10-05,4021,16516,2438,11,22986
765,2019-10-06,4670,13010,2620,11,20311
765,2019-10-07,5353,6500,1914,10,13777
765,2019-10-08,4598,12506,1685,12,18801
765,2019-10-09,8002,22965,2098,12,33077
765,2019-10-10,9181,17396,1893,10,28480
765,2019-10-11,9217,8171,926,9,18323
765,2019-10-12,10891,6715,2526,1,20133
765,2019-10-13,11207,12828,2777,2,26814
765,2019-10-14,10274,5502,1703,2,17481
765,2019-10-15,5090,8457,1350,0,14897
765,2019-10-16,1834,18112,1281,1,21228
765,2019-10-17,2425,8412,1724,0,12561
765,2019-10-18,2375,13970,1598,0,17943
765,2019-10-19,2853,8471,1908,0,13232
765,2019-10-20,3878,2887,1463,2,8230
765,2019-10-21,4909,11245,1226,1,17381
765,2019-10-22,4925,7360,1357,0,13642
765,2019-10-23,4389,8304,1496,1,14190
765,2019-10-24,4133,20582,1964,2,26681
765,2019-10-25,2613,18697,1764,4,23078
765,2019-10-26,3033,24715,1999,0,29747
765,2019-10-27,3670,18358,1770,703,24501
765,2019-10-28,3378,22817,1346,1,27542
765,2019-10-29,3833,16868,1725,3,22429
765,2019-10-30,4094,15216,1529,0,20839
765,2019-10-31,4125,19993,1527,501,26146
765,2019-11-01,5669,26790,1827,1,34287
765,2019-11-02,5294,17537,1949,0,24780
765,2019-11-03,5142,21848,848,3,27841
765,2019-11-04,6142,7369,1783,1,15295
765,2019-11-05,6598,6603,2069,0,15270
765,2019-11-06,4320,14113,1539,3,19975
765,2019-11-07,5282,24593,1137,2,31014
765,2019-11-08,5602,12647,1201,1,19451
765,2019-11-09,4126,13443,1139,0,18708
765,2019-11-10,3210,25410,994,0,29614
765,2019-11-11,2224,16419,1515,1,20159
765,2019-11-12,1670,12940,2089,1,16700
765,2019-11-13,1747,22558,1989,4,26298
765,2019-11-14,2779,11046,1021,1,14847
765,2019-11-15,2243,4505,1442,2,8192
765,2019-11-16,2474,2615,1641,0,6730
765,2019-11-17,2765,4194,2674,1,9634
765,2019-11-18,2302,3186,2914,5,8407
765,2019-11-19,2891,5427,2044,1,10363
765,2019-11-20,2368,2018,1599,0,5985
765,2019-11-21,2733,5539,1561,1,9834
765,2019-11-22,2950,4221,980,4,8155
765,2019-11-23,2153,6999,1551,2,10705
765,2019-11-24,1480,7078,1371,1,9930
765,2019-11-25,1906,10569,1810,0,14285
765,2019-11-26,1502,10449,1398,0,13349
765,2019-11-27,1867,6173,1487,0,9527
765,2019-11-28,1642,11768,522,1,13933
765,2019-11-29,249,1000,2,0,1251
765,2019-08-22,0,0,155,0,155
765,2019-08-23,2551,3211,2546,2,8310
765,2019-08-24,23489,2145,1832,1,27467
765,2019-08-25,25823,15364,1846,2,43035
765,2019-08-26,13124,24244,1980,1,39349
765,2019-08-27,2047,17536,1856,2,21441
765,2019-08-28,1024,12551,1980,0,15555
765,2019-08-29,6858,12693,1595,1,21147
765,2019-08-30,3241,2751,1080,3,7075
765,2019-08-31,2072,37,0,0,2109
765,2019-09-01,9472,1169,180,1,10822
765,2019-09-02,8853,935,0,0,9788
765,2019-09-03,17721,441,931,0,19093
765,2019-09-04,40209,10961,1742,3,52915
765,2019-09-05,30672,6113,1796,0,38581
765,2019-09-06,28528,11487,1917,0,41932
765,2019-09-07,28550,9534,2405,3,40492
765,2019-09-08,22216,4504,2171,0,28891
765,2019-09-09,10811,6605,2019,1,19436
765,2019-09-10,8747,6372,2636,0,17755
765,2019-09-11,5448,5968,2685,3,14104
765,2019-09-12,2865,9986,2162,3,15016
765,2019-09-13,3334,6201,1393,2,10930
765,2019-09-14,2717,9731,1747,2,14197
765,2019-09-15,2537,6095,1785,0,10417
765,2019-09-16,3127,7503,1869,3,12502
765,2019-09-17,3799,7223,2154,8,13184
765,2019-09-18,3042,11481,1528,9,16060
765,2019-09-19,2983,3332,1710,10,8035
765,2019-09-20,2689,7874,1590,9,12162
765,2019-09-21,4967,5737,1349,10,12063
765,2019-09-22,4486,11018,1869,8,17381
765,2019-09-23,4453,11658,2160,12,18283
765,2019-09-24,1871,8736,1709,14,12330
765,2019-09-25,2574,7049,1871,12,11506
765,2019-09-26,2813,10242,2135,10,15200
765,2019-09-27,4186,8080,2129,4,14399
765,2019-09-28,5514,13855,2177,3,21549
765,2019-09-29,6250,15735,1780,3,23768
765,2019-09-30,4518,16563,1769,0,22850
765,2019-10-01,4970,16004,1385,0,22359
765,2019-10-02,5707,13729,2030,6,21472
765,2019-10-03,5919,14119,1868,9,21915
765,2019-10-04,3949,18344,1563,12,23868
765,2019-10-05,4021,16516,2438,11,22986
765,2019-10-06,4670,13010,2620,11,20311
765,2019-10-07,5353,6500,1914,10,13777
765,2019-10-08,4598,12506,1685,12,18801
765,2019-10-09,8002,22965,2098,12,33077
765,2019-10-10,9181,17396,1893,10,28480
765,2019-10-11,9217,8171,926,9,18323
765,2019-10-12,10891,6715,2526,1,20133
765,2019-10-13,11207,12828,2777,2,26814
765,2019-10-14,10274,5502,1703,2,17481
765,2019-10-15,5090,8457,1350,0,14897
765,2019-10-16,1834,18112,1281,1,21228
765,2019-10-17,2425,8412,1724,0,12561
765,2019-10-18,2375,13970,1598,0,17943
765,2019-10-19,2853,8471,1908,0,13232
765,2019-10-20,3878,2887,1463,2,8230
765,2019-10-21,4909,11245,1226,1,17381
765,2019-10-22,4925,7360,1357,0,13642
765,2019-10-23,4389,8304,1496,1,14190
765,2019-10-24,4133,20582,1964,2,26681
765,2019-10-25,2613,18697,1764,4,23078
765,2019-10-26,3033,24715,1999,0,29747
765,2019-10-27,3670,18358,1770,703,24501
765,2019-10-28,3378,22817,1346,1,27542
765,2019-10-29,3833,16868,1725,3,22429
765,2019-10-30,4094,15216,1529,0,20839
765,2019-10-31,4125,19993,1527,501,26146
765,2019-11-01,5669,26790,1827,1,34287
765,2019-11-02,5294,17537,1949,0,24780
765,2019-11-03,5142,21848,848,3,27841
765,2019-11-04,6142,7369,1783,1,15295
765,2019-11-05,6598,6603,2069,0,15270
765,2019-11-06,4320,14113,1539,3,19975
765,2019-11-07,5282,24593,1137,2,31014
765,2019-11-08,5602,12647,1201,1,19451
765,2019-11-09,4126,13443,1139,0,18708
765,2019-11-10,3210,25410,994,0,29614
765,2019-11-11,2224,16419,1515,1,20159
765,2019-11-12,1670,12940,2089,1,16700
765,2019-11-13,1747,22558,1989,4,26298
765,2019-11-14,2779,11046,1021,1,14847
765,2019-11-15,2243,4505,1442,2,8192
765,2019-11-16,2474,2615,1641,0,6730
765,2019-11-17,2765,4194,2674,1,9634
765,2019-11-18,2302,3186,2914,5,8407
765,2019-11-19,2891,5427,2044,1,10363
765,2019-11-20,2368,2018,1599,0,5985
765,2019-11-21,2733,5539,1561,1,9834
765,2019-11-22,2950,4221,980,4,8155
765,2019-11-23,2153,6999,1551,2,10705
765,2019-11-24,1480,7078,1371,1,9930
765,2019-11-25,1906,10569,1810,0,14285
765,2019-11-26,1502,10449,1398,0,13349
765,2019-11-27,1867,6173,1487,0,9527
765,2019-11-28,1642,11768,522,1,13933
765,2019-11-29,249,1000,2,0,1251
765,2019-08-23,2551,3211,2546,2,8310
765,2019-08-24,23489,2145,1832,1,27467
765,2019-08-25,25823,15364,1846,2,43035
765,2019-08-26,13124,24244,1980,1,39349
765,2019-08-27,2047,17536,1856,2,21441
765,2019-08-28,1024,12551,1980,0,15555
765,2019-08-29,6858,12693,1595,1,21147
765,2019-08-30,3241,2751,1080,3,7075
765,2019-08-31,2072,37,0,0,2109
765,2019-09-01,9472,1169,180,1,10822
765,2019-09-02,8853,935,0,0,9788
765,2019-09-03,17721,441,931,0,19093
765,2019-09-04,40209,10961,1742,3,52915
765,2019-09-05,30672,6113,1796,0,38581
765,2019-09-06,28528,11487,1917,0,41932
765,2019-09-07,28550,9534,2405,3,40492
765,2019-09-08,22216,4504,2171,0,28891
765,2019-09-09,10811,6605,2019,1,19436
765,2019-09-10,8747,6372,2636,0,17755
765,2019-09-11,5448,5968,2685,3,14104
765,2019-09-12,2865,9986,2162,3,15016
765,2019-09-13,3334,6201,1393,2,10930
765,2019-09-14,2717,9731,1747,2,14197
765,2019-09-15,2537,6095,1785,0,10417
765,2019-09-16,3127,7503,1869,3,12502
765,2019-09-17,3799,7223,2154,8,13184
765,2019-09-18,3042,11481,1528,9,16060
765,2019-09-19,2983,3332,1710,10,8035
765,2019-09-20,2689,7874,1590,9,12162
765,2019-09-21,4967,5737,1349,10,12063
765,2019-09-22,4486,11018,1869,8,17381
765,2019-09-23,4453,11658,2160,12,18283
765,2019-09-24,1871,8736,1709,14,12330
765,2019-09-25,2574,7049,1871,12,11506
765,2019-09-26,2813,10242,2135,10,15200
765,2019-09-27,4186,8080,2129,4,14399
765,2019-09-28,5514,13855,2177,3,21549
765,2019-09-29,6250,15735,1780,3,23768
765,2019-09-30,4518,16563,1769,0,22850
765,2019-10-01,4970,16004,1385,0,22359
765,2019-10-02,5707,13729,2030,6,21472
765,2019-10-03,5919,14119,1868,9,21915
765,2019-10-04,3949,18344,1563,12,23868
765,2019-10-05,4021,16516,2438,11,22986
765,2019-10-06,4670,13010,2620,11,20311
765,2019-10-07,5353,6500,1914,10,13777
765,2019-10-08,4598,12506,1685,12,18801
765,2019-10-09,8002,22965,2098,12,33077
765,2019-10-10,9181,17396,1893,10,28480
765,2019-10-11,9217,8171,926,9,18323
765,2019-10-12,10891,6715,2526,1,20133
765,2019-10-13,11207,12828,2777,2,26814
765,2019-10-14,10274,5502,1703,2,17481
765,2019-10-15,5090,8457,1350,0,14897
765,2019-10-16,1834,18112,1281,1,21228
765,2019-10-17,2425,8412,1724,0,12561
765,2019-10-18,2375,13970,1598,0,17943
765,2019-10-19,2853,8471,1908,0,13232
765,2019-10-20,3878,2887,1463,2,8230
765,2019-10-21,4909,11245,1226,1,17381
765,2019-10-22,4925,7360,1357,0,13642
765,2019-10-23,4389,8304,1496,1,14190
765,2019-10-24,4133,20582,1964,2,26681
765,2019-10-25,2613,18697,1764,4,23078
765,2019-10-26,3033,24715,1999,0,29747
765,2019-10-27,3670,18358,1770,703,24501
765,2019-10-28,3378,22817,1346,1,27542
765,2019-10-29,3833,16868,1725,3,22429
765,2019-10-30,4094,15216,1529,0,20839
765,2019-10-31,4125,19993,1527,501,26146
765,2019-11-01,5669,26790,1827,1,34287
765,2019-11-02,5294,17537,1949,0,24780
765,2019-11-03,5142,21848,848,3,27841
765,2019-11-04,6142,7369,1783,1,15295
765,2019-11-05,6598,6603,2069,0,15270
765,2019-11-06,4320,14113,1539,3,19975
765,2019-11-07,5282,24593,1137,2,31014
765,2019-11-08,5602,12647,1201,1,19451
765,2019-11-09,4126,13443,1139,0,18708
765,2019-11-10,3210,25410,994,0,29614
765,2019-11-11,2224,16419,1515,1,20159
765,2019-11-12,1670,12940,2089,1,16700
765,2019-11-13,1747,22558,1989,4,26298
765,2019-11-14,2779,11046,1021,1,14847
765,2019-11-15,2243,4505,1442,2,8192
765,2019-11-16,2474,2615,1641,0,6730
765,2019-11-17,2765,4194,2674,1,9634
765,2019-11-18,2302,3186,2914,5,8407
765,2019-11-19,2891,5427,2044,1,10363
765,2019-11-20,2368,2018,1599,0,5985
765,2019-11-21,2733,5539,1561,1,9834
765,2019-11-22,2950,4221,980,4,8155
765,2019-11-23,2153,6999,1551,2,10705
765,2019-11-24,1480,7078,1371,1,9930
765,2019-11-25,1906,10569,1810,0,14285
765,2019-11-26,1502,10449,1398,0,13349
765,2019-11-27,1867,6173,1487,0,9527
765,2019-11-28,1642,11768,522,1,13933
766,2019-08-23,352,3489,1055,1,4897
766,2019-08-24,560,2050,723,0,3333
766,2019-08-25,650,13299,1177,1,15127
766,2019-08-26,539,13590,1282,3,15414
766,2019-08-27,1371,7991,1599,0,10961
766,2019-08-28,474,1633,2319,1,4427
766,2019-08-29,2704,10563,1537,0,14804
766,2019-08-30,544,2869,550,0,3963
766,2019-08-31,79,38,0,0,117
766,2019-09-01,134,585,276,0,995
766,2019-09-02,71,266,9,0,346
766,2019-09-03,122,417,1200,0,1739
766,2019-09-04,512,10138,3399,1,14050
766,2019-09-05,1351,4919,1568,3,7841
766,2019-09-06,592,9568,2049,2,12211
766,2019-09-07,625,7998,2598,0,11221
766,2019-09-08,916,5855,2736,1,9508
766,2019-09-09,549,6673,1899,0,9121
766,2019-09-10,384,4528,2133,0,7045
766,2019-09-11,281,6845,1511,3,8640
766,2019-09-12,318,7669,1194,2,9183
766,2019-09-13,1698,3735,2311,0,7744
766,2019-09-14,542,7746,2656,0,10944
766,2019-09-15,3415,11589,1892,0,16896
766,2019-09-16,412,5956,2539,1,8908
766,2019-09-17,395,9804,2576,0,12775
766,2019-09-18,597,11166,829,0,12592
766,2019-09-19,769,3755,1926,0,6450
766,2019-09-20,549,8215,1572,1,10337
766,2019-09-21,472,4683,1650,2,6807
766,2019-09-22,403,12605,1427,0,14435
766,2019-09-23,572,10495,2774,0,13841
766,2019-09-24,644,6835,1144,2,8625
766,2019-09-25,1117,8315,2160,5,11597
766,2019-09-26,204,9911,1890,0,12005
766,2019-09-27,182,7533,1745,3,9463
766,2019-09-28,174,12421,1628,0,14223
766,2019-09-29,1058,17274,1939,0,20271
766,2019-09-30,703,26766,1962,4,29435
766,2019-10-01,198,21826,911,1,22936
766,2019-10-02,1174,11062,1068,0,13304
766,2019-10-03,228,13186,1293,1,14708
766,2019-10-04,181,22766,1358,0,24305
766,2019-10-05,179,37065,2029,1,39274
766,2019-10-06,1044,19693,1748,2,22487
766,2019-10-07,1020,4679,1739,1,7439
766,2019-10-08,828,10932,2129,2,13891
766,2019-10-09,218,14461,1595,2,16276
766,2019-10-10,455,9126,1230,2,10813
766,2019-10-11,1634,10223,1980,0,13837
766,2019-10-12,369,9830,2217,0,12416
766,2019-10-13,380,10793,1715,1,12889
766,2019-10-14,382,3866,3548,2,7798
766,2019-10-15,446,7014,1206,3,8669
766,2019-10-16,376,17397,1499,0,19272
766,2019-10-17,1289,7296,2389,1,10975
766,2019-10-18,893,6756,1694,1,9344
766,2019-10-19,502,5461,2489,1,8453
766,2019-10-20,1342,657,2122,2,4123
766,2019-10-21,867,9832,1544,1,12244
766,2019-10-22,591,10423,1805,1,12820
766,2019-10-23,366,14980,2044,1,17391
766,2019-10-24,1255,13703,2150,0,17108
766,2019-10-25,625,11429,1559,4,13617
766,2019-10-26,409,12630,1555,782,15376
766,2019-10-27,474,15501,1522,0,17497
766,2019-10-28,418,12825,1646,0,14889
766,2019-10-29,484,14343,1715,0,16542
766,2019-10-30,881,17363,1123,3,19370
766,2019-10-31,526,11370,906,0,12802
766,2019-11-01,388,13317,1108,0,14813
766,2019-11-02,337,12979,1351,1,14668
766,2019-11-03,354,21496,1214,0,23064
766,2019-11-04,1303,8898,2094,2,12297
766,2019-11-05,430,1345,1862,0,3637
766,2019-11-06,404,7469,1031,0,8904
766,2019-11-07,474,13049,1243,2,14768
766,2019-11-08,724,8823,1129,1,10677
766,2019-11-09,498,7785,1456,2,9741
766,2019-11-10,355,11767,2060,1,14183
766,2019-11-11,403,8147,1945,2,10497
766,2019-11-12,1132,8922,2790,1,12845
766,2019-11-13,452,13854,2008,1,16315
766,2019-11-14,374,11210,1465,3,13052
766,2019-11-15,394,3841,2320,1,6556
766,2019-11-16,401,2963,3009,0,6373
766,2019-11-17,516,4067,3075,1,7659
766,2019-11-18,389,2493,3571,1,6454
766,2019-11-19,485,3244,2243,2,5974
766,2019-11-20,461,1325,2393,0,4179
766,2019-11-21,426,5436,1227,0,7089
766,2019-11-22,458,8273,1486,1,10218
766,2019-11-23,400,6643,2273,1,9317
766,2019-11-24,509,5226,1418,2,7155
766,2019-11-25,912,6862,1447,0,9221
766,2019-11-26,412,8926,1460,0,10798
766,2019-11-27,417,6348,1733,141,8639
766,2019-11-28,366,6901,332,147,7746
766,2019-11-29,80,319,0,0,399
766,2019-08-23,352,3489,1055,1,4897
766,2019-08-24,560,2050,723,0,3333
766,2019-08-25,650,13299,1177,1,15127
766,2019-08-26,539,13590,1282,3,15414
766,2019-08-27,1371,7991,1599,0,10961
766,2019-08-28,474,1633,2319,1,4427
766,2019-08-29,2704,10563,1537,0,14804
766,2019-08-30,544,2869,550,0,3963
766,2019-08-31,79,38,0,0,117
766,2019-09-01,134,585,276,0,995
766,2019-09-02,71,266,9,0,346
766,2019-09-03,122,417,1200,0,1739
766,2019-09-04,512,10138,3399,1,14050
766,2019-09-05,1351,4919,1568,3,7841
766,2019-09-06,592,9568,2049,2,12211
766,2019-09-07,625,7998,2598,0,11221
766,2019-09-08,916,5855,2736,1,9508
766,2019-09-09,549,6673,1899,0,9121
766,2019-09-10,384,4528,2133,0,7045
766,2019-09-11,281,6845,1511,3,8640
766,2019-09-12,318,7669,1194,2,9183
766,2019-09-13,1698,3735,2311,0,7744
766,2019-09-14,542,7746,2656,0,10944
766,2019-09-15,3415,11589,1892,0,16896
766,2019-09-16,412,5956,2539,1,8908
766,2019-09-17,395,9804,2576,0,12775
766,2019-09-18,597,11166,829,0,12592
766,2019-09-19,769,3755,1926,0,6450
766,2019-09-20,549,8215,1572,1,10337
766,2019-09-21,472,4683,1650,2,6807
766,2019-09-22,403,12605,1427,0,14435
766,2019-09-23,572,10495,2774,0,13841
766,2019-09-24,644,6835,1144,2,8625
766,2019-09-25,1117,8315,2160,5,11597
766,2019-09-26,204,9911,1890,0,12005
766,2019-09-27,182,7533,1745,3,9463
766,2019-09-28,174,12421,1628,0,14223
766,2019-09-29,1058,17274,1939,0,20271
766,2019-09-30,703,26766,1962,4,29435
766,2019-10-01,198,21826,911,1,22936
766,2019-10-02,1174,11062,1068,0,13304
766,2019-10-03,228,13186,1293,1,14708
766,2019-10-04,181,22766,1358,0,24305
766,2019-10-05,179,37065,2029,1,39274
766,2019-10-06,1044,19693,1748,2,22487
766,2019-10-07,1020,4679,1739,1,7439
766,2019-10-08,828,10932,2129,2,13891
766,2019-10-09,218,14461,1595,2,16276
766,2019-10-10,455,9126,1230,2,10813
766,2019-10-11,1634,10223,1980,0,13837
766,2019-10-12,369,9830,2217,0,12416
766,2019-10-13,380,10793,1715,1,12889
766,2019-10-14,382,3866,3548,2,7798
766,2019-10-15,446,7014,1206,3,8669
766,2019-10-16,376,17397,1499,0,19272
766,2019-10-17,1289,7296,2389,1,10975
766,2019-10-18,893,6756,1694,1,9344
766,2019-10-19,502,5461,2489,1,8453
766,2019-10-20,1342,657,2122,2,4123
766,2019-10-21,867,9832,1544,1,12244
766,2019-10-22,591,10423,1805,1,12820
766,2019-10-23,366,14980,2044,1,17391
766,2019-10-24,1255,13703,2150,0,17108
766,2019-10-25,625,11429,1559,4,13617
766,2019-10-26,409,12630,1555,782,15376
766,2019-10-27,474,15501,1522,0,17497
766,2019-10-28,418,12825,1646,0,14889
766,2019-10-29,484,14343,1715,0,16542
766,2019-10-30,881,17363,1123,3,19370
766,2019-10-31,526,11370,906,0,12802
766,2019-11-01,388,13317,1108,0,14813
766,2019-11-02,337,12979,1351,1,14668
766,2019-11-03,354,21496,1214,0,23064
766,2019-11-04,1303,8898,2094,2,12297
766,2019-11-05,430,1345,1862,0,3637
766,2019-11-06,404,7469,1031,0,8904
766,2019-11-07,474,13049,1243,2,14768
766,2019-11-08,724,8823,1129,1,10677
766,2019-11-09,498,7785,1456,2,9741
766,2019-11-10,355,11767,2060,1,14183
766,2019-11-11,403,8147,1945,2,10497
766,2019-11-12,1132,8922,2790,1,12845
766,2019-11-13,452,13854,2008,1,16315
766,2019-11-14,374,11210,1465,3,13052
766,2019-11-15,394,3841,2320,1,6556
766,2019-11-16,401,2963,3009,0,6373
766,2019-11-17,516,4067,3075,1,7659
766,2019-11-18,389,2493,3571,1,6454
766,2019-11-19,485,3244,2243,2,5974
766,2019-11-20,461,1325,2393,0,4179
766,2019-11-21,426,5436,1227,0,7089
766,2019-11-22,458,8273,1486,1,10218
766,2019-11-23,400,6643,2273,1,9317
766,2019-11-24,509,5226,1418,2,7155
766,2019-11-25,912,6862,1447,0,9221
766,2019-11-26,412,8926,1460,0,10798
766,2019-11-27,417,6348,1733,141,8639
766,2019-11-28,366,6901,332,147,7746
766,2019-11-29,80,319,0,0,399
766,2019-08-23,352,3489,1055,1,4897
766,2019-08-24,560,2050,723,0,3333
766,2019-08-25,650,13299,1177,1,15127
766,2019-08-26,539,13590,1282,3,15414
766,2019-08-27,1371,7991,1599,0,10961
766,2019-08-28,474,1633,2319,1,4427
766,2019-08-29,2704,10563,1537,0,14804
766,2019-08-30,544,2869,550,0,3963
766,2019-08-31,79,38,0,0,117
766,2019-09-01,134,585,276,0,995
766,2019-09-02,71,266,9,0,346
766,2019-09-03,122,417,1200,0,1739
766,2019-09-04,512,10138,3399,1,14050
766,2019-09-05,1351,4919,1568,3,7841
766,2019-09-06,592,9568,2049,2,12211
766,2019-09-07,625,7998,2598,0,11221
766,2019-09-08,916,5855,2736,1,9508
766,2019-09-09,549,6673,1899,0,9121
766,2019-09-10,384,4528,2133,0,7045
766,2019-09-11,281,6845,1511,3,8640
766,2019-09-12,318,7669,1194,2,9183
766,2019-09-13,1698,3735,2311,0,7744
766,2019-09-14,542,7746,2656,0,10944
766,2019-09-15,3415,11589,1892,0,16896
766,2019-09-16,412,5956,2539,1,8908
766,2019-09-17,395,9804,2576,0,12775
766,2019-09-18,597,11166,829,0,12592
766,2019-09-19,769,3755,1926,0,6450
766,2019-09-20,549,8215,1572,1,10337
766,2019-09-21,472,4683,1650,2,6807
766,2019-09-22,403,12605,1427,0,14435
766,2019-09-23,572,10495,2774,0,13841
766,2019-09-24,644,6835,1144,2,8625
766,2019-09-25,1117,8315,2160,5,11597
766,2019-09-26,204,9911,1890,0,12005
766,2019-09-27,182,7533,1745,3,9463
766,2019-09-28,174,12421,1628,0,14223
766,2019-09-29,1058,17274,1939,0,20271
766,2019-09-30,703,26766,1962,4,29435
766,2019-10-01,198,21826,911,1,22936
766,2019-10-02,1174,11062,1068,0,13304
766,2019-10-03,228,13186,1293,1,14708
766,2019-10-04,181,22766,1358,0,24305
766,2019-10-05,179,37065,2029,1,39274
766,2019-10-06,1044,19693,1748,2,22487
766,2019-10-07,1020,4679,1739,1,7439
766,2019-10-08,828,10932,2129,2,13891
766,2019-10-09,218,14461,1595,2,16276
766,2019-10-10,455,9126,1230,2,10813
766,2019-10-11,1634,10223,1980,0,13837
766,2019-10-12,369,9830,2217,0,12416
766,2019-10-13,380,10793,1715,1,12889
766,2019-10-14,382,3866,3548,2,7798
766,2019-10-15,446,7014,1206,3,8669
766,2019-10-16,376,17397,1499,0,19272
766,2019-10-17,1289,7296,2389,1,10975
766,2019-10-18,893,6756,1694,1,9344
766,2019-10-19,502,5461,2489,1,8453
766,2019-10-20,1342,657,2122,2,4123
766,2019-10-21,867,9832,1544,1,12244
766,2019-10-22,591,10423,1805,1,12820
766,2019-10-23,366,14980,2044,1,17391
766,2019-10-24,1255,13703,2150,0,17108
766,2019-10-25,625,11429,1559,4,13617
766,2019-10-26,409,12630,1555,782,15376
766,2019-10-27,474,15501,1522,0,17497
766,2019-10-28,418,12825,1646,0,14889
766,2019-10-29,484,14343,1715,0,16542
766,2019-10-30,881,17363,1123,3,19370
766,2019-10-31,526,11370,906,0,12802
766,2019-11-01,388,13317,1108,0,14813
766,2019-11-02,337,12979,1351,1,14668
766,2019-11-03,354,21496,1214,0,23064
766,2019-11-04,1303,8898,2094,2,12297
766,2019-11-05,430,1345,1862,0,3637
766,2019-11-06,404,7469,1031,0,8904
766,2019-11-07,474,13049,1243,2,14768
766,2019-11-08,724,8823,1129,1,10677
766,2019-11-09,498,7785,1456,2,9741
766,2019-11-10,355,11767,2060,1,14183
766,2019-11-11,403,8147,1945,2,10497
766,2019-11-12,1132,8922,2790,1,12845
766,2019-11-13,452,13854,2008,1,16315
766,2019-11-14,374,11210,1465,3,13052
766,2019-11-15,394,3841,2320,1,6556
766,2019-11-16,401,2963,3009,0,6373
766,2019-11-17,516,4067,3075,1,7659
766,2019-11-18,389,2493,3571,1,6454
766,2019-11-19,485,3244,2243,2,5974
766,2019-11-20,461,1325,2393,0,4179
766,2019-11-21,426,5436,1227,0,7089
766,2019-11-22,458,8273,1486,1,10218
766,2019-11-23,400,6643,2273,1,9317
766,2019-11-24,509,5226,1418,2,7155
766,2019-11-25,912,6862,1447,0,9221
766,2019-11-26,412,8926,1460,0,10798
766,2019-11-27,417,6348,1733,141,8639
766,2019-11-28,366,6901,332,147,7746
766,2019-08-23,352,3489,1055,1,4897
766,2019-08-24,560,2050,723,0,3333
766,2019-08-25,650,13299,1177,1,15127
766,2019-08-26,539,13590,1282,3,15414
766,2019-08-27,1371,7991,1599,0,10961
766,2019-08-28,474,1633,2319,1,4427
766,2019-08-29,2704,10563,1537,0,14804
766,2019-08-30,544,2869,550,0,3963
766,2019-08-31,79,38,0,0,117
766,2019-09-01,134,585,276,0,995
766,2019-09-02,71,266,9,0,346
766,2019-09-03,122,417,1200,0,1739
766,2019-09-04,512,10138,3399,1,14050
766,2019-09-05,1351,4919,1568,3,7841
766,2019-09-06,592,9568,2049,2,12211
766,2019-09-07,625,7998,2598,0,11221
766,2019-09-08,916,5855,2736,1,9508
766,2019-09-09,549,6673,1899,0,9121
766,2019-09-10,384,4528,2133,0,7045
766,2019-09-11,281,6845,1511,3,8640
766,2019-09-12,318,7669,1194,2,9183
766,2019-09-13,1698,3735,2311,0,7744
766,2019-09-14,542,7746,2656,0,10944
766,2019-09-15,3415,11589,1892,0,16896
766,2019-09-16,412,5956,2539,1,8908
766,2019-09-17,395,9804,2576,0,12775
766,2019-09-18,597,11166,829,0,12592
766,2019-09-19,769,3755,1926,0,6450
766,2019-09-20,549,8215,1572,1,10337
766,2019-09-21,472,4683,1650,2,6807
766,2019-09-22,403,12605,1427,0,14435
766,2019-09-23,572,10495,2774,0,13841
766,2019-09-24,644,6835,1144,2,8625
766,2019-09-25,1117,8315,2160,5,11597
766,2019-09-26,204,9911,1890,0,12005
766,2019-09-27,182,7533,1745,3,9463
766,2019-09-28,174,12421,1628,0,14223
766,2019-09-29,1058,17274,1939,0,20271
766,2019-09-30,703,26766,1962,4,29435
766,2019-10-01,198,21826,911,1,22936
766,2019-10-02,1174,11062,1068,0,13304
766,2019-10-03,228,13186,1293,1,14708
766,2019-10-04,181,22766,1358,0,24305
766,2019-10-05,179,37065,2029,1,39274
766,2019-10-06,1044,19693,1748,2,22487
766,2019-10-07,1020,4679,1739,1,7439
766,2019-10-08,828,10932,2129,2,13891
766,2019-10-09,218,14461,1595,2,16276
766,2019-10-10,455,9126,1230,2,10813
766,2019-10-11,1634,10223,1980,0,13837
766,2019-10-12,369,9830,2217,0,12416
766,2019-10-13,380,10793,1715,1,12889
766,2019-10-14,382,3866,3548,2,7798
766,2019-10-15,446,7014,1206,3,8669
766,2019-10-16,376,17397,1499,0,19272
766,2019-10-17,1289,7296,2389,1,10975
766,2019-10-18,893,6756,1694,1,9344
766,2019-10-19,502,5461,2489,1,8453
766,2019-10-20,1342,657,2122,2,4123
766,2019-10-21,867,9832,1544,1,12244
766,2019-10-22,591,10423,1805,1,12820
766,2019-10-23,366,14980,2044,1,17391
766,2019-10-24,1255,13703,2150,0,17108
766,2019-10-25,625,11429,1559,4,13617
766,2019-10-26,409,12630,1555,782,15376
766,2019-10-27,474,15501,1522,0,17497
766,2019-10-28,418,12825,1646,0,14889
766,2019-10-29,484,14343,1715,0,16542
766,2019-10-30,881,17363,1123,3,19370
766,2019-10-31,526,11370,906,0,12802
766,2019-11-01,388,13317,1108,0,14813
766,2019-11-02,337,12979,1351,1,14668
766,2019-11-03,354,21496,1214,0,23064
766,2019-11-04,1303,8898,2094,2,12297
766,2019-11-05,430,1345,1862,0,3637
766,2019-11-06,404,7469,1031,0,8904
766,2019-11-07,474,13049,1243,2,14768
766,2019-11-08,724,8823,1129,1,10677
766,2019-11-09,498,7785,1456,2,9741
766,2019-11-10,355,11767,2060,1,14183
766,2019-11-11,403,8147,1945,2,10497
766,2019-11-12,1132,8922,2790,1,12845
766,2019-11-13,452,13854,2008,1,16315
766,2019-11-14,374,11210,1465,3,13052
766,2019-11-15,394,3841,2320,1,6556
766,2019-11-16,401,2963,3009,0,6373
766,2019-11-17,516,4067,3075,1,7659
766,2019-11-18,389,2493,3571,1,6454
766,2019-11-19,485,3244,2243,2,5974
766,2019-11-20,461,1325,2393,0,4179
766,2019-11-21,426,5436,1227,0,7089
766,2019-11-22,458,8273,1486,1,10218
766,2019-11-23,400,6643,2273,1,9317
766,2019-11-24,509,5226,1418,2,7155
766,2019-11-25,912,6862,1447,0,9221
766,2019-11-26,412,8926,1460,0,10798
766,2019-11-27,417,6348,1733,141,8639
766,2019-11-28,366,6901,332,147,7746
767,2019-08-23,125,1517,1109,0,2751
767,2019-08-24,53,907,1802,0,2762
767,2019-08-25,219,3140,1568,1,4928
767,2019-08-26,95,1697,1406,0,3198
767,2019-08-27,85,7248,1981,1,9315
767,2019-08-28,174,2080,2714,0,4968
767,2019-08-29,264,10174,1773,0,12211
767,2019-08-30,81,2383,363,2,2829
767,2019-08-31,45,30,0,0,75
767,2019-09-01,49,158,184,0,391
767,2019-09-02,62,186,91,0,339
767,2019-09-03,79,3549,1109,0,4737
767,2019-09-04,85,13671,1967,2,15725
767,2019-09-05,189,8824,1831,0,10844
767,2019-09-06,96,12138,1863,0,14097
767,2019-09-07,1018,28307,1383,0,30708
767,2019-09-08,184,6070,2715,2,8971
767,2019-09-09,218,8974,2441,1,11634
767,2019-09-10,170,12848,1697,1,14716
767,2019-09-11,1806,9513,2282,2,13603
767,2019-09-12,51,8495,2025,0,10571
767,2019-09-13,73,3818,2114,0,6005
767,2019-09-14,80,10064,1989,1,12134
767,2019-09-15,133,8307,2257,0,10697
767,2019-09-16,143,6652,2001,0,8796
767,2019-09-17,80,8848,1826,1,10755
767,2019-09-18,148,10846,1076,1,12071
767,2019-09-19,318,5037,900,1,6256
767,2019-09-20,82,14038,1627,1,15748
767,2019-09-21,88,17831,1924,2,19845
767,2019-09-22,101,12943,1337,0,14381
767,2019-09-23,194,14489,2083,2,16768
767,2019-09-24,975,10278,1843,2,13098
767,2019-09-25,107,12718,1597,2,14424
767,2019-09-26,85,9644,2154,3,11886
767,2019-09-27,898,14036,2549,2,17485
767,2019-09-28,936,12913,1109,3,14961
767,2019-09-29,87,24989,1468,0,26544
767,2019-09-30,938,19967,2108,0,23013
767,2019-10-01,913,15636,2001,0,18550
767,2019-10-02,119,10516,1881,0,12516
767,2019-10-03,73,11625,1575,0,13273
767,2019-10-04,115,17884,1353,1,19353
767,2019-10-05,693,22888,1700,2,25283
767,2019-10-06,563,16156,2628,0,19347
767,2019-10-07,1931,4673,1467,1,8072
767,2019-10-08,1136,17074,1722,3,19935
767,2019-10-09,226,16816,1273,0,18315
767,2019-10-10,1181,16162,1504,1,18848
767,2019-10-11,804,9125,1850,1,11780
767,2019-10-12,110,5411,1724,1,7246
767,2019-10-13,1847,7169,2055,5,11076
767,2019-10-14,1841,9128,2353,0,13322
767,2019-10-15,1748,7147,1959,0,10854
767,2019-10-16,532,12109,2323,4,14968
767,2019-10-17,1033,3817,2157,1,7008
767,2019-10-18,183,7128,1167,2,8480
767,2019-10-19,998,3789,2720,0,7507
767,2019-10-20,95,863,2273,2,3233
767,2019-10-21,344,10304,1932,1,12581
767,2019-10-22,852,4969,1083,1,6905
767,2019-10-23,65,6976,1269,6,8316
767,2019-10-24,93,19738,1136,0,20967
767,2019-10-25,113,18436,733,1,19283
767,2019-10-26,757,15874,1216,1,17848
767,2019-10-27,937,15688,1425,0,18050
767,2019-10-28,93,21740,1247,2,23082
767,2019-10-29,314,17017,1964,1,19296
767,2019-10-30,125,23161,1671,0,24957
767,2019-10-31,66,16510,1432,0,18008
767,2019-11-01,55,13358,1312,0,14725
767,2019-11-02,549,22319,1278,3,24149
767,2019-11-03,160,37597,1289,0,39046
767,2019-11-04,111,9359,2067,1,11538
767,2019-11-05,1063,1509,1904,0,4476
767,2019-11-06,152,14275,944,2,15373
767,2019-11-07,806,15970,1620,2,18398
767,2019-11-08,117,14468,1545,0,16130
767,2019-11-09,1006,10656,1671,0,13333
767,2019-11-10,625,12242,1381,0,14248
767,2019-11-11,185,8252,1364,1,9802
767,2019-11-12,228,8700,2683,190,11801
767,2019-11-13,391,19724,1911,0,22026
767,2019-11-14,141,9626,2099,0,11866
767,2019-11-15,204,3645,2466,0,6315
767,2019-11-16,220,2975,2835,0,6030
767,2019-11-17,561,5905,2721,0,9187
767,2019-11-18,683,3258,3096,0,7037
767,2019-11-19,232,3244,2850,0,6326
767,2019-11-20,1117,1599,1451,0,4167
767,2019-11-21,139,5639,1691,0,7469
767,2019-11-22,313,4843,1849,0,7005
767,2019-11-23,159,6051,2430,0,8640
767,2019-11-24,91,6224,1924,0,8239
767,2019-11-25,130,6753,1971,0,8854
767,2019-11-26,400,9996,1853,0,12249
767,2019-11-27,146,6529,1405,0,8080
767,2019-11-28,67,11511,579,0,12157
767,2019-11-29,14,513,2,0,529
767,2019-08-23,125,1517,1109,0,2751
767,2019-08-24,53,907,1802,0,2762
767,2019-08-25,219,3140,1568,1,4928
767,2019-08-26,95,1697,1406,0,3198
767,2019-08-27,85,7248,1981,1,9315
767,2019-08-28,174,2080,2714,0,4968
767,2019-08-29,264,10174,1773,0,12211
767,2019-08-30,81,2383,363,2,2829
767,2019-08-31,45,30,0,0,75
767,2019-09-01,49,158,184,0,391
767,2019-09-02,62,186,91,0,339
767,2019-09-03,79,3549,1109,0,4737
767,2019-09-04,85,13671,1967,2,15725
767,2019-09-05,189,8824,1831,0,10844
767,2019-09-06,96,12138,1863,0,14097
767,2019-09-07,1018,28307,1383,0,30708
767,2019-09-08,184,6070,2715,2,8971
767,2019-09-09,218,8974,2441,1,11634
767,2019-09-10,170,12848,1697,1,14716
767,2019-09-11,1806,9513,2282,2,13603
767,2019-09-12,51,8495,2025,0,10571
767,2019-09-13,73,3818,2114,0,6005
767,2019-09-14,80,10064,1989,1,12134
767,2019-09-15,133,8307,2257,0,10697
767,2019-09-16,143,6652,2001,0,8796
767,2019-09-17,80,8848,1826,1,10755
767,2019-09-18,148,10846,1076,1,12071
767,2019-09-19,318,5037,900,1,6256
767,2019-09-20,82,14038,1627,1,15748
767,2019-09-21,88,17831,1924,2,19845
767,2019-09-22,101,12943,1337,0,14381
767,2019-09-23,194,14489,2083,2,16768
767,2019-09-24,975,10278,1843,2,13098
767,2019-09-25,107,12718,1597,2,14424
767,2019-09-26,85,9644,2154,3,11886
767,2019-09-27,898,14036,2549,2,17485
767,2019-09-28,936,12913,1109,3,14961
767,2019-09-29,87,24989,1468,0,26544
767,2019-09-30,938,19967,2108,0,23013
767,2019-10-01,913,15636,2001,0,18550
767,2019-10-02,119,10516,1881,0,12516
767,2019-10-03,73,11625,1575,0,13273
767,2019-10-04,115,17884,1353,1,19353
767,2019-10-05,693,22888,1700,2,25283
767,2019-10-06,563,16156,2628,0,19347
767,2019-10-07,1931,4673,1467,1,8072
767,2019-10-08,1136,17074,1722,3,19935
767,2019-10-09,226,16816,1273,0,18315
767,2019-10-10,1181,16162,1504,1,18848
767,2019-10-11,804,9125,1850,1,11780
767,2019-10-12,110,5411,1724,1,7246
767,2019-10-13,1847,7169,2055,5,11076
767,2019-10-14,1841,9128,2353,0,13322
767,2019-10-15,1748,7147,1959,0,10854
767,2019-10-16,532,12109,2323,4,14968
767,2019-10-17,1033,3817,2157,1,7008
767,2019-10-18,183,7128,1167,2,8480
767,2019-10-19,998,3789,2720,0,7507
767,2019-10-20,95,863,2273,2,3233
767,2019-10-21,344,10304,1932,1,12581
767,2019-10-22,852,4969,1083,1,6905
767,2019-10-23,65,6976,1269,6,8316
767,2019-10-24,93,19738,1136,0,20967
767,2019-10-25,113,18436,733,1,19283
767,2019-10-26,757,15874,1216,1,17848
767,2019-10-27,937,15688,1425,0,18050
767,2019-10-28,93,21740,1247,2,23082
767,2019-10-29,314,17017,1964,1,19296
767,2019-10-30,125,23161,1671,0,24957
767,2019-10-31,66,16510,1432,0,18008
767,2019-11-01,55,13358,1312,0,14725
767,2019-11-02,549,22319,1278,3,24149
767,2019-11-03,160,37597,1289,0,39046
767,2019-11-04,111,9359,2067,1,11538
767,2019-11-05,1063,1509,1904,0,4476
767,2019-11-06,152,14275,944,2,15373
767,2019-11-07,806,15970,1620,2,18398
767,2019-11-08,117,14468,1545,0,16130
767,2019-11-09,1006,10656,1671,0,13333
767,2019-11-10,625,12242,1381,0,14248
767,2019-11-11,185,8252,1364,1,9802
767,2019-11-12,228,8700,2683,190,11801
767,2019-11-13,391,19724,1911,0,22026
767,2019-11-14,141,9626,2099,0,11866
767,2019-11-15,204,3645,2466,0,6315
767,2019-11-16,220,2975,2835,0,6030
767,2019-11-17,561,5905,2721,0,9187
767,2019-11-18,683,3258,3096,0,7037
767,2019-11-19,232,3244,2850,0,6326
767,2019-11-20,1117,1599,1451,0,4167
767,2019-11-21,139,5639,1691,0,7469
767,2019-11-22,313,4843,1849,0,7005
767,2019-11-23,159,6051,2430,0,8640
767,2019-11-24,91,6224,1924,0,8239
767,2019-11-25,130,6753,1971,0,8854
767,2019-11-26,400,9996,1853,0,12249
767,2019-11-27,146,6529,1405,0,8080
767,2019-11-28,67,11511,579,0,12157
767,2019-11-29,14,513,2,0,529
767,2019-08-22,0,0,270,0,270
767,2019-08-23,125,1517,1109,0,2751
767,2019-08-24,53,907,1802,0,2762
767,2019-08-25,219,3140,1568,1,4928
767,2019-08-26,95,1697,1406,0,3198
767,2019-08-27,85,7248,1981,1,9315
767,2019-08-28,174,2080,2714,0,4968
767,2019-08-29,264,10174,1773,0,12211
767,2019-08-30,81,2383,363,2,2829
767,2019-08-31,45,30,0,0,75
767,2019-09-01,49,158,184,0,391
767,2019-09-02,62,186,91,0,339
767,2019-09-03,79,3549,1109,0,4737
767,2019-09-04,85,13671,1967,2,15725
767,2019-09-05,189,8824,1831,0,10844
767,2019-09-06,96,12138,1863,0,14097
767,2019-09-07,1018,28307,1383,0,30708
767,2019-09-08,184,6070,2715,2,8971
767,2019-09-09,218,8974,2441,1,11634
767,2019-09-10,170,12848,1697,1,14716
767,2019-09-11,1806,9513,2282,2,13603
767,2019-09-12,51,8495,2025,0,10571
767,2019-09-13,73,3818,2114,0,6005
767,2019-09-14,80,10064,1989,1,12134
767,2019-09-15,133,8307,2257,0,10697
767,2019-09-16,143,6652,2001,0,8796
767,2019-09-17,80,8848,1826,1,10755
767,2019-09-18,148,10846,1076,1,12071
767,2019-09-19,318,5037,900,1,6256
767,2019-09-20,82,14038,1627,1,15748
767,2019-09-21,88,17831,1924,2,19845
767,2019-09-22,101,12943,1337,0,14381
767,2019-09-23,194,14489,2083,2,16768
767,2019-09-24,975,10278,1843,2,13098
767,2019-09-25,107,12718,1597,2,14424
767,2019-09-26,85,9644,2154,3,11886
767,2019-09-27,898,14036,2549,2,17485
767,2019-09-28,936,12913,1109,3,14961
767,2019-09-29,87,24989,1468,0,26544
767,2019-09-30,938,19967,2108,0,23013
767,2019-10-01,913,15636,2001,0,18550
767,2019-10-02,119,10516,1881,0,12516
767,2019-10-03,73,11625,1575,0,13273
767,2019-10-04,115,17884,1353,1,19353
767,2019-10-05,693,22888,1700,2,25283
767,2019-10-06,563,16156,2628,0,19347
767,2019-10-07,1931,4673,1467,1,8072
767,2019-10-08,1136,17074,1722,3,19935
767,2019-10-09,226,16816,1273,0,18315
767,2019-10-10,1181,16162,1504,1,18848
767,2019-10-11,804,9125,1850,1,11780
767,2019-10-12,110,5411,1724,1,7246
767,2019-10-13,1847,7169,2055,5,11076
767,2019-10-14,1841,9128,2353,0,13322
767,2019-10-15,1748,7147,1959,0,10854
767,2019-10-16,532,12109,2323,4,14968
767,2019-10-17,1033,3817,2157,1,7008
767,2019-10-18,183,7128,1167,2,8480
767,2019-10-19,998,3789,2720,0,7507
767,2019-10-20,95,863,2273,2,3233
767,2019-10-21,344,10304,1932,1,12581
767,2019-10-22,852,4969,1083,1,6905
767,2019-10-23,65,6976,1269,6,8316
767,2019-10-24,93,19738,1136,0,20967
767,2019-10-25,113,18436,733,1,19283
767,2019-10-26,757,15874,1216,1,17848
767,2019-10-27,937,15688,1425,0,18050
767,2019-10-28,93,21740,1247,2,23082
767,2019-10-29,314,17017,1964,1,19296
767,2019-10-30,125,23161,1671,0,24957
767,2019-10-31,66,16510,1432,0,18008
767,2019-11-01,55,13358,1312,0,14725
767,2019-11-02,549,22319,1278,3,24149
767,2019-11-03,160,37597,1289,0,39046
767,2019-11-04,111,9359,2067,1,11538
767,2019-11-05,1063,1509,1904,0,4476
767,2019-11-06,152,14275,944,2,15373
767,2019-11-07,806,15970,1620,2,18398
767,2019-11-08,117,14468,1545,0,16130
767,2019-11-09,1006,10656,1671,0,13333
767,2019-11-10,625,12242,1381,0,14248
767,2019-11-11,185,8252,1364,1,9802
767,2019-11-12,228,8700,2683,190,11801
767,2019-11-13,391,19724,1911,0,22026
767,2019-11-14,141,9626,2099,0,11866
767,2019-11-15,204,3645,2466,0,6315
767,2019-11-16,220,2975,2835,0,6030
767,2019-11-17,561,5905,2721,0,9187
767,2019-11-18,683,3258,3096,0,7037
767,2019-11-19,232,3244,2850,0,6326
767,2019-11-20,1117,1599,1451,0,4167
767,2019-11-21,139,5639,1691,0,7469
767,2019-11-22,313,4843,1849,0,7005
767,2019-11-23,159,6051,2430,0,8640
767,2019-11-24,91,6224,1924,0,8239
767,2019-11-25,130,6753,1971,0,8854
767,2019-11-26,400,9996,1853,0,12249
767,2019-11-27,146,6529,1405,0,8080
767,2019-11-28,67,11511,579,0,12157
767,2019-11-29,14,513,2,0,529
767,2019-08-25,219,3140,1568,1,4928
767,2019-08-26,95,1697,1406,0,3198
767,2019-08-27,85,7248,1981,1,9315
767,2019-08-28,174,2080,2714,0,4968
767,2019-08-29,264,10174,1773,0,12211
767,2019-08-30,81,2383,363,2,2829
767,2019-08-31,45,30,0,0,75
767,2019-09-01,49,158,184,0,391
767,2019-09-02,62,186,91,0,339
767,2019-09-03,79,3549,1109,0,4737
767,2019-09-04,85,13671,1967,2,15725
767,2019-09-05,189,8824,1831,0,10844
767,2019-09-06,96,12138,1863,0,14097
767,2019-09-07,1018,28307,1383,0,30708
767,2019-09-08,184,6070,2715,2,8971
767,2019-09-09,218,8974,2441,1,11634
767,2019-09-10,170,12848,1697,1,14716
767,2019-09-11,1806,9513,2282,2,13603
767,2019-09-12,51,8495,2025,0,10571
767,2019-09-13,73,3818,2114,0,6005
767,2019-09-14,80,10064,1989,1,12134
767,2019-09-15,133,8307,2257,0,10697
767,2019-09-16,143,6652,2001,0,8796
767,2019-09-17,80,8848,1826,1,10755
767,2019-09-18,148,10846,1076,1,12071
767,2019-09-19,318,5037,900,1,6256
767,2019-09-20,82,14038,1627,1,15748
767,2019-09-21,88,17831,1924,2,19845
767,2019-09-22,101,12943,1337,0,14381
767,2019-09-23,194,14489,2083,2,16768
767,2019-09-24,975,10278,1843,2,13098
767,2019-09-25,107,12718,1597,2,14424
767,2019-09-26,85,9644,2154,3,11886
767,2019-09-27,898,14036,2549,2,17485
767,2019-09-28,936,12913,1109,3,14961
767,2019-09-29,87,24989,1468,0,26544
767,2019-09-30,938,19967,2108,0,23013
767,2019-10-01,913,15636,2001,0,18550
767,2019-10-02,119,10516,1881,0,12516
767,2019-10-03,73,11625,1575,0,13273
767,2019-10-04,115,17884,1353,1,19353
767,2019-10-05,693,22888,1700,2,25283
767,2019-10-06,563,16156,2628,0,19347
767,2019-10-07,1931,4673,1467,1,8072
767,2019-10-08,1136,17074,1722,3,19935
767,2019-10-09,226,16816,1273,0,18315
767,2019-10-10,1181,16162,1504,1,18848
767,2019-10-11,804,9125,1850,1,11780
767,2019-10-12,110,5411,1724,1,7246
767,2019-10-13,1847,7169,2055,5,11076
767,2019-10-14,1841,9128,2353,0,13322
767,2019-10-15,1748,7147,1959,0,10854
767,2019-10-16,532,12109,2323,4,14968
767,2019-10-17,1033,3817,2157,1,7008
767,2019-10-18,183,7128,1167,2,8480
767,2019-10-19,998,3789,2720,0,7507
767,2019-10-20,95,863,2273,2,3233
767,2019-10-21,344,10304,1932,1,12581
767,2019-10-22,852,4969,1083,1,6905
767,2019-10-23,65,6976,1269,6,8316
767,2019-10-24,93,19738,1136,0,20967
767,2019-10-25,113,18436,733,1,19283
767,2019-10-26,757,15874,1216,1,17848
767,2019-10-27,937,15688,1425,0,18050
767,2019-10-28,93,21740,1247,2,23082
767,2019-10-29,314,17017,1964,1,19296
767,2019-10-30,125,23161,1671,0,24957
767,2019-10-31,66,16510,1432,0,18008
767,2019-11-01,55,13358,1312,0,14725
767,2019-11-02,549,22319,1278,3,24149
767,2019-11-03,160,37597,1289,0,39046
767,2019-11-04,111,9359,2067,1,11538
767,2019-11-05,1063,1509,1904,0,4476
767,2019-11-06,152,14275,944,2,15373
767,2019-11-07,806,15970,1620,2,18398
767,2019-11-08,117,14468,1545,0,16130
767,2019-11-09,1006,10656,1671,0,13333
767,2019-11-10,625,12242,1381,0,14248
767,2019-11-11,185,8252,1364,1,9802
767,2019-11-12,228,8700,2683,190,11801
768,2019-08-23,205,1254,1381,0,2840
768,2019-08-24,920,2156,1080,0,4156
768,2019-08-25,247,13166,1727,0,15140
768,2019-08-26,278,23187,1800,0,25265
768,2019-08-27,191,11436,966,3,12596
768,2019-08-28,161,12690,1980,2,14833
768,2019-08-29,334,13479,1710,2,15525
768,2019-08-30,185,2804,1019,1,4009
768,2019-08-31,69,25,45,0,139
768,2019-09-01,156,915,2,0,1073
768,2019-09-02,115,951,27,0,1093
768,2019-09-03,246,866,995,0,2107
768,2019-09-04,358,13740,2422,2,16522
768,2019-09-05,270,13146,3303,1,16720
768,2019-09-06,144,10216,1586,0,11946
768,2019-09-07,402,8517,2021,1,10941
768,2019-09-08,1303,5949,2074,0,9326
768,2019-09-09,322,13319,1737,2,15380
768,2019-09-10,1077,7236,1760,0,10073
768,2019-09-11,1180,6435,1803,3,9421
768,2019-09-12,145,7017,2558,2,9722
768,2019-09-13,1070,4353,2272,1,7696
768,2019-09-14,186,7734,2660,2,10582
768,2019-09-15,997,11426,2138,0,14561
768,2019-09-16,295,5586,2460,3,8344
768,2019-09-17,1046,8133,1980,7,11166
768,2019-09-18,152,11283,1423,8,12866
768,2019-09-19,331,3010,1983,9,5333
768,2019-09-20,1034,12496,1618,13,15161
768,2019-09-21,152,6972,1800,9,8933
768,2019-09-22,127,9256,2833,9,12225
768,2019-09-23,220,8259,1285,10,9774
768,2019-09-24,169,19970,1479,15,21633
768,2019-09-25,237,14356,1596,12,16201
768,2019-09-26,135,13300,991,10,14436
768,2019-09-27,518,7923,1900,3,10344
768,2019-09-28,143,14151,2618,2,16914
768,2019-09-29,419,17759,1380,5,19563
768,2019-09-30,656,15100,1818,1,17575
768,2019-10-01,280,16557,1296,0,18133
768,2019-10-02,287,11138,1704,7,13136
768,2019-10-03,860,13993,1890,9,16752
768,2019-10-04,167,20909,1695,12,22783
768,2019-10-05,818,25197,1579,10,27604
768,2019-10-06,459,10134,1732,11,12336
768,2019-10-07,611,5097,2944,9,8661
768,2019-10-08,1116,21933,1554,11,24614
768,2019-10-09,1306,34607,1425,11,37349
768,2019-10-10,243,17389,2571,10,20213
768,2019-10-11,192,9701,1505,10,11408
768,2019-10-12,157,5538,1882,0,7577
768,2019-10-13,1664,7634,2502,3,11803
768,2019-10-14,991,6008,2313,0,9312
768,2019-10-15,1310,7835,2336,0,11481
768,2019-10-16,389,12351,1295,2,14037
768,2019-10-17,563,4042,1693,0,6298
768,2019-10-18,199,7213,2758,2,10172
768,2019-10-19,116,24846,1986,0,26948
768,2019-10-20,101,8821,1423,1,10346
768,2019-10-21,98,10820,1113,2,12033
768,2019-10-22,882,4838,2008,1,7729
768,2019-10-23,165,7015,1585,3,8768
768,2019-10-24,178,12901,2244,3,15326
768,2019-10-25,243,14151,1786,2,16182
768,2019-10-26,966,17474,2249,1,20690
768,2019-10-27,171,27591,907,1,28670
768,2019-10-28,70,31463,1331,0,32864
768,2019-10-29,163,36131,2575,3,38872
768,2019-10-30,109,27406,1291,2,28808
768,2019-10-31,283,21684,1394,0,23361
768,2019-11-01,147,26062,1748,0,27957
768,2019-11-02,149,15672,1672,0,17493
768,2019-11-03,660,23045,1504,3,25212
768,2019-11-04,163,6555,1357,1,8076
768,2019-11-05,184,2110,1890,1,4185
768,2019-11-06,1000,7548,1202,1,9751
768,2019-11-07,232,22234,1048,2,23516
768,2019-11-08,115,11286,991,1,12393
768,2019-11-09,158,8051,1588,1,9798
768,2019-11-10,168,22833,1727,714,25442
768,2019-11-11,1956,14907,1132,0,17995
768,2019-11-12,152,16425,2872,0,19449
768,2019-11-13,110,20964,1939,0,23013
768,2019-11-14,97,14346,1639,0,16082
768,2019-11-15,152,3569,4168,0,7889
768,2019-11-16,212,631,2509,0,3352
768,2019-11-17,208,3700,4159,0,8067
768,2019-11-18,140,1394,3349,0,4883
768,2019-11-19,1085,5030,2354,0,8469
768,2019-11-20,169,901,2166,0,3236
768,2019-11-21,173,2941,1292,0,4406
768,2019-11-22,108,4391,1904,0,6403
768,2019-11-23,174,10033,2030,0,12237
768,2019-11-24,208,9097,1826,0,11131
768,2019-11-25,148,10096,1780,0,12024
768,2019-11-26,106,8328,1778,0,10212
768,2019-11-27,150,10324,1359,0,11833
768,2019-11-28,74,11189,844,0,12107
768,2019-08-23,205,1254,1381,0,2840
768,2019-08-24,920,2156,1080,0,4156
768,2019-08-25,247,13166,1727,0,15140
768,2019-08-26,278,23187,1800,0,25265
768,2019-08-27,191,11436,966,3,12596
768,2019-08-28,161,12690,1980,2,14833
768,2019-08-29,334,13479,1710,2,15525
768,2019-08-30,185,2804,1019,1,4009
768,2019-08-31,69,25,45,0,139
768,2019-09-01,156,915,2,0,1073
768,2019-09-02,115,951,27,0,1093
768,2019-09-03,246,866,995,0,2107
768,2019-09-04,358,13740,2422,2,16522
768,2019-09-05,270,13146,3303,1,16720
768,2019-09-06,144,10216,1586,0,11946
768,2019-09-07,402,8517,2021,1,10941
768,2019-09-08,1303,5949,2074,0,9326
768,2019-09-09,322,13319,1737,2,15380
768,2019-09-10,1077,7236,1760,0,10073
768,2019-09-11,1180,6435,1803,3,9421
768,2019-09-12,145,7017,2558,2,9722
768,2019-09-13,1070,4353,2272,1,7696
768,2019-09-14,186,7734,2660,2,10582
768,2019-09-15,997,11426,2138,0,14561
768,2019-09-16,295,5586,2460,3,8344
768,2019-09-17,1046,8133,1980,7,11166
768,2019-09-18,152,11283,1423,8,12866
768,2019-09-19,331,3010,1983,9,5333
768,2019-09-20,1034,12496,1618,13,15161
768,2019-09-21,152,6972,1800,9,8933
768,2019-09-22,127,9256,2833,9,12225
768,2019-09-23,220,8259,1285,10,9774
768,2019-09-24,169,19970,1479,15,21633
768,2019-09-25,237,14356,1596,12,16201
768,2019-09-26,135,13300,991,10,14436
768,2019-09-27,518,7923,1900,3,10344
768,2019-09-28,143,14151,2618,2,16914
768,2019-09-29,419,17759,1380,5,19563
768,2019-09-30,656,15100,1818,1,17575
768,2019-10-01,280,16557,1296,0,18133
768,2019-10-02,287,11138,1704,7,13136
768,2019-10-03,860,13993,1890,9,16752
768,2019-10-04,167,20909,1695,12,22783
768,2019-10-05,818,25197,1579,10,27604
768,2019-10-06,459,10134,1732,11,12336
768,2019-10-07,611,5097,2944,9,8661
768,2019-10-08,1116,21933,1554,11,24614
768,2019-10-09,1306,34607,1425,11,37349
768,2019-10-10,243,17389,2571,10,20213
768,2019-10-11,192,9701,1505,10,11408
768,2019-10-12,157,5538,1882,0,7577
768,2019-10-13,1664,7634,2502,3,11803
768,2019-10-14,991,6008,2313,0,9312
768,2019-10-15,1310,7835,2336,0,11481
768,2019-10-16,389,12351,1295,2,14037
768,2019-10-17,563,4042,1693,0,6298
768,2019-10-18,199,7213,2758,2,10172
768,2019-10-19,116,24846,1986,0,26948
768,2019-10-20,101,8821,1423,1,10346
768,2019-10-21,98,10820,1113,2,12033
768,2019-10-22,882,4838,2008,1,7729
768,2019-10-23,165,7015,1585,3,8768
768,2019-10-24,178,12901,2244,3,15326
768,2019-10-25,243,14151,1786,2,16182
768,2019-10-26,966,17474,2249,1,20690
768,2019-10-27,171,27591,907,1,28670
768,2019-10-28,70,31463,1331,0,32864
768,2019-10-29,163,36131,2575,3,38872
768,2019-10-30,109,27406,1291,2,28808
768,2019-10-31,283,21684,1394,0,23361
768,2019-11-01,147,26062,1748,0,27957
768,2019-11-02,149,15672,1672,0,17493
768,2019-11-03,660,23045,1504,3,25212
768,2019-11-04,163,6555,1357,1,8076
768,2019-11-05,184,2110,1890,1,4185
768,2019-11-06,1000,7548,1202,1,9751
768,2019-11-07,232,22234,1048,2,23516
768,2019-11-08,115,11286,991,1,12393
768,2019-11-09,158,8051,1588,1,9798
768,2019-11-10,168,22833,1727,714,25442
768,2019-11-11,1956,14907,1132,0,17995
768,2019-11-12,152,16425,2872,0,19449
768,2019-11-13,110,20964,1939,0,23013
768,2019-11-14,97,14346,1639,0,16082
768,2019-11-15,152,3569,4168,0,7889
768,2019-11-16,212,631,2509,0,3352
768,2019-11-17,208,3700,4159,0,8067
768,2019-11-18,140,1394,3349,0,4883
768,2019-11-19,1085,5030,2354,0,8469
768,2019-11-20,169,901,2166,0,3236
768,2019-11-21,173,2941,1292,0,4406
768,2019-11-22,108,4391,1904,0,6403
768,2019-11-23,174,10033,2030,0,12237
768,2019-11-24,208,9097,1826,0,11131
768,2019-11-25,148,10096,1780,0,12024
768,2019-11-26,106,8328,1778,0,10212
768,2019-11-27,150,10324,1359,0,11833
768,2019-11-28,74,11189,844,0,12107
768,2019-11-29,0,347,0,0,347
768,2019-08-22,0,0,273,0,273
768,2019-08-23,205,1254,1381,0,2840
768,2019-08-24,920,2156,1080,0,4156
768,2019-08-25,247,13166,1727,0,15140
768,2019-08-26,278,23187,1800,0,25265
768,2019-08-27,191,11436,966,3,12596
768,2019-08-28,161,12690,1980,2,14833
768,2019-08-29,334,13479,1710,2,15525
768,2019-08-30,185,2804,1019,1,4009
768,2019-08-31,69,25,45,0,139
768,2019-09-01,156,915,2,0,1073
768,2019-09-02,115,951,27,0,1093
768,2019-09-03,246,866,995,0,2107
768,2019-09-04,358,13740,2422,2,16522
768,2019-09-05,270,13146,3303,1,16720
768,2019-09-06,144,10216,1586,0,11946
768,2019-09-07,402,8517,2021,1,10941
768,2019-09-08,1303,5949,2074,0,9326
768,2019-09-09,322,13319,1737,2,15380
768,2019-09-10,1077,7236,1760,0,10073
768,2019-09-11,1180,6435,1803,3,9421
768,2019-09-12,145,7017,2558,2,9722
768,2019-09-13,1070,4353,2272,1,7696
768,2019-09-14,186,7734,2660,2,10582
768,2019-09-15,997,11426,2138,0,14561
768,2019-09-16,295,5586,2460,3,8344
768,2019-09-17,1046,8133,1980,7,11166
768,2019-09-18,152,11283,1423,8,12866
768,2019-09-19,331,3010,1983,9,5333
768,2019-09-20,1034,12496,1618,13,15161
768,2019-09-21,152,6972,1800,9,8933
768,2019-09-22,127,9256,2833,9,12225
768,2019-09-23,220,8259,1285,10,9774
768,2019-09-24,169,19970,1479,15,21633
768,2019-09-25,237,14356,1596,12,16201
768,2019-09-26,135,13300,991,10,14436
768,2019-09-27,518,7923,1900,3,10344
768,2019-09-28,143,14151,2618,2,16914
768,2019-09-29,419,17759,1380,5,19563
768,2019-09-30,656,15100,1818,1,17575
768,2019-10-01,280,16557,1296,0,18133
768,2019-10-02,287,11138,1704,7,13136
768,2019-10-03,860,13993,1890,9,16752
768,2019-10-04,167,20909,1695,12,22783
768,2019-10-05,818,25197,1579,10,27604
768,2019-10-06,459,10134,1732,11,12336
768,2019-10-07,611,5097,2944,9,8661
768,2019-10-08,1116,21933,1554,11,24614
768,2019-10-09,1306,34607,1425,11,37349
768,2019-10-10,243,17389,2571,10,20213
768,2019-10-11,192,9701,1505,10,11408
768,2019-10-12,157,5538,1882,0,7577
768,2019-10-13,1664,7634,2502,3,11803
768,2019-10-14,991,6008,2313,0,9312
768,2019-10-15,1310,7835,2336,0,11481
768,2019-10-16,389,12351,1295,2,14037
768,2019-10-17,563,4042,1693,0,6298
768,2019-10-18,199,7213,2758,2,10172
768,2019-10-19,116,24846,1986,0,26948
768,2019-10-20,101,8821,1423,1,10346
768,2019-10-21,98,10820,1113,2,12033
768,2019-10-22,882,4838,2008,1,7729
768,2019-10-23,165,7015,1585,3,8768
768,2019-10-24,178,12901,2244,3,15326
768,2019-10-25,243,14151,1786,2,16182
768,2019-10-26,966,17474,2249,1,20690
768,2019-10-27,171,27591,907,1,28670
768,2019-10-28,70,31463,1331,0,32864
768,2019-10-29,163,36131,2575,3,38872
768,2019-10-30,109,27406,1291,2,28808
768,2019-10-31,283,21684,1394,0,23361
768,2019-11-01,147,26062,1748,0,27957
768,2019-11-02,149,15672,1672,0,17493
768,2019-11-03,660,23045,1504,3,25212
768,2019-11-04,163,6555,1357,1,8076
768,2019-11-05,184,2110,1890,1,4185
768,2019-11-06,1000,7548,1202,1,9751
768,2019-11-07,232,22234,1048,2,23516
768,2019-11-08,115,11286,991,1,12393
768,2019-11-09,158,8051,1588,1,9798
768,2019-11-10,168,22833,1727,714,25442
768,2019-11-11,1956,14907,1132,0,17995
768,2019-11-12,152,16425,2872,0,19449
768,2019-11-13,110,20964,1939,0,23013
768,2019-11-14,97,14346,1639,0,16082
768,2019-11-15,152,3569,4168,0,7889
768,2019-11-16,212,631,2509,0,3352
768,2019-11-17,208,3700,4159,0,8067
768,2019-11-18,140,1394,3349,0,4883
768,2019-11-19,1085,5030,2354,0,8469
768,2019-11-20,169,901,2166,0,3236
768,2019-11-21,173,2941,1292,0,4406
768,2019-11-22,108,4391,1904,0,6403
768,2019-11-23,174,10033,2030,0,12237
768,2019-11-24,208,9097,1826,0,11131
768,2019-11-25,148,10096,1780,0,12024
768,2019-11-26,106,8328,1778,0,10212
768,2019-11-27,150,10324,1359,0,11833
768,2019-11-28,74,11189,844,0,12107
768,2019-08-27,191,11436,966,3,12596
768,2019-08-28,161,12690,1980,2,14833
768,2019-08-29,334,13479,1710,2,15525
768,2019-08-30,185,2804,1019,1,4009
768,2019-08-31,69,25,45,0,139
768,2019-09-01,156,915,2,0,1073
768,2019-09-02,115,951,27,0,1093
768,2019-09-03,246,866,995,0,2107
768,2019-09-04,358,13740,2422,2,16522
768,2019-09-05,270,13146,3303,1,16720
768,2019-09-06,144,10216,1586,0,11946
768,2019-09-07,402,8517,2021,1,10941
768,2019-09-08,1303,5949,2074,0,9326
768,2019-09-09,322,13319,1737,2,15380
768,2019-09-10,1077,7236,1760,0,10073
768,2019-09-11,1180,6435,1803,3,9421
768,2019-09-12,145,7017,2558,2,9722
768,2019-09-13,1070,4353,2272,1,7696
768,2019-09-14,186,7734,2660,2,10582
768,2019-09-15,997,11426,2138,0,14561
768,2019-09-16,295,5586,2460,3,8344
768,2019-09-17,1046,8133,1980,7,11166
768,2019-09-18,152,11283,1423,8,12866
768,2019-09-19,331,3010,1983,9,5333
768,2019-09-20,1034,12496,1618,13,15161
768,2019-09-21,152,6972,1800,9,8933
768,2019-09-22,127,9256,2833,9,12225
768,2019-09-23,220,8259,1285,10,9774
768,2019-09-24,169,19970,1479,15,21633
768,2019-09-25,237,14356,1596,12,16201
768,2019-09-26,135,13300,991,10,14436
768,2019-09-27,518,7923,1900,3,10344
768,2019-09-28,143,14151,2618,2,16914
768,2019-09-29,419,17759,1380,5,19563
768,2019-09-30,656,15100,1818,1,17575
768,2019-10-01,280,16557,1296,0,18133
768,2019-10-02,287,11138,1704,7,13136
768,2019-10-03,860,13993,1890,9,16752
768,2019-10-04,167,20909,1695,12,22783
768,2019-10-05,818,25197,1579,10,27604
768,2019-10-06,459,10134,1732,11,12336
768,2019-10-07,611,5097,2944,9,8661
768,2019-10-08,1116,21933,1554,11,24614
768,2019-10-09,1306,34607,1425,11,37349
768,2019-10-10,243,17389,2571,10,20213
768,2019-10-11,192,9701,1505,10,11408
768,2019-10-12,157,5538,1882,0,7577
768,2019-10-13,1664,7634,2502,3,11803
768,2019-10-14,991,6008,2313,0,9312
768,2019-10-15,1310,7835,2336,0,11481
768,2019-10-16,389,12351,1295,2,14037
768,2019-10-17,563,4042,1693,0,6298
768,2019-10-18,199,7213,2758,2,10172
768,2019-10-19,116,24846,1986,0,26948
768,2019-10-20,101,8821,1423,1,10346
768,2019-10-21,98,10820,1113,2,12033
768,2019-10-22,882,4838,2008,1,7729
768,2019-10-23,165,7015,1585,3,8768
768,2019-10-24,178,12901,2244,3,15326
768,2019-10-25,243,14151,1786,2,16182
768,2019-10-26,966,17474,2249,1,20690
768,2019-10-27,171,27591,907,1,28670
768,2019-10-28,70,31463,1331,0,32864
768,2019-10-29,163,36131,2575,3,38872
768,2019-10-30,109,27406,1291,2,28808
768,2019-10-31,283,21684,1394,0,23361
768,2019-11-01,147,26062,1748,0,27957
768,2019-11-02,149,15672,1672,0,17493
768,2019-11-03,660,23045,1504,3,25212
768,2019-11-04,163,6555,1357,1,8076
768,2019-11-05,184,2110,1890,1,4185
768,2019-11-06,1000,7548,1202,1,9751
768,2019-11-07,232,22234,1048,2,23516
768,2019-11-08,115,11286,991,1,12393
768,2019-11-09,158,8051,1588,1,9798
768,2019-11-10,168,22833,1727,714,25442
769,2019-08-23,93,1164,827,0,2084
769,2019-08-24,89,3617,2101,0,5807
769,2019-08-25,109,12256,1852,1,14218
769,2019-08-26,129,15879,1710,0,17718
769,2019-08-27,988,9893,1499,2,12382
769,2019-08-28,142,4070,2070,0,6282
769,2019-08-29,969,9392,1446,1,11808
769,2019-08-30,801,2867,805,2,4475
769,2019-08-31,31,554,17,1,603
769,2019-09-01,91,374,271,1,737
769,2019-09-02,133,38,95,3,269
769,2019-09-03,66,3196,1762,1,5025
769,2019-09-04,245,7135,2681,0,10061
769,2019-09-05,112,15873,1807,0,17792
769,2019-09-06,112,22366,2395,0,24873
769,2019-09-07,203,16625,1791,2,18621
769,2019-09-08,192,5852,2406,0,8450
769,2019-09-09,171,9458,1703,0,11332
769,2019-09-10,75,13543,1938,1,15557
769,2019-09-11,165,10212,1929,2,12308
769,2019-09-12,1763,10018,2492,1,14274
769,2019-09-13,129,4221,1657,0,6007
769,2019-09-14,889,8952,4370,2,14213
769,2019-09-15,1786,10188,2115,0,14089
769,2019-09-16,140,9483,1985,0,11608
769,2019-09-17,198,11489,1797,2,13486
769,2019-09-18,81,20404,1581,0,22066
769,2019-09-19,320,4129,1572,1,6022
769,2019-09-20,190,15858,1765,1,17814
769,2019-09-21,79,7664,2062,1,9806
769,2019-09-22,340,14063,1206,0,15609
769,2019-09-23,833,11284,1802,2,13921
769,2019-09-24,1011,12304,2130,5,15450
769,2019-09-25,117,13028,2012,3,15160
769,2019-09-26,160,13408,1235,1,14804
769,2019-09-27,117,10800,1332,3,12252
769,2019-09-28,139,13717,1831,3,15690
769,2019-09-29,108,27193,1752,2,29055
769,2019-09-30,77,28137,2068,3,30285
769,2019-10-01,959,27820,1841,0,30620
769,2019-10-02,200,14076,1890,0,16166
769,2019-10-03,1010,15464,1442,1,17917
769,2019-10-04,859,14767,2052,5,17683
769,2019-10-05,410,22136,2212,0,24758
769,2019-10-06,101,17821,1427,1,19350
769,2019-10-07,107,6754,1821,1,8683
769,2019-10-08,110,18559,1512,2,20183
769,2019-10-09,139,25279,1894,4,27316
769,2019-10-10,171,11893,1447,2,13513
769,2019-10-11,568,9742,2078,1,12389
769,2019-10-12,963,7285,2189,2,10439
769,2019-10-13,1438,9054,852,2,11346
769,2019-10-14,633,8691,1630,0,10954
769,2019-10-15,1118,9018,1396,3,11535
769,2019-10-16,105,13186,1637,1,14929
769,2019-10-17,97,6099,1784,1,7981
769,2019-10-18,2335,14611,1451,1,18398
769,2019-10-19,92,9223,2044,1,11360
769,2019-10-20,143,3207,2229,3,5582
769,2019-10-21,1093,11907,1476,1,14477
769,2019-10-22,111,6841,2242,1,9195
769,2019-10-23,934,15922,763,1,17620
769,2019-10-24,261,25900,1513,0,27674
769,2019-10-25,124,15019,1803,4,16950
769,2019-10-26,391,15342,1660,1,17394
769,2019-10-27,536,17347,1675,2,19560
769,2019-10-28,116,23544,1831,0,25491
769,2019-10-29,1079,29216,1808,1,32104
769,2019-10-30,100,21106,1411,2,22619
769,2019-10-31,76,12806,1390,0,14272
769,2019-11-01,371,26181,1234,0,27786
769,2019-11-02,83,26891,1581,0,28555
769,2019-11-03,939,39788,1166,0,41893
769,2019-11-04,534,14161,1929,837,17461
769,2019-11-05,141,3577,1983,2,5703
769,2019-11-06,109,10300,1350,1,11760
769,2019-11-07,177,31140,1156,0,32473
769,2019-11-08,96,15320,1519,1,16936
769,2019-11-09,75,4926,1856,1,6858
769,2019-11-10,592,15296,1651,1,17540
769,2019-11-11,124,14802,1587,4,16517
769,2019-11-12,156,12802,2944,3,15905
769,2019-11-13,119,22319,1594,3,24035
769,2019-11-14,624,14660,1578,2,16864
769,2019-11-15,113,5124,2191,1,7429
769,2019-11-16,92,2492,2875,479,5938
769,2019-11-17,1110,3769,3860,0,8739
769,2019-11-18,439,3225,3071,0,6735
769,2019-11-19,121,3333,2647,3,6104
769,2019-11-20,118,1446,2974,0,4538
769,2019-11-21,99,5721,1076,1,6897
769,2019-11-22,748,4778,1095,2,6623
769,2019-11-23,122,6020,2512,1,8655
769,2019-11-24,214,6050,1958,2,8224
769,2019-11-25,130,11080,1425,1,12636
769,2019-11-26,87,10580,1489,0,12156
769,2019-11-27,998,6677,1593,0,9268
769,2019-11-28,526,12243,602,202,13573
769,2019-11-29,19,545,4,0,568
769,2019-08-23,93,1164,827,0,2084
769,2019-08-24,89,3617,2101,0,5807
769,2019-08-25,109,12256,1852,1,14218
769,2019-08-26,129,15879,1710,0,17718
769,2019-08-27,988,9893,1499,2,12382
769,2019-08-28,142,4070,2070,0,6282
769,2019-08-29,969,9392,1446,1,11808
769,2019-08-30,801,2867,805,2,4475
769,2019-08-31,31,554,17,1,603
769,2019-09-01,91,374,271,1,737
769,2019-09-02,133,38,95,3,269
769,2019-09-03,66,3196,1762,1,5025
769,2019-09-04,245,7135,2681,0,10061
769,2019-09-05,112,15873,1807,0,17792
769,2019-09-06,112,22366,2395,0,24873
769,2019-09-07,203,16625,1791,2,18621
769,2019-09-08,192,5852,2406,0,8450
769,2019-09-09,171,9458,1703,0,11332
769,2019-09-10,75,13543,1938,1,15557
769,2019-09-11,165,10212,1929,2,12308
769,2019-09-12,1763,10018,2492,1,14274
769,2019-09-13,129,4221,1657,0,6007
769,2019-09-14,889,8952,4370,2,14213
769,2019-09-15,1786,10188,2115,0,14089
769,2019-09-16,140,9483,1985,0,11608
769,2019-09-17,198,11489,1797,2,13486
769,2019-09-18,81,20404,1581,0,22066
769,2019-09-19,320,4129,1572,1,6022
769,2019-09-20,190,15858,1765,1,17814
769,2019-09-21,79,7664,2062,1,9806
769,2019-09-22,340,14063,1206,0,15609
769,2019-09-23,833,11284,1802,2,13921
769,2019-09-24,1011,12304,2130,5,15450
769,2019-09-25,117,13028,2012,3,15160
769,2019-09-26,160,13408,1235,1,14804
769,2019-09-27,117,10800,1332,3,12252
769,2019-09-28,139,13717,1831,3,15690
769,2019-09-29,108,27193,1752,2,29055
769,2019-09-30,77,28137,2068,3,30285
769,2019-10-01,959,27820,1841,0,30620
769,2019-10-02,200,14076,1890,0,16166
769,2019-10-03,1010,15464,1442,1,17917
769,2019-10-04,859,14767,2052,5,17683
769,2019-10-05,410,22136,2212,0,24758
769,2019-10-06,101,17821,1427,1,19350
769,2019-10-07,107,6754,1821,1,8683
769,2019-10-08,110,18559,1512,2,20183
769,2019-10-09,139,25279,1894,4,27316
769,2019-10-10,171,11893,1447,2,13513
769,2019-10-11,568,9742,2078,1,12389
769,2019-10-12,963,7285,2189,2,10439
769,2019-10-13,1438,9054,852,2,11346
769,2019-10-14,633,8691,1630,0,10954
769,2019-10-15,1118,9018,1396,3,11535
769,2019-10-16,105,13186,1637,1,14929
769,2019-10-17,97,6099,1784,1,7981
769,2019-10-18,2335,14611,1451,1,18398
769,2019-10-19,92,9223,2044,1,11360
769,2019-10-20,143,3207,2229,3,5582
769,2019-10-21,1093,11907,1476,1,14477
769,2019-10-22,111,6841,2242,1,9195
769,2019-10-23,934,15922,763,1,17620
769,2019-10-24,261,25900,1513,0,27674
769,2019-10-25,124,15019,1803,4,16950
769,2019-10-26,391,15342,1660,1,17394
769,2019-10-27,536,17347,1675,2,19560
769,2019-10-28,116,23544,1831,0,25491
769,2019-10-29,1079,29216,1808,1,32104
769,2019-10-30,100,21106,1411,2,22619
769,2019-10-31,76,12806,1390,0,14272
769,2019-11-01,371,26181,1234,0,27786
769,2019-11-02,83,26891,1581,0,28555
769,2019-11-03,939,39788,1166,0,41893
769,2019-11-04,534,14161,1929,837,17461
769,2019-11-05,141,3577,1983,2,5703
769,2019-11-06,109,10300,1350,1,11760
769,2019-11-07,177,31140,1156,0,32473
769,2019-11-08,96,15320,1519,1,16936
769,2019-11-09,75,4926,1856,1,6858
769,2019-11-10,592,15296,1651,1,17540
769,2019-11-11,124,14802,1587,4,16517
769,2019-11-12,156,12802,2944,3,15905
769,2019-11-13,119,22319,1594,3,24035
769,2019-11-14,624,14660,1578,2,16864
769,2019-11-15,113,5124,2191,1,7429
769,2019-11-16,92,2492,2875,479,5938
769,2019-11-17,1110,3769,3860,0,8739
769,2019-11-18,439,3225,3071,0,6735
769,2019-11-19,121,3333,2647,3,6104
769,2019-11-20,118,1446,2974,0,4538
769,2019-11-21,99,5721,1076,1,6897
769,2019-11-22,748,4778,1095,2,6623
769,2019-11-23,122,6020,2512,1,8655
769,2019-11-24,214,6050,1958,2,8224
769,2019-11-25,130,11080,1425,1,12636
769,2019-11-26,87,10580,1489,0,12156
769,2019-11-27,998,6677,1593,0,9268
769,2019-11-28,526,12243,602,202,13573
769,2019-11-29,19,545,4,0,568
769,2019-08-22,0,0,270,0,270
769,2019-08-23,93,1164,827,0,2084
769,2019-08-24,89,3617,2101,0,5807
769,2019-08-25,109,12256,1852,1,14218
769,2019-08-26,129,15879,1710,0,17718
769,2019-08-27,988,9893,1499,2,12382
769,2019-08-28,142,4070,2070,0,6282
769,2019-08-29,969,9392,1446,1,11808
769,2019-08-30,801,2867,805,2,4475
769,2019-08-31,31,554,17,1,603
769,2019-09-01,91,374,271,1,737
769,2019-09-02,133,38,95,3,269
769,2019-09-03,66,3196,1762,1,5025
769,2019-09-04,245,7135,2681,0,10061
769,2019-09-05,112,15873,1807,0,17792
769,2019-09-06,112,22366,2395,0,24873
769,2019-09-07,203,16625,1791,2,18621
769,2019-09-08,192,5852,2406,0,8450
769,2019-09-09,171,9458,1703,0,11332
769,2019-09-10,75,13543,1938,1,15557
769,2019-09-11,165,10212,1929,2,12308
769,2019-09-12,1763,10018,2492,1,14274
769,2019-09-13,129,4221,1657,0,6007
769,2019-09-14,889,8952,4370,2,14213
769,2019-09-15,1786,10188,2115,0,14089
769,2019-09-16,140,9483,1985,0,11608
769,2019-09-17,198,11489,1797,2,13486
769,2019-09-18,81,20404,1581,0,22066
769,2019-09-19,320,4129,1572,1,6022
769,2019-09-20,190,15858,1765,1,17814
769,2019-09-21,79,7664,2062,1,9806
769,2019-09-22,340,14063,1206,0,15609
769,2019-09-23,833,11284,1802,2,13921
769,2019-09-24,1011,12304,2130,5,15450
769,2019-09-25,117,13028,2012,3,15160
769,2019-09-26,160,13408,1235,1,14804
769,2019-09-27,117,10800,1332,3,12252
769,2019-09-28,139,13717,1831,3,15690
769,2019-09-29,108,27193,1752,2,29055
769,2019-09-30,77,28137,2068,3,30285
769,2019-10-01,959,27820,1841,0,30620
769,2019-10-02,200,14076,1890,0,16166
769,2019-10-03,1010,15464,1442,1,17917
769,2019-10-04,859,14767,2052,5,17683
769,2019-10-05,410,22136,2212,0,24758
769,2019-10-06,101,17821,1427,1,19350
769,2019-10-07,107,6754,1821,1,8683
769,2019-10-08,110,18559,1512,2,20183
769,2019-10-09,139,25279,1894,4,27316
769,2019-10-10,171,11893,1447,2,13513
769,2019-10-11,568,9742,2078,1,12389
769,2019-10-12,963,7285,2189,2,10439
769,2019-10-13,1438,9054,852,2,11346
769,2019-10-14,633,8691,1630,0,10954
769,2019-10-15,1118,9018,1396,3,11535
769,2019-10-16,105,13186,1637,1,14929
769,2019-10-17,97,6099,1784,1,7981
769,2019-10-18,2335,14611,1451,1,18398
769,2019-10-19,92,9223,2044,1,11360
769,2019-10-20,143,3207,2229,3,5582
769,2019-10-21,1093,11907,1476,1,14477
769,2019-10-22,111,6841,2242,1,9195
769,2019-10-23,934,15922,763,1,17620
769,2019-10-24,261,25900,1513,0,27674
769,2019-10-25,124,15019,1803,4,16950
769,2019-10-26,391,15342,1660,1,17394
769,2019-10-27,536,17347,1675,2,19560
769,2019-10-28,116,23544,1831,0,25491
769,2019-10-29,1079,29216,1808,1,32104
769,2019-10-30,100,21106,1411,2,22619
769,2019-10-31,76,12806,1390,0,14272
769,2019-11-01,371,26181,1234,0,27786
769,2019-11-02,83,26891,1581,0,28555
769,2019-11-03,939,39788,1166,0,41893
769,2019-11-04,534,14161,1929,837,17461
769,2019-11-05,141,3577,1983,2,5703
769,2019-11-06,109,10300,1350,1,11760
769,2019-11-07,177,31140,1156,0,32473
769,2019-11-08,96,15320,1519,1,16936
769,2019-11-09,75,4926,1856,1,6858
769,2019-11-10,592,15296,1651,1,17540
769,2019-11-11,124,14802,1587,4,16517
769,2019-11-12,156,12802,2944,3,15905
769,2019-11-13,119,22319,1594,3,24035
769,2019-11-14,624,14660,1578,2,16864
769,2019-11-15,113,5124,2191,1,7429
769,2019-11-16,92,2492,2875,479,5938
769,2019-11-17,1110,3769,3860,0,8739
769,2019-11-18,439,3225,3071,0,6735
769,2019-11-19,121,3333,2647,3,6104
769,2019-11-20,118,1446,2974,0,4538
769,2019-11-21,99,5721,1076,1,6897
769,2019-11-22,748,4778,1095,2,6623
769,2019-11-23,122,6020,2512,1,8655
769,2019-11-24,214,6050,1958,2,8224
769,2019-11-25,130,11080,1425,1,12636
769,2019-11-26,87,10580,1489,0,12156
769,2019-11-27,998,6677,1593,0,9268
769,2019-11-28,526,12243,602,202,13573
769,2019-11-29,19,545,4,0,568
769,2019-08-25,109,12256,1852,1,14218
769,2019-08-26,129,15879,1710,0,17718
769,2019-08-27,988,9893,1499,2,12382
769,2019-08-28,142,4070,2070,0,6282
769,2019-08-29,969,9392,1446,1,11808
769,2019-08-30,801,2867,805,2,4475
769,2019-08-31,31,554,17,1,603
769,2019-09-01,91,374,271,1,737
769,2019-09-02,133,38,95,3,269
769,2019-09-03,66,3196,1762,1,5025
769,2019-09-04,245,7135,2681,0,10061
769,2019-09-05,112,15873,1807,0,17792
769,2019-09-06,112,22366,2395,0,24873
769,2019-09-07,203,16625,1791,2,18621
769,2019-09-08,192,5852,2406,0,8450
769,2019-09-09,171,9458,1703,0,11332
769,2019-09-10,75,13543,1938,1,15557
769,2019-09-11,165,10212,1929,2,12308
769,2019-09-12,1763,10018,2492,1,14274
769,2019-09-13,129,4221,1657,0,6007
769,2019-09-14,889,8952,4370,2,14213
769,2019-09-15,1786,10188,2115,0,14089
769,2019-09-16,140,9483,1985,0,11608
769,2019-09-17,198,11489,1797,2,13486
769,2019-09-18,81,20404,1581,0,22066
769,2019-09-19,320,4129,1572,1,6022
769,2019-09-20,190,15858,1765,1,17814
769,2019-09-21,79,7664,2062,1,9806
769,2019-09-22,340,14063,1206,0,15609
769,2019-09-23,833,11284,1802,2,13921
769,2019-09-24,1011,12304,2130,5,15450
769,2019-09-25,117,13028,2012,3,15160
769,2019-09-26,160,13408,1235,1,14804
769,2019-09-27,117,10800,1332,3,12252
769,2019-09-28,139,13717,1831,3,15690
769,2019-09-29,108,27193,1752,2,29055
769,2019-09-30,77,28137,2068,3,30285
769,2019-10-01,959,27820,1841,0,30620
769,2019-10-02,200,14076,1890,0,16166
769,2019-10-03,1010,15464,1442,1,17917
769,2019-10-04,859,14767,2052,5,17683
769,2019-10-05,410,22136,2212,0,24758
769,2019-10-06,101,17821,1427,1,19350
769,2019-10-07,107,6754,1821,1,8683
769,2019-10-08,110,18559,1512,2,20183
769,2019-10-09,139,25279,1894,4,27316
769,2019-10-10,171,11893,1447,2,13513
769,2019-10-11,568,9742,2078,1,12389
769,2019-10-12,963,7285,2189,2,10439
769,2019-10-13,1438,9054,852,2,11346
769,2019-10-14,633,8691,1630,0,10954
769,2019-10-15,1118,9018,1396,3,11535
769,2019-10-16,105,13186,1637,1,14929
769,2019-10-17,97,6099,1784,1,7981
769,2019-10-18,2335,14611,1451,1,18398
769,2019-10-19,92,9223,2044,1,11360
769,2019-10-20,143,3207,2229,3,5582
769,2019-10-21,1093,11907,1476,1,14477
769,2019-10-22,111,6841,2242,1,9195
769,2019-10-23,934,15922,763,1,17620
769,2019-10-24,261,25900,1513,0,27674
769,2019-10-25,124,15019,1803,4,16950
769,2019-10-26,391,15342,1660,1,17394
769,2019-10-27,536,17347,1675,2,19560
769,2019-10-28,116,23544,1831,0,25491
769,2019-10-29,1079,29216,1808,1,32104
769,2019-10-30,100,21106,1411,2,22619
769,2019-10-31,76,12806,1390,0,14272
769,2019-11-01,371,26181,1234,0,27786
769,2019-11-02,83,26891,1581,0,28555
769,2019-11-03,939,39788,1166,0,41893
769,2019-11-04,534,14161,1929,837,17461
769,2019-11-05,141,3577,1983,2,5703
769,2019-11-06,109,10300,1350,1,11760
769,2019-11-07,177,31140,1156,0,32473
769,2019-11-08,96,15320,1519,1,16936
769,2019-11-09,75,4926,1856,1,6858
769,2019-11-10,592,15296,1651,1,17540
769,2019-11-11,124,14802,1587,4,16517
769,2019-11-12,156,12802,2944,3,15905
769,2019-11-13,119,22319,1594,3,24035
769,2019-11-14,624,14660,1578,2,16864
769,2019-11-15,113,5124,2191,1,7429
769,2019-11-16,92,2492,2875,479,5938
769,2019-11-17,1110,3769,3860,0,8739
769,2019-11-18,439,3225,3071,0,6735
769,2019-11-19,121,3333,2647,3,6104
769,2019-11-20,118,1446,2974,0,4538
769,2019-11-21,99,5721,1076,1,6897
769,2019-11-22,748,4778,1095,2,6623
769,2019-11-23,122,6020,2512,1,8655
769,2019-11-24,214,6050,1958,2,8224
769,2019-11-25,130,11080,1425,1,12636
769,2019-11-26,87,10580,1489,0,12156
769,2019-11-27,998,6677,1593,0,9268
769,2019-11-28,526,12243,602,202,13573
770,2019-08-23,1142,3125,1825,0,6092
770,2019-08-24,984,3196,1766,0,5946
770,2019-08-25,76,4602,1580,0,6258
770,2019-08-26,910,1727,2027,1,4665
770,2019-08-27,1035,2618,1802,0,5455
770,2019-08-28,877,1130,2150,1,4158
770,2019-08-29,854,9477,1889,1,12221
770,2019-08-30,71,2849,727,2,3649
770,2019-08-31,32,158,3,0,193
770,2019-09-01,77,955,244,0,1276
770,2019-09-02,48,821,3,0,872
770,2019-09-03,63,3211,1398,1,4673
770,2019-09-04,958,17000,1494,3,19455
770,2019-09-05,83,13300,2136,3,15522
770,2019-09-06,132,8521,1979,0,10632
770,2019-09-07,86,12258,2057,1,14402
770,2019-09-08,1035,6158,2458,1,9652
770,2019-09-09,1156,12512,2356,0,16024
770,2019-09-10,76,11220,1686,0,12982
770,2019-09-11,84,9868,2571,2,12525
770,2019-09-12,154,6923,2090,0,9167
770,2019-09-13,954,7260,1813,1,10028
770,2019-09-14,84,6431,2371,0,8886
770,2019-09-15,1180,12597,2185,0,15962
770,2019-09-16,101,5833,3175,0,9109
770,2019-09-17,91,6673,2616,0,9380
770,2019-09-18,82,12210,1039,2,13333
770,2019-09-19,1254,10714,1350,1,13319
770,2019-09-20,193,12757,1882,1,14833
770,2019-09-21,67,8291,1801,1,10160
770,2019-09-22,78,8588,1542,0,10208
770,2019-09-23,87,11189,1791,2,13069
770,2019-09-24,96,7179,2425,3,9703
770,2019-09-25,86,8647,1670,5,10408
770,2019-09-26,109,10155,1724,1,11989
770,2019-09-27,61,7487,2045,2,9595
770,2019-09-28,195,14666,1812,1,16674
770,2019-09-29,68,17134,1672,0,18874
770,2019-09-30,54,38207,1852,3,40116
770,2019-10-01,956,20273,2143,1,23373
770,2019-10-02,61,10566,1840,3,12470
770,2019-10-03,106,11345,1466,1,12918
770,2019-10-04,64,13087,1783,5,14939
770,2019-10-05,82,21308,1841,1,23232
770,2019-10-06,1451,15959,1970,5,19385
770,2019-10-07,71,5441,1898,0,7410
770,2019-10-08,158,17235,1887,0,19280
770,2019-10-09,97,18124,2293,101,20615
770,2019-10-10,105,8904,1508,3,10520
770,2019-10-11,1019,9858,1355,1,12233
770,2019-10-12,88,5335,2497,1,7921
770,2019-10-13,1219,7157,1883,2,10261
770,2019-10-14,159,4002,1835,2,5998
770,2019-10-15,71,7090,2100,2,9263
770,2019-10-16,673,12738,2495,2,15908
770,2019-10-17,56,3954,1907,0,5917
770,2019-10-18,173,7292,1158,0,8623
770,2019-10-19,52,35787,1297,1,37137
770,2019-10-20,1834,10254,1995,2,14085
770,2019-10-21,66,18960,1682,1,20709
770,2019-10-22,115,8696,1867,3,10681
770,2019-10-23,1048,13085,1431,1,15565
770,2019-10-24,97,18131,1268,1,19497
770,2019-10-25,402,9672,1308,3,11385
770,2019-10-26,84,21182,2046,0,23312
770,2019-10-27,988,20612,910,0,22510
770,2019-10-28,842,14733,1495,0,17070
770,2019-10-29,130,20249,1285,0,21664
770,2019-10-30,70,16029,943,3,17045
770,2019-10-31,1457,19369,1816,0,22642
770,2019-11-01,333,26615,1064,0,28012
770,2019-11-02,1356,15687,1391,2,18436
770,2019-11-03,183,50063,1196,0,51442
770,2019-11-04,531,12822,1554,2,14909
770,2019-11-05,492,5276,1263,0,7031
770,2019-11-06,181,13544,1608,1,15334
770,2019-11-07,247,16269,1113,1,17630
770,2019-11-08,1090,9047,1151,0,11288
770,2019-11-09,75,7948,1664,3,9690
770,2019-11-10,1680,11793,1370,0,14843
770,2019-11-11,1016,12441,1944,1,15402
770,2019-11-12,361,8884,2545,0,11790
770,2019-11-13,527,11263,2416,5,14211
770,2019-11-14,83,12872,1992,897,15844
770,2019-11-15,96,4754,3206,1,8057
770,2019-11-16,74,2920,3289,2,6285
770,2019-11-17,268,3187,4084,0,7539
770,2019-11-18,79,9715,3457,0,13251
770,2019-11-19,1118,3176,2455,3,6752
770,2019-11-20,98,1343,2647,0,4088
770,2019-11-21,116,5898,1708,0,7722
770,2019-11-22,475,8063,1648,1,10187
770,2019-11-23,79,10674,2914,2,13669
770,2019-11-24,191,10025,2111,0,12327
770,2019-11-25,588,11269,2390,1,14248
770,2019-11-26,71,10286,1356,1,11714
770,2019-11-27,73,14927,2133,0,17133
770,2019-11-28,92,12608,379,0,13079
770,2019-11-29,26,929,41,0,996
770,2019-08-23,1142,3125,1825,0,6092
770,2019-08-24,984,3196,1766,0,5946
770,2019-08-25,76,4602,1580,0,6258
770,2019-08-26,910,1727,2027,1,4665
770,2019-08-27,1035,2618,1802,0,5455
770,2019-08-28,877,1130,2150,1,4158
770,2019-08-29,854,9477,1889,1,12221
770,2019-08-30,71,2849,727,2,3649
770,2019-08-31,32,158,3,0,193
770,2019-09-01,77,955,244,0,1276
770,2019-09-02,48,821,3,0,872
770,2019-09-03,63,3211,1398,1,4673
770,2019-09-04,958,17000,1494,3,19455
770,2019-09-05,83,13300,2136,3,15522
770,2019-09-06,132,8521,1979,0,10632
770,2019-09-07,86,12258,2057,1,14402
770,2019-09-08,1035,6158,2458,1,9652
770,2019-09-09,1156,12512,2356,0,16024
770,2019-09-10,76,11220,1686,0,12982
770,2019-09-11,84,9868,2571,2,12525
770,2019-09-12,154,6923,2090,0,9167
770,2019-09-13,954,7260,1813,1,10028
770,2019-09-14,84,6431,2371,0,8886
770,2019-09-15,1180,12597,2185,0,15962
770,2019-09-16,101,5833,3175,0,9109
770,2019-09-17,91,6673,2616,0,9380
770,2019-09-18,82,12210,1039,2,13333
770,2019-09-19,1254,10714,1350,1,13319
770,2019-09-20,193,12757,1882,1,14833
770,2019-09-21,67,8291,1801,1,10160
770,2019-09-22,78,8588,1542,0,10208
770,2019-09-23,87,11189,1791,2,13069
770,2019-09-24,96,7179,2425,3,9703
770,2019-09-25,86,8647,1670,5,10408
770,2019-09-26,109,10155,1724,1,11989
770,2019-09-27,61,7487,2045,2,9595
770,2019-09-28,195,14666,1812,1,16674
770,2019-09-29,68,17134,1672,0,18874
770,2019-09-30,54,38207,1852,3,40116
770,2019-10-01,956,20273,2143,1,23373
770,2019-10-02,61,10566,1840,3,12470
770,2019-10-03,106,11345,1466,1,12918
770,2019-10-04,64,13087,1783,5,14939
770,2019-10-05,82,21308,1841,1,23232
770,2019-10-06,1451,15959,1970,5,19385
770,2019-10-07,71,5441,1898,0,7410
770,2019-10-08,158,17235,1887,0,19280
770,2019-10-09,97,18124,2293,101,20615
770,2019-10-10,105,8904,1508,3,10520
770,2019-10-11,1019,9858,1355,1,12233
770,2019-10-12,88,5335,2497,1,7921
770,2019-10-13,1219,7157,1883,2,10261
770,2019-10-14,159,4002,1835,2,5998
770,2019-10-15,71,7090,2100,2,9263
770,2019-10-16,673,12738,2495,2,15908
770,2019-10-17,56,3954,1907,0,5917
770,2019-10-18,173,7292,1158,0,8623
770,2019-10-19,52,35787,1297,1,37137
770,2019-10-20,1834,10254,1995,2,14085
770,2019-10-21,66,18960,1682,1,20709
770,2019-10-22,115,8696,1867,3,10681
770,2019-10-23,1048,13085,1431,1,15565
770,2019-10-24,97,18131,1268,1,19497
770,2019-10-25,402,9672,1308,3,11385
770,2019-10-26,84,21182,2046,0,23312
770,2019-10-27,988,20612,910,0,22510
770,2019-10-28,842,14733,1495,0,17070
770,2019-10-29,130,20249,1285,0,21664
770,2019-10-30,70,16029,943,3,17045
770,2019-10-31,1457,19369,1816,0,22642
770,2019-11-01,333,26615,1064,0,28012
770,2019-11-02,1356,15687,1391,2,18436
770,2019-11-03,183,50063,1196,0,51442
770,2019-11-04,531,12822,1554,2,14909
770,2019-11-05,492,5276,1263,0,7031
770,2019-11-06,181,13544,1608,1,15334
770,2019-11-07,247,16269,1113,1,17630
770,2019-11-08,1090,9047,1151,0,11288
770,2019-11-09,75,7948,1664,3,9690
770,2019-11-10,1680,11793,1370,0,14843
770,2019-11-11,1016,12441,1944,1,15402
770,2019-11-12,361,8884,2545,0,11790
770,2019-11-13,527,11263,2416,5,14211
770,2019-11-14,83,12872,1992,897,15844
770,2019-11-15,96,4754,3206,1,8057
770,2019-11-16,74,2920,3289,2,6285
770,2019-11-17,268,3187,4084,0,7539
770,2019-11-18,79,9715,3457,0,13251
770,2019-11-19,1118,3176,2455,3,6752
770,2019-11-20,98,1343,2647,0,4088
770,2019-11-21,116,5898,1708,0,7722
770,2019-11-22,475,8063,1648,1,10187
770,2019-11-23,79,10674,2914,2,13669
770,2019-11-24,191,10025,2111,0,12327
770,2019-11-25,588,11269,2390,1,14248
770,2019-11-26,71,10286,1356,1,11714
770,2019-11-27,73,14927,2133,0,17133
770,2019-11-28,92,12608,379,0,13079
770,2019-11-29,26,929,41,0,996
770,2019-08-22,0,0,180,0,180
770,2019-08-23,1142,3125,1825,0,6092
770,2019-08-24,984,3196,1766,0,5946
770,2019-08-25,76,4602,1580,0,6258
770,2019-08-26,910,1727,2027,1,4665
770,2019-08-27,1035,2618,1802,0,5455
770,2019-08-28,877,1130,2150,1,4158
770,2019-08-29,854,9477,1889,1,12221
770,2019-08-30,71,2849,727,2,3649
770,2019-08-31,32,158,3,0,193
770,2019-09-01,77,955,244,0,1276
770,2019-09-02,48,821,3,0,872
770,2019-09-03,63,3211,1398,1,4673
770,2019-09-04,958,17000,1494,3,19455
770,2019-09-05,83,13300,2136,3,15522
770,2019-09-06,132,8521,1979,0,10632
770,2019-09-07,86,12258,2057,1,14402
770,2019-09-08,1035,6158,2458,1,9652
770,2019-09-09,1156,12512,2356,0,16024
770,2019-09-10,76,11220,1686,0,12982
770,2019-09-11,84,9868,2571,2,12525
770,2019-09-12,154,6923,2090,0,9167
770,2019-09-13,954,7260,1813,1,10028
770,2019-09-14,84,6431,2371,0,8886
770,2019-09-15,1180,12597,2185,0,15962
770,2019-09-16,101,5833,3175,0,9109
770,2019-09-17,91,6673,2616,0,9380
770,2019-09-18,82,12210,1039,2,13333
770,2019-09-19,1254,10714,1350,1,13319
770,2019-09-20,193,12757,1882,1,14833
770,2019-09-21,67,8291,1801,1,10160
770,2019-09-22,78,8588,1542,0,10208
770,2019-09-23,87,11189,1791,2,13069
770,2019-09-24,96,7179,2425,3,9703
770,2019-09-25,86,8647,1670,5,10408
770,2019-09-26,109,10155,1724,1,11989
770,2019-09-27,61,7487,2045,2,9595
770,2019-09-28,195,14666,1812,1,16674
770,2019-09-29,68,17134,1672,0,18874
770,2019-09-30,54,38207,1852,3,40116
770,2019-10-01,956,20273,2143,1,23373
770,2019-10-02,61,10566,1840,3,12470
770,2019-10-03,106,11345,1466,1,12918
770,2019-10-04,64,13087,1783,5,14939
770,2019-10-05,82,21308,1841,1,23232
770,2019-10-06,1451,15959,1970,5,19385
770,2019-10-07,71,5441,1898,0,7410
770,2019-10-08,158,17235,1887,0,19280
770,2019-10-09,97,18124,2293,101,20615
770,2019-10-10,105,8904,1508,3,10520
770,2019-10-11,1019,9858,1355,1,12233
770,2019-10-12,88,5335,2497,1,7921
770,2019-10-13,1219,7157,1883,2,10261
770,2019-10-14,159,4002,1835,2,5998
770,2019-10-15,71,7090,2100,2,9263
770,2019-10-16,673,12738,2495,2,15908
770,2019-10-17,56,3954,1907,0,5917
770,2019-10-18,173,7292,1158,0,8623
770,2019-10-19,52,35787,1297,1,37137
770,2019-10-20,1834,10254,1995,2,14085
770,2019-10-21,66,18960,1682,1,20709
770,2019-10-22,115,8696,1867,3,10681
770,2019-10-23,1048,13085,1431,1,15565
770,2019-10-24,97,18131,1268,1,19497
770,2019-10-25,402,9672,1308,3,11385
770,2019-10-26,84,21182,2046,0,23312
770,2019-10-27,988,20612,910,0,22510
770,2019-10-28,842,14733,1495,0,17070
770,2019-10-29,130,20249,1285,0,21664
770,2019-10-30,70,16029,943,3,17045
770,2019-10-31,1457,19369,1816,0,22642
770,2019-11-01,333,26615,1064,0,28012
770,2019-11-02,1356,15687,1391,2,18436
770,2019-11-03,183,50063,1196,0,51442
770,2019-11-04,531,12822,1554,2,14909
770,2019-11-05,492,5276,1263,0,7031
770,2019-11-06,181,13544,1608,1,15334
770,2019-11-07,247,16269,1113,1,17630
770,2019-11-08,1090,9047,1151,0,11288
770,2019-11-09,75,7948,1664,3,9690
770,2019-11-10,1680,11793,1370,0,14843
770,2019-11-11,1016,12441,1944,1,15402
770,2019-11-12,361,8884,2545,0,11790
770,2019-11-13,527,11263,2416,5,14211
770,2019-11-14,83,12872,1992,897,15844
770,2019-11-15,96,4754,3206,1,8057
770,2019-11-16,74,2920,3289,2,6285
770,2019-11-17,268,3187,4084,0,7539
770,2019-11-18,79,9715,3457,0,13251
770,2019-11-19,1118,3176,2455,3,6752
770,2019-11-20,98,1343,2647,0,4088
770,2019-11-21,116,5898,1708,0,7722
770,2019-11-22,475,8063,1648,1,10187
770,2019-11-23,79,10674,2914,2,13669
770,2019-11-24,191,10025,2111,0,12327
770,2019-11-25,588,11269,2390,1,14248
770,2019-11-26,71,10286,1356,1,11714
770,2019-11-27,73,14927,2133,0,17133
770,2019-11-28,92,12608,379,0,13079
770,2019-11-29,26,929,41,0,996
770,2019-08-26,910,1727,2027,1,4665
770,2019-08-27,1035,2618,1802,0,5455
770,2019-08-28,877,1130,2150,1,4158
770,2019-08-29,854,9477,1889,1,12221
770,2019-08-30,71,2849,727,2,3649
770,2019-08-31,32,158,3,0,193
770,2019-09-01,77,955,244,0,1276
770,2019-09-02,48,821,3,0,872
770,2019-09-03,63,3211,1398,1,4673
770,2019-09-04,958,17000,1494,3,19455
770,2019-09-05,83,13300,2136,3,15522
770,2019-09-06,132,8521,1979,0,10632
770,2019-09-07,86,12258,2057,1,14402
770,2019-09-08,1035,6158,2458,1,9652
770,2019-09-09,1156,12512,2356,0,16024
770,2019-09-10,76,11220,1686,0,12982
770,2019-09-11,84,9868,2571,2,12525
770,2019-09-12,154,6923,2090,0,9167
770,2019-09-13,954,7260,1813,1,10028
770,2019-09-14,84,6431,2371,0,8886
770,2019-09-15,1180,12597,2185,0,15962
770,2019-09-16,101,5833,3175,0,9109
770,2019-09-17,91,6673,2616,0,9380
770,2019-09-18,82,12210,1039,2,13333
770,2019-09-19,1254,10714,1350,1,13319
770,2019-09-20,193,12757,1882,1,14833
770,2019-09-21,67,8291,1801,1,10160
770,2019-09-22,78,8588,1542,0,10208
770,2019-09-23,87,11189,1791,2,13069
770,2019-09-24,96,7179,2425,3,9703
770,2019-09-25,86,8647,1670,5,10408
770,2019-09-26,109,10155,1724,1,11989
770,2019-09-27,61,7487,2045,2,9595
770,2019-09-28,195,14666,1812,1,16674
770,2019-09-29,68,17134,1672,0,18874
770,2019-09-30,54,38207,1852,3,40116
770,2019-10-01,956,20273,2143,1,23373
770,2019-10-02,61,10566,1840,3,12470
770,2019-10-03,106,11345,1466,1,12918
770,2019-10-04,64,13087,1783,5,14939
770,2019-10-05,82,21308,1841,1,23232
770,2019-10-06,1451,15959,1970,5,19385
770,2019-10-07,71,5441,1898,0,7410
770,2019-10-08,158,17235,1887,0,19280
770,2019-10-09,97,18124,2293,101,20615
770,2019-10-10,105,8904,1508,3,10520
770,2019-10-11,1019,9858,1355,1,12233
770,2019-10-12,88,5335,2497,1,7921
770,2019-10-13,1219,7157,1883,2,10261
770,2019-10-14,159,4002,1835,2,5998
770,2019-10-15,71,7090,2100,2,9263
770,2019-10-16,673,12738,2495,2,15908
770,2019-10-17,56,3954,1907,0,5917
770,2019-10-18,173,7292,1158,0,8623
770,2019-10-19,52,35787,1297,1,37137
770,2019-10-20,1834,10254,1995,2,14085
770,2019-10-21,66,18960,1682,1,20709
770,2019-10-22,115,8696,1867,3,10681
770,2019-10-23,1048,13085,1431,1,15565
770,2019-10-24,97,18131,1268,1,19497
770,2019-10-25,402,9672,1308,3,11385
770,2019-10-26,84,21182,2046,0,23312
770,2019-10-27,988,20612,910,0,22510
770,2019-10-28,842,14733,1495,0,17070
770,2019-10-29,130,20249,1285,0,21664
770,2019-10-30,70,16029,943,3,17045
770,2019-10-31,1457,19369,1816,0,22642
770,2019-11-01,333,26615,1064,0,28012
770,2019-11-02,1356,15687,1391,2,18436
770,2019-11-03,183,50063,1196,0,51442
770,2019-11-04,531,12822,1554,2,14909
770,2019-11-05,492,5276,1263,0,7031
770,2019-11-06,181,13544,1608,1,15334
770,2019-11-07,247,16269,1113,1,17630
770,2019-11-08,1090,9047,1151,0,11288
770,2019-11-09,75,7948,1664,3,9690
770,2019-11-10,1680,11793,1370,0,14843
770,2019-11-11,1016,12441,1944,1,15402
770,2019-11-12,361,8884,2545,0,11790
770,2019-11-13,527,11263,2416,5,14211
770,2019-11-14,83,12872,1992,897,15844
770,2019-11-15,96,4754,3206,1,8057
770,2019-11-16,74,2920,3289,2,6285
770,2019-11-17,268,3187,4084,0,7539
770,2019-11-18,79,9715,3457,0,13251
770,2019-11-19,1118,3176,2455,3,6752
770,2019-11-20,98,1343,2647,0,4088
770,2019-11-21,116,5898,1708,0,7722
770,2019-11-22,475,8063,1648,1,10187
770,2019-11-23,79,10674,2914,2,13669
770,2019-11-24,191,10025,2111,0,12327
770,2019-11-25,588,11269,2390,1,14248
770,2019-11-26,71,10286,1356,1,11714
772,2019-08-24,849,2873,1396,1,5119
772,2019-08-25,5113,2862,2039,1,10015
772,2019-08-26,17142,2545,1816,1,21504
772,2019-08-27,9381,8722,1712,0,19815
772,2019-08-28,2227,1606,2535,0,6368
772,2019-08-29,9453,9533,1818,0,20804
772,2019-08-30,6147,2365,630,0,9142
772,2019-08-31,292,60,0,0,352
772,2019-09-01,4126,1452,480,0,6058
772,2019-09-02,2305,82,19,0,2406
772,2019-09-03,393,529,1194,1,2117
772,2019-09-04,40484,15053,1845,2,57384
772,2019-09-05,79148,4821,1478,1,85448
772,2019-09-06,2093,9415,2127,1,13636
772,2019-09-07,181887,18428,2065,0,202380
772,2019-09-08,118306,8022,1690,1,128019
772,2019-09-09,1562,8805,1421,2,11790
772,2019-09-10,51151,11831,1249,0,64231
772,2019-09-11,300955,7416,1776,1,310148
772,2019-09-12,24541,7299,1725,0,33565
772,2019-09-13,64252,5809,1537,1,71599
772,2019-09-14,92626,7905,2098,0,102629
772,2019-09-15,14335,8656,2105,0,25096
772,2019-09-16,50605,5589,1933,2,58129
772,2019-09-17,117932,4968,1804,0,124704
772,2019-09-18,12993,11108,1329,1,25431
772,2019-09-19,36906,3247,1263,0,41416
772,2019-09-20,165949,11433,1966,0,179348
772,2019-09-21,21023,8174,1774,3,30974
772,2019-09-22,34177,9687,1307,0,45171
772,2019-09-23,39656,10659,1044,0,51359
772,2019-09-24,21300,9019,1602,3,31924
772,2019-09-25,13584,10331,936,0,24851
772,2019-09-26,12631,10292,1657,3,24583
772,2019-09-27,17926,10187,1695,4,29812
772,2019-09-28,21891,14391,1779,0,38061
772,2019-09-29,9443,16728,1260,0,27431
772,2019-09-30,11366,24612,1960,1,37939
772,2019-10-01,9439,21677,1345,3,32464
772,2019-10-02,16500,11983,2524,0,31007
772,2019-10-03,17136,13744,2182,1,33063
772,2019-10-04,11119,14439,1639,0,27197
772,2019-10-05,14879,21472,1087,0,37438
772,2019-10-06,4574,18466,2170,4,25214
772,2019-10-07,11042,6629,2302,0,19973
772,2019-10-08,26645,11882,1089,0,39616
772,2019-10-09,17121,14656,1500,1,33278
772,2019-10-10,18743,16774,2565,2,38084
772,2019-10-11,22138,14785,1322,2,38247
772,2019-10-12,11355,8443,1951,0,21749
772,2019-10-13,13803,12396,1458,0,27657
772,2019-10-14,40459,6075,1453,1,47988
772,2019-10-15,28991,8283,1829,1,39104
772,2019-10-16,19224,18250,1689,3,39166
772,2019-10-17,42434,8437,1837,0,52708
772,2019-10-18,50434,2221,1098,0,53753
772,2019-10-19,39506,3143,1487,0,44136
772,2019-10-20,53758,16643,2018,2,72421
772,2019-10-21,29617,23052,2267,4,54940
772,2019-10-22,25638,10205,2117,1,37961
772,2019-10-23,19875,8166,1680,2,29723
772,2019-10-24,56019,13758,792,3,70572
772,2019-10-25,31415,14669,1263,1,47348
772,2019-10-26,329826,25466,2137,0,357429
772,2019-10-27,15021,29634,1040,0,45695
772,2019-10-28,11094,24470,2434,1,37999
772,2019-10-29,18446,15052,1977,1,35476
772,2019-10-30,17143,11956,1523,1,30623
772,2019-10-31,27798,20833,934,2,49567
772,2019-11-01,27789,26952,1422,0,56163
772,2019-11-02,17202,25917,1256,0,44375
772,2019-11-03,18530,24373,479,1,43383
772,2019-11-04,9649,7972,1814,2,19437
772,2019-11-05,404790,2612,1906,0,409308
772,2019-11-06,12217,14038,1097,0,27352
772,2019-11-07,3781,16548,1665,2,21996
772,2019-11-08,13846,9345,2016,1,25208
772,2019-11-09,13270,8521,2378,0,24169
772,2019-11-10,6083,23476,2114,1,31674
772,2019-11-11,13462,18165,888,2,32517
772,2019-11-12,9036,17317,2259,0,28612
772,2019-11-13,13918,14205,1813,3,29939
772,2019-11-14,11169,13395,2040,4,26608
772,2019-11-15,12883,5238,2028,1,20150
772,2019-11-16,14510,3039,2778,1,20328
772,2019-11-17,25978,7804,2905,0,36687
772,2019-11-18,19528,2725,3850,2,26105
772,2019-11-19,25494,3116,2277,0,30887
772,2019-11-20,19539,1366,2113,3,23021
772,2019-11-21,19718,5530,1942,68,27258
772,2019-11-22,14352,4379,1043,0,19774
772,2019-11-23,10364,5938,2795,3,19100
772,2019-11-24,13252,8390,1833,1,23476
772,2019-11-25,4909,7070,1573,0,13552
772,2019-11-26,13558,6196,1323,1,21078
772,2019-11-27,15716,6457,1919,0,24092
772,2019-11-28,1009,7633,747,1,9390
772,2019-11-29,881,978,3,0,1862
772,2019-08-24,849,2873,1396,1,5119
772,2019-08-25,5113,2862,2039,1,10015
772,2019-08-26,17142,2545,1816,1,21504
772,2019-08-27,9381,8722,1712,0,19815
772,2019-08-28,2227,1606,2535,0,6368
772,2019-08-29,9453,9533,1818,0,20804
772,2019-08-30,6147,2365,630,0,9142
772,2019-08-31,292,60,0,0,352
772,2019-09-01,4126,1452,480,0,6058
772,2019-09-02,2305,82,19,0,2406
772,2019-09-03,393,529,1194,1,2117
772,2019-09-04,40484,15053,1845,2,57384
772,2019-09-05,79148,4821,1478,1,85448
772,2019-09-06,2093,9415,2127,1,13636
772,2019-09-07,181887,18428,2065,0,202380
772,2019-09-08,118306,8022,1690,1,128019
772,2019-09-09,1562,8805,1421,2,11790
772,2019-09-10,51151,11831,1249,0,64231
772,2019-09-11,300955,7416,1776,1,310148
772,2019-09-12,24541,7299,1725,0,33565
772,2019-09-13,64252,5809,1537,1,71599
772,2019-09-14,92626,7905,2098,0,102629
772,2019-09-15,14335,8656,2105,0,25096
772,2019-09-16,50605,5589,1933,2,58129
772,2019-09-17,117932,4968,1804,0,124704
772,2019-09-18,12993,11108,1329,1,25431
772,2019-09-19,36906,3247,1263,0,41416
772,2019-09-20,165949,11433,1966,0,179348
772,2019-09-21,21023,8174,1774,3,30974
772,2019-09-22,34177,9687,1307,0,45171
772,2019-09-23,39656,10659,1044,0,51359
772,2019-09-24,21300,9019,1602,3,31924
772,2019-09-25,13584,10331,936,0,24851
772,2019-09-26,12631,10292,1657,3,24583
772,2019-09-27,17926,10187,1695,4,29812
772,2019-09-28,21891,14391,1779,0,38061
772,2019-09-29,9443,16728,1260,0,27431
772,2019-09-30,11366,24612,1960,1,37939
772,2019-10-01,9439,21677,1345,3,32464
772,2019-10-02,16500,11983,2524,0,31007
772,2019-10-03,17136,13744,2182,1,33063
772,2019-10-04,11119,14439,1639,0,27197
772,2019-10-05,14879,21472,1087,0,37438
772,2019-10-06,4574,18466,2170,4,25214
772,2019-10-07,11042,6629,2302,0,19973
772,2019-10-08,26645,11882,1089,0,39616
772,2019-10-09,17121,14656,1500,1,33278
772,2019-10-10,18743,16774,2565,2,38084
772,2019-10-11,22138,14785,1322,2,38247
772,2019-10-12,11355,8443,1951,0,21749
772,2019-10-13,13803,12396,1458,0,27657
772,2019-10-14,40459,6075,1453,1,47988
772,2019-10-15,28991,8283,1829,1,39104
772,2019-10-16,19224,18250,1689,3,39166
772,2019-10-17,42434,8437,1837,0,52708
772,2019-10-18,50434,2221,1098,0,53753
772,2019-10-19,39506,3143,1487,0,44136
772,2019-10-20,53758,16643,2018,2,72421
772,2019-10-21,29617,23052,2267,4,54940
772,2019-10-22,25638,10205,2117,1,37961
772,2019-10-23,19875,8166,1680,2,29723
772,2019-10-24,56019,13758,792,3,70572
772,2019-10-25,31415,14669,1263,1,47348
772,2019-10-26,329826,25466,2137,0,357429
772,2019-10-27,15021,29634,1040,0,45695
772,2019-10-28,11094,24470,2434,1,37999
772,2019-10-29,18446,15052,1977,1,35476
772,2019-10-30,17143,11956,1523,1,30623
772,2019-10-31,27798,20833,934,2,49567
772,2019-11-01,27789,26952,1422,0,56163
772,2019-11-02,17202,25917,1256,0,44375
772,2019-11-03,18530,24373,479,1,43383
772,2019-11-04,9649,7972,1814,2,19437
772,2019-11-05,404790,2612,1906,0,409308
772,2019-11-06,12217,14038,1097,0,27352
772,2019-11-07,3781,16548,1665,2,21996
772,2019-11-08,13846,9345,2016,1,25208
772,2019-11-09,13270,8521,2378,0,24169
772,2019-11-10,6083,23476,2114,1,31674
772,2019-11-11,13462,18165,888,2,32517
772,2019-11-12,9036,17317,2259,0,28612
772,2019-11-13,13918,14205,1813,3,29939
772,2019-11-14,11169,13395,2040,4,26608
772,2019-11-15,12883,5238,2028,1,20150
772,2019-11-16,14510,3039,2778,1,20328
772,2019-11-17,25978,7804,2905,0,36687
772,2019-11-18,19528,2725,3850,2,26105
772,2019-11-19,25494,3116,2277,0,30887
772,2019-11-20,19539,1366,2113,3,23021
772,2019-11-21,19718,5530,1942,68,27258
772,2019-11-22,14352,4379,1043,0,19774
772,2019-11-23,10364,5938,2795,3,19100
772,2019-11-24,13252,8390,1833,1,23476
772,2019-11-25,4909,7070,1573,0,13552
772,2019-11-26,13558,6196,1323,1,21078
772,2019-11-27,15716,6457,1919,0,24092
772,2019-11-28,1009,7633,747,1,9390
772,2019-11-29,881,978,3,0,1862
772,2019-08-23,0,0,90,0,90
772,2019-08-24,849,2873,1396,1,5119
772,2019-08-25,5113,2862,2039,1,10015
772,2019-08-26,17142,2545,1816,1,21504
772,2019-08-27,9381,8722,1712,0,19815
772,2019-08-28,2227,1606,2535,0,6368
772,2019-08-29,9453,9533,1818,0,20804
772,2019-08-30,6147,2365,630,0,9142
772,2019-08-31,292,60,0,0,352
772,2019-09-01,4126,1452,480,0,6058
772,2019-09-02,2305,82,19,0,2406
772,2019-09-03,393,529,1194,1,2117
772,2019-09-04,40484,15053,1845,2,57384
772,2019-09-05,79148,4821,1478,1,85448
772,2019-09-06,2093,9415,2127,1,13636
772,2019-09-07,181887,18428,2065,0,202380
772,2019-09-08,118306,8022,1690,1,128019
772,2019-09-09,1562,8805,1421,2,11790
772,2019-09-10,51151,11831,1249,0,64231
772,2019-09-11,300955,7416,1776,1,310148
772,2019-09-12,24541,7299,1725,0,33565
772,2019-09-13,64252,5809,1537,1,71599
772,2019-09-14,92626,7905,2098,0,102629
772,2019-09-15,14335,8656,2105,0,25096
772,2019-09-16,50605,5589,1933,2,58129
772,2019-09-17,117932,4968,1804,0,124704
772,2019-09-18,12993,11108,1329,1,25431
772,2019-09-19,36906,3247,1263,0,41416
772,2019-09-20,165949,11433,1966,0,179348
772,2019-09-21,21023,8174,1774,3,30974
772,2019-09-22,34177,9687,1307,0,45171
772,2019-09-23,39656,10659,1044,0,51359
772,2019-09-24,21300,9019,1602,3,31924
772,2019-09-25,13584,10331,936,0,24851
772,2019-09-26,12631,10292,1657,3,24583
772,2019-09-27,17926,10187,1695,4,29812
772,2019-09-28,21891,14391,1779,0,38061
772,2019-09-29,9443,16728,1260,0,27431
772,2019-09-30,11366,24612,1960,1,37939
772,2019-10-01,9439,21677,1345,3,32464
772,2019-10-02,16500,11983,2524,0,31007
772,2019-10-03,17136,13744,2182,1,33063
772,2019-10-04,11119,14439,1639,0,27197
772,2019-10-05,14879,21472,1087,0,37438
772,2019-10-06,4574,18466,2170,4,25214
772,2019-10-07,11042,6629,2302,0,19973
772,2019-10-08,26645,11882,1089,0,39616
772,2019-10-09,17121,14656,1500,1,33278
772,2019-10-10,18743,16774,2565,2,38084
772,2019-10-11,22138,14785,1322,2,38247
772,2019-10-12,11355,8443,1951,0,21749
772,2019-10-13,13803,12396,1458,0,27657
772,2019-10-14,40459,6075,1453,1,47988
772,2019-10-15,28991,8283,1829,1,39104
772,2019-10-16,19224,18250,1689,3,39166
772,2019-10-17,42434,8437,1837,0,52708
772,2019-10-18,50434,2221,1098,0,53753
772,2019-10-19,39506,3143,1487,0,44136
772,2019-10-20,53758,16643,2018,2,72421
772,2019-10-21,29617,23052,2267,4,54940
772,2019-10-22,25638,10205,2117,1,37961
772,2019-10-23,19875,8166,1680,2,29723
772,2019-10-24,56019,13758,792,3,70572
772,2019-10-25,31415,14669,1263,1,47348
772,2019-10-26,329826,25466,2137,0,357429
772,2019-10-27,15021,29634,1040,0,45695
772,2019-10-28,11094,24470,2434,1,37999
772,2019-10-29,18446,15052,1977,1,35476
772,2019-10-30,17143,11956,1523,1,30623
772,2019-10-31,27798,20833,934,2,49567
772,2019-11-01,27789,26952,1422,0,56163
772,2019-11-02,17202,25917,1256,0,44375
772,2019-11-03,18530,24373,479,1,43383
772,2019-11-04,9649,7972,1814,2,19437
772,2019-11-05,404790,2612,1906,0,409308
772,2019-11-06,12217,14038,1097,0,27352
772,2019-11-07,3781,16548,1665,2,21996
772,2019-11-08,13846,9345,2016,1,25208
772,2019-11-09,13270,8521,2378,0,24169
772,2019-11-10,6083,23476,2114,1,31674
772,2019-11-11,13462,18165,888,2,32517
772,2019-11-12,9036,17317,2259,0,28612
772,2019-11-13,13918,14205,1813,3,29939
772,2019-11-14,11169,13395,2040,4,26608
772,2019-11-15,12883,5238,2028,1,20150
772,2019-11-16,14510,3039,2778,1,20328
772,2019-11-17,25978,7804,2905,0,36687
772,2019-11-18,19528,2725,3850,2,26105
772,2019-11-19,25494,3116,2277,0,30887
772,2019-11-20,19539,1366,2113,3,23021
772,2019-11-21,19718,5530,1942,68,27258
772,2019-11-22,14352,4379,1043,0,19774
772,2019-11-23,10364,5938,2795,3,19100
772,2019-11-24,13252,8390,1833,1,23476
772,2019-11-25,4909,7070,1573,0,13552
772,2019-11-26,13558,6196,1323,1,21078
772,2019-11-27,15716,6457,1919,0,24092
772,2019-11-28,1009,7633,747,1,9390
772,2019-11-29,881,978,3,0,1862
772,2019-08-24,849,2873,1396,1,5119
772,2019-08-25,5113,2862,2039,1,10015
772,2019-08-26,17142,2545,1816,1,21504
772,2019-08-27,9381,8722,1712,0,19815
772,2019-08-28,2227,1606,2535,0,6368
772,2019-08-29,9453,9533,1818,0,20804
772,2019-08-30,6147,2365,630,0,9142
772,2019-08-31,292,60,0,0,352
772,2019-09-01,4126,1452,480,0,6058
772,2019-09-02,2305,82,19,0,2406
772,2019-09-03,393,529,1194,1,2117
772,2019-09-04,40484,15053,1845,2,57384
772,2019-09-05,79148,4821,1478,1,85448
772,2019-09-06,2093,9415,2127,1,13636
772,2019-09-07,181887,18428,2065,0,202380
772,2019-09-08,118306,8022,1690,1,128019
772,2019-09-09,1562,8805,1421,2,11790
772,2019-09-10,51151,11831,1249,0,64231
772,2019-09-11,300955,7416,1776,1,310148
772,2019-09-12,24541,7299,1725,0,33565
772,2019-09-13,64252,5809,1537,1,71599
772,2019-09-14,92626,7905,2098,0,102629
772,2019-09-15,14335,8656,2105,0,25096
772,2019-09-16,50605,5589,1933,2,58129
772,2019-09-17,117932,4968,1804,0,124704
772,2019-09-18,12993,11108,1329,1,25431
772,2019-09-19,36906,3247,1263,0,41416
772,2019-09-20,165949,11433,1966,0,179348
772,2019-09-21,21023,8174,1774,3,30974
772,2019-09-22,34177,9687,1307,0,45171
772,2019-09-23,39656,10659,1044,0,51359
772,2019-09-24,21300,9019,1602,3,31924
772,2019-09-25,13584,10331,936,0,24851
772,2019-09-26,12631,10292,1657,3,24583
772,2019-09-27,17926,10187,1695,4,29812
772,2019-09-28,21891,14391,1779,0,38061
772,2019-09-29,9443,16728,1260,0,27431
772,2019-09-30,11366,24612,1960,1,37939
772,2019-10-01,9439,21677,1345,3,32464
772,2019-10-02,16500,11983,2524,0,31007
772,2019-10-03,17136,13744,2182,1,33063
772,2019-10-04,11119,14439,1639,0,27197
772,2019-10-05,14879,21472,1087,0,37438
772,2019-10-06,4574,18466,2170,4,25214
772,2019-10-07,11042,6629,2302,0,19973
772,2019-10-08,26645,11882,1089,0,39616
772,2019-10-09,17121,14656,1500,1,33278
772,2019-10-10,18743,16774,2565,2,38084
772,2019-10-11,22138,14785,1322,2,38247
772,2019-10-12,11355,8443,1951,0,21749
772,2019-10-13,13803,12396,1458,0,27657
772,2019-10-14,40459,6075,1453,1,47988
772,2019-10-15,28991,8283,1829,1,39104
772,2019-10-16,19224,18250,1689,3,39166
772,2019-10-17,42434,8437,1837,0,52708
772,2019-10-18,50434,2221,1098,0,53753
772,2019-10-19,39506,3143,1487,0,44136
772,2019-10-20,53758,16643,2018,2,72421
772,2019-10-21,29617,23052,2267,4,54940
772,2019-10-22,25638,10205,2117,1,37961
772,2019-10-23,19875,8166,1680,2,29723
772,2019-10-24,56019,13758,792,3,70572
772,2019-10-25,31415,14669,1263,1,47348
772,2019-10-26,329826,25466,2137,0,357429
772,2019-10-27,15021,29634,1040,0,45695
772,2019-10-28,11094,24470,2434,1,37999
772,2019-10-29,18446,15052,1977,1,35476
772,2019-10-30,17143,11956,1523,1,30623
772,2019-10-31,27798,20833,934,2,49567
772,2019-11-01,27789,26952,1422,0,56163
772,2019-11-02,17202,25917,1256,0,44375
772,2019-11-03,18530,24373,479,1,43383
772,2019-11-04,9649,7972,1814,2,19437
772,2019-11-05,404790,2612,1906,0,409308
772,2019-11-06,12217,14038,1097,0,27352
772,2019-11-07,3781,16548,1665,2,21996
772,2019-11-08,13846,9345,2016,1,25208
772,2019-11-09,13270,8521,2378,0,24169
772,2019-11-10,6083,23476,2114,1,31674
772,2019-11-11,13462,18165,888,2,32517
772,2019-11-12,9036,17317,2259,0,28612
772,2019-11-13,13918,14205,1813,3,29939
772,2019-11-14,11169,13395,2040,4,26608
772,2019-11-15,12883,5238,2028,1,20150
772,2019-11-16,14510,3039,2778,1,20328
772,2019-11-17,25978,7804,2905,0,36687
772,2019-11-18,19528,2725,3850,2,26105
772,2019-11-19,25494,3116,2277,0,30887
772,2019-11-20,19539,1366,2113,3,23021
772,2019-11-21,19718,5530,1942,68,27258
772,2019-11-22,14352,4379,1043,0,19774
772,2019-11-23,10364,5938,2795,3,19100
772,2019-11-24,13252,8390,1833,1,23476
772,2019-11-25,4909,7070,1573,0,13552
772,2019-11-26,13558,6196,1323,1,21078
772,2019-11-27,15716,6457,1919,0,24092
772,2019-11-28,1009,7633,747,1,9390
773,2019-08-24,309,1557,1598,0,3464
773,2019-08-25,375,14967,2160,0,17502
773,2019-08-26,366,33377,1459,0,35202
773,2019-08-27,1135,12079,1693,1,14908
773,2019-08-28,291,1664,1350,0,3305
773,2019-08-29,330,9172,1803,0,11305
773,2019-08-30,1224,3174,390,1,4789
773,2019-08-31,42,224,57,0,323
773,2019-09-01,132,269,204,0,605
773,2019-09-02,46,390,6,0,442
773,2019-09-03,95,782,1407,1,2285
773,2019-09-04,384,15737,2091,1,18213
773,2019-09-05,351,8180,1769,2,10302
773,2019-09-06,339,11356,1895,0,13590
773,2019-09-07,303,13239,2083,2,15627
773,2019-09-08,459,8170,1992,2,10623
773,2019-09-09,1405,10518,2206,4,14133
773,2019-09-10,309,11541,1861,0,13711
773,2019-09-11,209,8786,2542,1,11538
773,2019-09-12,225,6887,1547,1,8660
773,2019-09-13,1388,5428,1954,1,8771
773,2019-09-14,271,7682,2196,0,10149
773,2019-09-15,228,12719,2028,1,14976
773,2019-09-16,264,5476,2047,0,7787
773,2019-09-17,243,9676,2211,0,12130
773,2019-09-18,337,11737,646,0,12720
773,2019-09-19,520,4488,1619,0,6627
773,2019-09-20,374,11020,1372,1,12767
773,2019-09-21,380,8909,1083,0,10372
773,2019-09-22,233,9199,1739,1,11172
773,2019-09-23,1108,14071,2187,2,17368
773,2019-09-24,1276,27008,2270,4,30558
773,2019-09-25,287,17502,1812,1,19602
773,2019-09-26,1106,11467,1974,0,14547
773,2019-09-27,1094,8663,2026,1,11784
773,2019-09-28,1081,15315,1796,2,18194
773,2019-09-29,142,17648,1731,3,19524
773,2019-09-30,192,16666,2259,0,19117
773,2019-10-01,140,17044,2264,0,19448
773,2019-10-02,225,12537,2040,1,14803
773,2019-10-03,186,14632,1783,1,16602
773,2019-10-04,147,19905,1599,2,21653
773,2019-10-05,737,16085,2606,0,19428
773,2019-10-06,745,12161,1708,1,14615
773,2019-10-07,1045,8875,2763,1,12684
773,2019-10-08,240,13980,2396,2,16618
773,2019-10-09,226,16854,2109,1,19190
773,2019-10-10,2036,10703,2389,1,15129
773,2019-10-11,1358,14072,786,1,16217
773,2019-10-12,1135,7216,2155,0,10506
773,2019-10-13,270,9043,1976,0,11289
773,2019-10-14,243,7441,2029,2,9715
773,2019-10-15,1185,9343,1134,0,11662
773,2019-10-16,217,12917,1005,0,14139
773,2019-10-17,283,5811,2223,0,8317
773,2019-10-18,300,9877,2046,1,12224
773,2019-10-19,301,9450,1735,1,11487
773,2019-10-20,1170,2967,2021,0,6158
773,2019-10-21,833,11358,1699,2,13892
773,2019-10-22,721,6843,1873,1,9438
773,2019-10-23,277,9019,1639,1,10936
773,2019-10-24,254,20062,1448,2,21766
773,2019-10-25,798,20035,1511,1,22345
773,2019-10-26,246,25635,1747,0,27628
773,2019-10-27,814,19294,1287,0,21395
773,2019-10-28,261,14223,1602,0,16086
773,2019-10-29,726,15775,1295,3,17799
773,2019-10-30,273,16164,1320,0,17757
773,2019-10-31,255,21232,1782,0,23269
773,2019-11-01,530,27290,1204,2,29026
773,2019-11-02,273,17592,838,0,18703
773,2019-11-03,334,22979,1506,2,24821
773,2019-11-04,327,8372,1099,0,9798
773,2019-11-05,298,3487,2498,0,6283
773,2019-11-06,266,8585,1407,1,10259
773,2019-11-07,1055,14200,873,3,16131
773,2019-11-08,266,10351,1115,3,11735
773,2019-11-09,279,14008,1489,0,15776
773,2019-11-10,1024,15226,1638,1,17889
773,2019-11-11,269,14452,995,0,15716
773,2019-11-12,406,13355,2755,0,16516
773,2019-11-13,784,15144,1631,0,17559
773,2019-11-14,279,8573,2097,0,10949
773,2019-11-15,374,3721,1845,0,5940
773,2019-11-16,260,2961,2395,0,5616
773,2019-11-17,383,3544,3458,0,7385
773,2019-11-18,287,3591,3746,0,7624
773,2019-11-19,309,4908,1594,0,6811
773,2019-11-20,636,1808,2778,0,5222
773,2019-11-21,328,5751,1725,0,7804
773,2019-11-22,821,8072,1362,0,10255
773,2019-11-23,247,6650,2679,0,9576
773,2019-11-24,413,5876,1786,0,8075
773,2019-11-25,250,6811,1469,0,8530
773,2019-11-26,873,6326,1489,0,8688
773,2019-11-27,259,6587,1267,1,8114
773,2019-11-28,288,11825,368,0,12481
773,2019-11-29,117,1198,22,0,1337
773,2019-08-24,309,1557,1598,0,3464
773,2019-08-25,375,14967,2160,0,17502
773,2019-08-26,366,33377,1459,0,35202
773,2019-08-27,1135,12079,1693,1,14908
773,2019-08-28,291,1664,1350,0,3305
773,2019-08-29,330,9172,1803,0,11305
773,2019-08-30,1224,3174,390,1,4789
773,2019-08-31,42,224,57,0,323
773,2019-09-01,132,269,204,0,605
773,2019-09-02,46,390,6,0,442
773,2019-09-03,95,782,1407,1,2285
773,2019-09-04,384,15737,2091,1,18213
773,2019-09-05,351,8180,1769,2,10302
773,2019-09-06,339,11356,1895,0,13590
773,2019-09-07,303,13239,2083,2,15627
773,2019-09-08,459,8170,1992,2,10623
773,2019-09-09,1405,10518,2206,4,14133
773,2019-09-10,309,11541,1861,0,13711
773,2019-09-11,209,8786,2542,1,11538
773,2019-09-12,225,6887,1547,1,8660
773,2019-09-13,1388,5428,1954,1,8771
773,2019-09-14,271,7682,2196,0,10149
773,2019-09-15,228,12719,2028,1,14976
773,2019-09-16,264,5476,2047,0,7787
773,2019-09-17,243,9676,2211,0,12130
773,2019-09-18,337,11737,646,0,12720
773,2019-09-19,520,4488,1619,0,6627
773,2019-09-20,374,11020,1372,1,12767
773,2019-09-21,380,8909,1083,0,10372
773,2019-09-22,233,9199,1739,1,11172
773,2019-09-23,1108,14071,2187,2,17368
773,2019-09-24,1276,27008,2270,4,30558
773,2019-09-25,287,17502,1812,1,19602
773,2019-09-26,1106,11467,1974,0,14547
773,2019-09-27,1094,8663,2026,1,11784
773,2019-09-28,1081,15315,1796,2,18194
773,2019-09-29,142,17648,1731,3,19524
773,2019-09-30,192,16666,2259,0,19117
773,2019-10-01,140,17044,2264,0,19448
773,2019-10-02,225,12537,2040,1,14803
773,2019-10-03,186,14632,1783,1,16602
773,2019-10-04,147,19905,1599,2,21653
773,2019-10-05,737,16085,2606,0,19428
773,2019-10-06,745,12161,1708,1,14615
773,2019-10-07,1045,8875,2763,1,12684
773,2019-10-08,240,13980,2396,2,16618
773,2019-10-09,226,16854,2109,1,19190
773,2019-10-10,2036,10703,2389,1,15129
773,2019-10-11,1358,14072,786,1,16217
773,2019-10-12,1135,7216,2155,0,10506
773,2019-10-13,270,9043,1976,0,11289
773,2019-10-14,243,7441,2029,2,9715
773,2019-10-15,1185,9343,1134,0,11662
773,2019-10-16,217,12917,1005,0,14139
773,2019-10-17,283,5811,2223,0,8317
773,2019-10-18,300,9877,2046,1,12224
773,2019-10-19,301,9450,1735,1,11487
773,2019-10-20,1170,2967,2021,0,6158
773,2019-10-21,833,11358,1699,2,13892
773,2019-10-22,721,6843,1873,1,9438
773,2019-10-23,277,9019,1639,1,10936
773,2019-10-24,254,20062,1448,2,21766
773,2019-10-25,798,20035,1511,1,22345
773,2019-10-26,246,25635,1747,0,27628
773,2019-10-27,814,19294,1287,0,21395
773,2019-10-28,261,14223,1602,0,16086
773,2019-10-29,726,15775,1295,3,17799
773,2019-10-30,273,16164,1320,0,17757
773,2019-10-31,255,21232,1782,0,23269
773,2019-11-01,530,27290,1204,2,29026
773,2019-11-02,273,17592,838,0,18703
773,2019-11-03,334,22979,1506,2,24821
773,2019-11-04,327,8372,1099,0,9798
773,2019-11-05,298,3487,2498,0,6283
773,2019-11-06,266,8585,1407,1,10259
773,2019-11-07,1055,14200,873,3,16131
773,2019-11-08,266,10351,1115,3,11735
773,2019-11-09,279,14008,1489,0,15776
773,2019-11-10,1024,15226,1638,1,17889
773,2019-11-11,269,14452,995,0,15716
773,2019-11-12,406,13355,2755,0,16516
773,2019-11-13,784,15144,1631,0,17559
773,2019-11-14,279,8573,2097,0,10949
773,2019-11-15,374,3721,1845,0,5940
773,2019-11-16,260,2961,2395,0,5616
773,2019-11-17,383,3544,3458,0,7385
773,2019-11-18,287,3591,3746,0,7624
773,2019-11-19,309,4908,1594,0,6811
773,2019-11-20,636,1808,2778,0,5222
773,2019-11-21,328,5751,1725,0,7804
773,2019-11-22,821,8072,1362,0,10255
773,2019-11-23,247,6650,2679,0,9576
773,2019-11-24,413,5876,1786,0,8075
773,2019-11-25,250,6811,1469,0,8530
773,2019-11-26,873,6326,1489,0,8688
773,2019-11-27,259,6587,1267,1,8114
773,2019-11-28,288,11825,368,0,12481
773,2019-11-29,117,1198,22,0,1337
773,2019-08-24,309,1557,1598,0,3464
773,2019-08-25,375,14967,2160,0,17502
773,2019-08-26,366,33377,1459,0,35202
773,2019-08-27,1135,12079,1693,1,14908
773,2019-08-28,291,1664,1350,0,3305
773,2019-08-29,330,9172,1803,0,11305
773,2019-08-30,1224,3174,390,1,4789
773,2019-08-31,42,224,57,0,323
773,2019-09-01,132,269,204,0,605
773,2019-09-02,46,390,6,0,442
773,2019-09-03,95,782,1407,1,2285
773,2019-09-04,384,15737,2091,1,18213
773,2019-09-05,351,8180,1769,2,10302
773,2019-09-06,339,11356,1895,0,13590
773,2019-09-07,303,13239,2083,2,15627
773,2019-09-08,459,8170,1992,2,10623
773,2019-09-09,1405,10518,2206,4,14133
773,2019-09-10,309,11541,1861,0,13711
773,2019-09-11,209,8786,2542,1,11538
773,2019-09-12,225,6887,1547,1,8660
773,2019-09-13,1388,5428,1954,1,8771
773,2019-09-14,271,7682,2196,0,10149
773,2019-09-15,228,12719,2028,1,14976
773,2019-09-16,264,5476,2047,0,7787
773,2019-09-17,243,9676,2211,0,12130
773,2019-09-18,337,11737,646,0,12720
773,2019-09-19,520,4488,1619,0,6627
773,2019-09-20,374,11020,1372,1,12767
773,2019-09-21,380,8909,1083,0,10372
773,2019-09-22,233,9199,1739,1,11172
773,2019-09-23,1108,14071,2187,2,17368
773,2019-09-24,1276,27008,2270,4,30558
773,2019-09-25,287,17502,1812,1,19602
773,2019-09-26,1106,11467,1974,0,14547
773,2019-09-27,1094,8663,2026,1,11784
773,2019-09-28,1081,15315,1796,2,18194
773,2019-09-29,142,17648,1731,3,19524
773,2019-09-30,192,16666,2259,0,19117
773,2019-10-01,140,17044,2264,0,19448
773,2019-10-02,225,12537,2040,1,14803
773,2019-10-03,186,14632,1783,1,16602
773,2019-10-04,147,19905,1599,2,21653
773,2019-10-05,737,16085,2606,0,19428
773,2019-10-06,745,12161,1708,1,14615
773,2019-10-07,1045,8875,2763,1,12684
773,2019-10-08,240,13980,2396,2,16618
773,2019-10-09,226,16854,2109,1,19190
773,2019-10-10,2036,10703,2389,1,15129
773,2019-10-11,1358,14072,786,1,16217
773,2019-10-12,1135,7216,2155,0,10506
773,2019-10-13,270,9043,1976,0,11289
773,2019-10-14,243,7441,2029,2,9715
773,2019-10-15,1185,9343,1134,0,11662
773,2019-10-16,217,12917,1005,0,14139
773,2019-10-17,283,5811,2223,0,8317
773,2019-10-18,300,9877,2046,1,12224
773,2019-10-19,301,9450,1735,1,11487
773,2019-10-20,1170,2967,2021,0,6158
773,2019-10-21,833,11358,1699,2,13892
773,2019-10-22,721,6843,1873,1,9438
773,2019-10-23,277,9019,1639,1,10936
773,2019-10-24,254,20062,1448,2,21766
773,2019-10-25,798,20035,1511,1,22345
773,2019-10-26,246,25635,1747,0,27628
773,2019-10-27,814,19294,1287,0,21395
773,2019-10-28,261,14223,1602,0,16086
773,2019-10-29,726,15775,1295,3,17799
773,2019-10-30,273,16164,1320,0,17757
773,2019-10-31,255,21232,1782,0,23269
773,2019-11-01,530,27290,1204,2,29026
773,2019-11-02,273,17592,838,0,18703
773,2019-11-03,334,22979,1506,2,24821
773,2019-11-04,327,8372,1099,0,9798
773,2019-11-05,298,3487,2498,0,6283
773,2019-11-06,266,8585,1407,1,10259
773,2019-11-07,1055,14200,873,3,16131
773,2019-11-08,266,10351,1115,3,11735
773,2019-11-09,279,14008,1489,0,15776
773,2019-11-10,1024,15226,1638,1,17889
773,2019-11-11,269,14452,995,0,15716
773,2019-11-12,406,13355,2755,0,16516
773,2019-11-13,784,15144,1631,0,17559
773,2019-11-14,279,8573,2097,0,10949
773,2019-11-15,374,3721,1845,0,5940
773,2019-11-16,260,2961,2395,0,5616
773,2019-11-17,383,3544,3458,0,7385
773,2019-11-18,287,3591,3746,0,7624
773,2019-11-19,309,4908,1594,0,6811
773,2019-11-20,636,1808,2778,0,5222
773,2019-11-21,328,5751,1725,0,7804
773,2019-11-22,821,8072,1362,0,10255
773,2019-11-23,247,6650,2679,0,9576
773,2019-11-24,413,5876,1786,0,8075
773,2019-11-25,250,6811,1469,0,8530
773,2019-11-26,873,6326,1489,0,8688
773,2019-11-27,259,6587,1267,1,8114
773,2019-11-28,288,11825,368,0,12481
773,2019-11-29,117,1198,22,0,1337
773,2019-08-27,1135,12079,1693,1,14908
773,2019-08-28,291,1664,1350,0,3305
773,2019-08-29,330,9172,1803,0,11305
773,2019-08-30,1224,3174,390,1,4789
773,2019-08-31,42,224,57,0,323
773,2019-09-01,132,269,204,0,605
773,2019-09-02,46,390,6,0,442
773,2019-09-03,95,782,1407,1,2285
773,2019-09-04,384,15737,2091,1,18213
773,2019-09-05,351,8180,1769,2,10302
773,2019-09-06,339,11356,1895,0,13590
773,2019-09-07,303,13239,2083,2,15627
773,2019-09-08,459,8170,1992,2,10623
773,2019-09-09,1405,10518,2206,4,14133
773,2019-09-10,309,11541,1861,0,13711
773,2019-09-11,209,8786,2542,1,11538
773,2019-09-12,225,6887,1547,1,8660
773,2019-09-13,1388,5428,1954,1,8771
773,2019-09-14,271,7682,2196,0,10149
773,2019-09-15,228,12719,2028,1,14976
773,2019-09-16,264,5476,2047,0,7787
773,2019-09-17,243,9676,2211,0,12130
773,2019-09-18,337,11737,646,0,12720
773,2019-09-19,520,4488,1619,0,6627
773,2019-09-20,374,11020,1372,1,12767
773,2019-09-21,380,8909,1083,0,10372
773,2019-09-22,233,9199,1739,1,11172
773,2019-09-23,1108,14071,2187,2,17368
773,2019-09-24,1276,27008,2270,4,30558
773,2019-09-25,287,17502,1812,1,19602
773,2019-09-26,1106,11467,1974,0,14547
773,2019-09-27,1094,8663,2026,1,11784
773,2019-09-28,1081,15315,1796,2,18194
773,2019-09-29,142,17648,1731,3,19524
773,2019-09-30,192,16666,2259,0,19117
773,2019-10-01,140,17044,2264,0,19448
773,2019-10-02,225,12537,2040,1,14803
773,2019-10-03,186,14632,1783,1,16602
773,2019-10-04,147,19905,1599,2,21653
773,2019-10-05,737,16085,2606,0,19428
773,2019-10-06,745,12161,1708,1,14615
773,2019-10-07,1045,8875,2763,1,12684
773,2019-10-08,240,13980,2396,2,16618
773,2019-10-09,226,16854,2109,1,19190
773,2019-10-10,2036,10703,2389,1,15129
773,2019-10-11,1358,14072,786,1,16217
773,2019-10-12,1135,7216,2155,0,10506
773,2019-10-13,270,9043,1976,0,11289
773,2019-10-14,243,7441,2029,2,9715
773,2019-10-15,1185,9343,1134,0,11662
773,2019-10-16,217,12917,1005,0,14139
773,2019-10-17,283,5811,2223,0,8317
773,2019-10-18,300,9877,2046,1,12224
773,2019-10-19,301,9450,1735,1,11487
773,2019-10-20,1170,2967,2021,0,6158
773,2019-10-21,833,11358,1699,2,13892
773,2019-10-22,721,6843,1873,1,9438
773,2019-10-23,277,9019,1639,1,10936
773,2019-10-24,254,20062,1448,2,21766
773,2019-10-25,798,20035,1511,1,22345
773,2019-10-26,246,25635,1747,0,27628
773,2019-10-27,814,19294,1287,0,21395
773,2019-10-28,261,14223,1602,0,16086
773,2019-10-29,726,15775,1295,3,17799
773,2019-10-30,273,16164,1320,0,17757
773,2019-10-31,255,21232,1782,0,23269
773,2019-11-01,530,27290,1204,2,29026
773,2019-11-02,273,17592,838,0,18703
773,2019-11-03,334,22979,1506,2,24821
773,2019-11-04,327,8372,1099,0,9798
773,2019-11-05,298,3487,2498,0,6283
773,2019-11-06,266,8585,1407,1,10259
773,2019-11-07,1055,14200,873,3,16131
773,2019-11-08,266,10351,1115,3,11735
773,2019-11-09,279,14008,1489,0,15776
773,2019-11-10,1024,15226,1638,1,17889
773,2019-11-11,269,14452,995,0,15716
773,2019-11-12,406,13355,2755,0,16516
773,2019-11-13,784,15144,1631,0,17559
773,2019-11-14,279,8573,2097,0,10949
773,2019-11-15,374,3721,1845,0,5940
773,2019-11-16,260,2961,2395,0,5616
773,2019-11-17,383,3544,3458,0,7385
773,2019-11-18,287,3591,3746,0,7624
773,2019-11-19,309,4908,1594,0,6811
773,2019-11-20,636,1808,2778,0,5222
773,2019-11-21,328,5751,1725,0,7804
773,2019-11-22,821,8072,1362,0,10255
773,2019-11-23,247,6650,2679,0,9576
773,2019-11-24,413,5876,1786,0,8075
773,2019-11-25,250,6811,1469,0,8530
773,2019-11-26,873,6326,1489,0,8688
773,2019-11-27,259,6587,1267,1,8114
774,2019-08-24,104,2447,1800,0,4351
774,2019-08-25,201,3398,2020,1,5620
774,2019-08-26,240,953,1440,4,2637
774,2019-08-27,240,8500,2253,1,10994
774,2019-08-28,1070,12841,1265,2,15178
774,2019-08-29,253,12119,2230,2,14604
774,2019-08-30,1044,2826,540,1,4411
774,2019-08-31,157,78,2,1,238
774,2019-09-01,975,441,273,0,1689
774,2019-09-02,166,140,146,0,452
774,2019-09-03,175,585,1754,1,2515
774,2019-09-04,252,10956,2014,0,13222
774,2019-09-05,1210,12443,2113,0,15766
774,2019-09-06,282,9229,2098,0,11609
774,2019-09-07,1204,16654,2255,1,20114
774,2019-09-08,419,5425,2115,1,7960
774,2019-09-09,459,13316,1892,0,15667
774,2019-09-10,296,8097,1594,0,9987
774,2019-09-11,357,6010,2650,2,9019
774,2019-09-12,265,10657,2143,0,13065
774,2019-09-13,1288,11890,1672,1,14851
774,2019-09-14,283,6350,1981,1,8615
774,2019-09-15,1403,5472,2236,96,9207
774,2019-09-16,981,5240,1984,1,8206
774,2019-09-17,189,7296,2068,3,9556
774,2019-09-18,1036,11716,1257,0,14009
774,2019-09-19,1245,1809,1812,0,4866
774,2019-09-20,290,7762,2413,0,10465
774,2019-09-21,178,8857,1813,0,10848
774,2019-09-22,181,14260,2164,2,16607
774,2019-09-23,1238,10506,2187,3,13934
774,2019-09-24,141,6101,2214,2,8458
774,2019-09-25,969,7829,2340,1,11139
774,2019-09-26,151,7393,1887,1,9432
774,2019-09-27,114,11786,2565,4,14469
774,2019-09-28,131,14172,1502,1,15806
774,2019-09-29,154,16116,1493,1,17764
774,2019-09-30,934,15363,1688,0,17985
774,2019-10-01,97,16197,2127,1,18422
774,2019-10-02,149,10350,1145,0,11644
774,2019-10-03,111,13029,1398,0,14538
774,2019-10-04,196,17667,746,1,18610
774,2019-10-05,965,22909,1548,2,25424
774,2019-10-06,211,16156,1504,0,17871
774,2019-10-07,1109,4566,2552,3,8230
774,2019-10-08,290,11073,2280,1,13644
774,2019-10-09,900,14208,2434,0,17542
774,2019-10-10,1010,11146,2161,1,14318
774,2019-10-11,1847,9396,2142,2,13387
774,2019-10-12,143,5488,1761,4,7396
774,2019-10-13,1917,10756,1689,0,14362
774,2019-10-14,127,3744,2036,3,5910
774,2019-10-15,1102,13110,2221,1,16434
774,2019-10-16,121,22585,1710,0,24416
774,2019-10-17,83,6787,1557,5,8432
774,2019-10-18,90,7120,2137,0,9347
774,2019-10-19,1829,3943,2104,0,7876
774,2019-10-20,108,698,2189,0,2995
774,2019-10-21,148,9990,1767,0,11905
774,2019-10-22,889,4533,1733,3,7158
774,2019-10-23,115,7285,1814,1,9215
774,2019-10-24,132,13078,1352,1,14563
774,2019-10-25,103,9408,1607,3,11121
774,2019-10-26,520,12563,2092,0,15175
774,2019-10-27,483,24603,1677,1,26764
774,2019-10-28,79,15365,1775,1,17220
774,2019-10-29,257,14821,1118,1,16197
774,2019-10-30,104,25714,1333,0,27151
774,2019-10-31,110,13614,1908,4,15636
774,2019-11-01,89,13645,1139,1,14874
774,2019-11-02,122,13032,1039,0,14193
774,2019-11-03,161,36563,1117,0,37841
774,2019-11-04,1011,9504,1602,0,12117
774,2019-11-05,246,1187,1874,1,3308
774,2019-11-06,134,7272,1915,4,9325
774,2019-11-07,437,13179,1071,1,14688
774,2019-11-08,141,8597,1037,1,9776
774,2019-11-09,100,7815,1718,0,9633
774,2019-11-10,457,11986,1587,0,14030
774,2019-11-11,298,7885,1256,4,9443
774,2019-11-12,297,8633,2732,0,11662
774,2019-11-13,279,13379,1772,1,15431
774,2019-11-14,196,7245,2236,0,9677
774,2019-11-15,428,2128,2498,0,5054
774,2019-11-16,1052,5363,2744,0,9159
774,2019-11-17,157,3814,3280,0,7251
774,2019-11-18,183,2887,3293,0,6363
774,2019-11-19,324,2592,2191,0,5107
774,2019-11-20,569,1098,2197,0,3864
774,2019-11-21,146,5357,1514,0,7017
774,2019-11-22,1076,7972,1554,0,10602
774,2019-11-23,156,6399,1487,0,8042
774,2019-11-24,1132,4704,1952,0,7788
774,2019-11-25,484,5525,1802,0,7811
774,2019-11-26,110,7260,1788,2,9160
774,2019-11-27,118,5578,1136,0,6832
774,2019-11-28,98,12426,865,0,13389
774,2019-11-29,70,580,4,0,654
774,2019-08-24,104,2447,1800,0,4351
774,2019-08-25,201,3398,2020,1,5620
774,2019-08-26,240,953,1440,4,2637
774,2019-08-27,240,8500,2253,1,10994
774,2019-08-28,1070,12841,1265,2,15178
774,2019-08-29,253,12119,2230,2,14604
774,2019-08-30,1044,2826,540,1,4411
774,2019-08-31,157,78,2,1,238
774,2019-09-01,975,441,273,0,1689
774,2019-09-02,166,140,146,0,452
774,2019-09-03,175,585,1754,1,2515
774,2019-09-04,252,10956,2014,0,13222
774,2019-09-05,1210,12443,2113,0,15766
774,2019-09-06,282,9229,2098,0,11609
774,2019-09-07,1204,16654,2255,1,20114
774,2019-09-08,419,5425,2115,1,7960
774,2019-09-09,459,13316,1892,0,15667
774,2019-09-10,296,8097,1594,0,9987
774,2019-09-11,357,6010,2650,2,9019
774,2019-09-12,265,10657,2143,0,13065
774,2019-09-13,1288,11890,1672,1,14851
774,2019-09-14,283,6350,1981,1,8615
774,2019-09-15,1403,5472,2236,96,9207
774,2019-09-16,981,5240,1984,1,8206
774,2019-09-17,189,7296,2068,3,9556
774,2019-09-18,1036,11716,1257,0,14009
774,2019-09-19,1245,1809,1812,0,4866
774,2019-09-20,290,7762,2413,0,10465
774,2019-09-21,178,8857,1813,0,10848
774,2019-09-22,181,14260,2164,2,16607
774,2019-09-23,1238,10506,2187,3,13934
774,2019-09-24,141,6101,2214,2,8458
774,2019-09-25,969,7829,2340,1,11139
774,2019-09-26,151,7393,1887,1,9432
774,2019-09-27,114,11786,2565,4,14469
774,2019-09-28,131,14172,1502,1,15806
774,2019-09-29,154,16116,1493,1,17764
774,2019-09-30,934,15363,1688,0,17985
774,2019-10-01,97,16197,2127,1,18422
774,2019-10-02,149,10350,1145,0,11644
774,2019-10-03,111,13029,1398,0,14538
774,2019-10-04,196,17667,746,1,18610
774,2019-10-05,965,22909,1548,2,25424
774,2019-10-06,211,16156,1504,0,17871
774,2019-10-07,1109,4566,2552,3,8230
774,2019-10-08,290,11073,2280,1,13644
774,2019-10-09,900,14208,2434,0,17542
774,2019-10-10,1010,11146,2161,1,14318
774,2019-10-11,1847,9396,2142,2,13387
774,2019-10-12,143,5488,1761,4,7396
774,2019-10-13,1917,10756,1689,0,14362
774,2019-10-14,127,3744,2036,3,5910
774,2019-10-15,1102,13110,2221,1,16434
774,2019-10-16,121,22585,1710,0,24416
774,2019-10-17,83,6787,1557,5,8432
774,2019-10-18,90,7120,2137,0,9347
774,2019-10-19,1829,3943,2104,0,7876
774,2019-10-20,108,698,2189,0,2995
774,2019-10-21,148,9990,1767,0,11905
774,2019-10-22,889,4533,1733,3,7158
774,2019-10-23,115,7285,1814,1,9215
774,2019-10-24,132,13078,1352,1,14563
774,2019-10-25,103,9408,1607,3,11121
774,2019-10-26,520,12563,2092,0,15175
774,2019-10-27,483,24603,1677,1,26764
774,2019-10-28,79,15365,1775,1,17220
774,2019-10-29,257,14821,1118,1,16197
774,2019-10-30,104,25714,1333,0,27151
774,2019-10-31,110,13614,1908,4,15636
774,2019-11-01,89,13645,1139,1,14874
774,2019-11-02,122,13032,1039,0,14193
774,2019-11-03,161,36563,1117,0,37841
774,2019-11-04,1011,9504,1602,0,12117
774,2019-11-05,246,1187,1874,1,3308
774,2019-11-06,134,7272,1915,4,9325
774,2019-11-07,437,13179,1071,1,14688
774,2019-11-08,141,8597,1037,1,9776
774,2019-11-09,100,7815,1718,0,9633
774,2019-11-10,457,11986,1587,0,14030
774,2019-11-11,298,7885,1256,4,9443
774,2019-11-12,297,8633,2732,0,11662
774,2019-11-13,279,13379,1772,1,15431
774,2019-11-14,196,7245,2236,0,9677
774,2019-11-15,428,2128,2498,0,5054
774,2019-11-16,1052,5363,2744,0,9159
774,2019-11-17,157,3814,3280,0,7251
774,2019-11-18,183,2887,3293,0,6363
774,2019-11-19,324,2592,2191,0,5107
774,2019-11-20,569,1098,2197,0,3864
774,2019-11-21,146,5357,1514,0,7017
774,2019-11-22,1076,7972,1554,0,10602
774,2019-11-23,156,6399,1487,0,8042
774,2019-11-24,1132,4704,1952,0,7788
774,2019-11-25,484,5525,1802,0,7811
774,2019-11-26,110,7260,1788,2,9160
774,2019-11-27,118,5578,1136,0,6832
774,2019-11-28,98,12426,865,0,13389
774,2019-11-29,70,580,4,0,654
774,2019-08-24,104,2447,1800,0,4351
774,2019-08-25,201,3398,2020,1,5620
774,2019-08-26,240,953,1440,4,2637
774,2019-08-27,240,8500,2253,1,10994
774,2019-08-28,1070,12841,1265,2,15178
774,2019-08-29,253,12119,2230,2,14604
774,2019-08-30,1044,2826,540,1,4411
774,2019-08-31,157,78,2,1,238
774,2019-09-01,975,441,273,0,1689
774,2019-09-02,166,140,146,0,452
774,2019-09-03,175,585,1754,1,2515
774,2019-09-04,252,10956,2014,0,13222
774,2019-09-05,1210,12443,2113,0,15766
774,2019-09-06,282,9229,2098,0,11609
774,2019-09-07,1204,16654,2255,1,20114
774,2019-09-08,419,5425,2115,1,7960
774,2019-09-09,459,13316,1892,0,15667
774,2019-09-10,296,8097,1594,0,9987
774,2019-09-11,357,6010,2650,2,9019
774,2019-09-12,265,10657,2143,0,13065
774,2019-09-13,1288,11890,1672,1,14851
774,2019-09-14,283,6350,1981,1,8615
774,2019-09-15,1403,5472,2236,96,9207
774,2019-09-16,981,5240,1984,1,8206
774,2019-09-17,189,7296,2068,3,9556
774,2019-09-18,1036,11716,1257,0,14009
774,2019-09-19,1245,1809,1812,0,4866
774,2019-09-20,290,7762,2413,0,10465
774,2019-09-21,178,8857,1813,0,10848
774,2019-09-22,181,14260,2164,2,16607
774,2019-09-23,1238,10506,2187,3,13934
774,2019-09-24,141,6101,2214,2,8458
774,2019-09-25,969,7829,2340,1,11139
774,2019-09-26,151,7393,1887,1,9432
774,2019-09-27,114,11786,2565,4,14469
774,2019-09-28,131,14172,1502,1,15806
774,2019-09-29,154,16116,1493,1,17764
774,2019-09-30,934,15363,1688,0,17985
774,2019-10-01,97,16197,2127,1,18422
774,2019-10-02,149,10350,1145,0,11644
774,2019-10-03,111,13029,1398,0,14538
774,2019-10-04,196,17667,746,1,18610
774,2019-10-05,965,22909,1548,2,25424
774,2019-10-06,211,16156,1504,0,17871
774,2019-10-07,1109,4566,2552,3,8230
774,2019-10-08,290,11073,2280,1,13644
774,2019-10-09,900,14208,2434,0,17542
774,2019-10-10,1010,11146,2161,1,14318
774,2019-10-11,1847,9396,2142,2,13387
774,2019-10-12,143,5488,1761,4,7396
774,2019-10-13,1917,10756,1689,0,14362
774,2019-10-14,127,3744,2036,3,5910
774,2019-10-15,1102,13110,2221,1,16434
774,2019-10-16,121,22585,1710,0,24416
774,2019-10-17,83,6787,1557,5,8432
774,2019-10-18,90,7120,2137,0,9347
774,2019-10-19,1829,3943,2104,0,7876
774,2019-10-20,108,698,2189,0,2995
774,2019-10-21,148,9990,1767,0,11905
774,2019-10-22,889,4533,1733,3,7158
774,2019-10-23,115,7285,1814,1,9215
774,2019-10-24,132,13078,1352,1,14563
774,2019-10-25,103,9408,1607,3,11121
774,2019-10-26,520,12563,2092,0,15175
774,2019-10-27,483,24603,1677,1,26764
774,2019-10-28,79,15365,1775,1,17220
774,2019-10-29,257,14821,1118,1,16197
774,2019-10-30,104,25714,1333,0,27151
774,2019-10-31,110,13614,1908,4,15636
774,2019-11-01,89,13645,1139,1,14874
774,2019-11-02,122,13032,1039,0,14193
774,2019-11-03,161,36563,1117,0,37841
774,2019-11-04,1011,9504,1602,0,12117
774,2019-11-05,246,1187,1874,1,3308
774,2019-11-06,134,7272,1915,4,9325
774,2019-11-07,437,13179,1071,1,14688
774,2019-11-08,141,8597,1037,1,9776
774,2019-11-09,100,7815,1718,0,9633
774,2019-11-10,457,11986,1587,0,14030
774,2019-11-11,298,7885,1256,4,9443
774,2019-11-12,297,8633,2732,0,11662
774,2019-11-13,279,13379,1772,1,15431
774,2019-11-14,196,7245,2236,0,9677
774,2019-11-15,428,2128,2498,0,5054
774,2019-11-16,1052,5363,2744,0,9159
774,2019-11-17,157,3814,3280,0,7251
774,2019-11-18,183,2887,3293,0,6363
774,2019-11-19,324,2592,2191,0,5107
774,2019-11-20,569,1098,2197,0,3864
774,2019-11-21,146,5357,1514,0,7017
774,2019-11-22,1076,7972,1554,0,10602
774,2019-11-23,156,6399,1487,0,8042
774,2019-11-24,1132,4704,1952,0,7788
774,2019-11-25,484,5525,1802,0,7811
774,2019-11-26,110,7260,1788,2,9160
774,2019-11-27,118,5578,1136,0,6832
774,2019-11-28,98,12426,865,0,13389
774,2019-11-29,70,580,4,0,654
774,2019-08-25,201,3398,2020,1,5620
774,2019-08-26,240,953,1440,4,2637
774,2019-08-27,240,8500,2253,1,10994
774,2019-08-28,1070,12841,1265,2,15178
774,2019-08-29,253,12119,2230,2,14604
774,2019-08-30,1044,2826,540,1,4411
774,2019-08-31,157,78,2,1,238
774,2019-09-01,975,441,273,0,1689
774,2019-09-02,166,140,146,0,452
774,2019-09-03,175,585,1754,1,2515
774,2019-09-04,252,10956,2014,0,13222
774,2019-09-05,1210,12443,2113,0,15766
774,2019-09-06,282,9229,2098,0,11609
774,2019-09-07,1204,16654,2255,1,20114
774,2019-09-08,419,5425,2115,1,7960
774,2019-09-09,459,13316,1892,0,15667
774,2019-09-10,296,8097,1594,0,9987
774,2019-09-11,357,6010,2650,2,9019
774,2019-09-12,265,10657,2143,0,13065
774,2019-09-13,1288,11890,1672,1,14851
774,2019-09-14,283,6350,1981,1,8615
774,2019-09-15,1403,5472,2236,96,9207
774,2019-09-16,981,5240,1984,1,8206
774,2019-09-17,189,7296,2068,3,9556
774,2019-09-18,1036,11716,1257,0,14009
774,2019-09-19,1245,1809,1812,0,4866
774,2019-09-20,290,7762,2413,0,10465
774,2019-09-21,178,8857,1813,0,10848
774,2019-09-22,181,14260,2164,2,16607
774,2019-09-23,1238,10506,2187,3,13934
774,2019-09-24,141,6101,2214,2,8458
774,2019-09-25,969,7829,2340,1,11139
774,2019-09-26,151,7393,1887,1,9432
774,2019-09-27,114,11786,2565,4,14469
774,2019-09-28,131,14172,1502,1,15806
774,2019-09-29,154,16116,1493,1,17764
774,2019-09-30,934,15363,1688,0,17985
774,2019-10-01,97,16197,2127,1,18422
774,2019-10-02,149,10350,1145,0,11644
774,2019-10-03,111,13029,1398,0,14538
774,2019-10-04,196,17667,746,1,18610
774,2019-10-05,965,22909,1548,2,25424
774,2019-10-06,211,16156,1504,0,17871
774,2019-10-07,1109,4566,2552,3,8230
774,2019-10-08,290,11073,2280,1,13644
774,2019-10-09,900,14208,2434,0,17542
774,2019-10-10,1010,11146,2161,1,14318
774,2019-10-11,1847,9396,2142,2,13387
774,2019-10-12,143,5488,1761,4,7396
774,2019-10-13,1917,10756,1689,0,14362
774,2019-10-14,127,3744,2036,3,5910
774,2019-10-15,1102,13110,2221,1,16434
774,2019-10-16,121,22585,1710,0,24416
774,2019-10-17,83,6787,1557,5,8432
774,2019-10-18,90,7120,2137,0,9347
774,2019-10-19,1829,3943,2104,0,7876
774,2019-10-20,108,698,2189,0,2995
774,2019-10-21,148,9990,1767,0,11905
774,2019-10-22,889,4533,1733,3,7158
774,2019-10-23,115,7285,1814,1,9215
774,2019-10-24,132,13078,1352,1,14563
774,2019-10-25,103,9408,1607,3,11121
774,2019-10-26,520,12563,2092,0,15175
774,2019-10-27,483,24603,1677,1,26764
774,2019-10-28,79,15365,1775,1,17220
774,2019-10-29,257,14821,1118,1,16197
774,2019-10-30,104,25714,1333,0,27151
774,2019-10-31,110,13614,1908,4,15636
774,2019-11-01,89,13645,1139,1,14874
774,2019-11-02,122,13032,1039,0,14193
774,2019-11-03,161,36563,1117,0,37841
774,2019-11-04,1011,9504,1602,0,12117
774,2019-11-05,246,1187,1874,1,3308
774,2019-11-06,134,7272,1915,4,9325
774,2019-11-07,437,13179,1071,1,14688
774,2019-11-08,141,8597,1037,1,9776
774,2019-11-09,100,7815,1718,0,9633
774,2019-11-10,457,11986,1587,0,14030
774,2019-11-11,298,7885,1256,4,9443
774,2019-11-12,297,8633,2732,0,11662
774,2019-11-13,279,13379,1772,1,15431
774,2019-11-14,196,7245,2236,0,9677
774,2019-11-15,428,2128,2498,0,5054
774,2019-11-16,1052,5363,2744,0,9159
774,2019-11-17,157,3814,3280,0,7251
774,2019-11-18,183,2887,3293,0,6363
774,2019-11-19,324,2592,2191,0,5107
774,2019-11-20,569,1098,2197,0,3864
774,2019-11-21,146,5357,1514,0,7017
774,2019-11-22,1076,7972,1554,0,10602
774,2019-11-23,156,6399,1487,0,8042
774,2019-11-24,1132,4704,1952,0,7788
774,2019-11-25,484,5525,1802,0,7811
774,2019-11-26,110,7260,1788,2,9160
775,2019-08-24,80,897,2161,0,3138
775,2019-08-25,1318,3437,1269,0,6024
775,2019-08-26,216,1037,1440,0,2693
775,2019-08-27,92,6566,1580,3,8241
775,2019-08-28,978,1464,1710,0,4152
775,2019-08-29,213,10140,1800,1,12154
775,2019-08-30,125,4937,302,1,5365
775,2019-08-31,93,8132,1,0,8226
775,2019-09-01,54,2637,453,0,3144
775,2019-09-02,47,879,38,0,964
775,2019-09-03,112,412,946,1,1471
775,2019-09-04,979,13130,2439,1,16549
775,2019-09-05,206,6470,2159,0,8835
775,2019-09-06,131,12402,2077,0,14610
775,2019-09-07,123,9837,1863,0,11823
775,2019-09-08,1120,7388,1550,0,10058
775,2019-09-09,969,8234,1411,0,10614
775,2019-09-10,151,7495,1889,0,9535
775,2019-09-11,149,5963,1708,2,7822
775,2019-09-12,148,8238,1710,1,10097
775,2019-09-13,262,7163,1765,0,9190
775,2019-09-14,949,9024,2149,2,12124
775,2019-09-15,140,6622,1832,0,8594
775,2019-09-16,125,5427,2236,1,7789
775,2019-09-17,203,12424,2759,2,15388
775,2019-09-18,793,11710,1591,0,14094
775,2019-09-19,330,4115,2183,2,6630
775,2019-09-20,969,7730,1295,1,9995
775,2019-09-21,975,9105,1886,0,11966
775,2019-09-22,85,8557,1599,0,10241
775,2019-09-23,251,8825,2077,1,11154
775,2019-09-24,149,9070,1084,4,10307
775,2019-09-25,161,8775,1985,3,10924
775,2019-09-26,189,18411,2175,1,20776
775,2019-09-27,115,8820,1540,3,10478
775,2019-09-28,108,15518,1733,2,17361
775,2019-09-29,86,17776,928,4,18794
775,2019-09-30,1313,25852,1083,0,28248
775,2019-10-01,109,23262,1669,3,25043
775,2019-10-02,147,18007,2229,0,20383
775,2019-10-03,1824,14974,1481,1,18280
775,2019-10-04,96,12588,1445,3,14132
775,2019-10-05,110,14660,1631,1,16402
775,2019-10-06,139,12076,2424,0,14639
775,2019-10-07,958,9065,1368,0,11391
775,2019-10-08,133,14318,1447,1,15899
775,2019-10-09,874,23993,1714,1,26582
775,2019-10-10,1044,12901,1725,4,15674
775,2019-10-11,1236,10879,1766,1,13882
775,2019-10-12,1216,7312,1954,2,10484
775,2019-10-13,260,12408,3009,1,15678
775,2019-10-14,175,6375,1571,3,8124
775,2019-10-15,143,10021,1294,1,11459
775,2019-10-16,99,17981,1975,3,20058
775,2019-10-17,92,8628,2189,0,10909
775,2019-10-18,938,8119,1298,0,10355
775,2019-10-19,144,5743,2121,1,8009
775,2019-10-20,150,3356,2196,0,5702
775,2019-10-21,178,11318,1584,0,13080
775,2019-10-22,1868,6864,502,1,9235
775,2019-10-23,235,14665,1453,0,16353
775,2019-10-24,355,19176,1528,3,21062
775,2019-10-25,614,15471,1383,2,17470
775,2019-10-26,157,24724,1765,0,26646
775,2019-10-27,131,31111,1488,0,32730
775,2019-10-28,545,24485,1793,2,26825
775,2019-10-29,1621,17360,2112,3,21096
775,2019-10-30,373,24124,1736,0,26233
775,2019-10-31,73,15253,1642,1,16969
775,2019-11-01,707,14859,1740,0,17306
775,2019-11-02,562,14412,1729,0,16703
775,2019-11-03,146,36134,1443,3,37726
775,2019-11-04,114,11249,1649,1,13013
775,2019-11-05,544,7717,1036,0,9297
775,2019-11-06,193,14702,1556,1,16452
775,2019-11-07,310,16712,1488,1,18511
775,2019-11-08,757,9706,1956,1,12420
775,2019-11-09,143,8669,2497,1,11310
775,2019-11-10,1070,24254,1975,0,27299
775,2019-11-11,1091,16143,2204,1,19439
775,2019-11-12,447,17630,3115,2,21194
775,2019-11-13,279,22031,1635,2,23947
775,2019-11-14,265,14946,2015,0,17226
775,2019-11-15,1737,4886,1846,1,8470
775,2019-11-16,198,4587,2096,0,6881
775,2019-11-17,252,3714,3340,0,7306
775,2019-11-18,234,2598,3156,0,5988
775,2019-11-19,808,3113,2203,0,6124
775,2019-11-20,1559,1753,2070,0,5382
775,2019-11-21,189,3636,2062,0,5887
775,2019-11-22,185,4662,1706,0,6553
775,2019-11-23,1097,12024,2286,0,15407
775,2019-11-24,170,9140,1359,0,10669
775,2019-11-25,187,11602,1726,0,13515
775,2019-11-26,1027,9055,1643,0,11725
775,2019-11-27,326,11136,1581,0,13043
775,2019-11-28,142,8672,621,1,9436
775,2019-11-29,57,459,1,0,517
775,2019-08-24,80,897,2161,0,3138
775,2019-08-25,1318,3437,1269,0,6024
775,2019-08-26,216,1037,1440,0,2693
775,2019-08-27,92,6566,1580,3,8241
775,2019-08-28,978,1464,1710,0,4152
775,2019-08-29,213,10140,1800,1,12154
775,2019-08-30,125,4937,302,1,5365
775,2019-08-31,93,8132,1,0,8226
775,2019-09-01,54,2637,453,0,3144
775,2019-09-02,47,879,38,0,964
775,2019-09-03,112,412,946,1,1471
775,2019-09-04,979,13130,2439,1,16549
775,2019-09-05,206,6470,2159,0,8835
775,2019-09-06,131,12402,2077,0,14610
775,2019-09-07,123,9837,1863,0,11823
775,2019-09-08,1120,7388,1550,0,10058
775,2019-09-09,969,8234,1411,0,10614
775,2019-09-10,151,7495,1889,0,9535
775,2019-09-11,149,5963,1708,2,7822
775,2019-09-12,148,8238,1710,1,10097
775,2019-09-13,262,7163,1765,0,9190
775,2019-09-14,949,9024,2149,2,12124
775,2019-09-15,140,6622,1832,0,8594
775,2019-09-16,125,5427,2236,1,7789
775,2019-09-17,203,12424,2759,2,15388
775,2019-09-18,793,11710,1591,0,14094
775,2019-09-19,330,4115,2183,2,6630
775,2019-09-20,969,7730,1295,1,9995
775,2019-09-21,975,9105,1886,0,11966
775,2019-09-22,85,8557,1599,0,10241
775,2019-09-23,251,8825,2077,1,11154
775,2019-09-24,149,9070,1084,4,10307
775,2019-09-25,161,8775,1985,3,10924
775,2019-09-26,189,18411,2175,1,20776
775,2019-09-27,115,8820,1540,3,10478
775,2019-09-28,108,15518,1733,2,17361
775,2019-09-29,86,17776,928,4,18794
775,2019-09-30,1313,25852,1083,0,28248
775,2019-10-01,109,23262,1669,3,25043
775,2019-10-02,147,18007,2229,0,20383
775,2019-10-03,1824,14974,1481,1,18280
775,2019-10-04,96,12588,1445,3,14132
775,2019-10-05,110,14660,1631,1,16402
775,2019-10-06,139,12076,2424,0,14639
775,2019-10-07,958,9065,1368,0,11391
775,2019-10-08,133,14318,1447,1,15899
775,2019-10-09,874,23993,1714,1,26582
775,2019-10-10,1044,12901,1725,4,15674
775,2019-10-11,1236,10879,1766,1,13882
775,2019-10-12,1216,7312,1954,2,10484
775,2019-10-13,260,12408,3009,1,15678
775,2019-10-14,175,6375,1571,3,8124
775,2019-10-15,143,10021,1294,1,11459
775,2019-10-16,99,17981,1975,3,20058
775,2019-10-17,92,8628,2189,0,10909
775,2019-10-18,938,8119,1298,0,10355
775,2019-10-19,144,5743,2121,1,8009
775,2019-10-20,150,3356,2196,0,5702
775,2019-10-21,178,11318,1584,0,13080
775,2019-10-22,1868,6864,502,1,9235
775,2019-10-23,235,14665,1453,0,16353
775,2019-10-24,355,19176,1528,3,21062
775,2019-10-25,614,15471,1383,2,17470
775,2019-10-26,157,24724,1765,0,26646
775,2019-10-27,131,31111,1488,0,32730
775,2019-10-28,545,24485,1793,2,26825
775,2019-10-29,1621,17360,2112,3,21096
775,2019-10-30,373,24124,1736,0,26233
775,2019-10-31,73,15253,1642,1,16969
775,2019-11-01,707,14859,1740,0,17306
775,2019-11-02,562,14412,1729,0,16703
775,2019-11-03,146,36134,1443,3,37726
775,2019-11-04,114,11249,1649,1,13013
775,2019-11-05,544,7717,1036,0,9297
775,2019-11-06,193,14702,1556,1,16452
775,2019-11-07,310,16712,1488,1,18511
775,2019-11-08,757,9706,1956,1,12420
775,2019-11-09,143,8669,2497,1,11310
775,2019-11-10,1070,24254,1975,0,27299
775,2019-11-11,1091,16143,2204,1,19439
775,2019-11-12,447,17630,3115,2,21194
775,2019-11-13,279,22031,1635,2,23947
775,2019-11-14,265,14946,2015,0,17226
775,2019-11-15,1737,4886,1846,1,8470
775,2019-11-16,198,4587,2096,0,6881
775,2019-11-17,252,3714,3340,0,7306
775,2019-11-18,234,2598,3156,0,5988
775,2019-11-19,808,3113,2203,0,6124
775,2019-11-20,1559,1753,2070,0,5382
775,2019-11-21,189,3636,2062,0,5887
775,2019-11-22,185,4662,1706,0,6553
775,2019-11-23,1097,12024,2286,0,15407
775,2019-11-24,170,9140,1359,0,10669
775,2019-11-25,187,11602,1726,0,13515
775,2019-11-26,1027,9055,1643,0,11725
775,2019-11-27,326,11136,1581,0,13043
775,2019-11-28,142,8672,621,1,9436
775,2019-11-29,57,459,1,0,517
775,2019-08-24,80,897,2161,0,3138
775,2019-08-25,1318,3437,1269,0,6024
775,2019-08-26,216,1037,1440,0,2693
775,2019-08-27,92,6566,1580,3,8241
775,2019-08-28,978,1464,1710,0,4152
775,2019-08-29,213,10140,1800,1,12154
775,2019-08-30,125,4937,302,1,5365
775,2019-08-31,93,8132,1,0,8226
775,2019-09-01,54,2637,453,0,3144
775,2019-09-02,47,879,38,0,964
775,2019-09-03,112,412,946,1,1471
775,2019-09-04,979,13130,2439,1,16549
775,2019-09-05,206,6470,2159,0,8835
775,2019-09-06,131,12402,2077,0,14610
775,2019-09-07,123,9837,1863,0,11823
775,2019-09-08,1120,7388,1550,0,10058
775,2019-09-09,969,8234,1411,0,10614
775,2019-09-10,151,7495,1889,0,9535
775,2019-09-11,149,5963,1708,2,7822
775,2019-09-12,148,8238,1710,1,10097
775,2019-09-13,262,7163,1765,0,9190
775,2019-09-14,949,9024,2149,2,12124
775,2019-09-15,140,6622,1832,0,8594
775,2019-09-16,125,5427,2236,1,7789
775,2019-09-17,203,12424,2759,2,15388
775,2019-09-18,793,11710,1591,0,14094
775,2019-09-19,330,4115,2183,2,6630
775,2019-09-20,969,7730,1295,1,9995
775,2019-09-21,975,9105,1886,0,11966
775,2019-09-22,85,8557,1599,0,10241
775,2019-09-23,251,8825,2077,1,11154
775,2019-09-24,149,9070,1084,4,10307
775,2019-09-25,161,8775,1985,3,10924
775,2019-09-26,189,18411,2175,1,20776
775,2019-09-27,115,8820,1540,3,10478
775,2019-09-28,108,15518,1733,2,17361
775,2019-09-29,86,17776,928,4,18794
775,2019-09-30,1313,25852,1083,0,28248
775,2019-10-01,109,23262,1669,3,25043
775,2019-10-02,147,18007,2229,0,20383
775,2019-10-03,1824,14974,1481,1,18280
775,2019-10-04,96,12588,1445,3,14132
775,2019-10-05,110,14660,1631,1,16402
775,2019-10-06,139,12076,2424,0,14639
775,2019-10-07,958,9065,1368,0,11391
775,2019-10-08,133,14318,1447,1,15899
775,2019-10-09,874,23993,1714,1,26582
775,2019-10-10,1044,12901,1725,4,15674
775,2019-10-11,1236,10879,1766,1,13882
775,2019-10-12,1216,7312,1954,2,10484
775,2019-10-13,260,12408,3009,1,15678
775,2019-10-14,175,6375,1571,3,8124
775,2019-10-15,143,10021,1294,1,11459
775,2019-10-16,99,17981,1975,3,20058
775,2019-10-17,92,8628,2189,0,10909
775,2019-10-18,938,8119,1298,0,10355
775,2019-10-19,144,5743,2121,1,8009
775,2019-10-20,150,3356,2196,0,5702
775,2019-10-21,178,11318,1584,0,13080
775,2019-10-22,1868,6864,502,1,9235
775,2019-10-23,235,14665,1453,0,16353
775,2019-10-24,355,19176,1528,3,21062
775,2019-10-25,614,15471,1383,2,17470
775,2019-10-26,157,24724,1765,0,26646
775,2019-10-27,131,31111,1488,0,32730
775,2019-10-28,545,24485,1793,2,26825
775,2019-10-29,1621,17360,2112,3,21096
775,2019-10-30,373,24124,1736,0,26233
775,2019-10-31,73,15253,1642,1,16969
775,2019-11-01,707,14859,1740,0,17306
775,2019-11-02,562,14412,1729,0,16703
775,2019-11-03,146,36134,1443,3,37726
775,2019-11-04,114,11249,1649,1,13013
775,2019-11-05,544,7717,1036,0,9297
775,2019-11-06,193,14702,1556,1,16452
775,2019-11-07,310,16712,1488,1,18511
775,2019-11-08,757,9706,1956,1,12420
775,2019-11-09,143,8669,2497,1,11310
775,2019-11-10,1070,24254,1975,0,27299
775,2019-11-11,1091,16143,2204,1,19439
775,2019-11-12,447,17630,3115,2,21194
775,2019-11-13,279,22031,1635,2,23947
775,2019-11-14,265,14946,2015,0,17226
775,2019-11-15,1737,4886,1846,1,8470
775,2019-11-16,198,4587,2096,0,6881
775,2019-11-17,252,3714,3340,0,7306
775,2019-11-18,234,2598,3156,0,5988
775,2019-11-19,808,3113,2203,0,6124
775,2019-11-20,1559,1753,2070,0,5382
775,2019-11-21,189,3636,2062,0,5887
775,2019-11-22,185,4662,1706,0,6553
775,2019-11-23,1097,12024,2286,0,15407
775,2019-11-24,170,9140,1359,0,10669
775,2019-11-25,187,11602,1726,0,13515
775,2019-11-26,1027,9055,1643,0,11725
775,2019-11-27,326,11136,1581,0,13043
775,2019-11-28,142,8672,621,1,9436
775,2019-11-29,57,459,1,0,517
775,2019-08-27,92,6566,1580,3,8241
775,2019-08-28,978,1464,1710,0,4152
775,2019-08-29,213,10140,1800,1,12154
775,2019-08-30,125,4937,302,1,5365
775,2019-08-31,93,8132,1,0,8226
775,2019-09-01,54,2637,453,0,3144
775,2019-09-02,47,879,38,0,964
775,2019-09-03,112,412,946,1,1471
775,2019-09-04,979,13130,2439,1,16549
775,2019-09-05,206,6470,2159,0,8835
775,2019-09-06,131,12402,2077,0,14610
775,2019-09-07,123,9837,1863,0,11823
775,2019-09-08,1120,7388,1550,0,10058
775,2019-09-09,969,8234,1411,0,10614
775,2019-09-10,151,7495,1889,0,9535
775,2019-09-11,149,5963,1708,2,7822
775,2019-09-12,148,8238,1710,1,10097
775,2019-09-13,262,7163,1765,0,9190
775,2019-09-14,949,9024,2149,2,12124
775,2019-09-15,140,6622,1832,0,8594
775,2019-09-16,125,5427,2236,1,7789
775,2019-09-17,203,12424,2759,2,15388
775,2019-09-18,793,11710,1591,0,14094
775,2019-09-19,330,4115,2183,2,6630
775,2019-09-20,969,7730,1295,1,9995
775,2019-09-21,975,9105,1886,0,11966
775,2019-09-22,85,8557,1599,0,10241
775,2019-09-23,251,8825,2077,1,11154
775,2019-09-24,149,9070,1084,4,10307
775,2019-09-25,161,8775,1985,3,10924
775,2019-09-26,189,18411,2175,1,20776
775,2019-09-27,115,8820,1540,3,10478
775,2019-09-28,108,15518,1733,2,17361
775,2019-09-29,86,17776,928,4,18794
775,2019-09-30,1313,25852,1083,0,28248
775,2019-10-01,109,23262,1669,3,25043
775,2019-10-02,147,18007,2229,0,20383
775,2019-10-03,1824,14974,1481,1,18280
775,2019-10-04,96,12588,1445,3,14132
775,2019-10-05,110,14660,1631,1,16402
775,2019-10-06,139,12076,2424,0,14639
775,2019-10-07,958,9065,1368,0,11391
775,2019-10-08,133,14318,1447,1,15899
775,2019-10-09,874,23993,1714,1,26582
775,2019-10-10,1044,12901,1725,4,15674
775,2019-10-11,1236,10879,1766,1,13882
775,2019-10-12,1216,7312,1954,2,10484
775,2019-10-13,260,12408,3009,1,15678
775,2019-10-14,175,6375,1571,3,8124
775,2019-10-15,143,10021,1294,1,11459
775,2019-10-16,99,17981,1975,3,20058
775,2019-10-17,92,8628,2189,0,10909
775,2019-10-18,938,8119,1298,0,10355
775,2019-10-19,144,5743,2121,1,8009
775,2019-10-20,150,3356,2196,0,5702
775,2019-10-21,178,11318,1584,0,13080
775,2019-10-22,1868,6864,502,1,9235
775,2019-10-23,235,14665,1453,0,16353
775,2019-10-24,355,19176,1528,3,21062
775,2019-10-25,614,15471,1383,2,17470
775,2019-10-26,157,24724,1765,0,26646
775,2019-10-27,131,31111,1488,0,32730
775,2019-10-28,545,24485,1793,2,26825
775,2019-10-29,1621,17360,2112,3,21096
775,2019-10-30,373,24124,1736,0,26233
775,2019-10-31,73,15253,1642,1,16969
775,2019-11-01,707,14859,1740,0,17306
775,2019-11-02,562,14412,1729,0,16703
775,2019-11-03,146,36134,1443,3,37726
775,2019-11-04,114,11249,1649,1,13013
775,2019-11-05,544,7717,1036,0,9297
775,2019-11-06,193,14702,1556,1,16452
775,2019-11-07,310,16712,1488,1,18511
775,2019-11-08,757,9706,1956,1,12420
775,2019-11-09,143,8669,2497,1,11310
775,2019-11-10,1070,24254,1975,0,27299
775,2019-11-11,1091,16143,2204,1,19439
775,2019-11-12,447,17630,3115,2,21194
775,2019-11-13,279,22031,1635,2,23947
775,2019-11-14,265,14946,2015,0,17226
775,2019-11-15,1737,4886,1846,1,8470
775,2019-11-16,198,4587,2096,0,6881
775,2019-11-17,252,3714,3340,0,7306
775,2019-11-18,234,2598,3156,0,5988
775,2019-11-19,808,3113,2203,0,6124
775,2019-11-20,1559,1753,2070,0,5382
775,2019-11-21,189,3636,2062,0,5887
775,2019-11-22,185,4662,1706,0,6553
775,2019-11-23,1097,12024,2286,0,15407
775,2019-11-24,170,9140,1359,0,10669
775,2019-11-25,187,11602,1726,0,13515
775,2019-11-26,1027,9055,1643,0,11725
775,2019-11-27,326,11136,1581,0,13043
775,2019-11-28,142,8672,621,1,9436
776,2019-08-24,84,2835,1530,1,4450
776,2019-08-25,196,13304,1170,0,14670
776,2019-08-26,242,12974,810,0,14026
776,2019-08-27,183,8010,1530,1,9724
776,2019-08-28,180,3032,1147,1,4360
776,2019-08-29,741,9984,1263,0,11988
776,2019-08-30,84,3735,379,1,4199
776,2019-08-31,45,132,34,0,211
776,2019-09-01,118,360,500,0,978
776,2019-09-02,142,238,29,0,409
776,2019-09-03,151,432,1443,1,2027
776,2019-09-04,250,6240,1918,0,8408
776,2019-09-05,202,6325,2610,1,9138
776,2019-09-06,188,14238,1745,0,16171
776,2019-09-07,279,12067,1422,1,13769
776,2019-09-08,288,7168,2133,1,9590
776,2019-09-09,184,6901,2547,2,9634
776,2019-09-10,988,9775,2193,0,12956
776,2019-09-11,97,5925,2466,1,8489
776,2019-09-12,1066,16678,1777,1,19522
776,2019-09-13,155,6009,2071,1,8236
776,2019-09-14,81,8283,2686,0,11050
776,2019-09-15,1805,8708,1719,1,12233
776,2019-09-16,131,5438,2235,0,7804
776,2019-09-17,160,9176,1980,2,11318
776,2019-09-18,848,11581,1070,0,13499
776,2019-09-19,270,3563,2180,0,6013
776,2019-09-20,240,15032,1288,1,16561
776,2019-09-21,113,16180,2236,1,18530
776,2019-09-22,164,11014,1231,1,12410
776,2019-09-23,274,13077,2006,1,15358
776,2019-09-24,189,16294,1723,1,18207
776,2019-09-25,457,6855,1509,2,8823
776,2019-09-26,162,10474,1703,4,12343
776,2019-09-27,128,8116,1527,1,9772
776,2019-09-28,126,14560,1284,1,15971
776,2019-09-29,967,15627,1381,3,17978
776,2019-09-30,122,18224,1862,0,20208
776,2019-10-01,153,15821,1351,1,17326
776,2019-10-02,1031,10578,1881,0,13490
776,2019-10-03,1387,13116,1461,3,15967
776,2019-10-04,107,11041,1841,1,12990
776,2019-10-05,1050,13416,1060,0,15526
776,2019-10-06,510,10396,1281,3,12190
776,2019-10-07,984,5204,2782,1,8971
776,2019-10-08,1040,10352,1420,0,12812
776,2019-10-09,436,14723,1859,1,17019
776,2019-10-10,230,8493,1771,1,10495
776,2019-10-11,144,9325,2113,4,11586
776,2019-10-12,102,6000,1895,1,7998
776,2019-10-13,1128,7620,2130,1,10879
776,2019-10-14,121,4044,1919,0,6084
776,2019-10-15,1004,6756,2198,0,9958
776,2019-10-16,762,17075,1411,2,19250
776,2019-10-17,1042,7056,3018,1,11117
776,2019-10-18,1948,7034,1120,1,10103
776,2019-10-19,214,3788,1610,1,5613
776,2019-10-20,1086,913,1743,0,3742
776,2019-10-21,1104,9922,2640,3,13669
776,2019-10-22,198,4633,1843,1,6675
776,2019-10-23,148,6861,1988,1,8998
776,2019-10-24,173,19503,1133,1,20810
776,2019-10-25,186,18134,1492,1,19813
776,2019-10-26,339,24841,1841,2,27023
776,2019-10-27,150,18429,1746,0,20325
776,2019-10-28,163,22147,1717,0,24027
776,2019-10-29,693,16965,1454,1,19113
776,2019-10-30,139,14767,1150,1,16057
776,2019-10-31,123,11383,1839,2,13347
776,2019-11-01,419,24136,1224,0,25779
776,2019-11-02,138,15312,2200,0,17650
776,2019-11-03,278,21354,1335,1,22968
776,2019-11-04,150,8966,1496,0,10612
776,2019-11-05,211,1452,2162,1,3826
776,2019-11-06,183,7090,862,1,8136
776,2019-11-07,215,13098,721,1,14035
776,2019-11-08,192,8818,1328,1,10339
776,2019-11-09,110,7575,2134,0,9819
776,2019-11-10,405,11797,1043,1,13246
776,2019-11-11,573,12148,1460,1,14182
776,2019-11-12,241,11034,2624,0,13899
776,2019-11-13,338,10868,1915,3,13124
776,2019-11-14,151,7771,1803,2,9727
776,2019-11-15,252,3744,2799,2,6797
776,2019-11-16,193,2851,3282,1,6327
776,2019-11-17,549,3011,2638,0,6198
776,2019-11-18,148,3514,3333,0,6995
776,2019-11-19,424,5219,3080,2,8725
776,2019-11-20,1123,1344,1989,1,4457
776,2019-11-21,1051,4826,1954,1,7832
776,2019-11-22,391,7759,1384,2,9536
776,2019-11-23,236,6803,2730,0,9769
776,2019-11-24,567,5604,1512,1,7684
776,2019-11-25,519,6957,1832,1,9309
776,2019-11-26,1520,5969,1474,1,8964
776,2019-11-27,203,6557,1185,0,7945
776,2019-11-28,133,7569,1390,18,9110
776,2019-11-29,57,554,2,0,613
776,2019-08-24,84,2835,1530,1,4450
776,2019-08-25,196,13304,1170,0,14670
776,2019-08-26,242,12974,810,0,14026
776,2019-08-27,183,8010,1530,1,9724
776,2019-08-28,180,3032,1147,1,4360
776,2019-08-29,741,9984,1263,0,11988
776,2019-08-30,84,3735,379,1,4199
776,2019-08-31,45,132,34,0,211
776,2019-09-01,118,360,500,0,978
776,2019-09-02,142,238,29,0,409
776,2019-09-03,151,432,1443,1,2027
776,2019-09-04,250,6240,1918,0,8408
776,2019-09-05,202,6325,2610,1,9138
776,2019-09-06,188,14238,1745,0,16171
776,2019-09-07,279,12067,1422,1,13769
776,2019-09-08,288,7168,2133,1,9590
776,2019-09-09,184,6901,2547,2,9634
776,2019-09-10,988,9775,2193,0,12956
776,2019-09-11,97,5925,2466,1,8489
776,2019-09-12,1066,16678,1777,1,19522
776,2019-09-13,155,6009,2071,1,8236
776,2019-09-14,81,8283,2686,0,11050
776,2019-09-15,1805,8708,1719,1,12233
776,2019-09-16,131,5438,2235,0,7804
776,2019-09-17,160,9176,1980,2,11318
776,2019-09-18,848,11581,1070,0,13499
776,2019-09-19,270,3563,2180,0,6013
776,2019-09-20,240,15032,1288,1,16561
776,2019-09-21,113,16180,2236,1,18530
776,2019-09-22,164,11014,1231,1,12410
776,2019-09-23,274,13077,2006,1,15358
776,2019-09-24,189,16294,1723,1,18207
776,2019-09-25,457,6855,1509,2,8823
776,2019-09-26,162,10474,1703,4,12343
776,2019-09-27,128,8116,1527,1,9772
776,2019-09-28,126,14560,1284,1,15971
776,2019-09-29,967,15627,1381,3,17978
776,2019-09-30,122,18224,1862,0,20208
776,2019-10-01,153,15821,1351,1,17326
776,2019-10-02,1031,10578,1881,0,13490
776,2019-10-03,1387,13116,1461,3,15967
776,2019-10-04,107,11041,1841,1,12990
776,2019-10-05,1050,13416,1060,0,15526
776,2019-10-06,510,10396,1281,3,12190
776,2019-10-07,984,5204,2782,1,8971
776,2019-10-08,1040,10352,1420,0,12812
776,2019-10-09,436,14723,1859,1,17019
776,2019-10-10,230,8493,1771,1,10495
776,2019-10-11,144,9325,2113,4,11586
776,2019-10-12,102,6000,1895,1,7998
776,2019-10-13,1128,7620,2130,1,10879
776,2019-10-14,121,4044,1919,0,6084
776,2019-10-15,1004,6756,2198,0,9958
776,2019-10-16,762,17075,1411,2,19250
776,2019-10-17,1042,7056,3018,1,11117
776,2019-10-18,1948,7034,1120,1,10103
776,2019-10-19,214,3788,1610,1,5613
776,2019-10-20,1086,913,1743,0,3742
776,2019-10-21,1104,9922,2640,3,13669
776,2019-10-22,198,4633,1843,1,6675
776,2019-10-23,148,6861,1988,1,8998
776,2019-10-24,173,19503,1133,1,20810
776,2019-10-25,186,18134,1492,1,19813
776,2019-10-26,339,24841,1841,2,27023
776,2019-10-27,150,18429,1746,0,20325
776,2019-10-28,163,22147,1717,0,24027
776,2019-10-29,693,16965,1454,1,19113
776,2019-10-30,139,14767,1150,1,16057
776,2019-10-31,123,11383,1839,2,13347
776,2019-11-01,419,24136,1224,0,25779
776,2019-11-02,138,15312,2200,0,17650
776,2019-11-03,278,21354,1335,1,22968
776,2019-11-04,150,8966,1496,0,10612
776,2019-11-05,211,1452,2162,1,3826
776,2019-11-06,183,7090,862,1,8136
776,2019-11-07,215,13098,721,1,14035
776,2019-11-08,192,8818,1328,1,10339
776,2019-11-09,110,7575,2134,0,9819
776,2019-11-10,405,11797,1043,1,13246
776,2019-11-11,573,12148,1460,1,14182
776,2019-11-12,241,11034,2624,0,13899
776,2019-11-13,338,10868,1915,3,13124
776,2019-11-14,151,7771,1803,2,9727
776,2019-11-15,252,3744,2799,2,6797
776,2019-11-16,193,2851,3282,1,6327
776,2019-11-17,549,3011,2638,0,6198
776,2019-11-18,148,3514,3333,0,6995
776,2019-11-19,424,5219,3080,2,8725
776,2019-11-20,1123,1344,1989,1,4457
776,2019-11-21,1051,4826,1954,1,7832
776,2019-11-22,391,7759,1384,2,9536
776,2019-11-23,236,6803,2730,0,9769
776,2019-11-24,567,5604,1512,1,7684
776,2019-11-25,519,6957,1832,1,9309
776,2019-11-26,1520,5969,1474,1,8964
776,2019-11-27,203,6557,1185,0,7945
776,2019-11-28,133,7569,1390,18,9110
776,2019-11-29,57,554,2,0,613
776,2019-08-24,84,2835,1530,1,4450
776,2019-08-25,196,13304,1170,0,14670
776,2019-08-26,242,12974,810,0,14026
776,2019-08-27,183,8010,1530,1,9724
776,2019-08-28,180,3032,1147,1,4360
776,2019-08-29,741,9984,1263,0,11988
776,2019-08-30,84,3735,379,1,4199
776,2019-08-31,45,132,34,0,211
776,2019-09-01,118,360,500,0,978
776,2019-09-02,142,238,29,0,409
776,2019-09-03,151,432,1443,1,2027
776,2019-09-04,250,6240,1918,0,8408
776,2019-09-05,202,6325,2610,1,9138
776,2019-09-06,188,14238,1745,0,16171
776,2019-09-07,279,12067,1422,1,13769
776,2019-09-08,288,7168,2133,1,9590
776,2019-09-09,184,6901,2547,2,9634
776,2019-09-10,988,9775,2193,0,12956
776,2019-09-11,97,5925,2466,1,8489
776,2019-09-12,1066,16678,1777,1,19522
776,2019-09-13,155,6009,2071,1,8236
776,2019-09-14,81,8283,2686,0,11050
776,2019-09-15,1805,8708,1719,1,12233
776,2019-09-16,131,5438,2235,0,7804
776,2019-09-17,160,9176,1980,2,11318
776,2019-09-18,848,11581,1070,0,13499
776,2019-09-19,270,3563,2180,0,6013
776,2019-09-20,240,15032,1288,1,16561
776,2019-09-21,113,16180,2236,1,18530
776,2019-09-22,164,11014,1231,1,12410
776,2019-09-23,274,13077,2006,1,15358
776,2019-09-24,189,16294,1723,1,18207
776,2019-09-25,457,6855,1509,2,8823
776,2019-09-26,162,10474,1703,4,12343
776,2019-09-27,128,8116,1527,1,9772
776,2019-09-28,126,14560,1284,1,15971
776,2019-09-29,967,15627,1381,3,17978
776,2019-09-30,122,18224,1862,0,20208
776,2019-10-01,153,15821,1351,1,17326
776,2019-10-02,1031,10578,1881,0,13490
776,2019-10-03,1387,13116,1461,3,15967
776,2019-10-04,107,11041,1841,1,12990
776,2019-10-05,1050,13416,1060,0,15526
776,2019-10-06,510,10396,1281,3,12190
776,2019-10-07,984,5204,2782,1,8971
776,2019-10-08,1040,10352,1420,0,12812
776,2019-10-09,436,14723,1859,1,17019
776,2019-10-10,230,8493,1771,1,10495
776,2019-10-11,144,9325,2113,4,11586
776,2019-10-12,102,6000,1895,1,7998
776,2019-10-13,1128,7620,2130,1,10879
776,2019-10-14,121,4044,1919,0,6084
776,2019-10-15,1004,6756,2198,0,9958
776,2019-10-16,762,17075,1411,2,19250
776,2019-10-17,1042,7056,3018,1,11117
776,2019-10-18,1948,7034,1120,1,10103
776,2019-10-19,214,3788,1610,1,5613
776,2019-10-20,1086,913,1743,0,3742
776,2019-10-21,1104,9922,2640,3,13669
776,2019-10-22,198,4633,1843,1,6675
776,2019-10-23,148,6861,1988,1,8998
776,2019-10-24,173,19503,1133,1,20810
776,2019-10-25,186,18134,1492,1,19813
776,2019-10-26,339,24841,1841,2,27023
776,2019-10-27,150,18429,1746,0,20325
776,2019-10-28,163,22147,1717,0,24027
776,2019-10-29,693,16965,1454,1,19113
776,2019-10-30,139,14767,1150,1,16057
776,2019-10-31,123,11383,1839,2,13347
776,2019-11-01,419,24136,1224,0,25779
776,2019-11-02,138,15312,2200,0,17650
776,2019-11-03,278,21354,1335,1,22968
776,2019-11-04,150,8966,1496,0,10612
776,2019-11-05,211,1452,2162,1,3826
776,2019-11-06,183,7090,862,1,8136
776,2019-11-07,215,13098,721,1,14035
776,2019-11-08,192,8818,1328,1,10339
776,2019-11-09,110,7575,2134,0,9819
776,2019-11-10,405,11797,1043,1,13246
776,2019-11-11,573,12148,1460,1,14182
776,2019-11-12,241,11034,2624,0,13899
776,2019-11-13,338,10868,1915,3,13124
776,2019-11-14,151,7771,1803,2,9727
776,2019-11-15,252,3744,2799,2,6797
776,2019-11-16,193,2851,3282,1,6327
776,2019-11-17,549,3011,2638,0,6198
776,2019-11-18,148,3514,3333,0,6995
776,2019-11-19,424,5219,3080,2,8725
776,2019-11-20,1123,1344,1989,1,4457
776,2019-11-21,1051,4826,1954,1,7832
776,2019-11-22,391,7759,1384,2,9536
776,2019-11-23,236,6803,2730,0,9769
776,2019-11-24,567,5604,1512,1,7684
776,2019-11-25,519,6957,1832,1,9309
776,2019-11-26,1520,5969,1474,1,8964
776,2019-11-27,203,6557,1185,0,7945
776,2019-11-28,133,7569,1390,18,9110
776,2019-11-29,57,554,2,0,613
776,2019-08-24,84,2835,1530,1,4450
776,2019-08-25,196,13304,1170,0,14670
776,2019-08-26,242,12974,810,0,14026
776,2019-08-27,183,8010,1530,1,9724
776,2019-08-28,180,3032,1147,1,4360
776,2019-08-29,741,9984,1263,0,11988
776,2019-08-30,84,3735,379,1,4199
776,2019-08-31,45,132,34,0,211
776,2019-09-01,118,360,500,0,978
776,2019-09-02,142,238,29,0,409
776,2019-09-03,151,432,1443,1,2027
776,2019-09-04,250,6240,1918,0,8408
776,2019-09-05,202,6325,2610,1,9138
776,2019-09-06,188,14238,1745,0,16171
776,2019-09-07,279,12067,1422,1,13769
776,2019-09-08,288,7168,2133,1,9590
776,2019-09-09,184,6901,2547,2,9634
776,2019-09-10,988,9775,2193,0,12956
776,2019-09-11,97,5925,2466,1,8489
776,2019-09-12,1066,16678,1777,1,19522
776,2019-09-13,155,6009,2071,1,8236
776,2019-09-14,81,8283,2686,0,11050
776,2019-09-15,1805,8708,1719,1,12233
776,2019-09-16,131,5438,2235,0,7804
776,2019-09-17,160,9176,1980,2,11318
776,2019-09-18,848,11581,1070,0,13499
776,2019-09-19,270,3563,2180,0,6013
776,2019-09-20,240,15032,1288,1,16561
776,2019-09-21,113,16180,2236,1,18530
776,2019-09-22,164,11014,1231,1,12410
776,2019-09-23,274,13077,2006,1,15358
776,2019-09-24,189,16294,1723,1,18207
776,2019-09-25,457,6855,1509,2,8823
776,2019-09-26,162,10474,1703,4,12343
776,2019-09-27,128,8116,1527,1,9772
776,2019-09-28,126,14560,1284,1,15971
776,2019-09-29,967,15627,1381,3,17978
776,2019-09-30,122,18224,1862,0,20208
776,2019-10-01,153,15821,1351,1,17326
776,2019-10-02,1031,10578,1881,0,13490
776,2019-10-03,1387,13116,1461,3,15967
776,2019-10-04,107,11041,1841,1,12990
776,2019-10-05,1050,13416,1060,0,15526
776,2019-10-06,510,10396,1281,3,12190
776,2019-10-07,984,5204,2782,1,8971
776,2019-10-08,1040,10352,1420,0,12812
776,2019-10-09,436,14723,1859,1,17019
776,2019-10-10,230,8493,1771,1,10495
776,2019-10-11,144,9325,2113,4,11586
776,2019-10-12,102,6000,1895,1,7998
776,2019-10-13,1128,7620,2130,1,10879
776,2019-10-14,121,4044,1919,0,6084
776,2019-10-15,1004,6756,2198,0,9958
776,2019-10-16,762,17075,1411,2,19250
776,2019-10-17,1042,7056,3018,1,11117
776,2019-10-18,1948,7034,1120,1,10103
776,2019-10-19,214,3788,1610,1,5613
776,2019-10-20,1086,913,1743,0,3742
776,2019-10-21,1104,9922,2640,3,13669
776,2019-10-22,198,4633,1843,1,6675
776,2019-10-23,148,6861,1988,1,8998
776,2019-10-24,173,19503,1133,1,20810
776,2019-10-25,186,18134,1492,1,19813
776,2019-10-26,339,24841,1841,2,27023
776,2019-10-27,150,18429,1746,0,20325
776,2019-10-28,163,22147,1717,0,24027
776,2019-10-29,693,16965,1454,1,19113
776,2019-10-30,139,14767,1150,1,16057
776,2019-10-31,123,11383,1839,2,13347
776,2019-11-01,419,24136,1224,0,25779
776,2019-11-02,138,15312,2200,0,17650
776,2019-11-03,278,21354,1335,1,22968
776,2019-11-04,150,8966,1496,0,10612
776,2019-11-05,211,1452,2162,1,3826
776,2019-11-06,183,7090,862,1,8136
776,2019-11-07,215,13098,721,1,14035
776,2019-11-08,192,8818,1328,1,10339
776,2019-11-09,110,7575,2134,0,9819
776,2019-11-10,405,11797,1043,1,13246
776,2019-11-11,573,12148,1460,1,14182
776,2019-11-12,241,11034,2624,0,13899
776,2019-11-13,338,10868,1915,3,13124
776,2019-11-14,151,7771,1803,2,9727
776,2019-11-15,252,3744,2799,2,6797
776,2019-11-16,193,2851,3282,1,6327
776,2019-11-17,549,3011,2638,0,6198
776,2019-11-18,148,3514,3333,0,6995
776,2019-11-19,424,5219,3080,2,8725
776,2019-11-20,1123,1344,1989,1,4457
776,2019-11-21,1051,4826,1954,1,7832
776,2019-11-22,391,7759,1384,2,9536
776,2019-11-23,236,6803,2730,0,9769
776,2019-11-24,567,5604,1512,1,7684
776,2019-11-25,519,6957,1832,1,9309
776,2019-11-26,1520,5969,1474,1,8964
776,2019-11-27,203,6557,1185,0,7945
776,2019-11-28,133,7569,1390,18,9110
777,2019-08-25,61,378,632,0,1071
777,2019-08-26,113,1516,1969,0,3598
777,2019-08-27,143,9360,1620,0,11123
777,2019-08-28,182,1774,1980,0,3936
777,2019-08-29,248,8963,1983,2,11196
777,2019-08-30,364,3346,464,0,4174
777,2019-08-31,44,68,0,1,113
777,2019-09-01,69,86,561,1,717
777,2019-09-02,74,204,106,1,385
777,2019-09-03,151,3598,726,3,4478
777,2019-09-04,151,13471,2284,0,15906
777,2019-09-05,995,4724,1936,1,7656
777,2019-09-06,982,11079,2083,1,14145
777,2019-09-07,222,17484,2517,0,20223
777,2019-09-08,256,6511,2161,0,8928
777,2019-09-09,185,6266,2656,0,9107
777,2019-09-10,134,11495,2047,0,13676
777,2019-09-11,162,8894,1214,2,10272
777,2019-09-12,963,11074,2199,0,14236
777,2019-09-13,136,3394,2454,2,5986
777,2019-09-14,685,7359,1641,1,9686
777,2019-09-15,959,10548,1801,0,13308
777,2019-09-16,1144,5915,2724,0,9783
777,2019-09-17,173,5403,2080,0,7656
777,2019-09-18,965,11844,1210,0,14019
777,2019-09-19,211,3259,2880,0,6350
777,2019-09-20,193,11176,2587,0,13956
777,2019-09-21,260,6580,3061,1,9902
777,2019-09-22,129,14651,1666,0,16446
777,2019-09-23,1052,11052,2178,0,14282
777,2019-09-24,195,9032,1704,3,10934
777,2019-09-25,193,12810,1098,0,14101
777,2019-09-26,167,9957,2355,18,12497
777,2019-09-27,151,10435,1910,0,12496
777,2019-09-28,962,15403,1375,2,17742
777,2019-09-29,168,18234,811,2,19215
777,2019-09-30,1768,15864,1706,0,19338
777,2019-10-01,825,16380,1421,1,18627
777,2019-10-02,1124,12580,1782,2,15488
777,2019-10-03,174,23554,1198,1,24927
777,2019-10-04,411,14593,1673,2,16679
777,2019-10-05,587,22367,1169,0,24123
777,2019-10-06,1234,19892,1455,2,22583
777,2019-10-07,1059,6930,2182,0,10171
777,2019-10-08,284,12504,1546,0,14334
777,2019-10-09,163,16170,2101,2,18436
777,2019-10-10,1915,16815,1705,746,21181
777,2019-10-11,139,11209,1487,4,12839
777,2019-10-12,105,7211,2424,0,9740
777,2019-10-13,1894,23812,1844,1,27551
777,2019-10-14,173,17789,1394,2,19358
777,2019-10-15,722,19245,874,1,20842
777,2019-10-16,121,28726,1794,2,30643
777,2019-10-17,135,19611,1834,0,21580
777,2019-10-18,281,25237,835,1,26354
777,2019-10-19,797,20918,1929,2,23646
777,2019-10-20,111,16366,1862,2,18341
777,2019-10-21,187,21475,1589,4,23255
777,2019-10-22,147,17503,1372,1,19023
777,2019-10-23,74,25047,1166,3,26290
777,2019-10-24,202,35845,1632,1,37680
777,2019-10-25,1015,29420,1920,2,32357
777,2019-10-26,225,35687,1558,1,37471
777,2019-10-27,786,41073,1008,1,42868
777,2019-10-28,179,34693,2367,0,37239
777,2019-10-29,175,38903,1592,0,40670
777,2019-10-30,104,30439,1363,2,31908
777,2019-10-31,117,24053,1440,2,25612
777,2019-11-01,94,37489,1737,0,39320
777,2019-11-02,92,47784,998,0,48874
777,2019-11-03,94,66972,987,1,68054
777,2019-11-04,320,28365,2277,0,30962
777,2019-11-05,161,13760,1159,1,15081
777,2019-11-06,217,25827,1499,0,27543
777,2019-11-07,191,27742,1869,0,29802
777,2019-11-08,116,20249,1713,0,22078
777,2019-11-09,99,24629,1691,0,26419
777,2019-11-10,664,16930,1270,0,18864
777,2019-11-11,158,10085,1106,0,11349
777,2019-11-12,297,10667,3476,0,14440
777,2019-11-13,462,13323,2595,0,16380
777,2019-11-14,140,13462,1817,0,15419
777,2019-11-15,118,5143,2084,0,7345
777,2019-11-16,227,2479,2743,0,5449
777,2019-11-17,1133,3734,3240,0,8107
777,2019-11-18,147,2549,3345,0,6041
777,2019-11-19,233,5698,2343,0,8274
777,2019-11-20,2135,1334,1646,0,5115
777,2019-11-21,146,4000,1348,0,5494
777,2019-11-22,239,8666,1532,0,10437
777,2019-11-23,163,7244,2269,0,9676
777,2019-11-24,209,6528,1537,0,8274
777,2019-11-25,130,6920,1797,0,8847
777,2019-11-26,89,6621,1665,0,8375
777,2019-11-27,104,6770,1513,0,8387
777,2019-11-28,563,13085,542,0,14190
777,2019-11-29,10,1392,0,0,1402
777,2019-08-25,61,378,632,0,1071
777,2019-08-26,113,1516,1969,0,3598
777,2019-08-27,143,9360,1620,0,11123
777,2019-08-28,182,1774,1980,0,3936
777,2019-08-29,248,8963,1983,2,11196
777,2019-08-30,364,3346,464,0,4174
777,2019-08-31,44,68,0,1,113
777,2019-09-01,69,86,561,1,717
777,2019-09-02,74,204,106,1,385
777,2019-09-03,151,3598,726,3,4478
777,2019-09-04,151,13471,2284,0,15906
777,2019-09-05,995,4724,1936,1,7656
777,2019-09-06,982,11079,2083,1,14145
777,2019-09-07,222,17484,2517,0,20223
777,2019-09-08,256,6511,2161,0,8928
777,2019-09-09,185,6266,2656,0,9107
777,2019-09-10,134,11495,2047,0,13676
777,2019-09-11,162,8894,1214,2,10272
777,2019-09-12,963,11074,2199,0,14236
777,2019-09-13,136,3394,2454,2,5986
777,2019-09-14,685,7359,1641,1,9686
777,2019-09-15,959,10548,1801,0,13308
777,2019-09-16,1144,5915,2724,0,9783
777,2019-09-17,173,5403,2080,0,7656
777,2019-09-18,965,11844,1210,0,14019
777,2019-09-19,211,3259,2880,0,6350
777,2019-09-20,193,11176,2587,0,13956
777,2019-09-21,260,6580,3061,1,9902
777,2019-09-22,129,14651,1666,0,16446
777,2019-09-23,1052,11052,2178,0,14282
777,2019-09-24,195,9032,1704,3,10934
777,2019-09-25,193,12810,1098,0,14101
777,2019-09-26,167,9957,2355,18,12497
777,2019-09-27,151,10435,1910,0,12496
777,2019-09-28,962,15403,1375,2,17742
777,2019-09-29,168,18234,811,2,19215
777,2019-09-30,1768,15864,1706,0,19338
777,2019-10-01,825,16380,1421,1,18627
777,2019-10-02,1124,12580,1782,2,15488
777,2019-10-03,174,23554,1198,1,24927
777,2019-10-04,411,14593,1673,2,16679
777,2019-10-05,587,22367,1169,0,24123
777,2019-10-06,1234,19892,1455,2,22583
777,2019-10-07,1059,6930,2182,0,10171
777,2019-10-08,284,12504,1546,0,14334
777,2019-10-09,163,16170,2101,2,18436
777,2019-10-10,1915,16815,1705,746,21181
777,2019-10-11,139,11209,1487,4,12839
777,2019-10-12,105,7211,2424,0,9740
777,2019-10-13,1894,23812,1844,1,27551
777,2019-10-14,173,17789,1394,2,19358
777,2019-10-15,722,19245,874,1,20842
777,2019-10-16,121,28726,1794,2,30643
777,2019-10-17,135,19611,1834,0,21580
777,2019-10-18,281,25237,835,1,26354
777,2019-10-19,797,20918,1929,2,23646
777,2019-10-20,111,16366,1862,2,18341
777,2019-10-21,187,21475,1589,4,23255
777,2019-10-22,147,17503,1372,1,19023
777,2019-10-23,74,25047,1166,3,26290
777,2019-10-24,202,35845,1632,1,37680
777,2019-10-25,1015,29420,1920,2,32357
777,2019-10-26,225,35687,1558,1,37471
777,2019-10-27,786,41073,1008,1,42868
777,2019-10-28,179,34693,2367,0,37239
777,2019-10-29,175,38903,1592,0,40670
777,2019-10-30,104,30439,1363,2,31908
777,2019-10-31,117,24053,1440,2,25612
777,2019-11-01,94,37489,1737,0,39320
777,2019-11-02,92,47784,998,0,48874
777,2019-11-03,94,66972,987,1,68054
777,2019-11-04,320,28365,2277,0,30962
777,2019-11-05,161,13760,1159,1,15081
777,2019-11-06,217,25827,1499,0,27543
777,2019-11-07,191,27742,1869,0,29802
777,2019-11-08,116,20249,1713,0,22078
777,2019-11-09,99,24629,1691,0,26419
777,2019-11-10,664,16930,1270,0,18864
777,2019-11-11,158,10085,1106,0,11349
777,2019-11-12,297,10667,3476,0,14440
777,2019-11-13,462,13323,2595,0,16380
777,2019-11-14,140,13462,1817,0,15419
777,2019-11-15,118,5143,2084,0,7345
777,2019-11-16,227,2479,2743,0,5449
777,2019-11-17,1133,3734,3240,0,8107
777,2019-11-18,147,2549,3345,0,6041
777,2019-11-19,233,5698,2343,0,8274
777,2019-11-20,2135,1334,1646,0,5115
777,2019-11-21,146,4000,1348,0,5494
777,2019-11-22,239,8666,1532,0,10437
777,2019-11-23,163,7244,2269,0,9676
777,2019-11-24,209,6528,1537,0,8274
777,2019-11-25,130,6920,1797,0,8847
777,2019-11-26,89,6621,1665,0,8375
777,2019-11-27,104,6770,1513,0,8387
777,2019-11-28,563,13085,542,0,14190
777,2019-11-29,10,1392,0,0,1402
777,2019-08-25,61,378,632,0,1071
777,2019-08-26,113,1516,1969,0,3598
777,2019-08-27,143,9360,1620,0,11123
777,2019-08-28,182,1774,1980,0,3936
777,2019-08-29,248,8963,1983,2,11196
777,2019-08-30,364,3346,464,0,4174
777,2019-08-31,44,68,0,1,113
777,2019-09-01,69,86,561,1,717
777,2019-09-02,74,204,106,1,385
777,2019-09-03,151,3598,726,3,4478
777,2019-09-04,151,13471,2284,0,15906
777,2019-09-05,995,4724,1936,1,7656
777,2019-09-06,982,11079,2083,1,14145
777,2019-09-07,222,17484,2517,0,20223
777,2019-09-08,256,6511,2161,0,8928
777,2019-09-09,185,6266,2656,0,9107
777,2019-09-10,134,11495,2047,0,13676
777,2019-09-11,162,8894,1214,2,10272
777,2019-09-12,963,11074,2199,0,14236
777,2019-09-13,136,3394,2454,2,5986
777,2019-09-14,685,7359,1641,1,9686
777,2019-09-15,959,10548,1801,0,13308
777,2019-09-16,1144,5915,2724,0,9783
777,2019-09-17,173,5403,2080,0,7656
777,2019-09-18,965,11844,1210,0,14019
777,2019-09-19,211,3259,2880,0,6350
777,2019-09-20,193,11176,2587,0,13956
777,2019-09-21,260,6580,3061,1,9902
777,2019-09-22,129,14651,1666,0,16446
777,2019-09-23,1052,11052,2178,0,14282
777,2019-09-24,195,9032,1704,3,10934
777,2019-09-25,193,12810,1098,0,14101
777,2019-09-26,167,9957,2355,18,12497
777,2019-09-27,151,10435,1910,0,12496
777,2019-09-28,962,15403,1375,2,17742
777,2019-09-29,168,18234,811,2,19215
777,2019-09-30,1768,15864,1706,0,19338
777,2019-10-01,825,16380,1421,1,18627
777,2019-10-02,1124,12580,1782,2,15488
777,2019-10-03,174,23554,1198,1,24927
777,2019-10-04,411,14593,1673,2,16679
777,2019-10-05,587,22367,1169,0,24123
777,2019-10-06,1234,19892,1455,2,22583
777,2019-10-07,1059,6930,2182,0,10171
777,2019-10-08,284,12504,1546,0,14334
777,2019-10-09,163,16170,2101,2,18436
777,2019-10-10,1915,16815,1705,746,21181
777,2019-10-11,139,11209,1487,4,12839
777,2019-10-12,105,7211,2424,0,9740
777,2019-10-13,1894,23812,1844,1,27551
777,2019-10-14,173,17789,1394,2,19358
777,2019-10-15,722,19245,874,1,20842
777,2019-10-16,121,28726,1794,2,30643
777,2019-10-17,135,19611,1834,0,21580
777,2019-10-18,281,25237,835,1,26354
777,2019-10-19,797,20918,1929,2,23646
777,2019-10-20,111,16366,1862,2,18341
777,2019-10-21,187,21475,1589,4,23255
777,2019-10-22,147,17503,1372,1,19023
777,2019-10-23,74,25047,1166,3,26290
777,2019-10-24,202,35845,1632,1,37680
777,2019-10-25,1015,29420,1920,2,32357
777,2019-10-26,225,35687,1558,1,37471
777,2019-10-27,786,41073,1008,1,42868
777,2019-10-28,179,34693,2367,0,37239
777,2019-10-29,175,38903,1592,0,40670
777,2019-10-30,104,30439,1363,2,31908
777,2019-10-31,117,24053,1440,2,25612
777,2019-11-01,94,37489,1737,0,39320
777,2019-11-02,92,47784,998,0,48874
777,2019-11-03,94,66972,987,1,68054
777,2019-11-04,320,28365,2277,0,30962
777,2019-11-05,161,13760,1159,1,15081
777,2019-11-06,217,25827,1499,0,27543
777,2019-11-07,191,27742,1869,0,29802
777,2019-11-08,116,20249,1713,0,22078
777,2019-11-09,99,24629,1691,0,26419
777,2019-11-10,664,16930,1270,0,18864
777,2019-11-11,158,10085,1106,0,11349
777,2019-11-12,297,10667,3476,0,14440
777,2019-11-13,462,13323,2595,0,16380
777,2019-11-14,140,13462,1817,0,15419
777,2019-11-15,118,5143,2084,0,7345
777,2019-11-16,227,2479,2743,0,5449
777,2019-11-17,1133,3734,3240,0,8107
777,2019-11-18,147,2549,3345,0,6041
777,2019-11-19,233,5698,2343,0,8274
777,2019-11-20,2135,1334,1646,0,5115
777,2019-11-21,146,4000,1348,0,5494
777,2019-11-22,239,8666,1532,0,10437
777,2019-11-23,163,7244,2269,0,9676
777,2019-11-24,209,6528,1537,0,8274
777,2019-11-25,130,6920,1797,0,8847
777,2019-11-26,89,6621,1665,0,8375
777,2019-11-27,104,6770,1513,0,8387
777,2019-11-28,563,13085,542,0,14190
777,2019-08-29,248,8963,1983,2,11196
777,2019-08-30,364,3346,464,0,4174
777,2019-08-31,44,68,0,1,113
777,2019-09-01,69,86,561,1,717
777,2019-09-02,74,204,106,1,385
777,2019-09-03,151,3598,726,3,4478
777,2019-09-04,151,13471,2284,0,15906
777,2019-09-05,995,4724,1936,1,7656
777,2019-09-06,982,11079,2083,1,14145
777,2019-09-07,222,17484,2517,0,20223
777,2019-09-08,256,6511,2161,0,8928
777,2019-09-09,185,6266,2656,0,9107
777,2019-09-10,134,11495,2047,0,13676
777,2019-09-11,162,8894,1214,2,10272
777,2019-09-12,963,11074,2199,0,14236
777,2019-09-13,136,3394,2454,2,5986
777,2019-09-14,685,7359,1641,1,9686
777,2019-09-15,959,10548,1801,0,13308
777,2019-09-16,1144,5915,2724,0,9783
777,2019-09-17,173,5403,2080,0,7656
777,2019-09-18,965,11844,1210,0,14019
777,2019-09-19,211,3259,2880,0,6350
777,2019-09-20,193,11176,2587,0,13956
777,2019-09-21,260,6580,3061,1,9902
777,2019-09-22,129,14651,1666,0,16446
777,2019-09-23,1052,11052,2178,0,14282
777,2019-09-24,195,9032,1704,3,10934
777,2019-09-25,193,12810,1098,0,14101
777,2019-09-26,167,9957,2355,18,12497
777,2019-09-27,151,10435,1910,0,12496
777,2019-09-28,962,15403,1375,2,17742
777,2019-09-29,168,18234,811,2,19215
777,2019-09-30,1768,15864,1706,0,19338
777,2019-10-01,825,16380,1421,1,18627
777,2019-10-02,1124,12580,1782,2,15488
777,2019-10-03,174,23554,1198,1,24927
777,2019-10-04,411,14593,1673,2,16679
777,2019-10-05,587,22367,1169,0,24123
777,2019-10-06,1234,19892,1455,2,22583
777,2019-10-07,1059,6930,2182,0,10171
777,2019-10-08,284,12504,1546,0,14334
777,2019-10-09,163,16170,2101,2,18436
777,2019-10-10,1915,16815,1705,746,21181
777,2019-10-11,139,11209,1487,4,12839
777,2019-10-12,105,7211,2424,0,9740
777,2019-10-13,1894,23812,1844,1,27551
777,2019-10-14,173,17789,1394,2,19358
777,2019-10-15,722,19245,874,1,20842
777,2019-10-16,121,28726,1794,2,30643
777,2019-10-17,135,19611,1834,0,21580
777,2019-10-18,281,25237,835,1,26354
777,2019-10-19,797,20918,1929,2,23646
777,2019-10-20,111,16366,1862,2,18341
777,2019-10-21,187,21475,1589,4,23255
777,2019-10-22,147,17503,1372,1,19023
777,2019-10-23,74,25047,1166,3,26290
777,2019-10-24,202,35845,1632,1,37680
777,2019-10-25,1015,29420,1920,2,32357
777,2019-10-26,225,35687,1558,1,37471
777,2019-10-27,786,41073,1008,1,42868
777,2019-10-28,179,34693,2367,0,37239
777,2019-10-29,175,38903,1592,0,40670
777,2019-10-30,104,30439,1363,2,31908
777,2019-10-31,117,24053,1440,2,25612
777,2019-11-01,94,37489,1737,0,39320
777,2019-11-02,92,47784,998,0,48874
777,2019-11-03,94,66972,987,1,68054
777,2019-11-04,320,28365,2277,0,30962
777,2019-11-05,161,13760,1159,1,15081
778,2019-08-25,370,508,1262,0,2140
778,2019-08-26,1370,675,1782,0,3827
778,2019-08-27,728,6373,2098,0,9199
778,2019-08-28,777,1602,2118,1,4498
778,2019-08-29,955,11034,1803,2,13794
778,2019-08-30,934,3142,774,0,4850
778,2019-08-31,274,11,1,0,286
778,2019-09-01,281,784,339,0,1404
778,2019-09-02,308,236,0,0,544
778,2019-09-03,475,848,1577,1,2901
778,2019-09-04,2169,12464,2116,0,16749
778,2019-09-05,1353,10304,2139,0,13796
778,2019-09-06,1824,18744,2228,0,22796
778,2019-09-07,1021,61346,2163,0,64530
778,2019-09-08,1054,4856,1968,2,7880
778,2019-09-09,2482,6652,1988,0,11122
778,2019-09-10,1089,6642,2131,1,9863
778,2019-09-11,1525,5877,1246,2,8650
778,2019-09-12,872,6637,2291,1,9801
778,2019-09-13,926,3361,1463,0,5750
778,2019-09-14,1278,6870,1844,2,9994
778,2019-09-15,2117,16546,2056,0,20719
778,2019-09-16,4948,5302,1978,0,12228
778,2019-09-17,928,7620,1237,0,9785
778,2019-09-18,902,11062,1136,0,13100
778,2019-09-19,969,2179,1238,2,4388
778,2019-09-20,3512,7350,1850,1,12713
778,2019-09-21,3709,7001,2937,0,13647
778,2019-09-22,3855,14406,1621,1,19883
778,2019-09-23,954,12682,2612,1,16249
778,2019-09-24,819,10086,860,5,11770
778,2019-09-25,1337,6505,1398,0,9240
778,2019-09-26,1129,9570,1626,0,12325
778,2019-09-27,412,7573,2071,2,10058
778,2019-09-28,393,13905,1832,1,16131
778,2019-09-29,310,15601,1565,4,17480
778,2019-09-30,821,17471,1551,3,19846
778,2019-10-01,4129,15504,1375,2,21010
778,2019-10-02,4995,10507,2452,1,17955
778,2019-10-03,5062,12899,1197,2,19160
778,2019-10-04,2628,10870,1173,2,14673
778,2019-10-05,3121,20080,1332,0,24533
778,2019-10-06,3836,15574,2694,3,22107
778,2019-10-07,3271,4574,2047,0,9892
778,2019-10-08,5521,10731,1496,1,17749
778,2019-10-09,3071,14026,1885,1,18983
778,2019-10-10,1981,10108,1991,1,14081
778,2019-10-11,1264,9340,2172,0,12776
778,2019-10-12,1072,5318,2068,0,8458
778,2019-10-13,1546,6995,1576,1,10118
778,2019-10-14,1312,3839,1734,3,6888
778,2019-10-15,2641,7578,1905,1,12125
778,2019-10-16,1079,12153,1241,2,14475
778,2019-10-17,2399,3840,1737,1,7977
778,2019-10-18,2678,6881,1769,1,11329
778,2019-10-19,1112,4513,1637,0,7262
778,2019-10-20,2088,9865,2117,1,14071
778,2019-10-21,720,18585,1661,0,20966
778,2019-10-22,2214,8420,1847,1,12482
778,2019-10-23,1335,7047,1286,1,9669
778,2019-10-24,758,19361,1468,2,21589
778,2019-10-25,1740,17844,1913,1,21498
778,2019-10-26,1313,16565,1122,1,19001
778,2019-10-27,1509,27475,1342,0,30326
778,2019-10-28,1119,24122,1095,0,26336
778,2019-10-29,1282,28173,1834,3,31292
778,2019-10-30,1139,19501,1489,0,22129
778,2019-10-31,760,19374,851,0,20985
778,2019-11-01,677,26052,1875,1,28605
778,2019-11-02,557,15562,870,0,16989
778,2019-11-03,675,21547,926,3,23151
778,2019-11-04,1392,8945,2328,0,12665
778,2019-11-05,977,1204,1639,0,3820
778,2019-11-06,615,13392,1194,1,15202
778,2019-11-07,623,24596,1324,1,26544
778,2019-11-08,897,11280,1684,0,13861
778,2019-11-09,1094,7775,1945,0,10814
778,2019-11-10,628,11911,1746,0,14285
778,2019-11-11,541,8192,1546,0,10279
778,2019-11-12,491,10742,2289,0,13522
778,2019-11-13,690,11226,1750,0,13666
778,2019-11-14,639,7888,2259,0,10786
778,2019-11-15,519,4112,3508,0,8139
778,2019-11-16,532,2575,3585,0,6692
778,2019-11-17,816,2993,3979,0,7788
778,2019-11-18,882,2824,3425,0,7131
778,2019-11-19,1070,3239,2195,0,6504
778,2019-11-20,663,1764,2363,0,4790
778,2019-11-21,595,5451,1669,1,7716
778,2019-11-22,614,8068,1229,2,9913
778,2019-11-23,612,6657,2088,3,9360
778,2019-11-24,844,7354,1771,0,9969
778,2019-11-25,1377,6721,2195,0,10293
778,2019-11-26,484,6420,1706,0,8610
778,2019-11-27,597,6481,1558,2,8638
778,2019-11-28,1850,7584,774,1,10209
778,2019-11-29,183,739,2,0,924
778,2019-08-25,370,508,1262,0,2140
778,2019-08-26,1370,675,1782,0,3827
778,2019-08-27,728,6373,2098,0,9199
778,2019-08-28,777,1602,2118,1,4498
778,2019-08-29,955,11034,1803,2,13794
778,2019-08-30,934,3142,774,0,4850
778,2019-08-31,274,11,1,0,286
778,2019-09-01,281,784,339,0,1404
778,2019-09-02,308,236,0,0,544
778,2019-09-03,475,848,1577,1,2901
778,2019-09-04,2169,12464,2116,0,16749
778,2019-09-05,1353,10304,2139,0,13796
778,2019-09-06,1824,18744,2228,0,22796
778,2019-09-07,1021,61346,2163,0,64530
778,2019-09-08,1054,4856,1968,2,7880
778,2019-09-09,2482,6652,1988,0,11122
778,2019-09-10,1089,6642,2131,1,9863
778,2019-09-11,1525,5877,1246,2,8650
778,2019-09-12,872,6637,2291,1,9801
778,2019-09-13,926,3361,1463,0,5750
778,2019-09-14,1278,6870,1844,2,9994
778,2019-09-15,2117,16546,2056,0,20719
778,2019-09-16,4948,5302,1978,0,12228
778,2019-09-17,928,7620,1237,0,9785
778,2019-09-18,902,11062,1136,0,13100
778,2019-09-19,969,2179,1238,2,4388
778,2019-09-20,3512,7350,1850,1,12713
778,2019-09-21,3709,7001,2937,0,13647
778,2019-09-22,3855,14406,1621,1,19883
778,2019-09-23,954,12682,2612,1,16249
778,2019-09-24,819,10086,860,5,11770
778,2019-09-25,1337,6505,1398,0,9240
778,2019-09-26,1129,9570,1626,0,12325
778,2019-09-27,412,7573,2071,2,10058
778,2019-09-28,393,13905,1832,1,16131
778,2019-09-29,310,15601,1565,4,17480
778,2019-09-30,821,17471,1551,3,19846
778,2019-10-01,4129,15504,1375,2,21010
778,2019-10-02,4995,10507,2452,1,17955
778,2019-10-03,5062,12899,1197,2,19160
778,2019-10-04,2628,10870,1173,2,14673
778,2019-10-05,3121,20080,1332,0,24533
778,2019-10-06,3836,15574,2694,3,22107
778,2019-10-07,3271,4574,2047,0,9892
778,2019-10-08,5521,10731,1496,1,17749
778,2019-10-09,3071,14026,1885,1,18983
778,2019-10-10,1981,10108,1991,1,14081
778,2019-10-11,1264,9340,2172,0,12776
778,2019-10-12,1072,5318,2068,0,8458
778,2019-10-13,1546,6995,1576,1,10118
778,2019-10-14,1312,3839,1734,3,6888
778,2019-10-15,2641,7578,1905,1,12125
778,2019-10-16,1079,12153,1241,2,14475
778,2019-10-17,2399,3840,1737,1,7977
778,2019-10-18,2678,6881,1769,1,11329
778,2019-10-19,1112,4513,1637,0,7262
778,2019-10-20,2088,9865,2117,1,14071
778,2019-10-21,720,18585,1661,0,20966
778,2019-10-22,2214,8420,1847,1,12482
778,2019-10-23,1335,7047,1286,1,9669
778,2019-10-24,758,19361,1468,2,21589
778,2019-10-25,1740,17844,1913,1,21498
778,2019-10-26,1313,16565,1122,1,19001
778,2019-10-27,1509,27475,1342,0,30326
778,2019-10-28,1119,24122,1095,0,26336
778,2019-10-29,1282,28173,1834,3,31292
778,2019-10-30,1139,19501,1489,0,22129
778,2019-10-31,760,19374,851,0,20985
778,2019-11-01,677,26052,1875,1,28605
778,2019-11-02,557,15562,870,0,16989
778,2019-11-03,675,21547,926,3,23151
778,2019-11-04,1392,8945,2328,0,12665
778,2019-11-05,977,1204,1639,0,3820
778,2019-11-06,615,13392,1194,1,15202
778,2019-11-07,623,24596,1324,1,26544
778,2019-11-08,897,11280,1684,0,13861
778,2019-11-09,1094,7775,1945,0,10814
778,2019-11-10,628,11911,1746,0,14285
778,2019-11-11,541,8192,1546,0,10279
778,2019-11-12,491,10742,2289,0,13522
778,2019-11-13,690,11226,1750,0,13666
778,2019-11-14,639,7888,2259,0,10786
778,2019-11-15,519,4112,3508,0,8139
778,2019-11-16,532,2575,3585,0,6692
778,2019-11-17,816,2993,3979,0,7788
778,2019-11-18,882,2824,3425,0,7131
778,2019-11-19,1070,3239,2195,0,6504
778,2019-11-20,663,1764,2363,0,4790
778,2019-11-21,595,5451,1669,1,7716
778,2019-11-22,614,8068,1229,2,9913
778,2019-11-23,612,6657,2088,3,9360
778,2019-11-24,844,7354,1771,0,9969
778,2019-11-25,1377,6721,2195,0,10293
778,2019-11-26,484,6420,1706,0,8610
778,2019-11-27,597,6481,1558,2,8638
778,2019-11-28,1850,7584,774,1,10209
778,2019-11-29,183,739,2,0,924
778,2019-08-25,370,508,1262,0,2140
778,2019-08-26,1370,675,1782,0,3827
778,2019-08-27,728,6373,2098,0,9199
778,2019-08-28,777,1602,2118,1,4498
778,2019-08-29,955,11034,1803,2,13794
778,2019-08-30,934,3142,774,0,4850
778,2019-08-31,274,11,1,0,286
778,2019-09-01,281,784,339,0,1404
778,2019-09-02,308,236,0,0,544
778,2019-09-03,475,848,1577,1,2901
778,2019-09-04,2169,12464,2116,0,16749
778,2019-09-05,1353,10304,2139,0,13796
778,2019-09-06,1824,18744,2228,0,22796
778,2019-09-07,1021,61346,2163,0,64530
778,2019-09-08,1054,4856,1968,2,7880
778,2019-09-09,2482,6652,1988,0,11122
778,2019-09-10,1089,6642,2131,1,9863
778,2019-09-11,1525,5877,1246,2,8650
778,2019-09-12,872,6637,2291,1,9801
778,2019-09-13,926,3361,1463,0,5750
778,2019-09-14,1278,6870,1844,2,9994
778,2019-09-15,2117,16546,2056,0,20719
778,2019-09-16,4948,5302,1978,0,12228
778,2019-09-17,928,7620,1237,0,9785
778,2019-09-18,902,11062,1136,0,13100
778,2019-09-19,969,2179,1238,2,4388
778,2019-09-20,3512,7350,1850,1,12713
778,2019-09-21,3709,7001,2937,0,13647
778,2019-09-22,3855,14406,1621,1,19883
778,2019-09-23,954,12682,2612,1,16249
778,2019-09-24,819,10086,860,5,11770
778,2019-09-25,1337,6505,1398,0,9240
778,2019-09-26,1129,9570,1626,0,12325
778,2019-09-27,412,7573,2071,2,10058
778,2019-09-28,393,13905,1832,1,16131
778,2019-09-29,310,15601,1565,4,17480
778,2019-09-30,821,17471,1551,3,19846
778,2019-10-01,4129,15504,1375,2,21010
778,2019-10-02,4995,10507,2452,1,17955
778,2019-10-03,5062,12899,1197,2,19160
778,2019-10-04,2628,10870,1173,2,14673
778,2019-10-05,3121,20080,1332,0,24533
778,2019-10-06,3836,15574,2694,3,22107
778,2019-10-07,3271,4574,2047,0,9892
778,2019-10-08,5521,10731,1496,1,17749
778,2019-10-09,3071,14026,1885,1,18983
778,2019-10-10,1981,10108,1991,1,14081
778,2019-10-11,1264,9340,2172,0,12776
778,2019-10-12,1072,5318,2068,0,8458
778,2019-10-13,1546,6995,1576,1,10118
778,2019-10-14,1312,3839,1734,3,6888
778,2019-10-15,2641,7578,1905,1,12125
778,2019-10-16,1079,12153,1241,2,14475
778,2019-10-17,2399,3840,1737,1,7977
778,2019-10-18,2678,6881,1769,1,11329
778,2019-10-19,1112,4513,1637,0,7262
778,2019-10-20,2088,9865,2117,1,14071
778,2019-10-21,720,18585,1661,0,20966
778,2019-10-22,2214,8420,1847,1,12482
778,2019-10-23,1335,7047,1286,1,9669
778,2019-10-24,758,19361,1468,2,21589
778,2019-10-25,1740,17844,1913,1,21498
778,2019-10-26,1313,16565,1122,1,19001
778,2019-10-27,1509,27475,1342,0,30326
778,2019-10-28,1119,24122,1095,0,26336
778,2019-10-29,1282,28173,1834,3,31292
778,2019-10-30,1139,19501,1489,0,22129
778,2019-10-31,760,19374,851,0,20985
778,2019-11-01,677,26052,1875,1,28605
778,2019-11-02,557,15562,870,0,16989
778,2019-11-03,675,21547,926,3,23151
778,2019-11-04,1392,8945,2328,0,12665
778,2019-11-05,977,1204,1639,0,3820
778,2019-11-06,615,13392,1194,1,15202
778,2019-11-07,623,24596,1324,1,26544
778,2019-11-08,897,11280,1684,0,13861
778,2019-11-09,1094,7775,1945,0,10814
778,2019-11-10,628,11911,1746,0,14285
778,2019-11-11,541,8192,1546,0,10279
778,2019-11-12,491,10742,2289,0,13522
778,2019-11-13,690,11226,1750,0,13666
778,2019-11-14,639,7888,2259,0,10786
778,2019-11-15,519,4112,3508,0,8139
778,2019-11-16,532,2575,3585,0,6692
778,2019-11-17,816,2993,3979,0,7788
778,2019-11-18,882,2824,3425,0,7131
778,2019-11-19,1070,3239,2195,0,6504
778,2019-11-20,663,1764,2363,0,4790
778,2019-11-21,595,5451,1669,1,7716
778,2019-11-22,614,8068,1229,2,9913
778,2019-11-23,612,6657,2088,3,9360
778,2019-11-24,844,7354,1771,0,9969
778,2019-11-25,1377,6721,2195,0,10293
778,2019-11-26,484,6420,1706,0,8610
778,2019-11-27,597,6481,1558,2,8638
778,2019-11-28,1850,7584,774,1,10209
778,2019-11-29,183,739,2,0,924
778,2019-08-28,777,1602,2118,1,4498
778,2019-08-29,955,11034,1803,2,13794
778,2019-08-30,934,3142,774,0,4850
778,2019-08-31,274,11,1,0,286
778,2019-09-01,281,784,339,0,1404
778,2019-09-02,308,236,0,0,544
778,2019-09-03,475,848,1577,1,2901
778,2019-09-04,2169,12464,2116,0,16749
778,2019-09-05,1353,10304,2139,0,13796
778,2019-09-06,1824,18744,2228,0,22796
778,2019-09-07,1021,61346,2163,0,64530
778,2019-09-08,1054,4856,1968,2,7880
778,2019-09-09,2482,6652,1988,0,11122
778,2019-09-10,1089,6642,2131,1,9863
778,2019-09-11,1525,5877,1246,2,8650
778,2019-09-12,872,6637,2291,1,9801
778,2019-09-13,926,3361,1463,0,5750
778,2019-09-14,1278,6870,1844,2,9994
778,2019-09-15,2117,16546,2056,0,20719
778,2019-09-16,4948,5302,1978,0,12228
778,2019-09-17,928,7620,1237,0,9785
778,2019-09-18,902,11062,1136,0,13100
778,2019-09-19,969,2179,1238,2,4388
778,2019-09-20,3512,7350,1850,1,12713
778,2019-09-21,3709,7001,2937,0,13647
778,2019-09-22,3855,14406,1621,1,19883
778,2019-09-23,954,12682,2612,1,16249
778,2019-09-24,819,10086,860,5,11770
778,2019-09-25,1337,6505,1398,0,9240
778,2019-09-26,1129,9570,1626,0,12325
778,2019-09-27,412,7573,2071,2,10058
778,2019-09-28,393,13905,1832,1,16131
778,2019-09-29,310,15601,1565,4,17480
778,2019-09-30,821,17471,1551,3,19846
778,2019-10-01,4129,15504,1375,2,21010
778,2019-10-02,4995,10507,2452,1,17955
778,2019-10-03,5062,12899,1197,2,19160
778,2019-10-04,2628,10870,1173,2,14673
778,2019-10-05,3121,20080,1332,0,24533
778,2019-10-06,3836,15574,2694,3,22107
778,2019-10-07,3271,4574,2047,0,9892
778,2019-10-08,5521,10731,1496,1,17749
778,2019-10-09,3071,14026,1885,1,18983
778,2019-10-10,1981,10108,1991,1,14081
778,2019-10-11,1264,9340,2172,0,12776
778,2019-10-12,1072,5318,2068,0,8458
778,2019-10-13,1546,6995,1576,1,10118
778,2019-10-14,1312,3839,1734,3,6888
778,2019-10-15,2641,7578,1905,1,12125
778,2019-10-16,1079,12153,1241,2,14475
778,2019-10-17,2399,3840,1737,1,7977
778,2019-10-18,2678,6881,1769,1,11329
778,2019-10-19,1112,4513,1637,0,7262
778,2019-10-20,2088,9865,2117,1,14071
778,2019-10-21,720,18585,1661,0,20966
778,2019-10-22,2214,8420,1847,1,12482
778,2019-10-23,1335,7047,1286,1,9669
778,2019-10-24,758,19361,1468,2,21589
778,2019-10-25,1740,17844,1913,1,21498
778,2019-10-26,1313,16565,1122,1,19001
778,2019-10-27,1509,27475,1342,0,30326
778,2019-10-28,1119,24122,1095,0,26336
778,2019-10-29,1282,28173,1834,3,31292
778,2019-10-30,1139,19501,1489,0,22129
778,2019-10-31,760,19374,851,0,20985
778,2019-11-01,677,26052,1875,1,28605
778,2019-11-02,557,15562,870,0,16989
778,2019-11-03,675,21547,926,3,23151
778,2019-11-04,1392,8945,2328,0,12665
778,2019-11-05,977,1204,1639,0,3820
778,2019-11-06,615,13392,1194,1,15202
778,2019-11-07,623,24596,1324,1,26544
778,2019-11-08,897,11280,1684,0,13861
778,2019-11-09,1094,7775,1945,0,10814
778,2019-11-10,628,11911,1746,0,14285
778,2019-11-11,541,8192,1546,0,10279
778,2019-11-12,491,10742,2289,0,13522
778,2019-11-13,690,11226,1750,0,13666
778,2019-11-14,639,7888,2259,0,10786
778,2019-11-15,519,4112,3508,0,8139
778,2019-11-16,532,2575,3585,0,6692
778,2019-11-17,816,2993,3979,0,7788
778,2019-11-18,882,2824,3425,0,7131
778,2019-11-19,1070,3239,2195,0,6504
778,2019-11-20,663,1764,2363,0,4790
778,2019-11-21,595,5451,1669,1,7716
778,2019-11-22,614,8068,1229,2,9913
778,2019-11-23,612,6657,2088,3,9360
778,2019-11-24,844,7354,1771,0,9969
778,2019-11-25,1377,6721,2195,0,10293
778,2019-11-26,484,6420,1706,0,8610
778,2019-11-27,597,6481,1558,2,8638
778,2019-11-28,1850,7584,774,1,10209
779,2019-08-25,117,410,661,0,1188
779,2019-08-26,645,12694,1988,1,15328
779,2019-08-27,656,8437,1700,0,10793
779,2019-08-28,529,1368,1890,1,3788
779,2019-08-29,646,9273,1626,0,11545
779,2019-08-30,466,3749,734,1,4950
779,2019-08-31,89,30,0,0,119
779,2019-09-01,135,69,590,0,794
779,2019-09-02,130,53,22,0,205
779,2019-09-03,141,1095,1587,1,2824
779,2019-09-04,510,12799,2499,1,15809
779,2019-09-05,456,12939,1652,0,15047
779,2019-09-06,1428,9480,2348,1,13257
779,2019-09-07,620,16053,1627,2,18302
779,2019-09-08,1749,8035,2445,0,12229
779,2019-09-09,521,5757,2330,0,8608
779,2019-09-10,453,11139,2062,1,13655
779,2019-09-11,1007,6182,1514,4,8707
779,2019-09-12,284,9470,1507,1,11262
779,2019-09-13,709,6630,2160,0,9499
779,2019-09-14,500,9479,1393,0,11372
779,2019-09-15,408,8600,2140,0,11148
779,2019-09-16,741,9474,2739,2,12956
779,2019-09-17,397,7693,1804,0,9894
779,2019-09-18,563,11668,1331,1,13563
779,2019-09-19,615,2806,1525,1,4947
779,2019-09-20,1527,18334,1563,2,21426
779,2019-09-21,468,7974,2702,2,11146
779,2019-09-22,414,8806,1745,1,10966
779,2019-09-23,1066,11462,2365,0,14893
779,2019-09-24,627,9047,2093,4,11771
779,2019-09-25,1109,7619,1869,6,10603
779,2019-09-26,183,12364,1275,0,13822
779,2019-09-27,183,9201,2688,3,12075
779,2019-09-28,257,15538,2010,1,17806
779,2019-09-29,309,16897,1733,4,18943
779,2019-09-30,164,27142,856,4,28166
779,2019-10-01,183,23284,1532,0,24999
779,2019-10-02,187,12205,1080,0,13472
779,2019-10-03,204,23486,903,1,24594
779,2019-10-04,189,20810,911,2,21912
779,2019-10-05,645,16927,1913,0,19485
779,2019-10-06,1046,12028,1594,1,14669
779,2019-10-07,192,6623,1792,2,8609
779,2019-10-08,257,18666,1793,0,20716
779,2019-10-09,170,17191,1834,2,19197
779,2019-10-10,419,10590,2041,4,13054
779,2019-10-11,2150,13728,1514,1,17393
779,2019-10-12,387,8915,2254,0,11556
779,2019-10-13,371,13239,1112,2,14724
779,2019-10-14,384,8605,2067,1,11057
779,2019-10-15,471,15150,1678,4,17303
779,2019-10-16,763,25928,1911,1,28603
779,2019-10-17,443,8967,1831,2,11243
779,2019-10-18,1009,8558,1349,0,10916
779,2019-10-19,523,5642,1824,1,7990
779,2019-10-20,551,3189,1800,3,5543
779,2019-10-21,497,10707,1290,2,12496
779,2019-10-22,669,6616,2193,1,9479
779,2019-10-23,422,9499,971,1,10893
779,2019-10-24,768,14284,1167,1,16220
779,2019-10-25,1037,15964,1660,3,18664
779,2019-10-26,967,28351,1583,0,30901
779,2019-10-27,1314,19335,2292,0,22941
779,2019-10-28,1196,14390,1612,0,17198
779,2019-10-29,489,17276,2148,0,19913
779,2019-10-30,434,15994,967,3,17398
779,2019-10-31,422,12765,1406,0,14593
779,2019-11-01,392,25346,1613,1,27352
779,2019-11-02,452,26680,1703,0,28835
779,2019-11-03,383,24760,1263,0,26406
779,2019-11-04,992,8160,1676,3,10831
779,2019-11-05,1127,3430,2700,0,7257
779,2019-11-06,415,8996,1244,0,10655
779,2019-11-07,496,14335,624,1,15456
779,2019-11-08,435,10304,1071,0,11810
779,2019-11-09,435,13988,1701,2,16126
779,2019-11-10,354,14735,1308,0,16397
779,2019-11-11,532,14586,1144,2,16264
779,2019-11-12,1909,12869,2839,1,17618
779,2019-11-13,461,19661,1479,1,21602
779,2019-11-14,406,10917,1792,5,13120
779,2019-11-15,397,4145,3235,0,7777
779,2019-11-16,429,2714,3034,1,6178
779,2019-11-17,475,2650,3939,2,7066
779,2019-11-18,488,3242,2970,2,6702
779,2019-11-19,595,3304,2523,1,6423
779,2019-11-20,1341,2039,1996,0,5376
779,2019-11-21,432,3481,2242,0,6155
779,2019-11-22,475,4729,1211,0,6415
779,2019-11-23,392,6163,2060,0,8615
779,2019-11-24,529,5020,1461,0,7010
779,2019-11-25,733,6912,2362,0,10007
779,2019-11-26,524,9962,1678,0,12164
779,2019-11-27,1121,6629,1761,0,9511
779,2019-11-28,407,7264,1012,0,8683
779,2019-11-29,147,952,2,0,1101
779,2019-08-25,117,410,661,0,1188
779,2019-08-26,645,12694,1988,1,15328
779,2019-08-27,656,8437,1700,0,10793
779,2019-08-28,529,1368,1890,1,3788
779,2019-08-29,646,9273,1626,0,11545
779,2019-08-30,466,3749,734,1,4950
779,2019-08-31,89,30,0,0,119
779,2019-09-01,135,69,590,0,794
779,2019-09-02,130,53,22,0,205
779,2019-09-03,141,1095,1587,1,2824
779,2019-09-04,510,12799,2499,1,15809
779,2019-09-05,456,12939,1652,0,15047
779,2019-09-06,1428,9480,2348,1,13257
779,2019-09-07,620,16053,1627,2,18302
779,2019-09-08,1749,8035,2445,0,12229
779,2019-09-09,521,5757,2330,0,8608
779,2019-09-10,453,11139,2062,1,13655
779,2019-09-11,1007,6182,1514,4,8707
779,2019-09-12,284,9470,1507,1,11262
779,2019-09-13,709,6630,2160,0,9499
779,2019-09-14,500,9479,1393,0,11372
779,2019-09-15,408,8600,2140,0,11148
779,2019-09-16,741,9474,2739,2,12956
779,2019-09-17,397,7693,1804,0,9894
779,2019-09-18,563,11668,1331,1,13563
779,2019-09-19,615,2806,1525,1,4947
779,2019-09-20,1527,18334,1563,2,21426
779,2019-09-21,468,7974,2702,2,11146
779,2019-09-22,414,8806,1745,1,10966
779,2019-09-23,1066,11462,2365,0,14893
779,2019-09-24,627,9047,2093,4,11771
779,2019-09-25,1109,7619,1869,6,10603
779,2019-09-26,183,12364,1275,0,13822
779,2019-09-27,183,9201,2688,3,12075
779,2019-09-28,257,15538,2010,1,17806
779,2019-09-29,309,16897,1733,4,18943
779,2019-09-30,164,27142,856,4,28166
779,2019-10-01,183,23284,1532,0,24999
779,2019-10-02,187,12205,1080,0,13472
779,2019-10-03,204,23486,903,1,24594
779,2019-10-04,189,20810,911,2,21912
779,2019-10-05,645,16927,1913,0,19485
779,2019-10-06,1046,12028,1594,1,14669
779,2019-10-07,192,6623,1792,2,8609
779,2019-10-08,257,18666,1793,0,20716
779,2019-10-09,170,17191,1834,2,19197
779,2019-10-10,419,10590,2041,4,13054
779,2019-10-11,2150,13728,1514,1,17393
779,2019-10-12,387,8915,2254,0,11556
779,2019-10-13,371,13239,1112,2,14724
779,2019-10-14,384,8605,2067,1,11057
779,2019-10-15,471,15150,1678,4,17303
779,2019-10-16,763,25928,1911,1,28603
779,2019-10-17,443,8967,1831,2,11243
779,2019-10-18,1009,8558,1349,0,10916
779,2019-10-19,523,5642,1824,1,7990
779,2019-10-20,551,3189,1800,3,5543
779,2019-10-21,497,10707,1290,2,12496
779,2019-10-22,669,6616,2193,1,9479
779,2019-10-23,422,9499,971,1,10893
779,2019-10-24,768,14284,1167,1,16220
779,2019-10-25,1037,15964,1660,3,18664
779,2019-10-26,967,28351,1583,0,30901
779,2019-10-27,1314,19335,2292,0,22941
779,2019-10-28,1196,14390,1612,0,17198
779,2019-10-29,489,17276,2148,0,19913
779,2019-10-30,434,15994,967,3,17398
779,2019-10-31,422,12765,1406,0,14593
779,2019-11-01,392,25346,1613,1,27352
779,2019-11-02,452,26680,1703,0,28835
779,2019-11-03,383,24760,1263,0,26406
779,2019-11-04,992,8160,1676,3,10831
779,2019-11-05,1127,3430,2700,0,7257
779,2019-11-06,415,8996,1244,0,10655
779,2019-11-07,496,14335,624,1,15456
779,2019-11-08,435,10304,1071,0,11810
779,2019-11-09,435,13988,1701,2,16126
779,2019-11-10,354,14735,1308,0,16397
779,2019-11-11,532,14586,1144,2,16264
779,2019-11-12,1909,12869,2839,1,17618
779,2019-11-13,461,19661,1479,1,21602
779,2019-11-14,406,10917,1792,5,13120
779,2019-11-15,397,4145,3235,0,7777
779,2019-11-16,429,2714,3034,1,6178
779,2019-11-17,475,2650,3939,2,7066
779,2019-11-18,488,3242,2970,2,6702
779,2019-11-19,595,3304,2523,1,6423
779,2019-11-20,1341,2039,1996,0,5376
779,2019-11-21,432,3481,2242,0,6155
779,2019-11-22,475,4729,1211,0,6415
779,2019-11-23,392,6163,2060,0,8615
779,2019-11-24,529,5020,1461,0,7010
779,2019-11-25,733,6912,2362,0,10007
779,2019-11-26,524,9962,1678,0,12164
779,2019-11-27,1121,6629,1761,0,9511
779,2019-11-28,407,7264,1012,0,8683
779,2019-11-29,147,952,2,0,1101
779,2019-08-25,117,410,661,0,1188
779,2019-08-26,645,12694,1988,1,15328
779,2019-08-27,656,8437,1700,0,10793
779,2019-08-28,529,1368,1890,1,3788
779,2019-08-29,646,9273,1626,0,11545
779,2019-08-30,466,3749,734,1,4950
779,2019-08-31,89,30,0,0,119
779,2019-09-01,135,69,590,0,794
779,2019-09-02,130,53,22,0,205
779,2019-09-03,141,1095,1587,1,2824
779,2019-09-04,510,12799,2499,1,15809
779,2019-09-05,456,12939,1652,0,15047
779,2019-09-06,1428,9480,2348,1,13257
779,2019-09-07,620,16053,1627,2,18302
779,2019-09-08,1749,8035,2445,0,12229
779,2019-09-09,521,5757,2330,0,8608
779,2019-09-10,453,11139,2062,1,13655
779,2019-09-11,1007,6182,1514,4,8707
779,2019-09-12,284,9470,1507,1,11262
779,2019-09-13,709,6630,2160,0,9499
779,2019-09-14,500,9479,1393,0,11372
779,2019-09-15,408,8600,2140,0,11148
779,2019-09-16,741,9474,2739,2,12956
779,2019-09-17,397,7693,1804,0,9894
779,2019-09-18,563,11668,1331,1,13563
779,2019-09-19,615,2806,1525,1,4947
779,2019-09-20,1527,18334,1563,2,21426
779,2019-09-21,468,7974,2702,2,11146
779,2019-09-22,414,8806,1745,1,10966
779,2019-09-23,1066,11462,2365,0,14893
779,2019-09-24,627,9047,2093,4,11771
779,2019-09-25,1109,7619,1869,6,10603
779,2019-09-26,183,12364,1275,0,13822
779,2019-09-27,183,9201,2688,3,12075
779,2019-09-28,257,15538,2010,1,17806
779,2019-09-29,309,16897,1733,4,18943
779,2019-09-30,164,27142,856,4,28166
779,2019-10-01,183,23284,1532,0,24999
779,2019-10-02,187,12205,1080,0,13472
779,2019-10-03,204,23486,903,1,24594
779,2019-10-04,189,20810,911,2,21912
779,2019-10-05,645,16927,1913,0,19485
779,2019-10-06,1046,12028,1594,1,14669
779,2019-10-07,192,6623,1792,2,8609
779,2019-10-08,257,18666,1793,0,20716
779,2019-10-09,170,17191,1834,2,19197
779,2019-10-10,419,10590,2041,4,13054
779,2019-10-11,2150,13728,1514,1,17393
779,2019-10-12,387,8915,2254,0,11556
779,2019-10-13,371,13239,1112,2,14724
779,2019-10-14,384,8605,2067,1,11057
779,2019-10-15,471,15150,1678,4,17303
779,2019-10-16,763,25928,1911,1,28603
779,2019-10-17,443,8967,1831,2,11243
779,2019-10-18,1009,8558,1349,0,10916
779,2019-10-19,523,5642,1824,1,7990
779,2019-10-20,551,3189,1800,3,5543
779,2019-10-21,497,10707,1290,2,12496
779,2019-10-22,669,6616,2193,1,9479
779,2019-10-23,422,9499,971,1,10893
779,2019-10-24,768,14284,1167,1,16220
779,2019-10-25,1037,15964,1660,3,18664
779,2019-10-26,967,28351,1583,0,30901
779,2019-10-27,1314,19335,2292,0,22941
779,2019-10-28,1196,14390,1612,0,17198
779,2019-10-29,489,17276,2148,0,19913
779,2019-10-30,434,15994,967,3,17398
779,2019-10-31,422,12765,1406,0,14593
779,2019-11-01,392,25346,1613,1,27352
779,2019-11-02,452,26680,1703,0,28835
779,2019-11-03,383,24760,1263,0,26406
779,2019-11-04,992,8160,1676,3,10831
779,2019-11-05,1127,3430,2700,0,7257
779,2019-11-06,415,8996,1244,0,10655
779,2019-11-07,496,14335,624,1,15456
779,2019-11-08,435,10304,1071,0,11810
779,2019-11-09,435,13988,1701,2,16126
779,2019-11-10,354,14735,1308,0,16397
779,2019-11-11,532,14586,1144,2,16264
779,2019-11-12,1909,12869,2839,1,17618
779,2019-11-13,461,19661,1479,1,21602
779,2019-11-14,406,10917,1792,5,13120
779,2019-11-15,397,4145,3235,0,7777
779,2019-11-16,429,2714,3034,1,6178
779,2019-11-17,475,2650,3939,2,7066
779,2019-11-18,488,3242,2970,2,6702
779,2019-11-19,595,3304,2523,1,6423
779,2019-11-20,1341,2039,1996,0,5376
779,2019-11-21,432,3481,2242,0,6155
779,2019-11-22,475,4729,1211,0,6415
779,2019-11-23,392,6163,2060,0,8615
779,2019-11-24,529,5020,1461,0,7010
779,2019-11-25,733,6912,2362,0,10007
779,2019-11-26,524,9962,1678,0,12164
779,2019-11-27,1121,6629,1761,0,9511
779,2019-11-28,407,7264,1012,0,8683
779,2019-11-29,147,952,2,0,1101
779,2019-08-26,645,12694,1988,1,15328
779,2019-08-27,656,8437,1700,0,10793
779,2019-08-28,529,1368,1890,1,3788
779,2019-08-29,646,9273,1626,0,11545
779,2019-08-30,466,3749,734,1,4950
779,2019-08-31,89,30,0,0,119
779,2019-09-01,135,69,590,0,794
779,2019-09-02,130,53,22,0,205
779,2019-09-03,141,1095,1587,1,2824
779,2019-09-04,510,12799,2499,1,15809
779,2019-09-05,456,12939,1652,0,15047
779,2019-09-06,1428,9480,2348,1,13257
779,2019-09-07,620,16053,1627,2,18302
779,2019-09-08,1749,8035,2445,0,12229
779,2019-09-09,521,5757,2330,0,8608
779,2019-09-10,453,11139,2062,1,13655
779,2019-09-11,1007,6182,1514,4,8707
779,2019-09-12,284,9470,1507,1,11262
779,2019-09-13,709,6630,2160,0,9499
779,2019-09-14,500,9479,1393,0,11372
779,2019-09-15,408,8600,2140,0,11148
779,2019-09-16,741,9474,2739,2,12956
779,2019-09-17,397,7693,1804,0,9894
779,2019-09-18,563,11668,1331,1,13563
779,2019-09-19,615,2806,1525,1,4947
779,2019-09-20,1527,18334,1563,2,21426
779,2019-09-21,468,7974,2702,2,11146
779,2019-09-22,414,8806,1745,1,10966
779,2019-09-23,1066,11462,2365,0,14893
779,2019-09-24,627,9047,2093,4,11771
779,2019-09-25,1109,7619,1869,6,10603
779,2019-09-26,183,12364,1275,0,13822
779,2019-09-27,183,9201,2688,3,12075
779,2019-09-28,257,15538,2010,1,17806
779,2019-09-29,309,16897,1733,4,18943
779,2019-09-30,164,27142,856,4,28166
779,2019-10-01,183,23284,1532,0,24999
779,2019-10-02,187,12205,1080,0,13472
779,2019-10-03,204,23486,903,1,24594
779,2019-10-04,189,20810,911,2,21912
779,2019-10-05,645,16927,1913,0,19485
779,2019-10-06,1046,12028,1594,1,14669
779,2019-10-07,192,6623,1792,2,8609
779,2019-10-08,257,18666,1793,0,20716
779,2019-10-09,170,17191,1834,2,19197
779,2019-10-10,419,10590,2041,4,13054
779,2019-10-11,2150,13728,1514,1,17393
779,2019-10-12,387,8915,2254,0,11556
779,2019-10-13,371,13239,1112,2,14724
779,2019-10-14,384,8605,2067,1,11057
779,2019-10-15,471,15150,1678,4,17303
779,2019-10-16,763,25928,1911,1,28603
779,2019-10-17,443,8967,1831,2,11243
779,2019-10-18,1009,8558,1349,0,10916
779,2019-10-19,523,5642,1824,1,7990
779,2019-10-20,551,3189,1800,3,5543
779,2019-10-21,497,10707,1290,2,12496
779,2019-10-22,669,6616,2193,1,9479
779,2019-10-23,422,9499,971,1,10893
779,2019-10-24,768,14284,1167,1,16220
779,2019-10-25,1037,15964,1660,3,18664
779,2019-10-26,967,28351,1583,0,30901
779,2019-10-27,1314,19335,2292,0,22941
779,2019-10-28,1196,14390,1612,0,17198
779,2019-10-29,489,17276,2148,0,19913
779,2019-10-30,434,15994,967,3,17398
779,2019-10-31,422,12765,1406,0,14593
779,2019-11-01,392,25346,1613,1,27352
779,2019-11-02,452,26680,1703,0,28835
779,2019-11-03,383,24760,1263,0,26406
779,2019-11-04,992,8160,1676,3,10831
779,2019-11-05,1127,3430,2700,0,7257
779,2019-11-06,415,8996,1244,0,10655
779,2019-11-07,496,14335,624,1,15456
779,2019-11-08,435,10304,1071,0,11810
779,2019-11-09,435,13988,1701,2,16126
779,2019-11-10,354,14735,1308,0,16397
779,2019-11-11,532,14586,1144,2,16264
779,2019-11-12,1909,12869,2839,1,17618
779,2019-11-13,461,19661,1479,1,21602
779,2019-11-14,406,10917,1792,5,13120
779,2019-11-15,397,4145,3235,0,7777
779,2019-11-16,429,2714,3034,1,6178
779,2019-11-17,475,2650,3939,2,7066
779,2019-11-18,488,3242,2970,2,6702
779,2019-11-19,595,3304,2523,1,6423
780,2019-08-26,373,5473,1731,0,7577
780,2019-08-27,538,7895,1440,2,9875
780,2019-08-28,521,1574,2169,2,4266
780,2019-08-29,574,9712,1743,0,12029
780,2019-08-30,762,3379,270,1,4412
780,2019-08-31,191,118,0,0,309
780,2019-09-01,518,914,540,1,1973
780,2019-09-02,295,925,103,0,1323
780,2019-09-03,559,3413,1663,0,5635
780,2019-09-04,1492,15261,2889,3,19645
780,2019-09-05,824,9677,1425,3,11929
780,2019-09-06,1794,12147,2119,0,16060
780,2019-09-07,1760,8901,2012,1,12674
780,2019-09-08,1717,5209,1856,1,8783
780,2019-09-09,884,10594,2052,0,13530
780,2019-09-10,778,7756,1962,0,10496
780,2019-09-11,2033,8661,2089,1,12784
780,2019-09-12,274,8593,1232,4,10103
780,2019-09-13,697,5622,1734,1,8054
780,2019-09-14,1612,8819,1369,2,11802
780,2019-09-15,1577,8896,2139,0,12612
780,2019-09-16,619,9175,1275,4,11073
780,2019-09-17,709,7419,1893,8,10029
780,2019-09-18,909,19761,1651,11,22332
780,2019-09-19,1163,4067,1171,9,6410
780,2019-09-20,710,11417,1273,11,13411
780,2019-09-21,857,6261,2162,9,9289
780,2019-09-22,693,14543,1254,8,16498
780,2019-09-23,738,13397,1881,11,16027
780,2019-09-24,1376,11997,1551,13,14937
780,2019-09-25,316,10295,1294,13,11918
780,2019-09-26,439,13046,2257,11,15753
780,2019-09-27,363,8550,2574,2,11489
780,2019-09-28,486,15233,1953,3,17675
780,2019-09-29,933,17388,1740,2,20063
780,2019-09-30,481,25150,2860,4,28495
780,2019-10-01,540,25061,2732,1,28334
780,2019-10-02,1504,17355,1566,6,20431
780,2019-10-03,1288,22506,2124,11,25929
780,2019-10-04,520,20474,1708,12,22714
780,2019-10-05,353,23694,1278,10,25335
780,2019-10-06,407,17443,1764,10,19624
780,2019-10-07,335,7068,1378,9,8790
780,2019-10-08,1789,17997,2508,12,22306
780,2019-10-09,856,33577,2090,11,36534
780,2019-10-10,503,12931,2524,11,15969
780,2019-10-11,703,9253,2085,9,12050
780,2019-10-12,2079,6927,2014,0,11020
780,2019-10-13,1915,9209,1486,2,12612
780,2019-10-14,742,6278,1820,1,8841
780,2019-10-15,1375,8569,1851,2,11797
780,2019-10-16,1441,12666,1102,1,15210
780,2019-10-17,636,6068,2817,0,9521
780,2019-10-18,715,8758,1553,1,11027
780,2019-10-19,1210,5659,2051,0,8920
780,2019-10-20,1049,3135,2111,3,6298
780,2019-10-21,1556,11680,1644,0,14880
780,2019-10-22,1594,6355,1667,2,9618
780,2019-10-23,1505,8589,1687,1,11782
780,2019-10-24,839,13827,1138,4,15808
780,2019-10-25,717,11030,1642,2,13391
780,2019-10-26,764,14382,1983,1,17130
780,2019-10-27,1115,28243,1341,1,30700
780,2019-10-28,1521,24957,1556,0,28034
780,2019-10-29,744,17939,1944,1,20628
780,2019-10-30,629,24166,1542,14,26351
780,2019-10-31,683,15102,2403,0,18188
780,2019-11-01,670,25505,1724,0,27899
780,2019-11-02,1667,17028,1760,0,20455
780,2019-11-03,1600,22350,1109,0,25059
780,2019-11-04,588,7989,1385,0,9962
780,2019-11-05,782,3123,1967,0,5872
780,2019-11-06,743,14917,2086,0,17746
780,2019-11-07,809,25571,768,0,27148
780,2019-11-08,568,12630,947,0,14145
780,2019-11-09,660,18333,1743,0,20736
780,2019-11-10,733,14839,1480,0,17052
780,2019-11-11,762,10227,1500,0,12489
780,2019-11-12,661,10467,2848,0,13976
780,2019-11-13,1593,12506,1591,0,15690
780,2019-11-14,645,8178,1563,3,10389
780,2019-11-15,1564,3890,2439,0,7893
780,2019-11-16,690,2998,2404,0,6092
780,2019-11-17,1848,3210,3305,0,8363
780,2019-11-18,697,2567,3540,0,6804
780,2019-11-19,956,3289,2714,2,6961
780,2019-11-20,577,1701,2076,1,4355
780,2019-11-21,572,5480,1491,0,7543
780,2019-11-22,1530,7737,1520,2,10789
780,2019-11-23,1007,6646,1961,1,9615
780,2019-11-24,1406,6942,1757,1,10106
780,2019-11-25,547,6871,1550,0,8968
780,2019-11-26,568,9349,1208,0,11125
780,2019-11-27,937,7191,1680,0,9808
780,2019-11-28,545,13386,585,1,14517
780,2019-11-29,228,348,9,0,585
780,2019-08-26,373,5473,1731,0,7577
780,2019-08-27,538,7895,1440,2,9875
780,2019-08-28,521,1574,2169,2,4266
780,2019-08-29,574,9712,1743,0,12029
780,2019-08-30,762,3379,270,1,4412
780,2019-08-31,191,118,0,0,309
780,2019-09-01,518,914,540,1,1973
780,2019-09-02,295,925,103,0,1323
780,2019-09-03,559,3413,1663,0,5635
780,2019-09-04,1492,15261,2889,3,19645
780,2019-09-05,824,9677,1425,3,11929
780,2019-09-06,1794,12147,2119,0,16060
780,2019-09-07,1760,8901,2012,1,12674
780,2019-09-08,1717,5209,1856,1,8783
780,2019-09-09,884,10594,2052,0,13530
780,2019-09-10,778,7756,1962,0,10496
780,2019-09-11,2033,8661,2089,1,12784
780,2019-09-12,274,8593,1232,4,10103
780,2019-09-13,697,5622,1734,1,8054
780,2019-09-14,1612,8819,1369,2,11802
780,2019-09-15,1577,8896,2139,0,12612
780,2019-09-16,619,9175,1275,4,11073
780,2019-09-17,709,7419,1893,8,10029
780,2019-09-18,909,19761,1651,11,22332
780,2019-09-19,1163,4067,1171,9,6410
780,2019-09-20,710,11417,1273,11,13411
780,2019-09-21,857,6261,2162,9,9289
780,2019-09-22,693,14543,1254,8,16498
780,2019-09-23,738,13397,1881,11,16027
780,2019-09-24,1376,11997,1551,13,14937
780,2019-09-25,316,10295,1294,13,11918
780,2019-09-26,439,13046,2257,11,15753
780,2019-09-27,363,8550,2574,2,11489
780,2019-09-28,486,15233,1953,3,17675
780,2019-09-29,933,17388,1740,2,20063
780,2019-09-30,481,25150,2860,4,28495
780,2019-10-01,540,25061,2732,1,28334
780,2019-10-02,1504,17355,1566,6,20431
780,2019-10-03,1288,22506,2124,11,25929
780,2019-10-04,520,20474,1708,12,22714
780,2019-10-05,353,23694,1278,10,25335
780,2019-10-06,407,17443,1764,10,19624
780,2019-10-07,335,7068,1378,9,8790
780,2019-10-08,1789,17997,2508,12,22306
780,2019-10-09,856,33577,2090,11,36534
780,2019-10-10,503,12931,2524,11,15969
780,2019-10-11,703,9253,2085,9,12050
780,2019-10-12,2079,6927,2014,0,11020
780,2019-10-13,1915,9209,1486,2,12612
780,2019-10-14,742,6278,1820,1,8841
780,2019-10-15,1375,8569,1851,2,11797
780,2019-10-16,1441,12666,1102,1,15210
780,2019-10-17,636,6068,2817,0,9521
780,2019-10-18,715,8758,1553,1,11027
780,2019-10-19,1210,5659,2051,0,8920
780,2019-10-20,1049,3135,2111,3,6298
780,2019-10-21,1556,11680,1644,0,14880
780,2019-10-22,1594,6355,1667,2,9618
780,2019-10-23,1505,8589,1687,1,11782
780,2019-10-24,839,13827,1138,4,15808
780,2019-10-25,717,11030,1642,2,13391
780,2019-10-26,764,14382,1983,1,17130
780,2019-10-27,1115,28243,1341,1,30700
780,2019-10-28,1521,24957,1556,0,28034
780,2019-10-29,744,17939,1944,1,20628
780,2019-10-30,629,24166,1542,14,26351
780,2019-10-31,683,15102,2403,0,18188
780,2019-11-01,670,25505,1724,0,27899
780,2019-11-02,1667,17028,1760,0,20455
780,2019-11-03,1600,22350,1109,0,25059
780,2019-11-04,588,7989,1385,0,9962
780,2019-11-05,782,3123,1967,0,5872
780,2019-11-06,743,14917,2086,0,17746
780,2019-11-07,809,25571,768,0,27148
780,2019-11-08,568,12630,947,0,14145
780,2019-11-09,660,18333,1743,0,20736
780,2019-11-10,733,14839,1480,0,17052
780,2019-11-11,762,10227,1500,0,12489
780,2019-11-12,661,10467,2848,0,13976
780,2019-11-13,1593,12506,1591,0,15690
780,2019-11-14,645,8178,1563,3,10389
780,2019-11-15,1564,3890,2439,0,7893
780,2019-11-16,690,2998,2404,0,6092
780,2019-11-17,1848,3210,3305,0,8363
780,2019-11-18,697,2567,3540,0,6804
780,2019-11-19,956,3289,2714,2,6961
780,2019-11-20,577,1701,2076,1,4355
780,2019-11-21,572,5480,1491,0,7543
780,2019-11-22,1530,7737,1520,2,10789
780,2019-11-23,1007,6646,1961,1,9615
780,2019-11-24,1406,6942,1757,1,10106
780,2019-11-25,547,6871,1550,0,8968
780,2019-11-26,568,9349,1208,0,11125
780,2019-11-27,937,7191,1680,0,9808
780,2019-11-28,545,13386,585,1,14517
780,2019-11-29,228,348,9,0,585
780,2019-08-26,373,5473,1731,0,7577
780,2019-08-27,538,7895,1440,2,9875
780,2019-08-28,521,1574,2169,2,4266
780,2019-08-29,574,9712,1743,0,12029
780,2019-08-30,762,3379,270,1,4412
780,2019-08-31,191,118,0,0,309
780,2019-09-01,518,914,540,1,1973
780,2019-09-02,295,925,103,0,1323
780,2019-09-03,559,3413,1663,0,5635
780,2019-09-04,1492,15261,2889,3,19645
780,2019-09-05,824,9677,1425,3,11929
780,2019-09-06,1794,12147,2119,0,16060
780,2019-09-07,1760,8901,2012,1,12674
780,2019-09-08,1717,5209,1856,1,8783
780,2019-09-09,884,10594,2052,0,13530
780,2019-09-10,778,7756,1962,0,10496
780,2019-09-11,2033,8661,2089,1,12784
780,2019-09-12,274,8593,1232,4,10103
780,2019-09-13,697,5622,1734,1,8054
780,2019-09-14,1612,8819,1369,2,11802
780,2019-09-15,1577,8896,2139,0,12612
780,2019-09-16,619,9175,1275,4,11073
780,2019-09-17,709,7419,1893,8,10029
780,2019-09-18,909,19761,1651,11,22332
780,2019-09-19,1163,4067,1171,9,6410
780,2019-09-20,710,11417,1273,11,13411
780,2019-09-21,857,6261,2162,9,9289
780,2019-09-22,693,14543,1254,8,16498
780,2019-09-23,738,13397,1881,11,16027
780,2019-09-24,1376,11997,1551,13,14937
780,2019-09-25,316,10295,1294,13,11918
780,2019-09-26,439,13046,2257,11,15753
780,2019-09-27,363,8550,2574,2,11489
780,2019-09-28,486,15233,1953,3,17675
780,2019-09-29,933,17388,1740,2,20063
780,2019-09-30,481,25150,2860,4,28495
780,2019-10-01,540,25061,2732,1,28334
780,2019-10-02,1504,17355,1566,6,20431
780,2019-10-03,1288,22506,2124,11,25929
780,2019-10-04,520,20474,1708,12,22714
780,2019-10-05,353,23694,1278,10,25335
780,2019-10-06,407,17443,1764,10,19624
780,2019-10-07,335,7068,1378,9,8790
780,2019-10-08,1789,17997,2508,12,22306
780,2019-10-09,856,33577,2090,11,36534
780,2019-10-10,503,12931,2524,11,15969
780,2019-10-11,703,9253,2085,9,12050
780,2019-10-12,2079,6927,2014,0,11020
780,2019-10-13,1915,9209,1486,2,12612
780,2019-10-14,742,6278,1820,1,8841
780,2019-10-15,1375,8569,1851,2,11797
780,2019-10-16,1441,12666,1102,1,15210
780,2019-10-17,636,6068,2817,0,9521
780,2019-10-18,715,8758,1553,1,11027
780,2019-10-19,1210,5659,2051,0,8920
780,2019-10-20,1049,3135,2111,3,6298
780,2019-10-21,1556,11680,1644,0,14880
780,2019-10-22,1594,6355,1667,2,9618
780,2019-10-23,1505,8589,1687,1,11782
780,2019-10-24,839,13827,1138,4,15808
780,2019-10-25,717,11030,1642,2,13391
780,2019-10-26,764,14382,1983,1,17130
780,2019-10-27,1115,28243,1341,1,30700
780,2019-10-28,1521,24957,1556,0,28034
780,2019-10-29,744,17939,1944,1,20628
780,2019-10-30,629,24166,1542,14,26351
780,2019-10-31,683,15102,2403,0,18188
780,2019-11-01,670,25505,1724,0,27899
780,2019-11-02,1667,17028,1760,0,20455
780,2019-11-03,1600,22350,1109,0,25059
780,2019-11-04,588,7989,1385,0,9962
780,2019-11-05,782,3123,1967,0,5872
780,2019-11-06,743,14917,2086,0,17746
780,2019-11-07,809,25571,768,0,27148
780,2019-11-08,568,12630,947,0,14145
780,2019-11-09,660,18333,1743,0,20736
780,2019-11-10,733,14839,1480,0,17052
780,2019-11-11,762,10227,1500,0,12489
780,2019-11-12,661,10467,2848,0,13976
780,2019-11-13,1593,12506,1591,0,15690
780,2019-11-14,645,8178,1563,3,10389
780,2019-11-15,1564,3890,2439,0,7893
780,2019-11-16,690,2998,2404,0,6092
780,2019-11-17,1848,3210,3305,0,8363
780,2019-11-18,697,2567,3540,0,6804
780,2019-11-19,956,3289,2714,2,6961
780,2019-11-20,577,1701,2076,1,4355
780,2019-11-21,572,5480,1491,0,7543
780,2019-11-22,1530,7737,1520,2,10789
780,2019-11-23,1007,6646,1961,1,9615
780,2019-11-24,1406,6942,1757,1,10106
780,2019-11-25,547,6871,1550,0,8968
780,2019-11-26,568,9349,1208,0,11125
780,2019-11-27,937,7191,1680,0,9808
780,2019-11-28,545,13386,585,1,14517
780,2019-11-29,228,348,9,0,585
780,2019-08-27,538,7895,1440,2,9875
780,2019-08-28,521,1574,2169,2,4266
780,2019-08-29,574,9712,1743,0,12029
780,2019-08-30,762,3379,270,1,4412
780,2019-08-31,191,118,0,0,309
780,2019-09-01,518,914,540,1,1973
780,2019-09-02,295,925,103,0,1323
780,2019-09-03,559,3413,1663,0,5635
780,2019-09-04,1492,15261,2889,3,19645
780,2019-09-05,824,9677,1425,3,11929
780,2019-09-06,1794,12147,2119,0,16060
780,2019-09-07,1760,8901,2012,1,12674
780,2019-09-08,1717,5209,1856,1,8783
780,2019-09-09,884,10594,2052,0,13530
780,2019-09-10,778,7756,1962,0,10496
780,2019-09-11,2033,8661,2089,1,12784
780,2019-09-12,274,8593,1232,4,10103
780,2019-09-13,697,5622,1734,1,8054
780,2019-09-14,1612,8819,1369,2,11802
780,2019-09-15,1577,8896,2139,0,12612
780,2019-09-16,619,9175,1275,4,11073
780,2019-09-17,709,7419,1893,8,10029
780,2019-09-18,909,19761,1651,11,22332
780,2019-09-19,1163,4067,1171,9,6410
780,2019-09-20,710,11417,1273,11,13411
780,2019-09-21,857,6261,2162,9,9289
780,2019-09-22,693,14543,1254,8,16498
780,2019-09-23,738,13397,1881,11,16027
780,2019-09-24,1376,11997,1551,13,14937
780,2019-09-25,316,10295,1294,13,11918
780,2019-09-26,439,13046,2257,11,15753
780,2019-09-27,363,8550,2574,2,11489
780,2019-09-28,486,15233,1953,3,17675
780,2019-09-29,933,17388,1740,2,20063
780,2019-09-30,481,25150,2860,4,28495
780,2019-10-01,540,25061,2732,1,28334
780,2019-10-02,1504,17355,1566,6,20431
780,2019-10-03,1288,22506,2124,11,25929
780,2019-10-04,520,20474,1708,12,22714
780,2019-10-05,353,23694,1278,10,25335
780,2019-10-06,407,17443,1764,10,19624
780,2019-10-07,335,7068,1378,9,8790
780,2019-10-08,1789,17997,2508,12,22306
780,2019-10-09,856,33577,2090,11,36534
780,2019-10-10,503,12931,2524,11,15969
780,2019-10-11,703,9253,2085,9,12050
780,2019-10-12,2079,6927,2014,0,11020
780,2019-10-13,1915,9209,1486,2,12612
780,2019-10-14,742,6278,1820,1,8841
780,2019-10-15,1375,8569,1851,2,11797
780,2019-10-16,1441,12666,1102,1,15210
780,2019-10-17,636,6068,2817,0,9521
780,2019-10-18,715,8758,1553,1,11027
780,2019-10-19,1210,5659,2051,0,8920
780,2019-10-20,1049,3135,2111,3,6298
780,2019-10-21,1556,11680,1644,0,14880
780,2019-10-22,1594,6355,1667,2,9618
780,2019-10-23,1505,8589,1687,1,11782
780,2019-10-24,839,13827,1138,4,15808
780,2019-10-25,717,11030,1642,2,13391
780,2019-10-26,764,14382,1983,1,17130
780,2019-10-27,1115,28243,1341,1,30700
780,2019-10-28,1521,24957,1556,0,28034
780,2019-10-29,744,17939,1944,1,20628
780,2019-10-30,629,24166,1542,14,26351
780,2019-10-31,683,15102,2403,0,18188
780,2019-11-01,670,25505,1724,0,27899
780,2019-11-02,1667,17028,1760,0,20455
780,2019-11-03,1600,22350,1109,0,25059
780,2019-11-04,588,7989,1385,0,9962
780,2019-11-05,782,3123,1967,0,5872
780,2019-11-06,743,14917,2086,0,17746
780,2019-11-07,809,25571,768,0,27148
780,2019-11-08,568,12630,947,0,14145
780,2019-11-09,660,18333,1743,0,20736
780,2019-11-10,733,14839,1480,0,17052
780,2019-11-11,762,10227,1500,0,12489
780,2019-11-12,661,10467,2848,0,13976
780,2019-11-13,1593,12506,1591,0,15690
780,2019-11-14,645,8178,1563,3,10389
780,2019-11-15,1564,3890,2439,0,7893
780,2019-11-16,690,2998,2404,0,6092
780,2019-11-17,1848,3210,3305,0,8363
780,2019-11-18,697,2567,3540,0,6804
780,2019-11-19,956,3289,2714,2,6961
780,2019-11-20,577,1701,2076,1,4355
780,2019-11-21,572,5480,1491,0,7543
780,2019-11-22,1530,7737,1520,2,10789
780,2019-11-23,1007,6646,1961,1,9615
780,2019-11-24,1406,6942,1757,1,10106
780,2019-11-25,547,6871,1550,0,8968
780,2019-11-26,568,9349,1208,0,11125
780,2019-11-27,937,7191,1680,0,9808
780,2019-11-28,545,13386,585,1,14517
781,2019-08-26,82,3676,1980,0,5738
781,2019-08-27,90,6384,1435,1,7910
781,2019-08-28,171,1963,1890,1,4025
781,2019-08-29,224,10242,1455,0,11921
781,2019-08-30,294,3371,380,1,4046
781,2019-08-31,152,61,0,0,213
781,2019-09-01,164,1056,175,0,1395
781,2019-09-02,159,24,21,0,204
781,2019-09-03,137,4111,1134,0,5382
781,2019-09-04,261,15960,1322,3,17546
781,2019-09-05,319,8752,1606,0,10677
781,2019-09-06,297,11590,1985,0,13872
781,2019-09-07,184,12793,2231,0,15208
781,2019-09-08,295,8615,1977,1,10888
781,2019-09-09,135,7275,1484,0,8894
781,2019-09-10,283,11229,1720,1,13233
781,2019-09-11,266,10459,2511,3,13239
781,2019-09-12,151,13599,1612,2,15364
781,2019-09-13,355,4658,2177,1,7191
781,2019-09-14,124,8412,1340,2,9878
781,2019-09-15,127,10684,1377,0,12188
781,2019-09-16,195,8732,1649,1,10577
781,2019-09-17,1208,10014,1650,0,12872
781,2019-09-18,100,11798,1118,1,13017
781,2019-09-19,255,3920,1718,2,5895
781,2019-09-20,1065,12905,1453,0,15423
781,2019-09-21,991,6044,1991,0,9026
781,2019-09-22,997,15442,1490,0,17929
781,2019-09-23,245,17136,1690,3,19074
781,2019-09-24,1027,12022,1890,4,14943
781,2019-09-25,124,10489,1612,1,12226
781,2019-09-26,687,9972,1387,1,12047
781,2019-09-27,207,13619,2355,1,16182
781,2019-09-28,186,15558,1229,4,16977
781,2019-09-29,194,27307,1555,3,29059
781,2019-09-30,465,21076,1526,269,23336
781,2019-10-01,1008,22451,1563,0,25022
781,2019-10-02,1120,14287,1526,806,17739
781,2019-10-03,219,14522,1598,0,16339
781,2019-10-04,987,18663,1077,3,20730
781,2019-10-05,1148,23223,1810,0,26181
781,2019-10-06,1682,17610,1733,1,21026
781,2019-10-07,1851,7738,1744,0,11333
781,2019-10-08,2328,18318,1030,1,21677
781,2019-10-09,160,25384,1756,2,27302
781,2019-10-10,186,11619,2232,1,14038
781,2019-10-11,263,9036,1103,1,10403
781,2019-10-12,1508,7140,2242,0,10890
781,2019-10-13,1036,9126,2107,0,12269
781,2019-10-14,129,5813,2197,4,8143
781,2019-10-15,294,9177,2295,2,11768
781,2019-10-16,195,18761,1118,1,20075
781,2019-10-17,432,9365,1784,0,11581
781,2019-10-18,308,8525,1978,1,10812
781,2019-10-19,974,5902,1421,0,8297
781,2019-10-20,2544,3054,1447,0,7045
781,2019-10-21,1030,11048,1468,1,13547
781,2019-10-22,104,6880,2060,1,9045
781,2019-10-23,102,8754,1934,1,10791
781,2019-10-24,187,14179,1424,2,15792
781,2019-10-25,149,16131,1321,1,17602
781,2019-10-26,735,18012,1622,2,20371
781,2019-10-27,142,28821,1870,0,30833
781,2019-10-28,216,25531,1649,0,27396
781,2019-10-29,487,17862,2275,3,20627
781,2019-10-30,89,15545,1581,0,17215
781,2019-10-31,165,12830,1076,0,14071
781,2019-11-01,984,25338,1371,1,27694
781,2019-11-02,196,17273,1640,0,19109
781,2019-11-03,1137,22858,1569,3,25567
781,2019-11-04,270,10607,1536,0,12413
781,2019-11-05,131,5302,2143,1,7577
781,2019-11-06,218,8893,1305,1,10417
781,2019-11-07,496,22850,869,2,24217
781,2019-11-08,641,17962,1614,2,20219
781,2019-11-09,841,16230,1657,0,18728
781,2019-11-10,96,15255,1315,0,16666
781,2019-11-11,1062,10318,1596,1,12977
781,2019-11-12,171,10866,2670,2,13709
781,2019-11-13,340,19671,2164,3,22178
781,2019-11-14,135,10813,2322,0,13270
781,2019-11-15,805,3891,3171,2,7869
781,2019-11-16,195,2540,2567,1,5303
781,2019-11-17,1385,2851,3971,3,8210
781,2019-11-18,115,3161,4111,4,7391
781,2019-11-19,158,3133,3048,1,6340
781,2019-11-20,171,1392,2446,0,4009
781,2019-11-21,146,3511,1838,0,5495
781,2019-11-22,172,4651,1447,2,6272
781,2019-11-23,121,9832,2791,0,12744
781,2019-11-24,1165,10487,1959,0,13611
781,2019-11-25,333,11870,1444,0,13647
781,2019-11-26,236,8822,1687,0,10745
781,2019-11-27,1080,10854,1164,0,13098
781,2019-11-28,102,7900,846,0,8848
781,2019-11-29,281,693,4,0,978
781,2019-08-26,82,3676,1980,0,5738
781,2019-08-27,90,6384,1435,1,7910
781,2019-08-28,171,1963,1890,1,4025
781,2019-08-29,224,10242,1455,0,11921
781,2019-08-30,294,3371,380,1,4046
781,2019-08-31,152,61,0,0,213
781,2019-09-01,164,1056,175,0,1395
781,2019-09-02,159,24,21,0,204
781,2019-09-03,137,4111,1134,0,5382
781,2019-09-04,261,15960,1322,3,17546
781,2019-09-05,319,8752,1606,0,10677
781,2019-09-06,297,11590,1985,0,13872
781,2019-09-07,184,12793,2231,0,15208
781,2019-09-08,295,8615,1977,1,10888
781,2019-09-09,135,7275,1484,0,8894
781,2019-09-10,283,11229,1720,1,13233
781,2019-09-11,266,10459,2511,3,13239
781,2019-09-12,151,13599,1612,2,15364
781,2019-09-13,355,4658,2177,1,7191
781,2019-09-14,124,8412,1340,2,9878
781,2019-09-15,127,10684,1377,0,12188
781,2019-09-16,195,8732,1649,1,10577
781,2019-09-17,1208,10014,1650,0,12872
781,2019-09-18,100,11798,1118,1,13017
781,2019-09-19,255,3920,1718,2,5895
781,2019-09-20,1065,12905,1453,0,15423
781,2019-09-21,991,6044,1991,0,9026
781,2019-09-22,997,15442,1490,0,17929
781,2019-09-23,245,17136,1690,3,19074
781,2019-09-24,1027,12022,1890,4,14943
781,2019-09-25,124,10489,1612,1,12226
781,2019-09-26,687,9972,1387,1,12047
781,2019-09-27,207,13619,2355,1,16182
781,2019-09-28,186,15558,1229,4,16977
781,2019-09-29,194,27307,1555,3,29059
781,2019-09-30,465,21076,1526,269,23336
781,2019-10-01,1008,22451,1563,0,25022
781,2019-10-02,1120,14287,1526,806,17739
781,2019-10-03,219,14522,1598,0,16339
781,2019-10-04,987,18663,1077,3,20730
781,2019-10-05,1148,23223,1810,0,26181
781,2019-10-06,1682,17610,1733,1,21026
781,2019-10-07,1851,7738,1744,0,11333
781,2019-10-08,2328,18318,1030,1,21677
781,2019-10-09,160,25384,1756,2,27302
781,2019-10-10,186,11619,2232,1,14038
781,2019-10-11,263,9036,1103,1,10403
781,2019-10-12,1508,7140,2242,0,10890
781,2019-10-13,1036,9126,2107,0,12269
781,2019-10-14,129,5813,2197,4,8143
781,2019-10-15,294,9177,2295,2,11768
781,2019-10-16,195,18761,1118,1,20075
781,2019-10-17,432,9365,1784,0,11581
781,2019-10-18,308,8525,1978,1,10812
781,2019-10-19,974,5902,1421,0,8297
781,2019-10-20,2544,3054,1447,0,7045
781,2019-10-21,1030,11048,1468,1,13547
781,2019-10-22,104,6880,2060,1,9045
781,2019-10-23,102,8754,1934,1,10791
781,2019-10-24,187,14179,1424,2,15792
781,2019-10-25,149,16131,1321,1,17602
781,2019-10-26,735,18012,1622,2,20371
781,2019-10-27,142,28821,1870,0,30833
781,2019-10-28,216,25531,1649,0,27396
781,2019-10-29,487,17862,2275,3,20627
781,2019-10-30,89,15545,1581,0,17215
781,2019-10-31,165,12830,1076,0,14071
781,2019-11-01,984,25338,1371,1,27694
781,2019-11-02,196,17273,1640,0,19109
781,2019-11-03,1137,22858,1569,3,25567
781,2019-11-04,270,10607,1536,0,12413
781,2019-11-05,131,5302,2143,1,7577
781,2019-11-06,218,8893,1305,1,10417
781,2019-11-07,496,22850,869,2,24217
781,2019-11-08,641,17962,1614,2,20219
781,2019-11-09,841,16230,1657,0,18728
781,2019-11-10,96,15255,1315,0,16666
781,2019-11-11,1062,10318,1596,1,12977
781,2019-11-12,171,10866,2670,2,13709
781,2019-11-13,340,19671,2164,3,22178
781,2019-11-14,135,10813,2322,0,13270
781,2019-11-15,805,3891,3171,2,7869
781,2019-11-16,195,2540,2567,1,5303
781,2019-11-17,1385,2851,3971,3,8210
781,2019-11-18,115,3161,4111,4,7391
781,2019-11-19,158,3133,3048,1,6340
781,2019-11-20,171,1392,2446,0,4009
781,2019-11-21,146,3511,1838,0,5495
781,2019-11-22,172,4651,1447,2,6272
781,2019-11-23,121,9832,2791,0,12744
781,2019-11-24,1165,10487,1959,0,13611
781,2019-11-25,333,11870,1444,0,13647
781,2019-11-26,236,8822,1687,0,10745
781,2019-11-27,1080,10854,1164,0,13098
781,2019-11-28,102,7900,846,0,8848
781,2019-11-29,281,693,4,0,978
781,2019-08-26,82,3676,1980,0,5738
781,2019-08-27,90,6384,1435,1,7910
781,2019-08-28,171,1963,1890,1,4025
781,2019-08-29,224,10242,1455,0,11921
781,2019-08-30,294,3371,380,1,4046
781,2019-08-31,152,61,0,0,213
781,2019-09-01,164,1056,175,0,1395
781,2019-09-02,159,24,21,0,204
781,2019-09-03,137,4111,1134,0,5382
781,2019-09-04,261,15960,1322,3,17546
781,2019-09-05,319,8752,1606,0,10677
781,2019-09-06,297,11590,1985,0,13872
781,2019-09-07,184,12793,2231,0,15208
781,2019-09-08,295,8615,1977,1,10888
781,2019-09-09,135,7275,1484,0,8894
781,2019-09-10,283,11229,1720,1,13233
781,2019-09-11,266,10459,2511,3,13239
781,2019-09-12,151,13599,1612,2,15364
781,2019-09-13,355,4658,2177,1,7191
781,2019-09-14,124,8412,1340,2,9878
781,2019-09-15,127,10684,1377,0,12188
781,2019-09-16,195,8732,1649,1,10577
781,2019-09-17,1208,10014,1650,0,12872
781,2019-09-18,100,11798,1118,1,13017
781,2019-09-19,255,3920,1718,2,5895
781,2019-09-20,1065,12905,1453,0,15423
781,2019-09-21,991,6044,1991,0,9026
781,2019-09-22,997,15442,1490,0,17929
781,2019-09-23,245,17136,1690,3,19074
781,2019-09-24,1027,12022,1890,4,14943
781,2019-09-25,124,10489,1612,1,12226
781,2019-09-26,687,9972,1387,1,12047
781,2019-09-27,207,13619,2355,1,16182
781,2019-09-28,186,15558,1229,4,16977
781,2019-09-29,194,27307,1555,3,29059
781,2019-09-30,465,21076,1526,269,23336
781,2019-10-01,1008,22451,1563,0,25022
781,2019-10-02,1120,14287,1526,806,17739
781,2019-10-03,219,14522,1598,0,16339
781,2019-10-04,987,18663,1077,3,20730
781,2019-10-05,1148,23223,1810,0,26181
781,2019-10-06,1682,17610,1733,1,21026
781,2019-10-07,1851,7738,1744,0,11333
781,2019-10-08,2328,18318,1030,1,21677
781,2019-10-09,160,25384,1756,2,27302
781,2019-10-10,186,11619,2232,1,14038
781,2019-10-11,263,9036,1103,1,10403
781,2019-10-12,1508,7140,2242,0,10890
781,2019-10-13,1036,9126,2107,0,12269
781,2019-10-14,129,5813,2197,4,8143
781,2019-10-15,294,9177,2295,2,11768
781,2019-10-16,195,18761,1118,1,20075
781,2019-10-17,432,9365,1784,0,11581
781,2019-10-18,308,8525,1978,1,10812
781,2019-10-19,974,5902,1421,0,8297
781,2019-10-20,2544,3054,1447,0,7045
781,2019-10-21,1030,11048,1468,1,13547
781,2019-10-22,104,6880,2060,1,9045
781,2019-10-23,102,8754,1934,1,10791
781,2019-10-24,187,14179,1424,2,15792
781,2019-10-25,149,16131,1321,1,17602
781,2019-10-26,735,18012,1622,2,20371
781,2019-10-27,142,28821,1870,0,30833
781,2019-10-28,216,25531,1649,0,27396
781,2019-10-29,487,17862,2275,3,20627
781,2019-10-30,89,15545,1581,0,17215
781,2019-10-31,165,12830,1076,0,14071
781,2019-11-01,984,25338,1371,1,27694
781,2019-11-02,196,17273,1640,0,19109
781,2019-11-03,1137,22858,1569,3,25567
781,2019-11-04,270,10607,1536,0,12413
781,2019-11-05,131,5302,2143,1,7577
781,2019-11-06,218,8893,1305,1,10417
781,2019-11-07,496,22850,869,2,24217
781,2019-11-08,641,17962,1614,2,20219
781,2019-11-09,841,16230,1657,0,18728
781,2019-11-10,96,15255,1315,0,16666
781,2019-11-11,1062,10318,1596,1,12977
781,2019-11-12,171,10866,2670,2,13709
781,2019-11-13,340,19671,2164,3,22178
781,2019-11-14,135,10813,2322,0,13270
781,2019-11-15,805,3891,3171,2,7869
781,2019-11-16,195,2540,2567,1,5303
781,2019-11-17,1385,2851,3971,3,8210
781,2019-11-18,115,3161,4111,4,7391
781,2019-11-19,158,3133,3048,1,6340
781,2019-11-20,171,1392,2446,0,4009
781,2019-11-21,146,3511,1838,0,5495
781,2019-11-22,172,4651,1447,2,6272
781,2019-11-23,121,9832,2791,0,12744
781,2019-11-24,1165,10487,1959,0,13611
781,2019-11-25,333,11870,1444,0,13647
781,2019-11-26,236,8822,1687,0,10745
781,2019-11-27,1080,10854,1164,0,13098
781,2019-11-28,102,7900,846,0,8848
781,2019-11-29,281,693,4,0,978
781,2019-08-27,90,6384,1435,1,7910
781,2019-08-28,171,1963,1890,1,4025
781,2019-08-29,224,10242,1455,0,11921
781,2019-08-30,294,3371,380,1,4046
781,2019-08-31,152,61,0,0,213
781,2019-09-01,164,1056,175,0,1395
781,2019-09-02,159,24,21,0,204
781,2019-09-03,137,4111,1134,0,5382
781,2019-09-04,261,15960,1322,3,17546
781,2019-09-05,319,8752,1606,0,10677
781,2019-09-06,297,11590,1985,0,13872
781,2019-09-07,184,12793,2231,0,15208
781,2019-09-08,295,8615,1977,1,10888
781,2019-09-09,135,7275,1484,0,8894
781,2019-09-10,283,11229,1720,1,13233
781,2019-09-11,266,10459,2511,3,13239
781,2019-09-12,151,13599,1612,2,15364
781,2019-09-13,355,4658,2177,1,7191
781,2019-09-14,124,8412,1340,2,9878
781,2019-09-15,127,10684,1377,0,12188
781,2019-09-16,195,8732,1649,1,10577
781,2019-09-17,1208,10014,1650,0,12872
781,2019-09-18,100,11798,1118,1,13017
781,2019-09-19,255,3920,1718,2,5895
781,2019-09-20,1065,12905,1453,0,15423
781,2019-09-21,991,6044,1991,0,9026
781,2019-09-22,997,15442,1490,0,17929
781,2019-09-23,245,17136,1690,3,19074
781,2019-09-24,1027,12022,1890,4,14943
781,2019-09-25,124,10489,1612,1,12226
781,2019-09-26,687,9972,1387,1,12047
781,2019-09-27,207,13619,2355,1,16182
781,2019-09-28,186,15558,1229,4,16977
781,2019-09-29,194,27307,1555,3,29059
781,2019-09-30,465,21076,1526,269,23336
781,2019-10-01,1008,22451,1563,0,25022
781,2019-10-02,1120,14287,1526,806,17739
781,2019-10-03,219,14522,1598,0,16339
781,2019-10-04,987,18663,1077,3,20730
781,2019-10-05,1148,23223,1810,0,26181
781,2019-10-06,1682,17610,1733,1,21026
781,2019-10-07,1851,7738,1744,0,11333
781,2019-10-08,2328,18318,1030,1,21677
781,2019-10-09,160,25384,1756,2,27302
781,2019-10-10,186,11619,2232,1,14038
781,2019-10-11,263,9036,1103,1,10403
781,2019-10-12,1508,7140,2242,0,10890
781,2019-10-13,1036,9126,2107,0,12269
781,2019-10-14,129,5813,2197,4,8143
781,2019-10-15,294,9177,2295,2,11768
781,2019-10-16,195,18761,1118,1,20075
781,2019-10-17,432,9365,1784,0,11581
781,2019-10-18,308,8525,1978,1,10812
781,2019-10-19,974,5902,1421,0,8297
781,2019-10-20,2544,3054,1447,0,7045
781,2019-10-21,1030,11048,1468,1,13547
781,2019-10-22,104,6880,2060,1,9045
781,2019-10-23,102,8754,1934,1,10791
781,2019-10-24,187,14179,1424,2,15792
781,2019-10-25,149,16131,1321,1,17602
781,2019-10-26,735,18012,1622,2,20371
781,2019-10-27,142,28821,1870,0,30833
781,2019-10-28,216,25531,1649,0,27396
781,2019-10-29,487,17862,2275,3,20627
781,2019-10-30,89,15545,1581,0,17215
781,2019-10-31,165,12830,1076,0,14071
781,2019-11-01,984,25338,1371,1,27694
781,2019-11-02,196,17273,1640,0,19109
781,2019-11-03,1137,22858,1569,3,25567
781,2019-11-04,270,10607,1536,0,12413
781,2019-11-05,131,5302,2143,1,7577
781,2019-11-06,218,8893,1305,1,10417
781,2019-11-07,496,22850,869,2,24217
781,2019-11-08,641,17962,1614,2,20219
781,2019-11-09,841,16230,1657,0,18728
781,2019-11-10,96,15255,1315,0,16666
781,2019-11-11,1062,10318,1596,1,12977
781,2019-11-12,171,10866,2670,2,13709
781,2019-11-13,340,19671,2164,3,22178
781,2019-11-14,135,10813,2322,0,13270
781,2019-11-15,805,3891,3171,2,7869
781,2019-11-16,195,2540,2567,1,5303
781,2019-11-17,1385,2851,3971,3,8210
781,2019-11-18,115,3161,4111,4,7391
781,2019-11-19,158,3133,3048,1,6340
781,2019-11-20,171,1392,2446,0,4009
781,2019-11-21,146,3511,1838,0,5495
781,2019-11-22,172,4651,1447,2,6272
782,2019-08-27,1303,8782,1171,0,11256
782,2019-08-28,1143,1697,1980,1,4821
782,2019-08-29,454,8954,1533,1,10942
782,2019-08-30,261,3147,916,1,4325
782,2019-08-31,53,47,1,0,101
782,2019-09-01,159,582,593,0,1334
782,2019-09-02,72,256,24,1,353
782,2019-09-03,238,353,570,0,1161
782,2019-09-04,364,12473,2121,1,14959
782,2019-09-05,2035,7556,2401,0,11992
782,2019-09-06,354,11834,1744,2,13934
782,2019-09-07,347,20167,2006,1,22521
782,2019-09-08,357,8332,1658,1,10348
782,2019-09-09,1174,10634,1881,1,13690
782,2019-09-10,269,11053,2132,0,13454
782,2019-09-11,238,8924,2377,3,11542
782,2019-09-12,139,10545,2400,1,13085
782,2019-09-13,1271,4607,2622,0,8500
782,2019-09-14,1660,12204,1850,1,15715
782,2019-09-15,285,7646,2243,1,10175
782,2019-09-16,233,8588,2012,0,10833
782,2019-09-17,260,11508,1890,2,13660
782,2019-09-18,334,19471,1374,0,21179
782,2019-09-19,807,2784,1980,0,5571
782,2019-09-20,393,11483,1912,0,13788
782,2019-09-21,267,8043,1561,4,9875
782,2019-09-22,228,8424,1614,1,10267
782,2019-09-23,369,11615,1887,1,13872
782,2019-09-24,371,15219,1826,2,17418
782,2019-09-25,153,10077,1975,4,12209
782,2019-09-26,190,13316,2538,5,16049
782,2019-09-27,973,8702,2770,1,12446
782,2019-09-28,1006,15871,1848,1,18726
782,2019-09-29,990,26974,1304,1,29269
782,2019-09-30,493,30318,1395,0,32206
782,2019-10-01,118,23036,1041,2,24197
782,2019-10-02,175,12469,1768,1,14413
782,2019-10-03,167,22848,1730,1,24746
782,2019-10-04,189,20945,935,0,22069
782,2019-10-05,234,25012,2124,1,27371
782,2019-10-06,1190,19140,1537,2,21869
782,2019-10-07,465,6322,1735,2,8524
782,2019-10-08,1894,18562,1061,0,21517
782,2019-10-09,261,26616,1548,0,28425
782,2019-10-10,1347,13096,2764,1,17208
782,2019-10-11,1207,10937,1813,2,13959
782,2019-10-12,231,7197,1957,2,9387
782,2019-10-13,713,8931,1685,0,11329
782,2019-10-14,335,7825,1580,3,9743
782,2019-10-15,241,8896,1439,0,10576
782,2019-10-16,749,12618,1735,2,15104
782,2019-10-17,242,5420,2337,2,8001
782,2019-10-18,402,14642,1312,1,16357
782,2019-10-19,297,8513,1256,0,10066
782,2019-10-20,1169,3046,2650,0,6865
782,2019-10-21,253,10677,1714,4,12648
782,2019-10-22,241,6602,1765,1,8609
782,2019-10-23,1091,9227,1734,1,12053
782,2019-10-24,357,14007,1593,0,15957
782,2019-10-25,269,10822,1517,1,12609
782,2019-10-26,1455,14538,1558,1,17552
782,2019-10-27,554,16738,1116,0,18408
782,2019-10-28,297,14175,2585,1,17058
782,2019-10-29,826,15609,1172,0,17607
782,2019-10-30,260,15792,850,0,16902
782,2019-10-31,235,12709,1656,5,14605
782,2019-11-01,248,14660,1284,0,16192
782,2019-11-02,1529,14504,944,0,16977
782,2019-11-03,1017,22657,1343,0,25017
782,2019-11-04,252,8441,2103,0,10796
782,2019-11-05,342,3736,950,1,5029
782,2019-11-06,368,8807,1672,2,10849
782,2019-11-07,326,14186,1267,0,15779
782,2019-11-08,277,10133,1426,2,11838
782,2019-11-09,281,8993,2324,0,11598
782,2019-11-10,298,25449,1462,1,27210
782,2019-11-11,770,17671,1571,2,20014
782,2019-11-12,351,12900,3040,1,16292
782,2019-11-13,382,20642,1599,4,22627
782,2019-11-14,247,14431,2263,2,16943
782,2019-11-15,347,5641,2800,1,8789
782,2019-11-16,593,2466,1982,1,5042
782,2019-11-17,406,3596,3640,0,7642
782,2019-11-18,253,2759,3368,0,6380
782,2019-11-19,584,3129,2339,1,6053
782,2019-11-20,285,1893,1788,4,3970
782,2019-11-21,276,5538,1510,0,7324
782,2019-11-22,263,8118,1927,2,10310
782,2019-11-23,264,6682,2269,1,9216
782,2019-11-24,349,6963,2191,1,9504
782,2019-11-25,579,6916,1929,0,9424
782,2019-11-26,236,9901,1458,2,11597
782,2019-11-27,246,6417,1755,0,8418
782,2019-11-28,1580,6432,1017,0,9029
782,2019-11-29,132,172,21,0,325
782,2019-08-27,1303,8782,1171,0,11256
782,2019-08-28,1143,1697,1980,1,4821
782,2019-08-29,454,8954,1533,1,10942
782,2019-08-30,261,3147,916,1,4325
782,2019-08-31,53,47,1,0,101
782,2019-09-01,159,582,593,0,1334
782,2019-09-02,72,256,24,1,353
782,2019-09-03,238,353,570,0,1161
782,2019-09-04,364,12473,2121,1,14959
782,2019-09-05,2035,7556,2401,0,11992
782,2019-09-06,354,11834,1744,2,13934
782,2019-09-07,347,20167,2006,1,22521
782,2019-09-08,357,8332,1658,1,10348
782,2019-09-09,1174,10634,1881,1,13690
782,2019-09-10,269,11053,2132,0,13454
782,2019-09-11,238,8924,2377,3,11542
782,2019-09-12,139,10545,2400,1,13085
782,2019-09-13,1271,4607,2622,0,8500
782,2019-09-14,1660,12204,1850,1,15715
782,2019-09-15,285,7646,2243,1,10175
782,2019-09-16,233,8588,2012,0,10833
782,2019-09-17,260,11508,1890,2,13660
782,2019-09-18,334,19471,1374,0,21179
782,2019-09-19,807,2784,1980,0,5571
782,2019-09-20,393,11483,1912,0,13788
782,2019-09-21,267,8043,1561,4,9875
782,2019-09-22,228,8424,1614,1,10267
782,2019-09-23,369,11615,1887,1,13872
782,2019-09-24,371,15219,1826,2,17418
782,2019-09-25,153,10077,1975,4,12209
782,2019-09-26,190,13316,2538,5,16049
782,2019-09-27,973,8702,2770,1,12446
782,2019-09-28,1006,15871,1848,1,18726
782,2019-09-29,990,26974,1304,1,29269
782,2019-09-30,493,30318,1395,0,32206
782,2019-10-01,118,23036,1041,2,24197
782,2019-10-02,175,12469,1768,1,14413
782,2019-10-03,167,22848,1730,1,24746
782,2019-10-04,189,20945,935,0,22069
782,2019-10-05,234,25012,2124,1,27371
782,2019-10-06,1190,19140,1537,2,21869
782,2019-10-07,465,6322,1735,2,8524
782,2019-10-08,1894,18562,1061,0,21517
782,2019-10-09,261,26616,1548,0,28425
782,2019-10-10,1347,13096,2764,1,17208
782,2019-10-11,1207,10937,1813,2,13959
782,2019-10-12,231,7197,1957,2,9387
782,2019-10-13,713,8931,1685,0,11329
782,2019-10-14,335,7825,1580,3,9743
782,2019-10-15,241,8896,1439,0,10576
782,2019-10-16,749,12618,1735,2,15104
782,2019-10-17,242,5420,2337,2,8001
782,2019-10-18,402,14642,1312,1,16357
782,2019-10-19,297,8513,1256,0,10066
782,2019-10-20,1169,3046,2650,0,6865
782,2019-10-21,253,10677,1714,4,12648
782,2019-10-22,241,6602,1765,1,8609
782,2019-10-23,1091,9227,1734,1,12053
782,2019-10-24,357,14007,1593,0,15957
782,2019-10-25,269,10822,1517,1,12609
782,2019-10-26,1455,14538,1558,1,17552
782,2019-10-27,554,16738,1116,0,18408
782,2019-10-28,297,14175,2585,1,17058
782,2019-10-29,826,15609,1172,0,17607
782,2019-10-30,260,15792,850,0,16902
782,2019-10-31,235,12709,1656,5,14605
782,2019-11-01,248,14660,1284,0,16192
782,2019-11-02,1529,14504,944,0,16977
782,2019-11-03,1017,22657,1343,0,25017
782,2019-11-04,252,8441,2103,0,10796
782,2019-11-05,342,3736,950,1,5029
782,2019-11-06,368,8807,1672,2,10849
782,2019-11-07,326,14186,1267,0,15779
782,2019-11-08,277,10133,1426,2,11838
782,2019-11-09,281,8993,2324,0,11598
782,2019-11-10,298,25449,1462,1,27210
782,2019-11-11,770,17671,1571,2,20014
782,2019-11-12,351,12900,3040,1,16292
782,2019-11-13,382,20642,1599,4,22627
782,2019-11-14,247,14431,2263,2,16943
782,2019-11-15,347,5641,2800,1,8789
782,2019-11-16,593,2466,1982,1,5042
782,2019-11-17,406,3596,3640,0,7642
782,2019-11-18,253,2759,3368,0,6380
782,2019-11-19,584,3129,2339,1,6053
782,2019-11-20,285,1893,1788,4,3970
782,2019-11-21,276,5538,1510,0,7324
782,2019-11-22,263,8118,1927,2,10310
782,2019-11-23,264,6682,2269,1,9216
782,2019-11-24,349,6963,2191,1,9504
782,2019-11-25,579,6916,1929,0,9424
782,2019-11-26,236,9901,1458,2,11597
782,2019-11-27,246,6417,1755,0,8418
782,2019-11-28,1580,6432,1017,0,9029
782,2019-11-29,132,172,21,0,325
782,2019-08-27,1303,8782,1171,0,11256
782,2019-08-28,1143,1697,1980,1,4821
782,2019-08-29,454,8954,1533,1,10942
782,2019-08-30,261,3147,916,1,4325
782,2019-08-31,53,47,1,0,101
782,2019-09-01,159,582,593,0,1334
782,2019-09-02,72,256,24,1,353
782,2019-09-03,238,353,570,0,1161
782,2019-09-04,364,12473,2121,1,14959
782,2019-09-05,2035,7556,2401,0,11992
782,2019-09-06,354,11834,1744,2,13934
782,2019-09-07,347,20167,2006,1,22521
782,2019-09-08,357,8332,1658,1,10348
782,2019-09-09,1174,10634,1881,1,13690
782,2019-09-10,269,11053,2132,0,13454
782,2019-09-11,238,8924,2377,3,11542
782,2019-09-12,139,10545,2400,1,13085
782,2019-09-13,1271,4607,2622,0,8500
782,2019-09-14,1660,12204,1850,1,15715
782,2019-09-15,285,7646,2243,1,10175
782,2019-09-16,233,8588,2012,0,10833
782,2019-09-17,260,11508,1890,2,13660
782,2019-09-18,334,19471,1374,0,21179
782,2019-09-19,807,2784,1980,0,5571
782,2019-09-20,393,11483,1912,0,13788
782,2019-09-21,267,8043,1561,4,9875
782,2019-09-22,228,8424,1614,1,10267
782,2019-09-23,369,11615,1887,1,13872
782,2019-09-24,371,15219,1826,2,17418
782,2019-09-25,153,10077,1975,4,12209
782,2019-09-26,190,13316,2538,5,16049
782,2019-09-27,973,8702,2770,1,12446
782,2019-09-28,1006,15871,1848,1,18726
782,2019-09-29,990,26974,1304,1,29269
782,2019-09-30,493,30318,1395,0,32206
782,2019-10-01,118,23036,1041,2,24197
782,2019-10-02,175,12469,1768,1,14413
782,2019-10-03,167,22848,1730,1,24746
782,2019-10-04,189,20945,935,0,22069
782,2019-10-05,234,25012,2124,1,27371
782,2019-10-06,1190,19140,1537,2,21869
782,2019-10-07,465,6322,1735,2,8524
782,2019-10-08,1894,18562,1061,0,21517
782,2019-10-09,261,26616,1548,0,28425
782,2019-10-10,1347,13096,2764,1,17208
782,2019-10-11,1207,10937,1813,2,13959
782,2019-10-12,231,7197,1957,2,9387
782,2019-10-13,713,8931,1685,0,11329
782,2019-10-14,335,7825,1580,3,9743
782,2019-10-15,241,8896,1439,0,10576
782,2019-10-16,749,12618,1735,2,15104
782,2019-10-17,242,5420,2337,2,8001
782,2019-10-18,402,14642,1312,1,16357
782,2019-10-19,297,8513,1256,0,10066
782,2019-10-20,1169,3046,2650,0,6865
782,2019-10-21,253,10677,1714,4,12648
782,2019-10-22,241,6602,1765,1,8609
782,2019-10-23,1091,9227,1734,1,12053
782,2019-10-24,357,14007,1593,0,15957
782,2019-10-25,269,10822,1517,1,12609
782,2019-10-26,1455,14538,1558,1,17552
782,2019-10-27,554,16738,1116,0,18408
782,2019-10-28,297,14175,2585,1,17058
782,2019-10-29,826,15609,1172,0,17607
782,2019-10-30,260,15792,850,0,16902
782,2019-10-31,235,12709,1656,5,14605
782,2019-11-01,248,14660,1284,0,16192
782,2019-11-02,1529,14504,944,0,16977
782,2019-11-03,1017,22657,1343,0,25017
782,2019-11-04,252,8441,2103,0,10796
782,2019-11-05,342,3736,950,1,5029
782,2019-11-06,368,8807,1672,2,10849
782,2019-11-07,326,14186,1267,0,15779
782,2019-11-08,277,10133,1426,2,11838
782,2019-11-09,281,8993,2324,0,11598
782,2019-11-10,298,25449,1462,1,27210
782,2019-11-11,770,17671,1571,2,20014
782,2019-11-12,351,12900,3040,1,16292
782,2019-11-13,382,20642,1599,4,22627
782,2019-11-14,247,14431,2263,2,16943
782,2019-11-15,347,5641,2800,1,8789
782,2019-11-16,593,2466,1982,1,5042
782,2019-11-17,406,3596,3640,0,7642
782,2019-11-18,253,2759,3368,0,6380
782,2019-11-19,584,3129,2339,1,6053
782,2019-11-20,285,1893,1788,4,3970
782,2019-11-21,276,5538,1510,0,7324
782,2019-11-22,263,8118,1927,2,10310
782,2019-11-23,264,6682,2269,1,9216
782,2019-11-24,349,6963,2191,1,9504
782,2019-11-25,579,6916,1929,0,9424
782,2019-11-26,236,9901,1458,2,11597
782,2019-11-27,246,6417,1755,0,8418
782,2019-11-28,1580,6432,1017,0,9029
782,2019-11-29,132,172,21,0,325
782,2019-08-28,1143,1697,1980,1,4821
782,2019-08-29,454,8954,1533,1,10942
782,2019-08-30,261,3147,916,1,4325
782,2019-08-31,53,47,1,0,101
782,2019-09-01,159,582,593,0,1334
782,2019-09-02,72,256,24,1,353
782,2019-09-03,238,353,570,0,1161
782,2019-09-04,364,12473,2121,1,14959
782,2019-09-05,2035,7556,2401,0,11992
782,2019-09-06,354,11834,1744,2,13934
782,2019-09-07,347,20167,2006,1,22521
782,2019-09-08,357,8332,1658,1,10348
782,2019-09-09,1174,10634,1881,1,13690
782,2019-09-10,269,11053,2132,0,13454
782,2019-09-11,238,8924,2377,3,11542
782,2019-09-12,139,10545,2400,1,13085
782,2019-09-13,1271,4607,2622,0,8500
782,2019-09-14,1660,12204,1850,1,15715
782,2019-09-15,285,7646,2243,1,10175
782,2019-09-16,233,8588,2012,0,10833
782,2019-09-17,260,11508,1890,2,13660
782,2019-09-18,334,19471,1374,0,21179
782,2019-09-19,807,2784,1980,0,5571
782,2019-09-20,393,11483,1912,0,13788
782,2019-09-21,267,8043,1561,4,9875
782,2019-09-22,228,8424,1614,1,10267
782,2019-09-23,369,11615,1887,1,13872
782,2019-09-24,371,15219,1826,2,17418
782,2019-09-25,153,10077,1975,4,12209
782,2019-09-26,190,13316,2538,5,16049
782,2019-09-27,973,8702,2770,1,12446
782,2019-09-28,1006,15871,1848,1,18726
782,2019-09-29,990,26974,1304,1,29269
782,2019-09-30,493,30318,1395,0,32206
782,2019-10-01,118,23036,1041,2,24197
782,2019-10-02,175,12469,1768,1,14413
782,2019-10-03,167,22848,1730,1,24746
782,2019-10-04,189,20945,935,0,22069
782,2019-10-05,234,25012,2124,1,27371
782,2019-10-06,1190,19140,1537,2,21869
782,2019-10-07,465,6322,1735,2,8524
782,2019-10-08,1894,18562,1061,0,21517
782,2019-10-09,261,26616,1548,0,28425
782,2019-10-10,1347,13096,2764,1,17208
782,2019-10-11,1207,10937,1813,2,13959
782,2019-10-12,231,7197,1957,2,9387
782,2019-10-13,713,8931,1685,0,11329
782,2019-10-14,335,7825,1580,3,9743
782,2019-10-15,241,8896,1439,0,10576
782,2019-10-16,749,12618,1735,2,15104
782,2019-10-17,242,5420,2337,2,8001
782,2019-10-18,402,14642,1312,1,16357
782,2019-10-19,297,8513,1256,0,10066
782,2019-10-20,1169,3046,2650,0,6865
782,2019-10-21,253,10677,1714,4,12648
782,2019-10-22,241,6602,1765,1,8609
782,2019-10-23,1091,9227,1734,1,12053
782,2019-10-24,357,14007,1593,0,15957
782,2019-10-25,269,10822,1517,1,12609
782,2019-10-26,1455,14538,1558,1,17552
782,2019-10-27,554,16738,1116,0,18408
782,2019-10-28,297,14175,2585,1,17058
782,2019-10-29,826,15609,1172,0,17607
782,2019-10-30,260,15792,850,0,16902
782,2019-10-31,235,12709,1656,5,14605
782,2019-11-01,248,14660,1284,0,16192
782,2019-11-02,1529,14504,944,0,16977
782,2019-11-03,1017,22657,1343,0,25017
782,2019-11-04,252,8441,2103,0,10796
782,2019-11-05,342,3736,950,1,5029
782,2019-11-06,368,8807,1672,2,10849
782,2019-11-07,326,14186,1267,0,15779
782,2019-11-08,277,10133,1426,2,11838
782,2019-11-09,281,8993,2324,0,11598
782,2019-11-10,298,25449,1462,1,27210
782,2019-11-11,770,17671,1571,2,20014
782,2019-11-12,351,12900,3040,1,16292
782,2019-11-13,382,20642,1599,4,22627
782,2019-11-14,247,14431,2263,2,16943
782,2019-11-15,347,5641,2800,1,8789
782,2019-11-16,593,2466,1982,1,5042
782,2019-11-17,406,3596,3640,0,7642
782,2019-11-18,253,2759,3368,0,6380
782,2019-11-19,584,3129,2339,1,6053
782,2019-11-20,285,1893,1788,4,3970
782,2019-11-21,276,5538,1510,0,7324
782,2019-11-22,263,8118,1927,2,10310
782,2019-11-23,264,6682,2269,1,9216
782,2019-11-24,349,6963,2191,1,9504
782,2019-11-25,579,6916,1929,0,9424
782,2019-11-26,236,9901,1458,2,11597
783,2019-08-27,241,6381,1440,2,8064
783,2019-08-28,228,26232,1659,2,28121
783,2019-08-29,454,13950,1829,0,16233
783,2019-08-30,263,2900,478,1,3642
783,2019-08-31,132,28,0,0,160
783,2019-09-01,666,1032,274,2,1974
783,2019-09-02,149,23,37,0,209
783,2019-09-03,206,396,1283,0,1885
783,2019-09-04,1098,6262,2012,0,9372
783,2019-09-05,380,14690,4623,1,19694
783,2019-09-06,308,12141,1806,0,14255
783,2019-09-07,343,12400,1655,0,14398
783,2019-09-08,1242,4168,1579,1,6990
783,2019-09-09,1091,6958,1554,1,9604
783,2019-09-10,1097,13286,1875,1,16259
783,2019-09-11,2160,8879,1871,3,12913
783,2019-09-12,1073,7139,1299,0,9511
783,2019-09-13,156,3389,1830,0,5375
783,2019-09-14,357,7028,1719,0,9104
783,2019-09-15,267,6482,2534,1,9284
783,2019-09-16,356,5150,2494,1,8001
783,2019-09-17,234,9365,2517,0,12116
783,2019-09-18,217,11818,1356,0,13391
783,2019-09-19,2066,2341,1946,0,6353
783,2019-09-20,363,10769,1867,4,13003
783,2019-09-21,1051,5347,1915,1,8314
783,2019-09-22,207,10365,1892,0,12464
783,2019-09-23,1244,9258,1538,1,12041
783,2019-09-24,269,8972,1679,4,10924
783,2019-09-25,207,7953,1875,3,10038
783,2019-09-26,275,11330,2469,1,14075
783,2019-09-27,172,8777,1351,1,10301
783,2019-09-28,216,15097,1101,1,16415
783,2019-09-29,237,16948,1293,1,18479
783,2019-09-30,441,18067,1440,3,19951
783,2019-10-01,1090,16936,1327,0,19353
783,2019-10-02,338,12721,1152,0,14211
783,2019-10-03,224,14608,2018,0,16850
783,2019-10-04,171,12720,1298,3,14192
783,2019-10-05,2076,22303,1421,1,25801
783,2019-10-06,170,18268,942,1,19381
783,2019-10-07,2961,7935,1402,0,12298
783,2019-10-08,213,12756,1924,1,14894
783,2019-10-09,175,15948,1759,2,17884
783,2019-10-10,278,10457,2156,3,12894
783,2019-10-11,447,10859,1489,1,12796
783,2019-10-12,1111,7371,2107,1,10590
783,2019-10-13,441,10154,2036,2,12633
783,2019-10-14,282,7621,1972,0,9875
783,2019-10-15,179,8874,1820,5,10878
783,2019-10-16,160,17954,927,0,19041
783,2019-10-17,121,8519,1935,1,10576
783,2019-10-18,314,9647,1655,0,11616
783,2019-10-19,137,6013,2181,0,8331
783,2019-10-20,168,7043,2721,2,9934
783,2019-10-21,191,19383,1628,2,21204
783,2019-10-22,1443,9957,1799,0,13199
783,2019-10-23,192,16172,926,2,17292
783,2019-10-24,1069,19566,1887,1,22523
783,2019-10-25,312,15264,1522,5,17103
783,2019-10-26,560,25918,1552,0,28030
783,2019-10-27,967,30668,1582,0,33217
783,2019-10-28,269,16176,1439,1,17885
783,2019-10-29,800,26652,1746,2,29200
783,2019-10-30,579,27702,1999,1,30281
783,2019-10-31,193,23411,1359,0,24963
783,2019-11-01,203,27011,999,1,28214
783,2019-11-02,196,26593,1791,0,28580
783,2019-11-03,1104,24869,1298,0,27271
783,2019-11-04,188,8375,1725,2,10290
783,2019-11-05,209,3672,1497,0,5378
783,2019-11-06,209,14873,1767,0,16849
783,2019-11-07,560,17014,891,3,18468
783,2019-11-08,186,10274,1152,2,11614
783,2019-11-09,166,9000,1842,1,11009
783,2019-11-10,1010,14510,985,2,16507
783,2019-11-11,769,13994,1627,1,16391
783,2019-11-12,154,13033,3226,2,16415
783,2019-11-13,188,12797,1897,1,14883
783,2019-11-14,1113,8411,2024,4,11552
783,2019-11-15,189,3625,2541,0,6355
783,2019-11-16,189,2597,2137,1,4924
783,2019-11-17,299,3427,3027,1,6754
783,2019-11-18,138,3286,3333,3,6760
783,2019-11-19,1245,3235,2564,4,7048
783,2019-11-20,190,1598,1699,0,3487
783,2019-11-21,149,5596,1776,0,7521
783,2019-11-22,1135,4824,1509,4,7472
783,2019-11-23,169,6184,2089,2,8444
783,2019-11-24,382,5129,1751,1,7263
783,2019-11-25,184,6822,1806,0,8812
783,2019-11-26,132,6284,1788,1,8205
783,2019-11-27,177,6652,1364,1,8194
783,2019-11-28,382,10736,579,0,11697
783,2019-11-29,24,413,3,0,440
783,2019-08-27,241,6381,1440,2,8064
783,2019-08-28,228,26232,1659,2,28121
783,2019-08-29,454,13950,1829,0,16233
783,2019-08-30,263,2900,478,1,3642
783,2019-08-31,132,28,0,0,160
783,2019-09-01,666,1032,274,2,1974
783,2019-09-02,149,23,37,0,209
783,2019-09-03,206,396,1283,0,1885
783,2019-09-04,1098,6262,2012,0,9372
783,2019-09-05,380,14690,4623,1,19694
783,2019-09-06,308,12141,1806,0,14255
783,2019-09-07,343,12400,1655,0,14398
783,2019-09-08,1242,4168,1579,1,6990
783,2019-09-09,1091,6958,1554,1,9604
783,2019-09-10,1097,13286,1875,1,16259
783,2019-09-11,2160,8879,1871,3,12913
783,2019-09-12,1073,7139,1299,0,9511
783,2019-09-13,156,3389,1830,0,5375
783,2019-09-14,357,7028,1719,0,9104
783,2019-09-15,267,6482,2534,1,9284
783,2019-09-16,356,5150,2494,1,8001
783,2019-09-17,234,9365,2517,0,12116
783,2019-09-18,217,11818,1356,0,13391
783,2019-09-19,2066,2341,1946,0,6353
783,2019-09-20,363,10769,1867,4,13003
783,2019-09-21,1051,5347,1915,1,8314
783,2019-09-22,207,10365,1892,0,12464
783,2019-09-23,1244,9258,1538,1,12041
783,2019-09-24,269,8972,1679,4,10924
783,2019-09-25,207,7953,1875,3,10038
783,2019-09-26,275,11330,2469,1,14075
783,2019-09-27,172,8777,1351,1,10301
783,2019-09-28,216,15097,1101,1,16415
783,2019-09-29,237,16948,1293,1,18479
783,2019-09-30,441,18067,1440,3,19951
783,2019-10-01,1090,16936,1327,0,19353
783,2019-10-02,338,12721,1152,0,14211
783,2019-10-03,224,14608,2018,0,16850
783,2019-10-04,171,12720,1298,3,14192
783,2019-10-05,2076,22303,1421,1,25801
783,2019-10-06,170,18268,942,1,19381
783,2019-10-07,2961,7935,1402,0,12298
783,2019-10-08,213,12756,1924,1,14894
783,2019-10-09,175,15948,1759,2,17884
783,2019-10-10,278,10457,2156,3,12894
783,2019-10-11,447,10859,1489,1,12796
783,2019-10-12,1111,7371,2107,1,10590
783,2019-10-13,441,10154,2036,2,12633
783,2019-10-14,282,7621,1972,0,9875
783,2019-10-15,179,8874,1820,5,10878
783,2019-10-16,160,17954,927,0,19041
783,2019-10-17,121,8519,1935,1,10576
783,2019-10-18,314,9647,1655,0,11616
783,2019-10-19,137,6013,2181,0,8331
783,2019-10-20,168,7043,2721,2,9934
783,2019-10-21,191,19383,1628,2,21204
783,2019-10-22,1443,9957,1799,0,13199
783,2019-10-23,192,16172,926,2,17292
783,2019-10-24,1069,19566,1887,1,22523
783,2019-10-25,312,15264,1522,5,17103
783,2019-10-26,560,25918,1552,0,28030
783,2019-10-27,967,30668,1582,0,33217
783,2019-10-28,269,16176,1439,1,17885
783,2019-10-29,800,26652,1746,2,29200
783,2019-10-30,579,27702,1999,1,30281
783,2019-10-31,193,23411,1359,0,24963
783,2019-11-01,203,27011,999,1,28214
783,2019-11-02,196,26593,1791,0,28580
783,2019-11-03,1104,24869,1298,0,27271
783,2019-11-04,188,8375,1725,2,10290
783,2019-11-05,209,3672,1497,0,5378
783,2019-11-06,209,14873,1767,0,16849
783,2019-11-07,560,17014,891,3,18468
783,2019-11-08,186,10274,1152,2,11614
783,2019-11-09,166,9000,1842,1,11009
783,2019-11-10,1010,14510,985,2,16507
783,2019-11-11,769,13994,1627,1,16391
783,2019-11-12,154,13033,3226,2,16415
783,2019-11-13,188,12797,1897,1,14883
783,2019-11-14,1113,8411,2024,4,11552
783,2019-11-15,189,3625,2541,0,6355
783,2019-11-16,189,2597,2137,1,4924
783,2019-11-17,299,3427,3027,1,6754
783,2019-11-18,138,3286,3333,3,6760
783,2019-11-19,1245,3235,2564,4,7048
783,2019-11-20,190,1598,1699,0,3487
783,2019-11-21,149,5596,1776,0,7521
783,2019-11-22,1135,4824,1509,4,7472
783,2019-11-23,169,6184,2089,2,8444
783,2019-11-24,382,5129,1751,1,7263
783,2019-11-25,184,6822,1806,0,8812
783,2019-11-26,132,6284,1788,1,8205
783,2019-11-27,177,6652,1364,1,8194
783,2019-11-28,382,10736,579,0,11697
783,2019-11-29,24,413,3,0,440
783,2019-08-27,241,6381,1440,2,8064
783,2019-08-28,228,26232,1659,2,28121
783,2019-08-29,454,13950,1829,0,16233
783,2019-08-30,263,2900,478,1,3642
783,2019-08-31,132,28,0,0,160
783,2019-09-01,666,1032,274,2,1974
783,2019-09-02,149,23,37,0,209
783,2019-09-03,206,396,1283,0,1885
783,2019-09-04,1098,6262,2012,0,9372
783,2019-09-05,380,14690,4623,1,19694
783,2019-09-06,308,12141,1806,0,14255
783,2019-09-07,343,12400,1655,0,14398
783,2019-09-08,1242,4168,1579,1,6990
783,2019-09-09,1091,6958,1554,1,9604
783,2019-09-10,1097,13286,1875,1,16259
783,2019-09-11,2160,8879,1871,3,12913
783,2019-09-12,1073,7139,1299,0,9511
783,2019-09-13,156,3389,1830,0,5375
783,2019-09-14,357,7028,1719,0,9104
783,2019-09-15,267,6482,2534,1,9284
783,2019-09-16,356,5150,2494,1,8001
783,2019-09-17,234,9365,2517,0,12116
783,2019-09-18,217,11818,1356,0,13391
783,2019-09-19,2066,2341,1946,0,6353
783,2019-09-20,363,10769,1867,4,13003
783,2019-09-21,1051,5347,1915,1,8314
783,2019-09-22,207,10365,1892,0,12464
783,2019-09-23,1244,9258,1538,1,12041
783,2019-09-24,269,8972,1679,4,10924
783,2019-09-25,207,7953,1875,3,10038
783,2019-09-26,275,11330,2469,1,14075
783,2019-09-27,172,8777,1351,1,10301
783,2019-09-28,216,15097,1101,1,16415
783,2019-09-29,237,16948,1293,1,18479
783,2019-09-30,441,18067,1440,3,19951
783,2019-10-01,1090,16936,1327,0,19353
783,2019-10-02,338,12721,1152,0,14211
783,2019-10-03,224,14608,2018,0,16850
783,2019-10-04,171,12720,1298,3,14192
783,2019-10-05,2076,22303,1421,1,25801
783,2019-10-06,170,18268,942,1,19381
783,2019-10-07,2961,7935,1402,0,12298
783,2019-10-08,213,12756,1924,1,14894
783,2019-10-09,175,15948,1759,2,17884
783,2019-10-10,278,10457,2156,3,12894
783,2019-10-11,447,10859,1489,1,12796
783,2019-10-12,1111,7371,2107,1,10590
783,2019-10-13,441,10154,2036,2,12633
783,2019-10-14,282,7621,1972,0,9875
783,2019-10-15,179,8874,1820,5,10878
783,2019-10-16,160,17954,927,0,19041
783,2019-10-17,121,8519,1935,1,10576
783,2019-10-18,314,9647,1655,0,11616
783,2019-10-19,137,6013,2181,0,8331
783,2019-10-20,168,7043,2721,2,9934
783,2019-10-21,191,19383,1628,2,21204
783,2019-10-22,1443,9957,1799,0,13199
783,2019-10-23,192,16172,926,2,17292
783,2019-10-24,1069,19566,1887,1,22523
783,2019-10-25,312,15264,1522,5,17103
783,2019-10-26,560,25918,1552,0,28030
783,2019-10-27,967,30668,1582,0,33217
783,2019-10-28,269,16176,1439,1,17885
783,2019-10-29,800,26652,1746,2,29200
783,2019-10-30,579,27702,1999,1,30281
783,2019-10-31,193,23411,1359,0,24963
783,2019-11-01,203,27011,999,1,28214
783,2019-11-02,196,26593,1791,0,28580
783,2019-11-03,1104,24869,1298,0,27271
783,2019-11-04,188,8375,1725,2,10290
783,2019-11-05,209,3672,1497,0,5378
783,2019-11-06,209,14873,1767,0,16849
783,2019-11-07,560,17014,891,3,18468
783,2019-11-08,186,10274,1152,2,11614
783,2019-11-09,166,9000,1842,1,11009
783,2019-11-10,1010,14510,985,2,16507
783,2019-11-11,769,13994,1627,1,16391
783,2019-11-12,154,13033,3226,2,16415
783,2019-11-13,188,12797,1897,1,14883
783,2019-11-14,1113,8411,2024,4,11552
783,2019-11-15,189,3625,2541,0,6355
783,2019-11-16,189,2597,2137,1,4924
783,2019-11-17,299,3427,3027,1,6754
783,2019-11-18,138,3286,3333,3,6760
783,2019-11-19,1245,3235,2564,4,7048
783,2019-11-20,190,1598,1699,0,3487
783,2019-11-21,149,5596,1776,0,7521
783,2019-11-22,1135,4824,1509,4,7472
783,2019-11-23,169,6184,2089,2,8444
783,2019-11-24,382,5129,1751,1,7263
783,2019-11-25,184,6822,1806,0,8812
783,2019-11-26,132,6284,1788,1,8205
783,2019-11-27,177,6652,1364,1,8194
783,2019-11-28,382,10736,579,0,11697
783,2019-11-29,24,413,3,0,440
783,2019-08-27,241,6381,1440,2,8064
783,2019-08-28,228,26232,1659,2,28121
783,2019-08-29,454,13950,1829,0,16233
783,2019-08-30,263,2900,478,1,3642
783,2019-08-31,132,28,0,0,160
783,2019-09-01,666,1032,274,2,1974
783,2019-09-02,149,23,37,0,209
783,2019-09-03,206,396,1283,0,1885
783,2019-09-04,1098,6262,2012,0,9372
783,2019-09-05,380,14690,4623,1,19694
783,2019-09-06,308,12141,1806,0,14255
783,2019-09-07,343,12400,1655,0,14398
783,2019-09-08,1242,4168,1579,1,6990
783,2019-09-09,1091,6958,1554,1,9604
783,2019-09-10,1097,13286,1875,1,16259
783,2019-09-11,2160,8879,1871,3,12913
783,2019-09-12,1073,7139,1299,0,9511
783,2019-09-13,156,3389,1830,0,5375
783,2019-09-14,357,7028,1719,0,9104
783,2019-09-15,267,6482,2534,1,9284
783,2019-09-16,356,5150,2494,1,8001
783,2019-09-17,234,9365,2517,0,12116
783,2019-09-18,217,11818,1356,0,13391
783,2019-09-19,2066,2341,1946,0,6353
783,2019-09-20,363,10769,1867,4,13003
783,2019-09-21,1051,5347,1915,1,8314
783,2019-09-22,207,10365,1892,0,12464
783,2019-09-23,1244,9258,1538,1,12041
783,2019-09-24,269,8972,1679,4,10924
783,2019-09-25,207,7953,1875,3,10038
783,2019-09-26,275,11330,2469,1,14075
783,2019-09-27,172,8777,1351,1,10301
783,2019-09-28,216,15097,1101,1,16415
783,2019-09-29,237,16948,1293,1,18479
783,2019-09-30,441,18067,1440,3,19951
783,2019-10-01,1090,16936,1327,0,19353
783,2019-10-02,338,12721,1152,0,14211
783,2019-10-03,224,14608,2018,0,16850
783,2019-10-04,171,12720,1298,3,14192
783,2019-10-05,2076,22303,1421,1,25801
783,2019-10-06,170,18268,942,1,19381
783,2019-10-07,2961,7935,1402,0,12298
783,2019-10-08,213,12756,1924,1,14894
783,2019-10-09,175,15948,1759,2,17884
783,2019-10-10,278,10457,2156,3,12894
783,2019-10-11,447,10859,1489,1,12796
783,2019-10-12,1111,7371,2107,1,10590
783,2019-10-13,441,10154,2036,2,12633
783,2019-10-14,282,7621,1972,0,9875
783,2019-10-15,179,8874,1820,5,10878
783,2019-10-16,160,17954,927,0,19041
783,2019-10-17,121,8519,1935,1,10576
783,2019-10-18,314,9647,1655,0,11616
783,2019-10-19,137,6013,2181,0,8331
783,2019-10-20,168,7043,2721,2,9934
783,2019-10-21,191,19383,1628,2,21204
783,2019-10-22,1443,9957,1799,0,13199
783,2019-10-23,192,16172,926,2,17292
783,2019-10-24,1069,19566,1887,1,22523
783,2019-10-25,312,15264,1522,5,17103
783,2019-10-26,560,25918,1552,0,28030
783,2019-10-27,967,30668,1582,0,33217
783,2019-10-28,269,16176,1439,1,17885
783,2019-10-29,800,26652,1746,2,29200
783,2019-10-30,579,27702,1999,1,30281
783,2019-10-31,193,23411,1359,0,24963
783,2019-11-01,203,27011,999,1,28214
783,2019-11-02,196,26593,1791,0,28580
783,2019-11-03,1104,24869,1298,0,27271
783,2019-11-04,188,8375,1725,2,10290
783,2019-11-05,209,3672,1497,0,5378
783,2019-11-06,209,14873,1767,0,16849
783,2019-11-07,560,17014,891,3,18468
783,2019-11-08,186,10274,1152,2,11614
783,2019-11-09,166,9000,1842,1,11009
783,2019-11-10,1010,14510,985,2,16507
783,2019-11-11,769,13994,1627,1,16391
783,2019-11-12,154,13033,3226,2,16415
783,2019-11-13,188,12797,1897,1,14883
783,2019-11-14,1113,8411,2024,4,11552
783,2019-11-15,189,3625,2541,0,6355
783,2019-11-16,189,2597,2137,1,4924
783,2019-11-17,299,3427,3027,1,6754
783,2019-11-18,138,3286,3333,3,6760
783,2019-11-19,1245,3235,2564,4,7048
783,2019-11-20,190,1598,1699,0,3487
783,2019-11-21,149,5596,1776,0,7521
783,2019-11-22,1135,4824,1509,4,7472
783,2019-11-23,169,6184,2089,2,8444
783,2019-11-24,382,5129,1751,1,7263
783,2019-11-25,184,6822,1806,0,8812
783,2019-11-26,132,6284,1788,1,8205
783,2019-11-27,177,6652,1364,1,8194
784,2019-08-27,395,7765,2094,2,10256
784,2019-08-28,409,2633,1658,2,4702
784,2019-08-29,589,8838,1710,2,11139
784,2019-08-30,851,2482,540,2,3875
784,2019-08-31,95,68,3,0,166
784,2019-09-01,237,916,432,0,1585
784,2019-09-02,92,788,47,0,927
784,2019-09-03,1128,322,1481,1,2932
784,2019-09-04,405,6814,2530,2,9751
784,2019-09-05,1239,9490,1745,3,12477
784,2019-09-06,1328,10869,2613,0,14810
784,2019-09-07,325,11671,1758,1,13755
784,2019-09-08,1253,3909,1822,3,6987
784,2019-09-09,1452,11626,1422,0,14500
784,2019-09-10,312,11886,2645,1,14844
784,2019-09-11,1058,5889,1886,3,8836
784,2019-09-12,308,7653,2129,2,10092
784,2019-09-13,492,4497,2125,0,7114
784,2019-09-14,300,8670,2021,0,10991
784,2019-09-15,303,6187,989,0,7479
784,2019-09-16,1237,6623,2270,1,10131
784,2019-09-17,299,8840,1635,1,10775
784,2019-09-18,407,11885,1406,0,13698
784,2019-09-19,512,2243,2125,0,4880
784,2019-09-20,395,11710,2313,1,14419
784,2019-09-21,298,13604,1980,0,15882
784,2019-09-22,1967,14930,2240,1,19138
784,2019-09-23,1169,10662,2364,1,14196
784,2019-09-24,1251,10135,2230,6,13622
784,2019-09-25,188,6201,1861,6,8256
784,2019-09-26,1059,10020,2134,2,13215
784,2019-09-27,202,9921,2667,2,12792
784,2019-09-28,992,14941,1598,1,17532
784,2019-09-29,114,16081,2142,0,18337
784,2019-09-30,1305,16743,2633,3,20684
784,2019-10-01,999,15609,1917,0,18525
784,2019-10-02,709,10384,1701,2,12796
784,2019-10-03,1110,13098,1716,0,15924
784,2019-10-04,748,16965,1480,1,19194
784,2019-10-05,276,22243,1877,1,24397
784,2019-10-06,1487,15782,1737,1,19007
784,2019-10-07,1075,4466,2198,0,7739
784,2019-10-08,1171,15413,1479,1,18064
784,2019-10-09,286,15903,1848,1,18038
784,2019-10-10,868,14114,1409,3,16394
784,2019-10-11,1048,14423,1582,4,17057
784,2019-10-12,336,7345,2599,0,10280
784,2019-10-13,1233,10737,1347,0,13317
784,2019-10-14,1633,4027,1633,2,7295
784,2019-10-15,1183,12819,2077,2,16081
784,2019-10-16,617,22011,995,1,23624
784,2019-10-17,627,6818,1894,0,9339
784,2019-10-18,462,7274,1893,0,9629
784,2019-10-19,532,3832,1466,1,5831
784,2019-10-20,311,694,1816,3,2824
784,2019-10-21,1144,18169,1244,0,20557
784,2019-10-22,1205,8411,2069,1,11686
784,2019-10-23,319,13289,1437,1,15046
784,2019-10-24,320,24641,1506,1,26468
784,2019-10-25,1188,13326,1076,3,15593
784,2019-10-26,647,12639,1335,1,14622
784,2019-10-27,298,15628,1037,0,16963
784,2019-10-28,256,12431,2718,0,15405
784,2019-10-29,1349,14354,1690,1,17394
784,2019-10-30,332,14627,1504,1,16464
784,2019-10-31,961,19668,1167,0,21796
784,2019-11-01,271,26342,1336,0,27949
784,2019-11-02,239,16192,1621,0,18052
784,2019-11-03,414,21544,1563,0,23521
784,2019-11-04,424,6701,1330,3,8458
784,2019-11-05,339,1464,1608,0,3411
784,2019-11-06,258,13376,1732,1,15367
784,2019-11-07,380,15762,1562,7,17711
784,2019-11-08,1193,9296,1378,0,11867
784,2019-11-09,290,7995,1714,0,9999
784,2019-11-10,1235,22851,780,0,24866
784,2019-11-11,324,14845,1789,0,16958
784,2019-11-12,714,11174,2870,0,14758
784,2019-11-13,872,13227,1692,0,15791
784,2019-11-14,323,7175,1065,0,8563
784,2019-11-15,1249,2171,2033,0,5453
784,2019-11-16,415,1012,3203,0,4630
784,2019-11-17,830,1104,2725,0,4659
784,2019-11-18,398,1236,3112,0,4746
784,2019-11-19,407,4589,2601,1,7598
784,2019-11-20,1259,899,2736,0,4894
784,2019-11-21,1289,4962,1675,0,7926
784,2019-11-22,348,4111,1774,1,6234
784,2019-11-23,355,5817,3319,1,9492
784,2019-11-24,448,7281,1929,1,9659
784,2019-11-25,275,6072,1761,0,8108
784,2019-11-26,406,4444,1499,0,6349
784,2019-11-27,323,5427,1697,1,7448
784,2019-11-28,157,6916,778,2,7853
784,2019-11-29,6,420,1,0,427
784,2019-08-27,395,7765,2094,2,10256
784,2019-08-28,409,2633,1658,2,4702
784,2019-08-29,589,8838,1710,2,11139
784,2019-08-30,851,2482,540,2,3875
784,2019-08-31,95,68,3,0,166
784,2019-09-01,237,916,432,0,1585
784,2019-09-02,92,788,47,0,927
784,2019-09-03,1128,322,1481,1,2932
784,2019-09-04,405,6814,2530,2,9751
784,2019-09-05,1239,9490,1745,3,12477
784,2019-09-06,1328,10869,2613,0,14810
784,2019-09-07,325,11671,1758,1,13755
784,2019-09-08,1253,3909,1822,3,6987
784,2019-09-09,1452,11626,1422,0,14500
784,2019-09-10,312,11886,2645,1,14844
784,2019-09-11,1058,5889,1886,3,8836
784,2019-09-12,308,7653,2129,2,10092
784,2019-09-13,492,4497,2125,0,7114
784,2019-09-14,300,8670,2021,0,10991
784,2019-09-15,303,6187,989,0,7479
784,2019-09-16,1237,6623,2270,1,10131
784,2019-09-17,299,8840,1635,1,10775
784,2019-09-18,407,11885,1406,0,13698
784,2019-09-19,512,2243,2125,0,4880
784,2019-09-20,395,11710,2313,1,14419
784,2019-09-21,298,13604,1980,0,15882
784,2019-09-22,1967,14930,2240,1,19138
784,2019-09-23,1169,10662,2364,1,14196
784,2019-09-24,1251,10135,2230,6,13622
784,2019-09-25,188,6201,1861,6,8256
784,2019-09-26,1059,10020,2134,2,13215
784,2019-09-27,202,9921,2667,2,12792
784,2019-09-28,992,14941,1598,1,17532
784,2019-09-29,114,16081,2142,0,18337
784,2019-09-30,1305,16743,2633,3,20684
784,2019-10-01,999,15609,1917,0,18525
784,2019-10-02,709,10384,1701,2,12796
784,2019-10-03,1110,13098,1716,0,15924
784,2019-10-04,748,16965,1480,1,19194
784,2019-10-05,276,22243,1877,1,24397
784,2019-10-06,1487,15782,1737,1,19007
784,2019-10-07,1075,4466,2198,0,7739
784,2019-10-08,1171,15413,1479,1,18064
784,2019-10-09,286,15903,1848,1,18038
784,2019-10-10,868,14114,1409,3,16394
784,2019-10-11,1048,14423,1582,4,17057
784,2019-10-12,336,7345,2599,0,10280
784,2019-10-13,1233,10737,1347,0,13317
784,2019-10-14,1633,4027,1633,2,7295
784,2019-10-15,1183,12819,2077,2,16081
784,2019-10-16,617,22011,995,1,23624
784,2019-10-17,627,6818,1894,0,9339
784,2019-10-18,462,7274,1893,0,9629
784,2019-10-19,532,3832,1466,1,5831
784,2019-10-20,311,694,1816,3,2824
784,2019-10-21,1144,18169,1244,0,20557
784,2019-10-22,1205,8411,2069,1,11686
784,2019-10-23,319,13289,1437,1,15046
784,2019-10-24,320,24641,1506,1,26468
784,2019-10-25,1188,13326,1076,3,15593
784,2019-10-26,647,12639,1335,1,14622
784,2019-10-27,298,15628,1037,0,16963
784,2019-10-28,256,12431,2718,0,15405
784,2019-10-29,1349,14354,1690,1,17394
784,2019-10-30,332,14627,1504,1,16464
784,2019-10-31,961,19668,1167,0,21796
784,2019-11-01,271,26342,1336,0,27949
784,2019-11-02,239,16192,1621,0,18052
784,2019-11-03,414,21544,1563,0,23521
784,2019-11-04,424,6701,1330,3,8458
784,2019-11-05,339,1464,1608,0,3411
784,2019-11-06,258,13376,1732,1,15367
784,2019-11-07,380,15762,1562,7,17711
784,2019-11-08,1193,9296,1378,0,11867
784,2019-11-09,290,7995,1714,0,9999
784,2019-11-10,1235,22851,780,0,24866
784,2019-11-11,324,14845,1789,0,16958
784,2019-11-12,714,11174,2870,0,14758
784,2019-11-13,872,13227,1692,0,15791
784,2019-11-14,323,7175,1065,0,8563
784,2019-11-15,1249,2171,2033,0,5453
784,2019-11-16,415,1012,3203,0,4630
784,2019-11-17,830,1104,2725,0,4659
784,2019-11-18,398,1236,3112,0,4746
784,2019-11-19,407,4589,2601,1,7598
784,2019-11-20,1259,899,2736,0,4894
784,2019-11-21,1289,4962,1675,0,7926
784,2019-11-22,348,4111,1774,1,6234
784,2019-11-23,355,5817,3319,1,9492
784,2019-11-24,448,7281,1929,1,9659
784,2019-11-25,275,6072,1761,0,8108
784,2019-11-26,406,4444,1499,0,6349
784,2019-11-27,323,5427,1697,1,7448
784,2019-11-28,157,6916,778,2,7853
784,2019-11-29,6,420,1,0,427
784,2019-08-26,0,0,91,0,91
784,2019-08-27,395,7765,2094,2,10256
784,2019-08-28,409,2633,1658,2,4702
784,2019-08-29,589,8838,1710,2,11139
784,2019-08-30,851,2482,540,2,3875
784,2019-08-31,95,68,3,0,166
784,2019-09-01,237,916,432,0,1585
784,2019-09-02,92,788,47,0,927
784,2019-09-03,1128,322,1481,1,2932
784,2019-09-04,405,6814,2530,2,9751
784,2019-09-05,1239,9490,1745,3,12477
784,2019-09-06,1328,10869,2613,0,14810
784,2019-09-07,325,11671,1758,1,13755
784,2019-09-08,1253,3909,1822,3,6987
784,2019-09-09,1452,11626,1422,0,14500
784,2019-09-10,312,11886,2645,1,14844
784,2019-09-11,1058,5889,1886,3,8836
784,2019-09-12,308,7653,2129,2,10092
784,2019-09-13,492,4497,2125,0,7114
784,2019-09-14,300,8670,2021,0,10991
784,2019-09-15,303,6187,989,0,7479
784,2019-09-16,1237,6623,2270,1,10131
784,2019-09-17,299,8840,1635,1,10775
784,2019-09-18,407,11885,1406,0,13698
784,2019-09-19,512,2243,2125,0,4880
784,2019-09-20,395,11710,2313,1,14419
784,2019-09-21,298,13604,1980,0,15882
784,2019-09-22,1967,14930,2240,1,19138
784,2019-09-23,1169,10662,2364,1,14196
784,2019-09-24,1251,10135,2230,6,13622
784,2019-09-25,188,6201,1861,6,8256
784,2019-09-26,1059,10020,2134,2,13215
784,2019-09-27,202,9921,2667,2,12792
784,2019-09-28,992,14941,1598,1,17532
784,2019-09-29,114,16081,2142,0,18337
784,2019-09-30,1305,16743,2633,3,20684
784,2019-10-01,999,15609,1917,0,18525
784,2019-10-02,709,10384,1701,2,12796
784,2019-10-03,1110,13098,1716,0,15924
784,2019-10-04,748,16965,1480,1,19194
784,2019-10-05,276,22243,1877,1,24397
784,2019-10-06,1487,15782,1737,1,19007
784,2019-10-07,1075,4466,2198,0,7739
784,2019-10-08,1171,15413,1479,1,18064
784,2019-10-09,286,15903,1848,1,18038
784,2019-10-10,868,14114,1409,3,16394
784,2019-10-11,1048,14423,1582,4,17057
784,2019-10-12,336,7345,2599,0,10280
784,2019-10-13,1233,10737,1347,0,13317
784,2019-10-14,1633,4027,1633,2,7295
784,2019-10-15,1183,12819,2077,2,16081
784,2019-10-16,617,22011,995,1,23624
784,2019-10-17,627,6818,1894,0,9339
784,2019-10-18,462,7274,1893,0,9629
784,2019-10-19,532,3832,1466,1,5831
784,2019-10-20,311,694,1816,3,2824
784,2019-10-21,1144,18169,1244,0,20557
784,2019-10-22,1205,8411,2069,1,11686
784,2019-10-23,319,13289,1437,1,15046
784,2019-10-24,320,24641,1506,1,26468
784,2019-10-25,1188,13326,1076,3,15593
784,2019-10-26,647,12639,1335,1,14622
784,2019-10-27,298,15628,1037,0,16963
784,2019-10-28,256,12431,2718,0,15405
784,2019-10-29,1349,14354,1690,1,17394
784,2019-10-30,332,14627,1504,1,16464
784,2019-10-31,961,19668,1167,0,21796
784,2019-11-01,271,26342,1336,0,27949
784,2019-11-02,239,16192,1621,0,18052
784,2019-11-03,414,21544,1563,0,23521
784,2019-11-04,424,6701,1330,3,8458
784,2019-11-05,339,1464,1608,0,3411
784,2019-11-06,258,13376,1732,1,15367
784,2019-11-07,380,15762,1562,7,17711
784,2019-11-08,1193,9296,1378,0,11867
784,2019-11-09,290,7995,1714,0,9999
784,2019-11-10,1235,22851,780,0,24866
784,2019-11-11,324,14845,1789,0,16958
784,2019-11-12,714,11174,2870,0,14758
784,2019-11-13,872,13227,1692,0,15791
784,2019-11-14,323,7175,1065,0,8563
784,2019-11-15,1249,2171,2033,0,5453
784,2019-11-16,415,1012,3203,0,4630
784,2019-11-17,830,1104,2725,0,4659
784,2019-11-18,398,1236,3112,0,4746
784,2019-11-19,407,4589,2601,1,7598
784,2019-11-20,1259,899,2736,0,4894
784,2019-11-21,1289,4962,1675,0,7926
784,2019-11-22,348,4111,1774,1,6234
784,2019-11-23,355,5817,3319,1,9492
784,2019-11-24,448,7281,1929,1,9659
784,2019-11-25,275,6072,1761,0,8108
784,2019-11-26,406,4444,1499,0,6349
784,2019-11-27,323,5427,1697,1,7448
784,2019-11-28,157,6916,778,2,7853
784,2019-11-29,6,420,1,0,427
784,2019-08-27,395,7765,2094,2,10256
784,2019-08-28,409,2633,1658,2,4702
784,2019-08-29,589,8838,1710,2,11139
784,2019-08-30,851,2482,540,2,3875
784,2019-08-31,95,68,3,0,166
784,2019-09-01,237,916,432,0,1585
784,2019-09-02,92,788,47,0,927
784,2019-09-03,1128,322,1481,1,2932
784,2019-09-04,405,6814,2530,2,9751
784,2019-09-05,1239,9490,1745,3,12477
784,2019-09-06,1328,10869,2613,0,14810
784,2019-09-07,325,11671,1758,1,13755
784,2019-09-08,1253,3909,1822,3,6987
784,2019-09-09,1452,11626,1422,0,14500
784,2019-09-10,312,11886,2645,1,14844
784,2019-09-11,1058,5889,1886,3,8836
784,2019-09-12,308,7653,2129,2,10092
784,2019-09-13,492,4497,2125,0,7114
784,2019-09-14,300,8670,2021,0,10991
784,2019-09-15,303,6187,989,0,7479
784,2019-09-16,1237,6623,2270,1,10131
784,2019-09-17,299,8840,1635,1,10775
784,2019-09-18,407,11885,1406,0,13698
784,2019-09-19,512,2243,2125,0,4880
784,2019-09-20,395,11710,2313,1,14419
784,2019-09-21,298,13604,1980,0,15882
784,2019-09-22,1967,14930,2240,1,19138
784,2019-09-23,1169,10662,2364,1,14196
784,2019-09-24,1251,10135,2230,6,13622
784,2019-09-25,188,6201,1861,6,8256
784,2019-09-26,1059,10020,2134,2,13215
784,2019-09-27,202,9921,2667,2,12792
784,2019-09-28,992,14941,1598,1,17532
784,2019-09-29,114,16081,2142,0,18337
784,2019-09-30,1305,16743,2633,3,20684
784,2019-10-01,999,15609,1917,0,18525
784,2019-10-02,709,10384,1701,2,12796
784,2019-10-03,1110,13098,1716,0,15924
784,2019-10-04,748,16965,1480,1,19194
784,2019-10-05,276,22243,1877,1,24397
784,2019-10-06,1487,15782,1737,1,19007
784,2019-10-07,1075,4466,2198,0,7739
784,2019-10-08,1171,15413,1479,1,18064
784,2019-10-09,286,15903,1848,1,18038
784,2019-10-10,868,14114,1409,3,16394
784,2019-10-11,1048,14423,1582,4,17057
784,2019-10-12,336,7345,2599,0,10280
784,2019-10-13,1233,10737,1347,0,13317
784,2019-10-14,1633,4027,1633,2,7295
784,2019-10-15,1183,12819,2077,2,16081
784,2019-10-16,617,22011,995,1,23624
784,2019-10-17,627,6818,1894,0,9339
784,2019-10-18,462,7274,1893,0,9629
784,2019-10-19,532,3832,1466,1,5831
784,2019-10-20,311,694,1816,3,2824
784,2019-10-21,1144,18169,1244,0,20557
784,2019-10-22,1205,8411,2069,1,11686
784,2019-10-23,319,13289,1437,1,15046
784,2019-10-24,320,24641,1506,1,26468
784,2019-10-25,1188,13326,1076,3,15593
784,2019-10-26,647,12639,1335,1,14622
784,2019-10-27,298,15628,1037,0,16963
784,2019-10-28,256,12431,2718,0,15405
784,2019-10-29,1349,14354,1690,1,17394
784,2019-10-30,332,14627,1504,1,16464
784,2019-10-31,961,19668,1167,0,21796
784,2019-11-01,271,26342,1336,0,27949
784,2019-11-02,239,16192,1621,0,18052
784,2019-11-03,414,21544,1563,0,23521
784,2019-11-04,424,6701,1330,3,8458
784,2019-11-05,339,1464,1608,0,3411
784,2019-11-06,258,13376,1732,1,15367
784,2019-11-07,380,15762,1562,7,17711
784,2019-11-08,1193,9296,1378,0,11867
784,2019-11-09,290,7995,1714,0,9999
784,2019-11-10,1235,22851,780,0,24866
784,2019-11-11,324,14845,1789,0,16958
784,2019-11-12,714,11174,2870,0,14758
784,2019-11-13,872,13227,1692,0,15791
784,2019-11-14,323,7175,1065,0,8563
784,2019-11-15,1249,2171,2033,0,5453
784,2019-11-16,415,1012,3203,0,4630
784,2019-11-17,830,1104,2725,0,4659
784,2019-11-18,398,1236,3112,0,4746
784,2019-11-19,407,4589,2601,1,7598
784,2019-11-20,1259,899,2736,0,4894
784,2019-11-21,1289,4962,1675,0,7926
784,2019-11-22,348,4111,1774,1,6234
784,2019-11-23,355,5817,3319,1,9492
784,2019-11-24,448,7281,1929,1,9659
784,2019-11-25,275,6072,1761,0,8108
784,2019-11-26,406,4444,1499,0,6349
784,2019-11-27,323,5427,1697,1,7448
784,2019-11-28,157,6916,778,2,7853
785,2019-08-27,2288,2430,1202,1,5921
785,2019-08-28,1308,1428,1260,1,3997
785,2019-08-29,1739,8747,1641,0,12127
785,2019-08-30,1568,2707,1014,0,5289
785,2019-08-31,805,239,4,0,1048
785,2019-09-01,981,1521,317,0,2819
785,2019-09-02,1008,426,64,0,1498
785,2019-09-03,1404,677,693,1,2775
785,2019-09-04,1332,11991,2086,2,15411
785,2019-09-05,2915,5171,1673,1,9760
785,2019-09-06,3010,7907,2066,0,12983
785,2019-09-07,1617,8633,1970,0,12220
785,2019-09-08,2542,8558,1440,1,12541
785,2019-09-09,1556,6321,1407,1,9285
785,2019-09-10,1780,7748,1811,1,11340
785,2019-09-11,1445,6294,2009,1,9749
785,2019-09-12,1162,6765,2487,1,10415
785,2019-09-13,1789,5597,1801,0,9187
785,2019-09-14,1781,6378,2543,0,10702
785,2019-09-15,2084,9770,1869,0,13723
785,2019-09-16,2005,5590,2747,26,10368
785,2019-09-17,1847,8024,2774,0,12645
785,2019-09-18,1744,12494,1277,0,15515
785,2019-09-19,1972,2778,2178,3,6931
785,2019-09-20,1581,8193,2162,1,11937
785,2019-09-21,1515,5550,1800,0,8865
785,2019-09-22,1400,8114,1985,11,11510
785,2019-09-23,1412,10273,2371,0,14056
785,2019-09-24,1879,6848,1842,5,10574
785,2019-09-25,1407,5982,2872,2514,12775
785,2019-09-26,1152,7958,900,1,10011
785,2019-09-27,1463,8615,1516,1,11595
785,2019-09-28,1584,14404,1411,1,17400
785,2019-09-29,1286,16855,1546,7,19694
785,2019-09-30,1417,17662,1552,1,20632
785,2019-10-01,2106,15125,1511,1,18743
785,2019-10-02,1331,11041,1267,0,13639
785,2019-10-03,1328,12948,1061,1,15338
785,2019-10-04,1341,11448,1760,2,14551
785,2019-10-05,1471,13122,1577,1,16171
785,2019-10-06,1772,10641,2021,1,14435
785,2019-10-07,3131,4769,1882,2,9784
785,2019-10-08,3008,16523,1937,1,21469
785,2019-10-09,1603,15515,2376,3,19497
785,2019-10-10,2605,9579,1758,0,13942
785,2019-10-11,1909,7212,0,0,9121
785,2019-10-12,2756,3992,0,0,6748
785,2019-10-13,181,268,0,0,449
785,2019-10-14,33,22,6,0,61
785,2019-10-15,10,13,19,0,42
785,2019-10-16,0,8,0,1,9
785,2019-10-17,10,0,0,0,10
785,2019-08-27,2288,2430,1202,1,5921
785,2019-08-28,1308,1428,1260,1,3997
785,2019-08-29,1739,8747,1641,0,12127
785,2019-08-30,1568,2707,1014,0,5289
785,2019-08-31,805,239,4,0,1048
785,2019-09-01,981,1521,317,0,2819
785,2019-09-02,1008,426,64,0,1498
785,2019-09-03,1404,677,693,1,2775
785,2019-09-04,1332,11991,2086,2,15411
785,2019-09-05,2915,5171,1673,1,9760
785,2019-09-06,3010,7907,2066,0,12983
785,2019-09-07,1617,8633,1970,0,12220
785,2019-09-08,2542,8558,1440,1,12541
785,2019-09-09,1556,6321,1407,1,9285
785,2019-09-10,1780,7748,1811,1,11340
785,2019-09-11,1445,6294,2009,1,9749
785,2019-09-12,1162,6765,2487,1,10415
785,2019-09-13,1789,5597,1801,0,9187
785,2019-09-14,1781,6378,2543,0,10702
785,2019-09-15,2084,9770,1869,0,13723
785,2019-09-16,2005,5590,2747,26,10368
785,2019-09-17,1847,8024,2774,0,12645
785,2019-09-18,1744,12494,1277,0,15515
785,2019-09-19,1972,2778,2178,3,6931
785,2019-09-20,1581,8193,2162,1,11937
785,2019-09-21,1515,5550,1800,0,8865
785,2019-09-22,1400,8114,1985,11,11510
785,2019-09-23,1412,10273,2371,0,14056
785,2019-09-24,1879,6848,1842,5,10574
785,2019-09-25,1407,5982,2872,2514,12775
785,2019-09-26,1152,7958,900,1,10011
785,2019-09-27,1463,8615,1516,1,11595
785,2019-09-28,1584,14404,1411,1,17400
785,2019-09-29,1286,16855,1546,7,19694
785,2019-09-30,1417,17662,1552,1,20632
785,2019-10-01,2106,15125,1511,1,18743
785,2019-10-02,1331,11041,1267,0,13639
785,2019-10-03,1328,12948,1061,1,15338
785,2019-10-04,1341,11448,1760,2,14551
785,2019-10-05,1471,13122,1577,1,16171
785,2019-10-06,1772,10641,2021,1,14435
785,2019-10-07,3131,4769,1882,2,9784
785,2019-10-08,3008,16523,1937,1,21469
785,2019-10-09,1603,15515,2376,3,19497
785,2019-10-10,2605,9579,1758,0,13942
785,2019-10-11,1909,7212,0,0,9121
785,2019-10-12,2756,3992,0,0,6748
785,2019-10-13,181,268,0,0,449
785,2019-10-14,33,22,6,0,61
785,2019-10-15,10,13,19,0,42
785,2019-10-16,0,8,0,1,9
785,2019-08-26,0,0,116,0,116
785,2019-08-27,2288,2430,1202,1,5921
785,2019-08-28,1308,1428,1260,1,3997
785,2019-08-29,1739,8747,1641,0,12127
785,2019-08-30,1568,2707,1014,0,5289
785,2019-08-31,805,239,4,0,1048
785,2019-09-01,981,1521,317,0,2819
785,2019-09-02,1008,426,64,0,1498
785,2019-09-03,1404,677,693,1,2775
785,2019-09-04,1332,11991,2086,2,15411
785,2019-09-05,2915,5171,1673,1,9760
785,2019-09-06,3010,7907,2066,0,12983
785,2019-09-07,1617,8633,1970,0,12220
785,2019-09-08,2542,8558,1440,1,12541
785,2019-09-09,1556,6321,1407,1,9285
785,2019-09-10,1780,7748,1811,1,11340
785,2019-09-11,1445,6294,2009,1,9749
785,2019-09-12,1162,6765,2487,1,10415
785,2019-09-13,1789,5597,1801,0,9187
785,2019-09-14,1781,6378,2543,0,10702
785,2019-09-15,2084,9770,1869,0,13723
785,2019-09-16,2005,5590,2747,26,10368
785,2019-09-17,1847,8024,2774,0,12645
785,2019-09-18,1744,12494,1277,0,15515
785,2019-09-19,1972,2778,2178,3,6931
785,2019-09-20,1581,8193,2162,1,11937
785,2019-09-21,1515,5550,1800,0,8865
785,2019-09-22,1400,8114,1985,11,11510
785,2019-09-23,1412,10273,2371,0,14056
785,2019-09-24,1879,6848,1842,5,10574
785,2019-09-25,1407,5982,2872,2514,12775
785,2019-09-26,1152,7958,900,1,10011
785,2019-09-27,1463,8615,1516,1,11595
785,2019-09-28,1584,14404,1411,1,17400
785,2019-09-29,1286,16855,1546,7,19694
785,2019-09-30,1417,17662,1552,1,20632
785,2019-10-01,2106,15125,1511,1,18743
785,2019-10-02,1331,11041,1267,0,13639
785,2019-10-03,1328,12948,1061,1,15338
785,2019-10-04,1341,11448,1760,2,14551
785,2019-10-05,1471,13122,1577,1,16171
785,2019-10-06,1772,10641,2021,1,14435
785,2019-10-07,3131,4769,1882,2,9784
785,2019-10-08,3008,16523,1937,1,21469
785,2019-10-09,1603,15515,2376,3,19497
785,2019-10-10,2605,9579,1758,0,13942
785,2019-10-11,1909,7212,0,0,9121
785,2019-10-12,2756,3992,0,0,6748
785,2019-10-13,181,268,0,0,449
785,2019-10-14,33,22,6,0,61
785,2019-10-15,10,13,19,0,42
785,2019-08-27,2288,2430,1202,1,5921
785,2019-08-28,1308,1428,1260,1,3997
785,2019-08-29,1739,8747,1641,0,12127
785,2019-08-30,1568,2707,1014,0,5289
785,2019-08-31,805,239,4,0,1048
785,2019-09-01,981,1521,317,0,2819
785,2019-09-02,1008,426,64,0,1498
785,2019-09-03,1404,677,693,1,2775
785,2019-09-04,1332,11991,2086,2,15411
785,2019-09-05,2915,5171,1673,1,9760
785,2019-09-06,3010,7907,2066,0,12983
785,2019-09-07,1617,8633,1970,0,12220
785,2019-09-08,2542,8558,1440,1,12541
785,2019-09-09,1556,6321,1407,1,9285
785,2019-09-10,1780,7748,1811,1,11340
785,2019-09-11,1445,6294,2009,1,9749
785,2019-09-12,1162,6765,2487,1,10415
785,2019-09-13,1789,5597,1801,0,9187
785,2019-09-14,1781,6378,2543,0,10702
785,2019-09-15,2084,9770,1869,0,13723
785,2019-09-16,2005,5590,2747,26,10368
785,2019-09-17,1847,8024,2774,0,12645
785,2019-09-18,1744,12494,1277,0,15515
785,2019-09-19,1972,2778,2178,3,6931
785,2019-09-20,1581,8193,2162,1,11937
785,2019-09-21,1515,5550,1800,0,8865
785,2019-09-22,1400,8114,1985,11,11510
785,2019-09-23,1412,10273,2371,0,14056
785,2019-09-24,1879,6848,1842,5,10574
785,2019-09-25,1407,5982,2872,2514,12775
785,2019-09-26,1152,7958,900,1,10011
785,2019-09-27,1463,8615,1516,1,11595
785,2019-09-28,1584,14404,1411,1,17400
785,2019-09-29,1286,16855,1546,7,19694
785,2019-09-30,1417,17662,1552,1,20632
785,2019-10-01,2106,15125,1511,1,18743
785,2019-10-02,1331,11041,1267,0,13639
785,2019-10-03,1328,12948,1061,1,15338
785,2019-10-04,1341,11448,1760,2,14551
785,2019-10-05,1471,13122,1577,1,16171
785,2019-10-06,1772,10641,2021,1,14435
785,2019-10-07,3131,4769,1882,2,9784
785,2019-10-08,3008,16523,1937,1,21469
785,2019-10-09,1603,15515,2376,3,19497
785,2019-10-10,2605,9579,1758,0,13942
785,2019-10-11,1909,7212,0,0,9121
785,2019-10-12,2756,3992,0,0,6748
785,2019-10-13,181,268,0,0,449
785,2019-10-14,33,22,6,0,61
785,2019-10-15,10,13,19,0,42
785,2019-10-16,0,8,0,1,9
786,2019-08-27,125,7074,1991,1,9191
786,2019-08-28,205,10917,2386,1,13509
786,2019-08-29,264,12055,1260,2,13581
786,2019-08-30,2387,2926,653,1,5967
786,2019-08-31,97,111,2,0,210
786,2019-09-01,117,458,478,0,1053
786,2019-09-02,140,400,93,0,633
786,2019-09-03,147,723,1346,0,2216
786,2019-09-04,245,15342,1861,0,17448
786,2019-09-05,529,11536,1619,0,13684
786,2019-09-06,245,11143,1531,0,12919
786,2019-09-07,335,16764,1600,0,18699
786,2019-09-08,1112,6105,2020,1,9238
786,2019-09-09,255,7463,2482,2,10202
786,2019-09-10,146,7418,2046,0,9610
786,2019-09-11,209,5858,1666,2,7735
786,2019-09-12,125,10500,1724,0,12349
786,2019-09-13,140,3953,3015,0,7108
786,2019-09-14,940,6072,2147,1,9160
786,2019-09-15,198,13833,1809,0,15840
786,2019-09-16,132,5922,2700,1,8755
786,2019-09-17,149,6964,2790,4,9907
786,2019-09-18,82,11505,1560,1,13148
786,2019-09-19,221,3157,1725,2,5105
786,2019-09-20,478,10983,2003,2,13466
786,2019-09-21,166,8253,1830,2,10251
786,2019-09-22,906,9366,2438,3,12713
786,2019-09-23,270,8010,1655,1,9936
786,2019-09-24,217,7004,2375,5,9601
786,2019-09-25,269,6318,1893,3,8483
786,2019-09-26,1084,10808,1484,3,13379
786,2019-09-27,934,7507,1861,4,10306
786,2019-09-28,185,14408,1168,3,15764
786,2019-09-29,106,16176,1865,0,18147
786,2019-09-30,131,17173,1458,0,18762
786,2019-10-01,130,15705,1611,1,17447
786,2019-10-02,978,10391,1323,0,12692
786,2019-10-03,1089,13326,1404,2,15821
786,2019-10-04,108,11449,2256,0,13813
786,2019-10-05,106,14155,1370,1,15632
786,2019-10-06,94,11920,1003,1,13018
786,2019-10-07,1109,4945,1362,4,7420
786,2019-10-08,110,17207,1915,0,19232
786,2019-10-09,1883,17019,1877,0,20779
786,2019-10-10,996,8858,1104,1,10959
786,2019-10-11,587,9701,1611,1,11900
786,2019-10-12,973,5346,1417,2,7738
786,2019-10-13,986,7135,1102,1,9224
786,2019-10-14,1282,4414,2142,0,7838
786,2019-10-15,1345,8693,1883,1,11922
786,2019-10-16,106,11684,1538,0,13328
786,2019-10-17,108,4138,2390,4,6640
786,2019-10-18,294,7069,2086,1,9450
786,2019-10-19,979,3667,2137,2,6785
786,2019-10-20,1002,684,1998,0,3684
786,2019-10-21,188,9485,1681,0,11354
786,2019-10-22,254,4491,2025,2,6772
786,2019-10-23,268,7252,1758,1,9279
786,2019-10-24,131,20427,1784,2,22344
786,2019-10-25,122,17934,2043,2,20101
786,2019-10-26,151,23665,1427,1,25244
786,2019-10-27,1425,17612,1049,0,20086
786,2019-10-28,1396,21545,1720,2,24663
786,2019-10-29,212,16674,2389,1,19276
786,2019-10-30,124,14700,1192,0,16016
786,2019-10-31,984,19400,1573,1,21958
786,2019-11-01,1007,25870,1390,2,28269
786,2019-11-02,424,15593,1075,622,17714
786,2019-11-03,113,21551,1887,0,23551
786,2019-11-04,1059,6417,1098,0,8574
786,2019-11-05,151,1229,2144,0,3524
786,2019-11-06,92,20107,1092,0,21291
786,2019-11-07,198,15685,825,0,16708
786,2019-11-08,108,9174,1533,0,10815
786,2019-11-09,82,7809,1335,0,9226
786,2019-11-10,119,11886,1542,0,13547
786,2019-11-11,137,7912,1236,0,9285
786,2019-11-12,519,8477,2053,0,11049
786,2019-11-13,138,13270,1551,0,14959
786,2019-11-14,122,7982,2412,0,10516
786,2019-11-15,115,3431,2846,0,6392
786,2019-11-16,179,6460,2632,0,9271
786,2019-11-17,201,3449,3211,0,6861
786,2019-11-18,98,3443,3031,0,6572
786,2019-11-19,455,2975,2466,0,5896
786,2019-11-20,115,3207,1905,2,5229
786,2019-11-21,103,3488,1606,2,5199
786,2019-11-22,96,8317,1327,3,9743
786,2019-11-23,126,6770,2692,0,9588
786,2019-11-24,222,7048,1618,0,8888
786,2019-11-25,93,7044,1721,0,8858
786,2019-11-26,78,5605,1231,3,6917
786,2019-11-27,85,6635,2120,1,8841
786,2019-11-28,118,7211,289,0,7618
786,2019-11-29,22,853,18,0,893
786,2019-08-27,125,7074,1991,1,9191
786,2019-08-28,205,10917,2386,1,13509
786,2019-08-29,264,12055,1260,2,13581
786,2019-08-30,2387,2926,653,1,5967
786,2019-08-31,97,111,2,0,210
786,2019-09-01,117,458,478,0,1053
786,2019-09-02,140,400,93,0,633
786,2019-09-03,147,723,1346,0,2216
786,2019-09-04,245,15342,1861,0,17448
786,2019-09-05,529,11536,1619,0,13684
786,2019-09-06,245,11143,1531,0,12919
786,2019-09-07,335,16764,1600,0,18699
786,2019-09-08,1112,6105,2020,1,9238
786,2019-09-09,255,7463,2482,2,10202
786,2019-09-10,146,7418,2046,0,9610
786,2019-09-11,209,5858,1666,2,7735
786,2019-09-12,125,10500,1724,0,12349
786,2019-09-13,140,3953,3015,0,7108
786,2019-09-14,940,6072,2147,1,9160
786,2019-09-15,198,13833,1809,0,15840
786,2019-09-16,132,5922,2700,1,8755
786,2019-09-17,149,6964,2790,4,9907
786,2019-09-18,82,11505,1560,1,13148
786,2019-09-19,221,3157,1725,2,5105
786,2019-09-20,478,10983,2003,2,13466
786,2019-09-21,166,8253,1830,2,10251
786,2019-09-22,906,9366,2438,3,12713
786,2019-09-23,270,8010,1655,1,9936
786,2019-09-24,217,7004,2375,5,9601
786,2019-09-25,269,6318,1893,3,8483
786,2019-09-26,1084,10808,1484,3,13379
786,2019-09-27,934,7507,1861,4,10306
786,2019-09-28,185,14408,1168,3,15764
786,2019-09-29,106,16176,1865,0,18147
786,2019-09-30,131,17173,1458,0,18762
786,2019-10-01,130,15705,1611,1,17447
786,2019-10-02,978,10391,1323,0,12692
786,2019-10-03,1089,13326,1404,2,15821
786,2019-10-04,108,11449,2256,0,13813
786,2019-10-05,106,14155,1370,1,15632
786,2019-10-06,94,11920,1003,1,13018
786,2019-10-07,1109,4945,1362,4,7420
786,2019-10-08,110,17207,1915,0,19232
786,2019-10-09,1883,17019,1877,0,20779
786,2019-10-10,996,8858,1104,1,10959
786,2019-10-11,587,9701,1611,1,11900
786,2019-10-12,973,5346,1417,2,7738
786,2019-10-13,986,7135,1102,1,9224
786,2019-10-14,1282,4414,2142,0,7838
786,2019-10-15,1345,8693,1883,1,11922
786,2019-10-16,106,11684,1538,0,13328
786,2019-10-17,108,4138,2390,4,6640
786,2019-10-18,294,7069,2086,1,9450
786,2019-10-19,979,3667,2137,2,6785
786,2019-10-20,1002,684,1998,0,3684
786,2019-10-21,188,9485,1681,0,11354
786,2019-10-22,254,4491,2025,2,6772
786,2019-10-23,268,7252,1758,1,9279
786,2019-10-24,131,20427,1784,2,22344
786,2019-10-25,122,17934,2043,2,20101
786,2019-10-26,151,23665,1427,1,25244
786,2019-10-27,1425,17612,1049,0,20086
786,2019-10-28,1396,21545,1720,2,24663
786,2019-10-29,212,16674,2389,1,19276
786,2019-10-30,124,14700,1192,0,16016
786,2019-10-31,984,19400,1573,1,21958
786,2019-11-01,1007,25870,1390,2,28269
786,2019-11-02,424,15593,1075,622,17714
786,2019-11-03,113,21551,1887,0,23551
786,2019-11-04,1059,6417,1098,0,8574
786,2019-11-05,151,1229,2144,0,3524
786,2019-11-06,92,20107,1092,0,21291
786,2019-11-07,198,15685,825,0,16708
786,2019-11-08,108,9174,1533,0,10815
786,2019-11-09,82,7809,1335,0,9226
786,2019-11-10,119,11886,1542,0,13547
786,2019-11-11,137,7912,1236,0,9285
786,2019-11-12,519,8477,2053,0,11049
786,2019-11-13,138,13270,1551,0,14959
786,2019-11-14,122,7982,2412,0,10516
786,2019-11-15,115,3431,2846,0,6392
786,2019-11-16,179,6460,2632,0,9271
786,2019-11-17,201,3449,3211,0,6861
786,2019-11-18,98,3443,3031,0,6572
786,2019-11-19,455,2975,2466,0,5896
786,2019-11-20,115,3207,1905,2,5229
786,2019-11-21,103,3488,1606,2,5199
786,2019-11-22,96,8317,1327,3,9743
786,2019-11-23,126,6770,2692,0,9588
786,2019-11-24,222,7048,1618,0,8888
786,2019-11-25,93,7044,1721,0,8858
786,2019-11-26,78,5605,1231,3,6917
786,2019-11-27,85,6635,2120,1,8841
786,2019-11-28,118,7211,289,0,7618
786,2019-11-29,22,853,18,0,893
786,2019-08-26,0,0,90,0,90
786,2019-08-27,125,7074,1991,1,9191
786,2019-08-28,205,10917,2386,1,13509
786,2019-08-29,264,12055,1260,2,13581
786,2019-08-30,2387,2926,653,1,5967
786,2019-08-31,97,111,2,0,210
786,2019-09-01,117,458,478,0,1053
786,2019-09-02,140,400,93,0,633
786,2019-09-03,147,723,1346,0,2216
786,2019-09-04,245,15342,1861,0,17448
786,2019-09-05,529,11536,1619,0,13684
786,2019-09-06,245,11143,1531,0,12919
786,2019-09-07,335,16764,1600,0,18699
786,2019-09-08,1112,6105,2020,1,9238
786,2019-09-09,255,7463,2482,2,10202
786,2019-09-10,146,7418,2046,0,9610
786,2019-09-11,209,5858,1666,2,7735
786,2019-09-12,125,10500,1724,0,12349
786,2019-09-13,140,3953,3015,0,7108
786,2019-09-14,940,6072,2147,1,9160
786,2019-09-15,198,13833,1809,0,15840
786,2019-09-16,132,5922,2700,1,8755
786,2019-09-17,149,6964,2790,4,9907
786,2019-09-18,82,11505,1560,1,13148
786,2019-09-19,221,3157,1725,2,5105
786,2019-09-20,478,10983,2003,2,13466
786,2019-09-21,166,8253,1830,2,10251
786,2019-09-22,906,9366,2438,3,12713
786,2019-09-23,270,8010,1655,1,9936
786,2019-09-24,217,7004,2375,5,9601
786,2019-09-25,269,6318,1893,3,8483
786,2019-09-26,1084,10808,1484,3,13379
786,2019-09-27,934,7507,1861,4,10306
786,2019-09-28,185,14408,1168,3,15764
786,2019-09-29,106,16176,1865,0,18147
786,2019-09-30,131,17173,1458,0,18762
786,2019-10-01,130,15705,1611,1,17447
786,2019-10-02,978,10391,1323,0,12692
786,2019-10-03,1089,13326,1404,2,15821
786,2019-10-04,108,11449,2256,0,13813
786,2019-10-05,106,14155,1370,1,15632
786,2019-10-06,94,11920,1003,1,13018
786,2019-10-07,1109,4945,1362,4,7420
786,2019-10-08,110,17207,1915,0,19232
786,2019-10-09,1883,17019,1877,0,20779
786,2019-10-10,996,8858,1104,1,10959
786,2019-10-11,587,9701,1611,1,11900
786,2019-10-12,973,5346,1417,2,7738
786,2019-10-13,986,7135,1102,1,9224
786,2019-10-14,1282,4414,2142,0,7838
786,2019-10-15,1345,8693,1883,1,11922
786,2019-10-16,106,11684,1538,0,13328
786,2019-10-17,108,4138,2390,4,6640
786,2019-10-18,294,7069,2086,1,9450
786,2019-10-19,979,3667,2137,2,6785
786,2019-10-20,1002,684,1998,0,3684
786,2019-10-21,188,9485,1681,0,11354
786,2019-10-22,254,4491,2025,2,6772
786,2019-10-23,268,7252,1758,1,9279
786,2019-10-24,131,20427,1784,2,22344
786,2019-10-25,122,17934,2043,2,20101
786,2019-10-26,151,23665,1427,1,25244
786,2019-10-27,1425,17612,1049,0,20086
786,2019-10-28,1396,21545,1720,2,24663
786,2019-10-29,212,16674,2389,1,19276
786,2019-10-30,124,14700,1192,0,16016
786,2019-10-31,984,19400,1573,1,21958
786,2019-11-01,1007,25870,1390,2,28269
786,2019-11-02,424,15593,1075,622,17714
786,2019-11-03,113,21551,1887,0,23551
786,2019-11-04,1059,6417,1098,0,8574
786,2019-11-05,151,1229,2144,0,3524
786,2019-11-06,92,20107,1092,0,21291
786,2019-11-07,198,15685,825,0,16708
786,2019-11-08,108,9174,1533,0,10815
786,2019-11-09,82,7809,1335,0,9226
786,2019-11-10,119,11886,1542,0,13547
786,2019-11-11,137,7912,1236,0,9285
786,2019-11-12,519,8477,2053,0,11049
786,2019-11-13,138,13270,1551,0,14959
786,2019-11-14,122,7982,2412,0,10516
786,2019-11-15,115,3431,2846,0,6392
786,2019-11-16,179,6460,2632,0,9271
786,2019-11-17,201,3449,3211,0,6861
786,2019-11-18,98,3443,3031,0,6572
786,2019-11-19,455,2975,2466,0,5896
786,2019-11-20,115,3207,1905,2,5229
786,2019-11-21,103,3488,1606,2,5199
786,2019-11-22,96,8317,1327,3,9743
786,2019-11-23,126,6770,2692,0,9588
786,2019-11-24,222,7048,1618,0,8888
786,2019-11-25,93,7044,1721,0,8858
786,2019-11-26,78,5605,1231,3,6917
786,2019-11-27,85,6635,2120,1,8841
786,2019-11-28,118,7211,289,0,7618
786,2019-11-29,22,853,18,0,893
786,2019-08-27,125,7074,1991,1,9191
786,2019-08-28,205,10917,2386,1,13509
786,2019-08-29,264,12055,1260,2,13581
786,2019-08-30,2387,2926,653,1,5967
786,2019-08-31,97,111,2,0,210
786,2019-09-01,117,458,478,0,1053
786,2019-09-02,140,400,93,0,633
786,2019-09-03,147,723,1346,0,2216
786,2019-09-04,245,15342,1861,0,17448
786,2019-09-05,529,11536,1619,0,13684
786,2019-09-06,245,11143,1531,0,12919
786,2019-09-07,335,16764,1600,0,18699
786,2019-09-08,1112,6105,2020,1,9238
786,2019-09-09,255,7463,2482,2,10202
786,2019-09-10,146,7418,2046,0,9610
786,2019-09-11,209,5858,1666,2,7735
786,2019-09-12,125,10500,1724,0,12349
786,2019-09-13,140,3953,3015,0,7108
786,2019-09-14,940,6072,2147,1,9160
786,2019-09-15,198,13833,1809,0,15840
786,2019-09-16,132,5922,2700,1,8755
786,2019-09-17,149,6964,2790,4,9907
786,2019-09-18,82,11505,1560,1,13148
786,2019-09-19,221,3157,1725,2,5105
786,2019-09-20,478,10983,2003,2,13466
786,2019-09-21,166,8253,1830,2,10251
786,2019-09-22,906,9366,2438,3,12713
786,2019-09-23,270,8010,1655,1,9936
786,2019-09-24,217,7004,2375,5,9601
786,2019-09-25,269,6318,1893,3,8483
786,2019-09-26,1084,10808,1484,3,13379
786,2019-09-27,934,7507,1861,4,10306
786,2019-09-28,185,14408,1168,3,15764
786,2019-09-29,106,16176,1865,0,18147
786,2019-09-30,131,17173,1458,0,18762
786,2019-10-01,130,15705,1611,1,17447
786,2019-10-02,978,10391,1323,0,12692
786,2019-10-03,1089,13326,1404,2,15821
786,2019-10-04,108,11449,2256,0,13813
786,2019-10-05,106,14155,1370,1,15632
786,2019-10-06,94,11920,1003,1,13018
786,2019-10-07,1109,4945,1362,4,7420
786,2019-10-08,110,17207,1915,0,19232
786,2019-10-09,1883,17019,1877,0,20779
786,2019-10-10,996,8858,1104,1,10959
786,2019-10-11,587,9701,1611,1,11900
786,2019-10-12,973,5346,1417,2,7738
786,2019-10-13,986,7135,1102,1,9224
786,2019-10-14,1282,4414,2142,0,7838
786,2019-10-15,1345,8693,1883,1,11922
786,2019-10-16,106,11684,1538,0,13328
786,2019-10-17,108,4138,2390,4,6640
786,2019-10-18,294,7069,2086,1,9450
786,2019-10-19,979,3667,2137,2,6785
786,2019-10-20,1002,684,1998,0,3684
786,2019-10-21,188,9485,1681,0,11354
786,2019-10-22,254,4491,2025,2,6772
786,2019-10-23,268,7252,1758,1,9279
786,2019-10-24,131,20427,1784,2,22344
786,2019-10-25,122,17934,2043,2,20101
786,2019-10-26,151,23665,1427,1,25244
786,2019-10-27,1425,17612,1049,0,20086
786,2019-10-28,1396,21545,1720,2,24663
786,2019-10-29,212,16674,2389,1,19276
786,2019-10-30,124,14700,1192,0,16016
786,2019-10-31,984,19400,1573,1,21958
786,2019-11-01,1007,25870,1390,2,28269
786,2019-11-02,424,15593,1075,622,17714
786,2019-11-03,113,21551,1887,0,23551
786,2019-11-04,1059,6417,1098,0,8574
786,2019-11-05,151,1229,2144,0,3524
786,2019-11-06,92,20107,1092,0,21291
786,2019-11-07,198,15685,825,0,16708
786,2019-11-08,108,9174,1533,0,10815
786,2019-11-09,82,7809,1335,0,9226
786,2019-11-10,119,11886,1542,0,13547
786,2019-11-11,137,7912,1236,0,9285
786,2019-11-12,519,8477,2053,0,11049
786,2019-11-13,138,13270,1551,0,14959
786,2019-11-14,122,7982,2412,0,10516
786,2019-11-15,115,3431,2846,0,6392
786,2019-11-16,179,6460,2632,0,9271
786,2019-11-17,201,3449,3211,0,6861
786,2019-11-18,98,3443,3031,0,6572
786,2019-11-19,455,2975,2466,0,5896
786,2019-11-20,115,3207,1905,2,5229
786,2019-11-21,103,3488,1606,2,5199
786,2019-11-22,96,8317,1327,3,9743
786,2019-11-23,126,6770,2692,0,9588
786,2019-11-24,222,7048,1618,0,8888
786,2019-11-25,93,7044,1721,0,8858
786,2019-11-26,78,5605,1231,3,6917
786,2019-11-27,85,6635,2120,1,8841
787,2019-08-27,182,8430,1178,0,9790
787,2019-08-28,232,1516,2504,0,4252
787,2019-08-29,605,9229,1641,1,11476
787,2019-08-30,279,2915,632,0,3826
787,2019-08-31,70,141,11,0,222
787,2019-09-01,121,1246,90,0,1457
787,2019-09-02,89,209,13,0,311
787,2019-09-03,104,1585,1404,1,3094
787,2019-09-04,239,21955,1814,1,24009
787,2019-09-05,376,6449,1849,0,8674
787,2019-09-06,216,12637,1939,0,14792
787,2019-09-07,1133,24932,1847,0,27912
787,2019-09-08,342,5259,1859,2,7462
787,2019-09-09,197,7681,1990,1,9869
787,2019-09-10,216,11928,1937,0,14081
787,2019-09-11,959,5827,1755,2,8543
787,2019-09-12,156,8939,1554,1,10650
787,2019-09-13,145,5141,1820,1,7107
787,2019-09-14,124,7164,1735,0,9023
787,2019-09-15,240,8855,1896,0,10991
787,2019-09-16,447,6031,2004,3,8485
787,2019-09-17,145,6936,1877,0,8958
787,2019-09-18,206,11735,1608,4,13553
787,2019-09-19,302,4093,2430,1,6826
787,2019-09-20,260,11110,1429,2,12801
787,2019-09-21,141,11845,1643,2,13631
787,2019-09-22,164,16446,1748,0,18358
787,2019-09-23,223,9286,1811,1,11321
787,2019-09-24,215,6915,1551,3,8684
787,2019-09-25,158,8410,1424,0,9992
787,2019-09-26,197,9036,1622,3,10858
787,2019-09-27,167,13081,2351,4,15603
787,2019-09-28,526,14151,1392,0,16069
787,2019-09-29,180,16230,2245,1,18656
787,2019-09-30,265,19193,1832,1,21291
787,2019-10-01,174,15540,1000,2,16716
787,2019-10-02,459,10696,1912,1,13068
787,2019-10-03,284,12648,1420,0,14352
787,2019-10-04,619,11086,1796,0,13501
787,2019-10-05,2118,20499,2043,1,24661
787,2019-10-06,138,19115,2282,481,22016
787,2019-10-07,1876,5121,2332,0,9329
787,2019-10-08,250,10467,2186,1,12904
787,2019-10-09,1059,13684,1428,1,16172
787,2019-10-10,1045,15905,2013,1,18964
787,2019-10-11,285,13574,1372,2,15233
787,2019-10-12,141,5641,1518,0,7300
787,2019-10-13,1670,11385,2100,3,15158
787,2019-10-14,2067,6151,2691,0,10909
787,2019-10-15,254,6997,2225,0,9476
787,2019-10-16,876,17447,2003,4,20330
787,2019-10-17,1250,6749,1180,0,9179
787,2019-10-18,166,7333,1425,1,8925
787,2019-10-19,1032,4127,1486,1,6646
787,2019-10-20,159,657,1935,0,2751
787,2019-10-21,1032,10381,796,5,12214
787,2019-10-22,144,4752,2189,9151,16236
787,2019-10-23,202,7474,1826,1,9503
787,2019-10-24,736,12812,1188,1,14737
787,2019-10-25,556,14607,1548,1,16712
787,2019-10-26,147,16005,1619,0,17771
787,2019-10-27,310,15602,1029,0,16941
787,2019-10-28,152,12995,1995,0,15142
787,2019-10-29,566,26413,1107,0,28086
787,2019-10-30,809,28688,1883,2,31382
787,2019-10-31,134,29553,1813,4,31504
787,2019-11-01,155,27412,2107,0,29674
787,2019-11-02,160,15409,1505,0,17074
787,2019-11-03,146,35810,907,1,36864
787,2019-11-04,971,9143,1832,0,11946
787,2019-11-05,205,1444,1559,0,3208
787,2019-11-06,272,13536,1483,1,15292
787,2019-11-07,242,24794,1129,2,26167
787,2019-11-08,156,11170,1509,0,12835
787,2019-11-09,142,7892,1718,0,9752
787,2019-11-10,257,22849,1264,2,24372
787,2019-11-11,148,15442,1199,3,16792
787,2019-11-12,150,11195,2339,0,13684
787,2019-11-13,137,16945,1512,0,18594
787,2019-11-14,200,13507,2064,0,15771
787,2019-11-15,179,3556,2587,0,6322
787,2019-11-16,130,1166,2305,0,3601
787,2019-11-17,272,2054,3405,0,5731
787,2019-11-18,128,1503,2887,0,4518
787,2019-11-19,175,8129,3055,0,11359
787,2019-11-20,163,1298,2580,0,4041
787,2019-11-21,152,4842,1294,0,6288
787,2019-11-22,178,7562,1488,0,9228
787,2019-11-23,477,10159,2142,0,12778
787,2019-11-24,1537,8398,1224,0,11159
787,2019-11-25,207,10039,1469,0,11715
787,2019-11-26,508,8044,1915,1,10468
787,2019-11-27,159,9354,1478,0,10991
787,2019-11-28,116,10691,316,0,11123
787,2019-11-29,42,707,2,0,751
787,2019-08-27,182,8430,1178,0,9790
787,2019-08-28,232,1516,2504,0,4252
787,2019-08-29,605,9229,1641,1,11476
787,2019-08-30,279,2915,632,0,3826
787,2019-08-31,70,141,11,0,222
787,2019-09-01,121,1246,90,0,1457
787,2019-09-02,89,209,13,0,311
787,2019-09-03,104,1585,1404,1,3094
787,2019-09-04,239,21955,1814,1,24009
787,2019-09-05,376,6449,1849,0,8674
787,2019-09-06,216,12637,1939,0,14792
787,2019-09-07,1133,24932,1847,0,27912
787,2019-09-08,342,5259,1859,2,7462
787,2019-09-09,197,7681,1990,1,9869
787,2019-09-10,216,11928,1937,0,14081
787,2019-09-11,959,5827,1755,2,8543
787,2019-09-12,156,8939,1554,1,10650
787,2019-09-13,145,5141,1820,1,7107
787,2019-09-14,124,7164,1735,0,9023
787,2019-09-15,240,8855,1896,0,10991
787,2019-09-16,447,6031,2004,3,8485
787,2019-09-17,145,6936,1877,0,8958
787,2019-09-18,206,11735,1608,4,13553
787,2019-09-19,302,4093,2430,1,6826
787,2019-09-20,260,11110,1429,2,12801
787,2019-09-21,141,11845,1643,2,13631
787,2019-09-22,164,16446,1748,0,18358
787,2019-09-23,223,9286,1811,1,11321
787,2019-09-24,215,6915,1551,3,8684
787,2019-09-25,158,8410,1424,0,9992
787,2019-09-26,197,9036,1622,3,10858
787,2019-09-27,167,13081,2351,4,15603
787,2019-09-28,526,14151,1392,0,16069
787,2019-09-29,180,16230,2245,1,18656
787,2019-09-30,265,19193,1832,1,21291
787,2019-10-01,174,15540,1000,2,16716
787,2019-10-02,459,10696,1912,1,13068
787,2019-10-03,284,12648,1420,0,14352
787,2019-10-04,619,11086,1796,0,13501
787,2019-10-05,2118,20499,2043,1,24661
787,2019-10-06,138,19115,2282,481,22016
787,2019-10-07,1876,5121,2332,0,9329
787,2019-10-08,250,10467,2186,1,12904
787,2019-10-09,1059,13684,1428,1,16172
787,2019-10-10,1045,15905,2013,1,18964
787,2019-10-11,285,13574,1372,2,15233
787,2019-10-12,141,5641,1518,0,7300
787,2019-10-13,1670,11385,2100,3,15158
787,2019-10-14,2067,6151,2691,0,10909
787,2019-10-15,254,6997,2225,0,9476
787,2019-10-16,876,17447,2003,4,20330
787,2019-10-17,1250,6749,1180,0,9179
787,2019-10-18,166,7333,1425,1,8925
787,2019-10-19,1032,4127,1486,1,6646
787,2019-10-20,159,657,1935,0,2751
787,2019-10-21,1032,10381,796,5,12214
787,2019-10-22,144,4752,2189,9151,16236
787,2019-10-23,202,7474,1826,1,9503
787,2019-10-24,736,12812,1188,1,14737
787,2019-10-25,556,14607,1548,1,16712
787,2019-10-26,147,16005,1619,0,17771
787,2019-10-27,310,15602,1029,0,16941
787,2019-10-28,152,12995,1995,0,15142
787,2019-10-29,566,26413,1107,0,28086
787,2019-10-30,809,28688,1883,2,31382
787,2019-10-31,134,29553,1813,4,31504
787,2019-11-01,155,27412,2107,0,29674
787,2019-11-02,160,15409,1505,0,17074
787,2019-11-03,146,35810,907,1,36864
787,2019-11-04,971,9143,1832,0,11946
787,2019-11-05,205,1444,1559,0,3208
787,2019-11-06,272,13536,1483,1,15292
787,2019-11-07,242,24794,1129,2,26167
787,2019-11-08,156,11170,1509,0,12835
787,2019-11-09,142,7892,1718,0,9752
787,2019-11-10,257,22849,1264,2,24372
787,2019-11-11,148,15442,1199,3,16792
787,2019-11-12,150,11195,2339,0,13684
787,2019-11-13,137,16945,1512,0,18594
787,2019-11-14,200,13507,2064,0,15771
787,2019-11-15,179,3556,2587,0,6322
787,2019-11-16,130,1166,2305,0,3601
787,2019-11-17,272,2054,3405,0,5731
787,2019-11-18,128,1503,2887,0,4518
787,2019-11-19,175,8129,3055,0,11359
787,2019-11-20,163,1298,2580,0,4041
787,2019-11-21,152,4842,1294,0,6288
787,2019-11-22,178,7562,1488,0,9228
787,2019-11-23,477,10159,2142,0,12778
787,2019-11-24,1537,8398,1224,0,11159
787,2019-11-25,207,10039,1469,0,11715
787,2019-11-26,508,8044,1915,1,10468
787,2019-11-27,159,9354,1478,0,10991
787,2019-11-28,116,10691,316,0,11123
787,2019-11-29,42,707,2,0,751
787,2019-08-26,0,0,3,0,3
787,2019-08-27,182,8430,1178,0,9790
787,2019-08-28,232,1516,2504,0,4252
787,2019-08-29,605,9229,1641,1,11476
787,2019-08-30,279,2915,632,0,3826
787,2019-08-31,70,141,11,0,222
787,2019-09-01,121,1246,90,0,1457
787,2019-09-02,89,209,13,0,311
787,2019-09-03,104,1585,1404,1,3094
787,2019-09-04,239,21955,1814,1,24009
787,2019-09-05,376,6449,1849,0,8674
787,2019-09-06,216,12637,1939,0,14792
787,2019-09-07,1133,24932,1847,0,27912
787,2019-09-08,342,5259,1859,2,7462
787,2019-09-09,197,7681,1990,1,9869
787,2019-09-10,216,11928,1937,0,14081
787,2019-09-11,959,5827,1755,2,8543
787,2019-09-12,156,8939,1554,1,10650
787,2019-09-13,145,5141,1820,1,7107
787,2019-09-14,124,7164,1735,0,9023
787,2019-09-15,240,8855,1896,0,10991
787,2019-09-16,447,6031,2004,3,8485
787,2019-09-17,145,6936,1877,0,8958
787,2019-09-18,206,11735,1608,4,13553
787,2019-09-19,302,4093,2430,1,6826
787,2019-09-20,260,11110,1429,2,12801
787,2019-09-21,141,11845,1643,2,13631
787,2019-09-22,164,16446,1748,0,18358
787,2019-09-23,223,9286,1811,1,11321
787,2019-09-24,215,6915,1551,3,8684
787,2019-09-25,158,8410,1424,0,9992
787,2019-09-26,197,9036,1622,3,10858
787,2019-09-27,167,13081,2351,4,15603
787,2019-09-28,526,14151,1392,0,16069
787,2019-09-29,180,16230,2245,1,18656
787,2019-09-30,265,19193,1832,1,21291
787,2019-10-01,174,15540,1000,2,16716
787,2019-10-02,459,10696,1912,1,13068
787,2019-10-03,284,12648,1420,0,14352
787,2019-10-04,619,11086,1796,0,13501
787,2019-10-05,2118,20499,2043,1,24661
787,2019-10-06,138,19115,2282,481,22016
787,2019-10-07,1876,5121,2332,0,9329
787,2019-10-08,250,10467,2186,1,12904
787,2019-10-09,1059,13684,1428,1,16172
787,2019-10-10,1045,15905,2013,1,18964
787,2019-10-11,285,13574,1372,2,15233
787,2019-10-12,141,5641,1518,0,7300
787,2019-10-13,1670,11385,2100,3,15158
787,2019-10-14,2067,6151,2691,0,10909
787,2019-10-15,254,6997,2225,0,9476
787,2019-10-16,876,17447,2003,4,20330
787,2019-10-17,1250,6749,1180,0,9179
787,2019-10-18,166,7333,1425,1,8925
787,2019-10-19,1032,4127,1486,1,6646
787,2019-10-20,159,657,1935,0,2751
787,2019-10-21,1032,10381,796,5,12214
787,2019-10-22,144,4752,2189,9151,16236
787,2019-10-23,202,7474,1826,1,9503
787,2019-10-24,736,12812,1188,1,14737
787,2019-10-25,556,14607,1548,1,16712
787,2019-10-26,147,16005,1619,0,17771
787,2019-10-27,310,15602,1029,0,16941
787,2019-10-28,152,12995,1995,0,15142
787,2019-10-29,566,26413,1107,0,28086
787,2019-10-30,809,28688,1883,2,31382
787,2019-10-31,134,29553,1813,4,31504
787,2019-11-01,155,27412,2107,0,29674
787,2019-11-02,160,15409,1505,0,17074
787,2019-11-03,146,35810,907,1,36864
787,2019-11-04,971,9143,1832,0,11946
787,2019-11-05,205,1444,1559,0,3208
787,2019-11-06,272,13536,1483,1,15292
787,2019-11-07,242,24794,1129,2,26167
787,2019-11-08,156,11170,1509,0,12835
787,2019-11-09,142,7892,1718,0,9752
787,2019-11-10,257,22849,1264,2,24372
787,2019-11-11,148,15442,1199,3,16792
787,2019-11-12,150,11195,2339,0,13684
787,2019-11-13,137,16945,1512,0,18594
787,2019-11-14,200,13507,2064,0,15771
787,2019-11-15,179,3556,2587,0,6322
787,2019-11-16,130,1166,2305,0,3601
787,2019-11-17,272,2054,3405,0,5731
787,2019-11-18,128,1503,2887,0,4518
787,2019-11-19,175,8129,3055,0,11359
787,2019-11-20,163,1298,2580,0,4041
787,2019-11-21,152,4842,1294,0,6288
787,2019-11-22,178,7562,1488,0,9228
787,2019-11-23,477,10159,2142,0,12778
787,2019-11-24,1537,8398,1224,0,11159
787,2019-11-25,207,10039,1469,0,11715
787,2019-11-26,508,8044,1915,1,10468
787,2019-11-27,159,9354,1478,0,10991
787,2019-11-28,116,10691,316,0,11123
787,2019-11-29,42,707,2,0,751
787,2019-08-29,605,9229,1641,1,11476
787,2019-08-30,279,2915,632,0,3826
787,2019-08-31,70,141,11,0,222
787,2019-09-01,121,1246,90,0,1457
787,2019-09-02,89,209,13,0,311
787,2019-09-03,104,1585,1404,1,3094
787,2019-09-04,239,21955,1814,1,24009
787,2019-09-05,376,6449,1849,0,8674
787,2019-09-06,216,12637,1939,0,14792
787,2019-09-07,1133,24932,1847,0,27912
787,2019-09-08,342,5259,1859,2,7462
787,2019-09-09,197,7681,1990,1,9869
787,2019-09-10,216,11928,1937,0,14081
787,2019-09-11,959,5827,1755,2,8543
787,2019-09-12,156,8939,1554,1,10650
787,2019-09-13,145,5141,1820,1,7107
787,2019-09-14,124,7164,1735,0,9023
787,2019-09-15,240,8855,1896,0,10991
787,2019-09-16,447,6031,2004,3,8485
787,2019-09-17,145,6936,1877,0,8958
787,2019-09-18,206,11735,1608,4,13553
787,2019-09-19,302,4093,2430,1,6826
787,2019-09-20,260,11110,1429,2,12801
787,2019-09-21,141,11845,1643,2,13631
787,2019-09-22,164,16446,1748,0,18358
787,2019-09-23,223,9286,1811,1,11321
787,2019-09-24,215,6915,1551,3,8684
787,2019-09-25,158,8410,1424,0,9992
787,2019-09-26,197,9036,1622,3,10858
787,2019-09-27,167,13081,2351,4,15603
787,2019-09-28,526,14151,1392,0,16069
787,2019-09-29,180,16230,2245,1,18656
787,2019-09-30,265,19193,1832,1,21291
787,2019-10-01,174,15540,1000,2,16716
787,2019-10-02,459,10696,1912,1,13068
787,2019-10-03,284,12648,1420,0,14352
787,2019-10-04,619,11086,1796,0,13501
787,2019-10-05,2118,20499,2043,1,24661
787,2019-10-06,138,19115,2282,481,22016
787,2019-10-07,1876,5121,2332,0,9329
787,2019-10-08,250,10467,2186,1,12904
787,2019-10-09,1059,13684,1428,1,16172
787,2019-10-10,1045,15905,2013,1,18964
787,2019-10-11,285,13574,1372,2,15233
787,2019-10-12,141,5641,1518,0,7300
787,2019-10-13,1670,11385,2100,3,15158
787,2019-10-14,2067,6151,2691,0,10909
787,2019-10-15,254,6997,2225,0,9476
787,2019-10-16,876,17447,2003,4,20330
787,2019-10-17,1250,6749,1180,0,9179
787,2019-10-18,166,7333,1425,1,8925
787,2019-10-19,1032,4127,1486,1,6646
787,2019-10-20,159,657,1935,0,2751
787,2019-10-21,1032,10381,796,5,12214
787,2019-10-22,144,4752,2189,9151,16236
787,2019-10-23,202,7474,1826,1,9503
787,2019-10-24,736,12812,1188,1,14737
787,2019-10-25,556,14607,1548,1,16712
787,2019-10-26,147,16005,1619,0,17771
787,2019-10-27,310,15602,1029,0,16941
787,2019-10-28,152,12995,1995,0,15142
787,2019-10-29,566,26413,1107,0,28086
787,2019-10-30,809,28688,1883,2,31382
787,2019-10-31,134,29553,1813,4,31504
787,2019-11-01,155,27412,2107,0,29674
787,2019-11-02,160,15409,1505,0,17074
787,2019-11-03,146,35810,907,1,36864
787,2019-11-04,971,9143,1832,0,11946
787,2019-11-05,205,1444,1559,0,3208
787,2019-11-06,272,13536,1483,1,15292
787,2019-11-07,242,24794,1129,2,26167
787,2019-11-08,156,11170,1509,0,12835
787,2019-11-09,142,7892,1718,0,9752
787,2019-11-10,257,22849,1264,2,24372
787,2019-11-11,148,15442,1199,3,16792
787,2019-11-12,150,11195,2339,0,13684
787,2019-11-13,137,16945,1512,0,18594
787,2019-11-14,200,13507,2064,0,15771
787,2019-11-15,179,3556,2587,0,6322
787,2019-11-16,130,1166,2305,0,3601
787,2019-11-17,272,2054,3405,0,5731
787,2019-11-18,128,1503,2887,0,4518
787,2019-11-19,175,8129,3055,0,11359
787,2019-11-20,163,1298,2580,0,4041
787,2019-11-21,152,4842,1294,0,6288
787,2019-11-22,178,7562,1488,0,9228
787,2019-11-23,477,10159,2142,0,12778
787,2019-11-24,1537,8398,1224,0,11159
787,2019-11-25,207,10039,1469,0,11715
787,2019-11-26,508,8044,1915,1,10468
788,2019-08-27,182,8136,1710,1,10029
788,2019-08-28,241,1924,2057,1,4223
788,2019-08-29,269,9147,2251,1,11668
788,2019-08-30,223,2951,384,1,3559
788,2019-08-31,94,49,0,2,145
788,2019-09-01,177,311,205,1,694
788,2019-09-02,162,270,17,2,451
788,2019-09-03,178,447,921,1,1547
788,2019-09-04,297,13350,1788,0,15435
788,2019-09-05,547,5779,2203,0,8529
788,2019-09-06,1116,6759,2439,1,10315
788,2019-09-07,295,9296,2400,1,11992
788,2019-09-08,1268,4845,1430,1,7544
788,2019-09-09,349,7660,1804,0,9813
788,2019-09-10,1075,7576,1696,0,10347
788,2019-09-11,230,6328,1795,2,8355
788,2019-09-12,184,6457,2761,1,9403
788,2019-09-13,304,2209,1640,0,4153
788,2019-09-14,230,8034,1468,0,9732
788,2019-09-15,981,9633,2513,1,13128
788,2019-09-16,182,6124,1506,0,7812
788,2019-09-17,1033,9651,2973,0,13657
788,2019-09-18,658,11483,1933,0,14074
788,2019-09-19,331,2523,1440,2,4296
788,2019-09-20,329,9125,1762,0,11216
788,2019-09-21,158,8645,2017,0,10820
788,2019-09-22,220,10137,2483,2,12842
788,2019-09-23,221,9893,2336,0,12450
788,2019-09-24,262,8832,1709,1,10804
788,2019-09-25,206,7941,1568,2,9717
788,2019-09-26,1088,11057,2200,0,14345
788,2019-09-27,174,6980,1935,3,9092
788,2019-09-28,309,13392,1789,1,15491
788,2019-09-29,721,17097,1285,2,19105
788,2019-09-30,786,18282,1962,1,21031
788,2019-10-01,140,16429,1932,0,18501
788,2019-10-02,268,12374,1464,1,14107
788,2019-10-03,172,14917,1803,3,16895
788,2019-10-04,179,12491,1003,43,13716
788,2019-10-05,2315,14292,1899,27,18533
788,2019-10-06,248,13779,2002,3,16032
788,2019-10-07,223,6254,1412,3,7892
788,2019-10-08,856,18348,1268,0,20472
788,2019-10-09,188,17525,1637,0,19350
788,2019-10-10,1077,10506,1771,2,13356
788,2019-10-11,150,11649,1416,2,13217
788,2019-10-12,812,7103,1863,3,9781
788,2019-10-13,272,8938,1514,0,10724
788,2019-10-14,272,6130,2306,1,8709
788,2019-10-15,1959,8745,1942,2,12648
788,2019-10-16,268,18246,1121,3,19638
788,2019-10-17,187,8775,1819,2,10783
788,2019-10-18,185,8628,1641,0,10454
788,2019-10-19,205,5803,1585,3,7596
788,2019-10-20,1068,3205,1500,0,5773
788,2019-10-21,626,10794,1509,2,12931
788,2019-10-22,174,6853,2708,2,9737
788,2019-10-23,1031,8732,821,2,10586
788,2019-10-24,201,20478,1292,2,21973
788,2019-10-25,224,19286,1048,3,20561
788,2019-10-26,615,17481,1823,0,19919
788,2019-10-27,195,16420,1577,0,18192
788,2019-10-28,768,14348,2393,2,17511
788,2019-10-29,728,15959,1163,0,17850
788,2019-10-30,1045,15735,1424,0,18204
788,2019-10-31,118,12777,1671,1,14567
788,2019-11-01,131,25575,1395,2,27103
788,2019-11-02,128,17294,1091,0,18513
788,2019-11-03,934,22350,1700,1,24985
788,2019-11-04,488,10970,2138,0,13596
788,2019-11-05,252,5488,2423,0,8163
788,2019-11-06,244,14708,1148,4,16104
788,2019-11-07,463,16946,799,1,18209
788,2019-11-08,217,10450,985,0,11652
788,2019-11-09,186,13653,1722,0,15561
788,2019-11-10,1117,25442,1470,0,28029
788,2019-11-11,241,16748,1671,5,18665
788,2019-11-12,180,17655,3350,2,21187
788,2019-11-13,272,23201,2084,1,25558
788,2019-11-14,158,10447,1565,0,12170
788,2019-11-15,534,3816,2584,0,6934
788,2019-11-16,854,2343,2657,0,5854
788,2019-11-17,2710,2481,3713,0,8904
788,2019-11-18,198,2721,3510,0,6429
788,2019-11-19,206,5188,2292,0,7686
788,2019-11-20,516,1617,2762,0,4895
788,2019-11-21,200,3485,1755,0,5440
788,2019-11-22,622,4641,1190,0,6453
788,2019-11-23,200,6038,1711,0,7949
788,2019-11-24,578,8119,1565,0,10262
788,2019-11-25,188,6929,1759,2,8878
788,2019-11-26,111,8389,1751,2,10253
788,2019-11-27,149,6346,1347,0,7842
788,2019-11-28,144,7080,878,1,8103
788,2019-11-29,44,186,4,0,234
788,2019-08-27,182,8136,1710,1,10029
788,2019-08-28,241,1924,2057,1,4223
788,2019-08-29,269,9147,2251,1,11668
788,2019-08-30,223,2951,384,1,3559
788,2019-08-31,94,49,0,2,145
788,2019-09-01,177,311,205,1,694
788,2019-09-02,162,270,17,2,451
788,2019-09-03,178,447,921,1,1547
788,2019-09-04,297,13350,1788,0,15435
788,2019-09-05,547,5779,2203,0,8529
788,2019-09-06,1116,6759,2439,1,10315
788,2019-09-07,295,9296,2400,1,11992
788,2019-09-08,1268,4845,1430,1,7544
788,2019-09-09,349,7660,1804,0,9813
788,2019-09-10,1075,7576,1696,0,10347
788,2019-09-11,230,6328,1795,2,8355
788,2019-09-12,184,6457,2761,1,9403
788,2019-09-13,304,2209,1640,0,4153
788,2019-09-14,230,8034,1468,0,9732
788,2019-09-15,981,9633,2513,1,13128
788,2019-09-16,182,6124,1506,0,7812
788,2019-09-17,1033,9651,2973,0,13657
788,2019-09-18,658,11483,1933,0,14074
788,2019-09-19,331,2523,1440,2,4296
788,2019-09-20,329,9125,1762,0,11216
788,2019-09-21,158,8645,2017,0,10820
788,2019-09-22,220,10137,2483,2,12842
788,2019-09-23,221,9893,2336,0,12450
788,2019-09-24,262,8832,1709,1,10804
788,2019-09-25,206,7941,1568,2,9717
788,2019-09-26,1088,11057,2200,0,14345
788,2019-09-27,174,6980,1935,3,9092
788,2019-09-28,309,13392,1789,1,15491
788,2019-09-29,721,17097,1285,2,19105
788,2019-09-30,786,18282,1962,1,21031
788,2019-10-01,140,16429,1932,0,18501
788,2019-10-02,268,12374,1464,1,14107
788,2019-10-03,172,14917,1803,3,16895
788,2019-10-04,179,12491,1003,43,13716
788,2019-10-05,2315,14292,1899,27,18533
788,2019-10-06,248,13779,2002,3,16032
788,2019-10-07,223,6254,1412,3,7892
788,2019-10-08,856,18348,1268,0,20472
788,2019-10-09,188,17525,1637,0,19350
788,2019-10-10,1077,10506,1771,2,13356
788,2019-10-11,150,11649,1416,2,13217
788,2019-10-12,812,7103,1863,3,9781
788,2019-10-13,272,8938,1514,0,10724
788,2019-10-14,272,6130,2306,1,8709
788,2019-10-15,1959,8745,1942,2,12648
788,2019-10-16,268,18246,1121,3,19638
788,2019-10-17,187,8775,1819,2,10783
788,2019-10-18,185,8628,1641,0,10454
788,2019-10-19,205,5803,1585,3,7596
788,2019-10-20,1068,3205,1500,0,5773
788,2019-10-21,626,10794,1509,2,12931
788,2019-10-22,174,6853,2708,2,9737
788,2019-10-23,1031,8732,821,2,10586
788,2019-10-24,201,20478,1292,2,21973
788,2019-10-25,224,19286,1048,3,20561
788,2019-10-26,615,17481,1823,0,19919
788,2019-10-27,195,16420,1577,0,18192
788,2019-10-28,768,14348,2393,2,17511
788,2019-10-29,728,15959,1163,0,17850
788,2019-10-30,1045,15735,1424,0,18204
788,2019-10-31,118,12777,1671,1,14567
788,2019-11-01,131,25575,1395,2,27103
788,2019-11-02,128,17294,1091,0,18513
788,2019-11-03,934,22350,1700,1,24985
788,2019-11-04,488,10970,2138,0,13596
788,2019-11-05,252,5488,2423,0,8163
788,2019-11-06,244,14708,1148,4,16104
788,2019-11-07,463,16946,799,1,18209
788,2019-11-08,217,10450,985,0,11652
788,2019-11-09,186,13653,1722,0,15561
788,2019-11-10,1117,25442,1470,0,28029
788,2019-11-11,241,16748,1671,5,18665
788,2019-11-12,180,17655,3350,2,21187
788,2019-11-13,272,23201,2084,1,25558
788,2019-11-14,158,10447,1565,0,12170
788,2019-11-15,534,3816,2584,0,6934
788,2019-11-16,854,2343,2657,0,5854
788,2019-11-17,2710,2481,3713,0,8904
788,2019-11-18,198,2721,3510,0,6429
788,2019-11-19,206,5188,2292,0,7686
788,2019-11-20,516,1617,2762,0,4895
788,2019-11-21,200,3485,1755,0,5440
788,2019-11-22,622,4641,1190,0,6453
788,2019-11-23,200,6038,1711,0,7949
788,2019-11-24,578,8119,1565,0,10262
788,2019-11-25,188,6929,1759,2,8878
788,2019-11-26,111,8389,1751,2,10253
788,2019-11-27,149,6346,1347,0,7842
788,2019-11-28,144,7080,878,1,8103
788,2019-11-29,44,186,4,0,234
788,2019-08-26,0,0,270,0,270
788,2019-08-27,182,8136,1710,1,10029
788,2019-08-28,241,1924,2057,1,4223
788,2019-08-29,269,9147,2251,1,11668
788,2019-08-30,223,2951,384,1,3559
788,2019-08-31,94,49,0,2,145
788,2019-09-01,177,311,205,1,694
788,2019-09-02,162,270,17,2,451
788,2019-09-03,178,447,921,1,1547
788,2019-09-04,297,13350,1788,0,15435
788,2019-09-05,547,5779,2203,0,8529
788,2019-09-06,1116,6759,2439,1,10315
788,2019-09-07,295,9296,2400,1,11992
788,2019-09-08,1268,4845,1430,1,7544
788,2019-09-09,349,7660,1804,0,9813
788,2019-09-10,1075,7576,1696,0,10347
788,2019-09-11,230,6328,1795,2,8355
788,2019-09-12,184,6457,2761,1,9403
788,2019-09-13,304,2209,1640,0,4153
788,2019-09-14,230,8034,1468,0,9732
788,2019-09-15,981,9633,2513,1,13128
788,2019-09-16,182,6124,1506,0,7812
788,2019-09-17,1033,9651,2973,0,13657
788,2019-09-18,658,11483,1933,0,14074
788,2019-09-19,331,2523,1440,2,4296
788,2019-09-20,329,9125,1762,0,11216
788,2019-09-21,158,8645,2017,0,10820
788,2019-09-22,220,10137,2483,2,12842
788,2019-09-23,221,9893,2336,0,12450
788,2019-09-24,262,8832,1709,1,10804
788,2019-09-25,206,7941,1568,2,9717
788,2019-09-26,1088,11057,2200,0,14345
788,2019-09-27,174,6980,1935,3,9092
788,2019-09-28,309,13392,1789,1,15491
788,2019-09-29,721,17097,1285,2,19105
788,2019-09-30,786,18282,1962,1,21031
788,2019-10-01,140,16429,1932,0,18501
788,2019-10-02,268,12374,1464,1,14107
788,2019-10-03,172,14917,1803,3,16895
788,2019-10-04,179,12491,1003,43,13716
788,2019-10-05,2315,14292,1899,27,18533
788,2019-10-06,248,13779,2002,3,16032
788,2019-10-07,223,6254,1412,3,7892
788,2019-10-08,856,18348,1268,0,20472
788,2019-10-09,188,17525,1637,0,19350
788,2019-10-10,1077,10506,1771,2,13356
788,2019-10-11,150,11649,1416,2,13217
788,2019-10-12,812,7103,1863,3,9781
788,2019-10-13,272,8938,1514,0,10724
788,2019-10-14,272,6130,2306,1,8709
788,2019-10-15,1959,8745,1942,2,12648
788,2019-10-16,268,18246,1121,3,19638
788,2019-10-17,187,8775,1819,2,10783
788,2019-10-18,185,8628,1641,0,10454
788,2019-10-19,205,5803,1585,3,7596
788,2019-10-20,1068,3205,1500,0,5773
788,2019-10-21,626,10794,1509,2,12931
788,2019-10-22,174,6853,2708,2,9737
788,2019-10-23,1031,8732,821,2,10586
788,2019-10-24,201,20478,1292,2,21973
788,2019-10-25,224,19286,1048,3,20561
788,2019-10-26,615,17481,1823,0,19919
788,2019-10-27,195,16420,1577,0,18192
788,2019-10-28,768,14348,2393,2,17511
788,2019-10-29,728,15959,1163,0,17850
788,2019-10-30,1045,15735,1424,0,18204
788,2019-10-31,118,12777,1671,1,14567
788,2019-11-01,131,25575,1395,2,27103
788,2019-11-02,128,17294,1091,0,18513
788,2019-11-03,934,22350,1700,1,24985
788,2019-11-04,488,10970,2138,0,13596
788,2019-11-05,252,5488,2423,0,8163
788,2019-11-06,244,14708,1148,4,16104
788,2019-11-07,463,16946,799,1,18209
788,2019-11-08,217,10450,985,0,11652
788,2019-11-09,186,13653,1722,0,15561
788,2019-11-10,1117,25442,1470,0,28029
788,2019-11-11,241,16748,1671,5,18665
788,2019-11-12,180,17655,3350,2,21187
788,2019-11-13,272,23201,2084,1,25558
788,2019-11-14,158,10447,1565,0,12170
788,2019-11-15,534,3816,2584,0,6934
788,2019-11-16,854,2343,2657,0,5854
788,2019-11-17,2710,2481,3713,0,8904
788,2019-11-18,198,2721,3510,0,6429
788,2019-11-19,206,5188,2292,0,7686
788,2019-11-20,516,1617,2762,0,4895
788,2019-11-21,200,3485,1755,0,5440
788,2019-11-22,622,4641,1190,0,6453
788,2019-11-23,200,6038,1711,0,7949
788,2019-11-24,578,8119,1565,0,10262
788,2019-11-25,188,6929,1759,2,8878
788,2019-11-26,111,8389,1751,2,10253
788,2019-11-27,149,6346,1347,0,7842
788,2019-11-28,144,7080,878,1,8103
788,2019-11-29,44,186,4,0,234
788,2019-08-27,182,8136,1710,1,10029
788,2019-08-28,241,1924,2057,1,4223
788,2019-08-29,269,9147,2251,1,11668
788,2019-08-30,223,2951,384,1,3559
788,2019-08-31,94,49,0,2,145
788,2019-09-01,177,311,205,1,694
788,2019-09-02,162,270,17,2,451
788,2019-09-03,178,447,921,1,1547
788,2019-09-04,297,13350,1788,0,15435
788,2019-09-05,547,5779,2203,0,8529
788,2019-09-06,1116,6759,2439,1,10315
788,2019-09-07,295,9296,2400,1,11992
788,2019-09-08,1268,4845,1430,1,7544
788,2019-09-09,349,7660,1804,0,9813
788,2019-09-10,1075,7576,1696,0,10347
788,2019-09-11,230,6328,1795,2,8355
788,2019-09-12,184,6457,2761,1,9403
788,2019-09-13,304,2209,1640,0,4153
788,2019-09-14,230,8034,1468,0,9732
788,2019-09-15,981,9633,2513,1,13128
788,2019-09-16,182,6124,1506,0,7812
788,2019-09-17,1033,9651,2973,0,13657
788,2019-09-18,658,11483,1933,0,14074
788,2019-09-19,331,2523,1440,2,4296
788,2019-09-20,329,9125,1762,0,11216
788,2019-09-21,158,8645,2017,0,10820
788,2019-09-22,220,10137,2483,2,12842
788,2019-09-23,221,9893,2336,0,12450
788,2019-09-24,262,8832,1709,1,10804
788,2019-09-25,206,7941,1568,2,9717
788,2019-09-26,1088,11057,2200,0,14345
788,2019-09-27,174,6980,1935,3,9092
788,2019-09-28,309,13392,1789,1,15491
788,2019-09-29,721,17097,1285,2,19105
788,2019-09-30,786,18282,1962,1,21031
788,2019-10-01,140,16429,1932,0,18501
788,2019-10-02,268,12374,1464,1,14107
788,2019-10-03,172,14917,1803,3,16895
788,2019-10-04,179,12491,1003,43,13716
788,2019-10-05,2315,14292,1899,27,18533
788,2019-10-06,248,13779,2002,3,16032
788,2019-10-07,223,6254,1412,3,7892
788,2019-10-08,856,18348,1268,0,20472
788,2019-10-09,188,17525,1637,0,19350
788,2019-10-10,1077,10506,1771,2,13356
788,2019-10-11,150,11649,1416,2,13217
788,2019-10-12,812,7103,1863,3,9781
788,2019-10-13,272,8938,1514,0,10724
788,2019-10-14,272,6130,2306,1,8709
788,2019-10-15,1959,8745,1942,2,12648
788,2019-10-16,268,18246,1121,3,19638
788,2019-10-17,187,8775,1819,2,10783
788,2019-10-18,185,8628,1641,0,10454
788,2019-10-19,205,5803,1585,3,7596
788,2019-10-20,1068,3205,1500,0,5773
788,2019-10-21,626,10794,1509,2,12931
788,2019-10-22,174,6853,2708,2,9737
788,2019-10-23,1031,8732,821,2,10586
788,2019-10-24,201,20478,1292,2,21973
788,2019-10-25,224,19286,1048,3,20561
788,2019-10-26,615,17481,1823,0,19919
788,2019-10-27,195,16420,1577,0,18192
788,2019-10-28,768,14348,2393,2,17511
788,2019-10-29,728,15959,1163,0,17850
788,2019-10-30,1045,15735,1424,0,18204
788,2019-10-31,118,12777,1671,1,14567
788,2019-11-01,131,25575,1395,2,27103
788,2019-11-02,128,17294,1091,0,18513
788,2019-11-03,934,22350,1700,1,24985
788,2019-11-04,488,10970,2138,0,13596
788,2019-11-05,252,5488,2423,0,8163
788,2019-11-06,244,14708,1148,4,16104
788,2019-11-07,463,16946,799,1,18209
788,2019-11-08,217,10450,985,0,11652
788,2019-11-09,186,13653,1722,0,15561
788,2019-11-10,1117,25442,1470,0,28029
788,2019-11-11,241,16748,1671,5,18665
788,2019-11-12,180,17655,3350,2,21187
788,2019-11-13,272,23201,2084,1,25558
788,2019-11-14,158,10447,1565,0,12170
788,2019-11-15,534,3816,2584,0,6934
788,2019-11-16,854,2343,2657,0,5854
788,2019-11-17,2710,2481,3713,0,8904
788,2019-11-18,198,2721,3510,0,6429
788,2019-11-19,206,5188,2292,0,7686
788,2019-11-20,516,1617,2762,0,4895
788,2019-11-21,200,3485,1755,0,5440
788,2019-11-22,622,4641,1190,0,6453
788,2019-11-23,200,6038,1711,0,7949
788,2019-11-24,578,8119,1565,0,10262
788,2019-11-25,188,6929,1759,2,8878
788,2019-11-26,111,8389,1751,2,10253
788,2019-11-27,149,6346,1347,0,7842
788,2019-11-28,144,7080,878,1,8103
789,2019-08-27,80,6414,2158,1,8653
789,2019-08-28,948,1242,2250,0,4440
789,2019-08-29,170,9647,1531,1,11349
789,2019-08-30,91,2726,368,2,3187
789,2019-08-31,49,285,2,0,336
789,2019-09-01,41,447,453,0,941
789,2019-09-02,104,802,111,0,1017
789,2019-09-03,78,85,1103,0,1266
789,2019-09-04,112,14018,2777,1,16908
789,2019-09-05,151,5700,1148,0,6999
789,2019-09-06,155,10327,1662,0,12144
789,2019-09-07,146,15694,2025,3,17868
789,2019-09-08,202,7619,1988,1,9810
789,2019-09-09,127,13196,1414,0,14737
789,2019-09-10,81,8327,2079,0,10487
789,2019-09-11,111,6955,1517,1,8584
789,2019-09-12,54,11599,2184,1,13838
789,2019-09-13,899,5912,2344,0,9155
789,2019-09-14,860,10739,2122,1,13722
789,2019-09-15,918,11780,2155,1,14854
789,2019-09-16,94,6091,2773,1,8959
789,2019-09-17,64,9756,2058,2,11880
789,2019-09-18,52,11852,1210,0,13114
789,2019-09-19,282,3020,1758,0,5060
789,2019-09-20,1022,19874,2742,1,23639
789,2019-09-21,918,5886,2044,0,8848
789,2019-09-22,100,9742,1978,0,11820
789,2019-09-23,149,9014,2323,0,11486
789,2019-09-24,101,9020,1270,4,10395
789,2019-09-25,81,8089,1829,5,10004
789,2019-09-26,106,11024,2453,1,13584
789,2019-09-27,176,8835,1650,3,10664
789,2019-09-28,78,15529,1727,1,17335
789,2019-09-29,80,16867,1286,3,18236
789,2019-09-30,62,18964,2164,3,21193
789,2019-10-01,62,16523,2116,0,18701
789,2019-10-02,131,12461,1689,0,14281
789,2019-10-03,115,14729,1578,0,16422
789,2019-10-04,173,12347,1216,23,13759
789,2019-10-05,59,14650,2233,2,16944
789,2019-10-06,523,11880,2196,1,14600
789,2019-10-07,70,7621,1059,0,8750
789,2019-10-08,869,13160,1945,1,15975
789,2019-10-09,101,24443,1252,1,25797
789,2019-10-10,683,13873,1632,4,16192
789,2019-10-11,1269,11249,1771,4,14293
789,2019-10-12,67,7194,1531,0,8792
789,2019-10-13,375,7673,1915,0,9963
789,2019-10-14,54,5739,1240,1,7034
789,2019-10-15,962,8658,1673,2,11295
789,2019-10-16,580,13317,1657,0,15554
789,2019-10-17,679,6134,1846,0,8659
789,2019-10-18,80,8859,1396,0,10335
789,2019-10-19,529,6826,1719,2,9076
789,2019-10-20,959,3315,2127,2,6403
789,2019-10-21,95,10972,2127,0,13194
789,2019-10-22,154,6678,1306,1,8139
789,2019-10-23,483,8840,2023,0,11346
789,2019-10-24,104,20555,1754,3,22416
789,2019-10-25,184,14717,1885,4,16790
789,2019-10-26,994,21921,1373,0,24288
789,2019-10-27,87,17855,1161,0,19103
789,2019-10-28,2327,23129,1280,1,26737
789,2019-10-29,118,15592,1370,0,17080
789,2019-10-30,80,13109,1809,3,15001
789,2019-10-31,775,13039,1428,0,15242
789,2019-11-01,156,25405,1008,0,26569
789,2019-11-02,154,16860,941,0,17955
789,2019-11-03,81,22646,1421,0,24148
789,2019-11-04,116,8219,1469,881,10685
789,2019-11-05,224,3637,2108,0,5969
789,2019-11-06,201,14628,1657,1,16487
789,2019-11-07,157,16627,984,1,17769
789,2019-11-08,758,10266,1202,1,12227
789,2019-11-09,74,9265,1744,2,11085
789,2019-11-10,104,14771,1978,0,16853
789,2019-11-11,480,9665,2383,0,12528
789,2019-11-12,676,10518,2202,1,13397
789,2019-11-13,91,12043,1793,1,13928
789,2019-11-14,86,8293,1659,3,10041
789,2019-11-15,91,5045,2863,1,8000
789,2019-11-16,109,2615,3266,0,5990
789,2019-11-17,93,3249,4024,1,7367
789,2019-11-18,962,2376,3695,2,7035
789,2019-11-19,1032,5140,2962,2,9136
789,2019-11-20,77,1426,1993,0,3496
789,2019-11-21,89,3673,2002,2,5766
789,2019-11-22,68,4774,1269,1,6112
789,2019-11-23,76,9699,2061,3,11839
789,2019-11-24,290,10765,1036,0,12091
789,2019-11-25,505,11297,1388,1,13191
789,2019-11-26,57,5738,1430,0,7225
789,2019-11-27,70,11164,1512,0,12746
789,2019-11-28,92,8307,694,796,9889
789,2019-11-29,23,378,2,0,403
789,2019-08-27,80,6414,2158,1,8653
789,2019-08-28,948,1242,2250,0,4440
789,2019-08-29,170,9647,1531,1,11349
789,2019-08-30,91,2726,368,2,3187
789,2019-08-31,49,285,2,0,336
789,2019-09-01,41,447,453,0,941
789,2019-09-02,104,802,111,0,1017
789,2019-09-03,78,85,1103,0,1266
789,2019-09-04,112,14018,2777,1,16908
789,2019-09-05,151,5700,1148,0,6999
789,2019-09-06,155,10327,1662,0,12144
789,2019-09-07,146,15694,2025,3,17868
789,2019-09-08,202,7619,1988,1,9810
789,2019-09-09,127,13196,1414,0,14737
789,2019-09-10,81,8327,2079,0,10487
789,2019-09-11,111,6955,1517,1,8584
789,2019-09-12,54,11599,2184,1,13838
789,2019-09-13,899,5912,2344,0,9155
789,2019-09-14,860,10739,2122,1,13722
789,2019-09-15,918,11780,2155,1,14854
789,2019-09-16,94,6091,2773,1,8959
789,2019-09-17,64,9756,2058,2,11880
789,2019-09-18,52,11852,1210,0,13114
789,2019-09-19,282,3020,1758,0,5060
789,2019-09-20,1022,19874,2742,1,23639
789,2019-09-21,918,5886,2044,0,8848
789,2019-09-22,100,9742,1978,0,11820
789,2019-09-23,149,9014,2323,0,11486
789,2019-09-24,101,9020,1270,4,10395
789,2019-09-25,81,8089,1829,5,10004
789,2019-09-26,106,11024,2453,1,13584
789,2019-09-27,176,8835,1650,3,10664
789,2019-09-28,78,15529,1727,1,17335
789,2019-09-29,80,16867,1286,3,18236
789,2019-09-30,62,18964,2164,3,21193
789,2019-10-01,62,16523,2116,0,18701
789,2019-10-02,131,12461,1689,0,14281
789,2019-10-03,115,14729,1578,0,16422
789,2019-10-04,173,12347,1216,23,13759
789,2019-10-05,59,14650,2233,2,16944
789,2019-10-06,523,11880,2196,1,14600
789,2019-10-07,70,7621,1059,0,8750
789,2019-10-08,869,13160,1945,1,15975
789,2019-10-09,101,24443,1252,1,25797
789,2019-10-10,683,13873,1632,4,16192
789,2019-10-11,1269,11249,1771,4,14293
789,2019-10-12,67,7194,1531,0,8792
789,2019-10-13,375,7673,1915,0,9963
789,2019-10-14,54,5739,1240,1,7034
789,2019-10-15,962,8658,1673,2,11295
789,2019-10-16,580,13317,1657,0,15554
789,2019-10-17,679,6134,1846,0,8659
789,2019-10-18,80,8859,1396,0,10335
789,2019-10-19,529,6826,1719,2,9076
789,2019-10-20,959,3315,2127,2,6403
789,2019-10-21,95,10972,2127,0,13194
789,2019-10-22,154,6678,1306,1,8139
789,2019-10-23,483,8840,2023,0,11346
789,2019-10-24,104,20555,1754,3,22416
789,2019-10-25,184,14717,1885,4,16790
789,2019-10-26,994,21921,1373,0,24288
789,2019-10-27,87,17855,1161,0,19103
789,2019-10-28,2327,23129,1280,1,26737
789,2019-10-29,118,15592,1370,0,17080
789,2019-10-30,80,13109,1809,3,15001
789,2019-10-31,775,13039,1428,0,15242
789,2019-11-01,156,25405,1008,0,26569
789,2019-11-02,154,16860,941,0,17955
789,2019-11-03,81,22646,1421,0,24148
789,2019-11-04,116,8219,1469,881,10685
789,2019-11-05,224,3637,2108,0,5969
789,2019-11-06,201,14628,1657,1,16487
789,2019-11-07,157,16627,984,1,17769
789,2019-11-08,758,10266,1202,1,12227
789,2019-11-09,74,9265,1744,2,11085
789,2019-11-10,104,14771,1978,0,16853
789,2019-11-11,480,9665,2383,0,12528
789,2019-11-12,676,10518,2202,1,13397
789,2019-11-13,91,12043,1793,1,13928
789,2019-11-14,86,8293,1659,3,10041
789,2019-11-15,91,5045,2863,1,8000
789,2019-11-16,109,2615,3266,0,5990
789,2019-11-17,93,3249,4024,1,7367
789,2019-11-18,962,2376,3695,2,7035
789,2019-11-19,1032,5140,2962,2,9136
789,2019-11-20,77,1426,1993,0,3496
789,2019-11-21,89,3673,2002,2,5766
789,2019-11-22,68,4774,1269,1,6112
789,2019-11-23,76,9699,2061,3,11839
789,2019-11-24,290,10765,1036,0,12091
789,2019-11-25,505,11297,1388,1,13191
789,2019-11-26,57,5738,1430,0,7225
789,2019-11-27,70,11164,1512,0,12746
789,2019-11-28,92,8307,694,796,9889
789,2019-11-29,23,378,2,0,403
789,2019-08-26,0,0,90,0,90
789,2019-08-27,80,6414,2158,1,8653
789,2019-08-28,948,1242,2250,0,4440
789,2019-08-29,170,9647,1531,1,11349
789,2019-08-30,91,2726,368,2,3187
789,2019-08-31,49,285,2,0,336
789,2019-09-01,41,447,453,0,941
789,2019-09-02,104,802,111,0,1017
789,2019-09-03,78,85,1103,0,1266
789,2019-09-04,112,14018,2777,1,16908
789,2019-09-05,151,5700,1148,0,6999
789,2019-09-06,155,10327,1662,0,12144
789,2019-09-07,146,15694,2025,3,17868
789,2019-09-08,202,7619,1988,1,9810
789,2019-09-09,127,13196,1414,0,14737
789,2019-09-10,81,8327,2079,0,10487
789,2019-09-11,111,6955,1517,1,8584
789,2019-09-12,54,11599,2184,1,13838
789,2019-09-13,899,5912,2344,0,9155
789,2019-09-14,860,10739,2122,1,13722
789,2019-09-15,918,11780,2155,1,14854
789,2019-09-16,94,6091,2773,1,8959
789,2019-09-17,64,9756,2058,2,11880
789,2019-09-18,52,11852,1210,0,13114
789,2019-09-19,282,3020,1758,0,5060
789,2019-09-20,1022,19874,2742,1,23639
789,2019-09-21,918,5886,2044,0,8848
789,2019-09-22,100,9742,1978,0,11820
789,2019-09-23,149,9014,2323,0,11486
789,2019-09-24,101,9020,1270,4,10395
789,2019-09-25,81,8089,1829,5,10004
789,2019-09-26,106,11024,2453,1,13584
789,2019-09-27,176,8835,1650,3,10664
789,2019-09-28,78,15529,1727,1,17335
789,2019-09-29,80,16867,1286,3,18236
789,2019-09-30,62,18964,2164,3,21193
789,2019-10-01,62,16523,2116,0,18701
789,2019-10-02,131,12461,1689,0,14281
789,2019-10-03,115,14729,1578,0,16422
789,2019-10-04,173,12347,1216,23,13759
789,2019-10-05,59,14650,2233,2,16944
789,2019-10-06,523,11880,2196,1,14600
789,2019-10-07,70,7621,1059,0,8750
789,2019-10-08,869,13160,1945,1,15975
789,2019-10-09,101,24443,1252,1,25797
789,2019-10-10,683,13873,1632,4,16192
789,2019-10-11,1269,11249,1771,4,14293
789,2019-10-12,67,7194,1531,0,8792
789,2019-10-13,375,7673,1915,0,9963
789,2019-10-14,54,5739,1240,1,7034
789,2019-10-15,962,8658,1673,2,11295
789,2019-10-16,580,13317,1657,0,15554
789,2019-10-17,679,6134,1846,0,8659
789,2019-10-18,80,8859,1396,0,10335
789,2019-10-19,529,6826,1719,2,9076
789,2019-10-20,959,3315,2127,2,6403
789,2019-10-21,95,10972,2127,0,13194
789,2019-10-22,154,6678,1306,1,8139
789,2019-10-23,483,8840,2023,0,11346
789,2019-10-24,104,20555,1754,3,22416
789,2019-10-25,184,14717,1885,4,16790
789,2019-10-26,994,21921,1373,0,24288
789,2019-10-27,87,17855,1161,0,19103
789,2019-10-28,2327,23129,1280,1,26737
789,2019-10-29,118,15592,1370,0,17080
789,2019-10-30,80,13109,1809,3,15001
789,2019-10-31,775,13039,1428,0,15242
789,2019-11-01,156,25405,1008,0,26569
789,2019-11-02,154,16860,941,0,17955
789,2019-11-03,81,22646,1421,0,24148
789,2019-11-04,116,8219,1469,881,10685
789,2019-11-05,224,3637,2108,0,5969
789,2019-11-06,201,14628,1657,1,16487
789,2019-11-07,157,16627,984,1,17769
789,2019-11-08,758,10266,1202,1,12227
789,2019-11-09,74,9265,1744,2,11085
789,2019-11-10,104,14771,1978,0,16853
789,2019-11-11,480,9665,2383,0,12528
789,2019-11-12,676,10518,2202,1,13397
789,2019-11-13,91,12043,1793,1,13928
789,2019-11-14,86,8293,1659,3,10041
789,2019-11-15,91,5045,2863,1,8000
789,2019-11-16,109,2615,3266,0,5990
789,2019-11-17,93,3249,4024,1,7367
789,2019-11-18,962,2376,3695,2,7035
789,2019-11-19,1032,5140,2962,2,9136
789,2019-11-20,77,1426,1993,0,3496
789,2019-11-21,89,3673,2002,2,5766
789,2019-11-22,68,4774,1269,1,6112
789,2019-11-23,76,9699,2061,3,11839
789,2019-11-24,290,10765,1036,0,12091
789,2019-11-25,505,11297,1388,1,13191
789,2019-11-26,57,5738,1430,0,7225
789,2019-11-27,70,11164,1512,0,12746
789,2019-11-28,92,8307,694,796,9889
789,2019-11-29,23,378,2,0,403
789,2019-08-27,80,6414,2158,1,8653
789,2019-08-28,948,1242,2250,0,4440
789,2019-08-29,170,9647,1531,1,11349
789,2019-08-30,91,2726,368,2,3187
789,2019-08-31,49,285,2,0,336
789,2019-09-01,41,447,453,0,941
789,2019-09-02,104,802,111,0,1017
789,2019-09-03,78,85,1103,0,1266
789,2019-09-04,112,14018,2777,1,16908
789,2019-09-05,151,5700,1148,0,6999
789,2019-09-06,155,10327,1662,0,12144
789,2019-09-07,146,15694,2025,3,17868
789,2019-09-08,202,7619,1988,1,9810
789,2019-09-09,127,13196,1414,0,14737
789,2019-09-10,81,8327,2079,0,10487
789,2019-09-11,111,6955,1517,1,8584
789,2019-09-12,54,11599,2184,1,13838
789,2019-09-13,899,5912,2344,0,9155
789,2019-09-14,860,10739,2122,1,13722
789,2019-09-15,918,11780,2155,1,14854
789,2019-09-16,94,6091,2773,1,8959
789,2019-09-17,64,9756,2058,2,11880
789,2019-09-18,52,11852,1210,0,13114
789,2019-09-19,282,3020,1758,0,5060
789,2019-09-20,1022,19874,2742,1,23639
789,2019-09-21,918,5886,2044,0,8848
789,2019-09-22,100,9742,1978,0,11820
789,2019-09-23,149,9014,2323,0,11486
789,2019-09-24,101,9020,1270,4,10395
789,2019-09-25,81,8089,1829,5,10004
789,2019-09-26,106,11024,2453,1,13584
789,2019-09-27,176,8835,1650,3,10664
789,2019-09-28,78,15529,1727,1,17335
789,2019-09-29,80,16867,1286,3,18236
789,2019-09-30,62,18964,2164,3,21193
789,2019-10-01,62,16523,2116,0,18701
789,2019-10-02,131,12461,1689,0,14281
789,2019-10-03,115,14729,1578,0,16422
789,2019-10-04,173,12347,1216,23,13759
789,2019-10-05,59,14650,2233,2,16944
789,2019-10-06,523,11880,2196,1,14600
789,2019-10-07,70,7621,1059,0,8750
789,2019-10-08,869,13160,1945,1,15975
789,2019-10-09,101,24443,1252,1,25797
789,2019-10-10,683,13873,1632,4,16192
789,2019-10-11,1269,11249,1771,4,14293
789,2019-10-12,67,7194,1531,0,8792
789,2019-10-13,375,7673,1915,0,9963
789,2019-10-14,54,5739,1240,1,7034
789,2019-10-15,962,8658,1673,2,11295
789,2019-10-16,580,13317,1657,0,15554
789,2019-10-17,679,6134,1846,0,8659
789,2019-10-18,80,8859,1396,0,10335
789,2019-10-19,529,6826,1719,2,9076
789,2019-10-20,959,3315,2127,2,6403
789,2019-10-21,95,10972,2127,0,13194
789,2019-10-22,154,6678,1306,1,8139
789,2019-10-23,483,8840,2023,0,11346
789,2019-10-24,104,20555,1754,3,22416
789,2019-10-25,184,14717,1885,4,16790
789,2019-10-26,994,21921,1373,0,24288
789,2019-10-27,87,17855,1161,0,19103
789,2019-10-28,2327,23129,1280,1,26737
789,2019-10-29,118,15592,1370,0,17080
789,2019-10-30,80,13109,1809,3,15001
789,2019-10-31,775,13039,1428,0,15242
789,2019-11-01,156,25405,1008,0,26569
789,2019-11-02,154,16860,941,0,17955
789,2019-11-03,81,22646,1421,0,24148
789,2019-11-04,116,8219,1469,881,10685
789,2019-11-05,224,3637,2108,0,5969
789,2019-11-06,201,14628,1657,1,16487
789,2019-11-07,157,16627,984,1,17769
789,2019-11-08,758,10266,1202,1,12227
789,2019-11-09,74,9265,1744,2,11085
789,2019-11-10,104,14771,1978,0,16853
789,2019-11-11,480,9665,2383,0,12528
789,2019-11-12,676,10518,2202,1,13397
789,2019-11-13,91,12043,1793,1,13928
789,2019-11-14,86,8293,1659,3,10041
789,2019-11-15,91,5045,2863,1,8000
789,2019-11-16,109,2615,3266,0,5990
789,2019-11-17,93,3249,4024,1,7367
789,2019-11-18,962,2376,3695,2,7035
789,2019-11-19,1032,5140,2962,2,9136
789,2019-11-20,77,1426,1993,0,3496
789,2019-11-21,89,3673,2002,2,5766
789,2019-11-22,68,4774,1269,1,6112
789,2019-11-23,76,9699,2061,3,11839
789,2019-11-24,290,10765,1036,0,12091
789,2019-11-25,505,11297,1388,1,13191
789,2019-11-26,57,5738,1430,0,7225
789,2019-11-27,70,11164,1512,0,12746
789,2019-11-28,92,8307,694,796,9889
791,2019-08-28,107,1257,1624,1,2989
791,2019-08-29,144,10359,2202,2,12707
791,2019-08-30,65,3121,1180,2,4368
791,2019-08-31,20,95,0,0,115
791,2019-09-01,99,333,327,0,759
791,2019-09-02,39,199,9,0,247
791,2019-09-03,91,520,848,0,1459
791,2019-09-04,79,11728,1666,2,13475
791,2019-09-05,139,5460,1660,0,7259
791,2019-09-06,982,9802,1868,0,12652
791,2019-09-07,1061,11379,2106,0,14546
791,2019-09-08,207,5741,1994,2,7944
791,2019-09-09,71,13024,1707,1,14803
791,2019-09-10,112,8057,2208,0,10377
791,2019-09-11,96,8779,2009,1,10885
791,2019-09-12,133,10540,1497,3259,15429
791,2019-09-13,120,4464,2609,1,7194
791,2019-09-14,116,7695,1895,1,9707
791,2019-09-15,93,8783,1714,0,10590
791,2019-09-16,105,6290,2293,0,8688
791,2019-09-17,342,9320,1469,1,11132
791,2019-09-18,190,11027,1939,2,13158
791,2019-09-19,317,4848,2016,3,7184
791,2019-09-20,165,18845,1493,1,20504
791,2019-09-21,93,6036,1912,0,8041
791,2019-09-22,1014,9982,1760,1,12757
791,2019-09-23,121,10185,1352,2,11660
791,2019-09-24,102,8671,2687,3,11463
791,2019-09-25,1024,10457,1738,4,13223
791,2019-09-26,118,10181,2058,0,12357
791,2019-09-27,60,8541,1024,4,9629
791,2019-09-28,65,15585,1712,2,17364
791,2019-09-29,245,17299,1861,4,19409
791,2019-09-30,77,17895,1506,0,19478
791,2019-10-01,3530,16593,1611,0,21734
791,2019-10-02,1112,14032,2368,1,17513
791,2019-10-03,125,14545,1451,2,16123
791,2019-10-04,144,12483,1072,1,13700
791,2019-10-05,152,22482,1532,1,24167
791,2019-10-06,599,17639,1868,1,20107
791,2019-10-07,113,7380,915,3,8411
791,2019-10-08,494,11100,1513,0,13107
791,2019-10-09,177,14532,1872,0,16581
791,2019-10-10,1068,10894,2329,0,14291
791,2019-10-11,1012,11507,1384,1,13904
791,2019-10-12,1046,7273,1913,3,10235
791,2019-10-13,201,8870,2433,1,11505
791,2019-10-14,112,5883,1380,0,7375
791,2019-10-15,155,8652,1729,0,10536
791,2019-10-16,124,18504,2027,1,20656
791,2019-10-17,54,8683,1489,4,10230
791,2019-10-18,1126,8845,2137,0,12108
791,2019-10-19,67,5495,1310,1,6873
791,2019-10-20,1839,2989,1654,1,6483
791,2019-10-21,1185,10620,2220,1,14026
791,2019-10-22,88,6712,1937,3,8740
791,2019-10-23,176,8629,1808,1,10614
791,2019-10-24,1105,14024,1339,1,16469
791,2019-10-25,90,11016,1466,2,12574
791,2019-10-26,845,14312,1692,0,16849
791,2019-10-27,82,16192,913,0,17187
791,2019-10-28,88,13401,1318,2,14809
791,2019-10-29,853,15847,1420,0,18120
791,2019-10-30,74,15713,1332,0,17119
791,2019-10-31,1019,12748,2077,2,15846
791,2019-11-01,936,14949,994,2,16881
791,2019-11-02,82,14540,1829,0,16451
791,2019-11-03,978,22563,1734,1,25276
791,2019-11-04,841,14659,1178,0,16678
791,2019-11-05,429,3984,1597,0,6010
791,2019-11-06,143,14938,1221,4,16306
791,2019-11-07,137,25499,977,1,26614
791,2019-11-08,97,12525,1012,2,13636
791,2019-11-09,71,9412,1725,716,11924
791,2019-11-10,778,25119,1491,0,27388
791,2019-11-11,136,16704,1665,7,18512
791,2019-11-12,1036,17220,3044,1,21301
791,2019-11-13,995,14032,1431,1,16459
791,2019-11-14,102,12314,1487,0,13903
791,2019-11-15,59,4953,1779,1,6792
791,2019-11-16,81,2542,2500,3,5126
791,2019-11-17,467,3232,3271,2,6972
791,2019-11-18,81,4535,2759,2,7377
791,2019-11-19,827,3108,2448,0,6383
791,2019-11-20,105,1307,1189,2,2603
791,2019-11-21,73,3325,1198,2,4598
791,2019-11-22,73,8281,1182,2,9538
791,2019-11-23,131,7166,2068,0,9365
791,2019-11-24,483,7101,1746,0,9330
791,2019-11-25,91,7001,1470,2,8564
791,2019-11-26,997,5728,1535,2,8262
791,2019-11-27,974,6396,1455,0,8825
791,2019-11-28,68,7006,1052,0,8126
791,2019-11-29,25,12,1,0,38
791,2019-08-28,107,1257,1624,1,2989
791,2019-08-29,144,10359,2202,2,12707
791,2019-08-30,65,3121,1180,2,4368
791,2019-08-31,20,95,0,0,115
791,2019-09-01,99,333,327,0,759
791,2019-09-02,39,199,9,0,247
791,2019-09-03,91,520,848,0,1459
791,2019-09-04,79,11728,1666,2,13475
791,2019-09-05,139,5460,1660,0,7259
791,2019-09-06,982,9802,1868,0,12652
791,2019-09-07,1061,11379,2106,0,14546
791,2019-09-08,207,5741,1994,2,7944
791,2019-09-09,71,13024,1707,1,14803
791,2019-09-10,112,8057,2208,0,10377
791,2019-09-11,96,8779,2009,1,10885
791,2019-09-12,133,10540,1497,3259,15429
791,2019-09-13,120,4464,2609,1,7194
791,2019-09-14,116,7695,1895,1,9707
791,2019-09-15,93,8783,1714,0,10590
791,2019-09-16,105,6290,2293,0,8688
791,2019-09-17,342,9320,1469,1,11132
791,2019-09-18,190,11027,1939,2,13158
791,2019-09-19,317,4848,2016,3,7184
791,2019-09-20,165,18845,1493,1,20504
791,2019-09-21,93,6036,1912,0,8041
791,2019-09-22,1014,9982,1760,1,12757
791,2019-09-23,121,10185,1352,2,11660
791,2019-09-24,102,8671,2687,3,11463
791,2019-09-25,1024,10457,1738,4,13223
791,2019-09-26,118,10181,2058,0,12357
791,2019-09-27,60,8541,1024,4,9629
791,2019-09-28,65,15585,1712,2,17364
791,2019-09-29,245,17299,1861,4,19409
791,2019-09-30,77,17895,1506,0,19478
791,2019-10-01,3530,16593,1611,0,21734
791,2019-10-02,1112,14032,2368,1,17513
791,2019-10-03,125,14545,1451,2,16123
791,2019-10-04,144,12483,1072,1,13700
791,2019-10-05,152,22482,1532,1,24167
791,2019-10-06,599,17639,1868,1,20107
791,2019-10-07,113,7380,915,3,8411
791,2019-10-08,494,11100,1513,0,13107
791,2019-10-09,177,14532,1872,0,16581
791,2019-10-10,1068,10894,2329,0,14291
791,2019-10-11,1012,11507,1384,1,13904
791,2019-10-12,1046,7273,1913,3,10235
791,2019-10-13,201,8870,2433,1,11505
791,2019-10-14,112,5883,1380,0,7375
791,2019-10-15,155,8652,1729,0,10536
791,2019-10-16,124,18504,2027,1,20656
791,2019-10-17,54,8683,1489,4,10230
791,2019-10-18,1126,8845,2137,0,12108
791,2019-10-19,67,5495,1310,1,6873
791,2019-10-20,1839,2989,1654,1,6483
791,2019-10-21,1185,10620,2220,1,14026
791,2019-10-22,88,6712,1937,3,8740
791,2019-10-23,176,8629,1808,1,10614
791,2019-10-24,1105,14024,1339,1,16469
791,2019-10-25,90,11016,1466,2,12574
791,2019-10-26,845,14312,1692,0,16849
791,2019-10-27,82,16192,913,0,17187
791,2019-10-28,88,13401,1318,2,14809
791,2019-10-29,853,15847,1420,0,18120
791,2019-10-30,74,15713,1332,0,17119
791,2019-10-31,1019,12748,2077,2,15846
791,2019-11-01,936,14949,994,2,16881
791,2019-11-02,82,14540,1829,0,16451
791,2019-11-03,978,22563,1734,1,25276
791,2019-11-04,841,14659,1178,0,16678
791,2019-11-05,429,3984,1597,0,6010
791,2019-11-06,143,14938,1221,4,16306
791,2019-11-07,137,25499,977,1,26614
791,2019-11-08,97,12525,1012,2,13636
791,2019-11-09,71,9412,1725,716,11924
791,2019-11-10,778,25119,1491,0,27388
791,2019-11-11,136,16704,1665,7,18512
791,2019-11-12,1036,17220,3044,1,21301
791,2019-11-13,995,14032,1431,1,16459
791,2019-11-14,102,12314,1487,0,13903
791,2019-11-15,59,4953,1779,1,6792
791,2019-11-16,81,2542,2500,3,5126
791,2019-11-17,467,3232,3271,2,6972
791,2019-11-18,81,4535,2759,2,7377
791,2019-11-19,827,3108,2448,0,6383
791,2019-11-20,105,1307,1189,2,2603
791,2019-11-21,73,3325,1198,2,4598
791,2019-11-22,73,8281,1182,2,9538
791,2019-11-23,131,7166,2068,0,9365
791,2019-11-24,483,7101,1746,0,9330
791,2019-11-25,91,7001,1470,2,8564
791,2019-11-26,997,5728,1535,2,8262
791,2019-11-27,974,6396,1455,0,8825
791,2019-11-28,68,7006,1052,0,8126
791,2019-11-29,25,12,1,0,38
791,2019-08-27,0,0,450,0,450
791,2019-08-28,107,1257,1624,1,2989
791,2019-08-29,144,10359,2202,2,12707
791,2019-08-30,65,3121,1180,2,4368
791,2019-08-31,20,95,0,0,115
791,2019-09-01,99,333,327,0,759
791,2019-09-02,39,199,9,0,247
791,2019-09-03,91,520,848,0,1459
791,2019-09-04,79,11728,1666,2,13475
791,2019-09-05,139,5460,1660,0,7259
791,2019-09-06,982,9802,1868,0,12652
791,2019-09-07,1061,11379,2106,0,14546
791,2019-09-08,207,5741,1994,2,7944
791,2019-09-09,71,13024,1707,1,14803
791,2019-09-10,112,8057,2208,0,10377
791,2019-09-11,96,8779,2009,1,10885
791,2019-09-12,133,10540,1497,3259,15429
791,2019-09-13,120,4464,2609,1,7194
791,2019-09-14,116,7695,1895,1,9707
791,2019-09-15,93,8783,1714,0,10590
791,2019-09-16,105,6290,2293,0,8688
791,2019-09-17,342,9320,1469,1,11132
791,2019-09-18,190,11027,1939,2,13158
791,2019-09-19,317,4848,2016,3,7184
791,2019-09-20,165,18845,1493,1,20504
791,2019-09-21,93,6036,1912,0,8041
791,2019-09-22,1014,9982,1760,1,12757
791,2019-09-23,121,10185,1352,2,11660
791,2019-09-24,102,8671,2687,3,11463
791,2019-09-25,1024,10457,1738,4,13223
791,2019-09-26,118,10181,2058,0,12357
791,2019-09-27,60,8541,1024,4,9629
791,2019-09-28,65,15585,1712,2,17364
791,2019-09-29,245,17299,1861,4,19409
791,2019-09-30,77,17895,1506,0,19478
791,2019-10-01,3530,16593,1611,0,21734
791,2019-10-02,1112,14032,2368,1,17513
791,2019-10-03,125,14545,1451,2,16123
791,2019-10-04,144,12483,1072,1,13700
791,2019-10-05,152,22482,1532,1,24167
791,2019-10-06,599,17639,1868,1,20107
791,2019-10-07,113,7380,915,3,8411
791,2019-10-08,494,11100,1513,0,13107
791,2019-10-09,177,14532,1872,0,16581
791,2019-10-10,1068,10894,2329,0,14291
791,2019-10-11,1012,11507,1384,1,13904
791,2019-10-12,1046,7273,1913,3,10235
791,2019-10-13,201,8870,2433,1,11505
791,2019-10-14,112,5883,1380,0,7375
791,2019-10-15,155,8652,1729,0,10536
791,2019-10-16,124,18504,2027,1,20656
791,2019-10-17,54,8683,1489,4,10230
791,2019-10-18,1126,8845,2137,0,12108
791,2019-10-19,67,5495,1310,1,6873
791,2019-10-20,1839,2989,1654,1,6483
791,2019-10-21,1185,10620,2220,1,14026
791,2019-10-22,88,6712,1937,3,8740
791,2019-10-23,176,8629,1808,1,10614
791,2019-10-24,1105,14024,1339,1,16469
791,2019-10-25,90,11016,1466,2,12574
791,2019-10-26,845,14312,1692,0,16849
791,2019-10-27,82,16192,913,0,17187
791,2019-10-28,88,13401,1318,2,14809
791,2019-10-29,853,15847,1420,0,18120
791,2019-10-30,74,15713,1332,0,17119
791,2019-10-31,1019,12748,2077,2,15846
791,2019-11-01,936,14949,994,2,16881
791,2019-11-02,82,14540,1829,0,16451
791,2019-11-03,978,22563,1734,1,25276
791,2019-11-04,841,14659,1178,0,16678
791,2019-11-05,429,3984,1597,0,6010
791,2019-11-06,143,14938,1221,4,16306
791,2019-11-07,137,25499,977,1,26614
791,2019-11-08,97,12525,1012,2,13636
791,2019-11-09,71,9412,1725,716,11924
791,2019-11-10,778,25119,1491,0,27388
791,2019-11-11,136,16704,1665,7,18512
791,2019-11-12,1036,17220,3044,1,21301
791,2019-11-13,995,14032,1431,1,16459
791,2019-11-14,102,12314,1487,0,13903
791,2019-11-15,59,4953,1779,1,6792
791,2019-11-16,81,2542,2500,3,5126
791,2019-11-17,467,3232,3271,2,6972
791,2019-11-18,81,4535,2759,2,7377
791,2019-11-19,827,3108,2448,0,6383
791,2019-11-20,105,1307,1189,2,2603
791,2019-11-21,73,3325,1198,2,4598
791,2019-11-22,73,8281,1182,2,9538
791,2019-11-23,131,7166,2068,0,9365
791,2019-11-24,483,7101,1746,0,9330
791,2019-11-25,91,7001,1470,2,8564
791,2019-11-26,997,5728,1535,2,8262
791,2019-11-27,974,6396,1455,0,8825
791,2019-11-28,68,7006,1052,0,8126
791,2019-11-29,25,12,1,0,38
791,2019-08-28,107,1257,1624,1,2989
791,2019-08-29,144,10359,2202,2,12707
791,2019-08-30,65,3121,1180,2,4368
791,2019-08-31,20,95,0,0,115
791,2019-09-01,99,333,327,0,759
791,2019-09-02,39,199,9,0,247
791,2019-09-03,91,520,848,0,1459
791,2019-09-04,79,11728,1666,2,13475
791,2019-09-05,139,5460,1660,0,7259
791,2019-09-06,982,9802,1868,0,12652
791,2019-09-07,1061,11379,2106,0,14546
791,2019-09-08,207,5741,1994,2,7944
791,2019-09-09,71,13024,1707,1,14803
791,2019-09-10,112,8057,2208,0,10377
791,2019-09-11,96,8779,2009,1,10885
791,2019-09-12,133,10540,1497,3259,15429
791,2019-09-13,120,4464,2609,1,7194
791,2019-09-14,116,7695,1895,1,9707
791,2019-09-15,93,8783,1714,0,10590
791,2019-09-16,105,6290,2293,0,8688
791,2019-09-17,342,9320,1469,1,11132
791,2019-09-18,190,11027,1939,2,13158
791,2019-09-19,317,4848,2016,3,7184
791,2019-09-20,165,18845,1493,1,20504
791,2019-09-21,93,6036,1912,0,8041
791,2019-09-22,1014,9982,1760,1,12757
791,2019-09-23,121,10185,1352,2,11660
791,2019-09-24,102,8671,2687,3,11463
791,2019-09-25,1024,10457,1738,4,13223
791,2019-09-26,118,10181,2058,0,12357
791,2019-09-27,60,8541,1024,4,9629
791,2019-09-28,65,15585,1712,2,17364
791,2019-09-29,245,17299,1861,4,19409
791,2019-09-30,77,17895,1506,0,19478
791,2019-10-01,3530,16593,1611,0,21734
791,2019-10-02,1112,14032,2368,1,17513
791,2019-10-03,125,14545,1451,2,16123
791,2019-10-04,144,12483,1072,1,13700
791,2019-10-05,152,22482,1532,1,24167
791,2019-10-06,599,17639,1868,1,20107
791,2019-10-07,113,7380,915,3,8411
791,2019-10-08,494,11100,1513,0,13107
791,2019-10-09,177,14532,1872,0,16581
791,2019-10-10,1068,10894,2329,0,14291
791,2019-10-11,1012,11507,1384,1,13904
791,2019-10-12,1046,7273,1913,3,10235
791,2019-10-13,201,8870,2433,1,11505
791,2019-10-14,112,5883,1380,0,7375
791,2019-10-15,155,8652,1729,0,10536
791,2019-10-16,124,18504,2027,1,20656
791,2019-10-17,54,8683,1489,4,10230
791,2019-10-18,1126,8845,2137,0,12108
791,2019-10-19,67,5495,1310,1,6873
791,2019-10-20,1839,2989,1654,1,6483
791,2019-10-21,1185,10620,2220,1,14026
791,2019-10-22,88,6712,1937,3,8740
791,2019-10-23,176,8629,1808,1,10614
791,2019-10-24,1105,14024,1339,1,16469
791,2019-10-25,90,11016,1466,2,12574
791,2019-10-26,845,14312,1692,0,16849
791,2019-10-27,82,16192,913,0,17187
791,2019-10-28,88,13401,1318,2,14809
791,2019-10-29,853,15847,1420,0,18120
791,2019-10-30,74,15713,1332,0,17119
791,2019-10-31,1019,12748,2077,2,15846
791,2019-11-01,936,14949,994,2,16881
791,2019-11-02,82,14540,1829,0,16451
791,2019-11-03,978,22563,1734,1,25276
791,2019-11-04,841,14659,1178,0,16678
791,2019-11-05,429,3984,1597,0,6010
791,2019-11-06,143,14938,1221,4,16306
791,2019-11-07,137,25499,977,1,26614
791,2019-11-08,97,12525,1012,2,13636
791,2019-11-09,71,9412,1725,716,11924
791,2019-11-10,778,25119,1491,0,27388
791,2019-11-11,136,16704,1665,7,18512
791,2019-11-12,1036,17220,3044,1,21301
791,2019-11-13,995,14032,1431,1,16459
791,2019-11-14,102,12314,1487,0,13903
791,2019-11-15,59,4953,1779,1,6792
791,2019-11-16,81,2542,2500,3,5126
791,2019-11-17,467,3232,3271,2,6972
791,2019-11-18,81,4535,2759,2,7377
791,2019-11-19,827,3108,2448,0,6383
791,2019-11-20,105,1307,1189,2,2603
791,2019-11-21,73,3325,1198,2,4598
791,2019-11-22,73,8281,1182,2,9538
791,2019-11-23,131,7166,2068,0,9365
791,2019-11-24,483,7101,1746,0,9330
791,2019-11-25,91,7001,1470,2,8564
791,2019-11-26,997,5728,1535,2,8262
792,2019-08-28,427,1512,1891,0,3830
792,2019-08-29,579,8956,2070,0,11605
792,2019-08-30,338,3153,546,0,4037
792,2019-08-31,92,88,12,0,192
792,2019-09-01,156,435,366,0,957
792,2019-09-02,129,1099,46,0,1274
792,2019-09-03,203,3272,1031,1,4507
792,2019-09-04,717,17557,2585,0,20859
792,2019-09-05,1925,5173,1619,3,8720
792,2019-09-06,1032,11421,1549,1,14003
792,2019-09-07,746,14406,2006,0,17158
792,2019-09-08,679,5972,1805,0,8456
792,2019-09-09,1353,11538,2084,1,14976
792,2019-09-10,491,7825,2467,0,10783
792,2019-09-11,1169,5786,2020,1,8976
792,2019-09-12,2011,7201,2266,2,11480
792,2019-09-13,739,5693,2485,3,8920
792,2019-09-14,729,7722,1839,1,10291
792,2019-09-15,393,6493,1718,0,8604
792,2019-09-16,1228,6743,2189,3,10163
792,2019-09-17,360,7256,1831,8,9455
792,2019-09-18,653,12368,1458,9,14488
792,2019-09-19,661,2575,1359,9,4604
792,2019-09-20,501,12310,1710,10,14531
792,2019-09-21,502,9537,2160,10,12209
792,2019-09-22,331,14643,1343,9,16326
792,2019-09-23,1694,14807,1296,11,17808
792,2019-09-24,875,11900,2395,13,15183
792,2019-09-25,703,7720,2469,13,10905
792,2019-09-26,1477,11658,1195,10,14340
792,2019-09-27,704,8288,1279,2,10273
792,2019-09-28,703,23950,1912,1,26566
792,2019-09-29,840,19427,1372,3,21642
792,2019-09-30,1624,15873,1677,3,19177
792,2019-10-01,617,17437,2285,1,20340
792,2019-10-02,665,11982,2105,9,14761
792,2019-10-03,743,22812,2255,9,25819
792,2019-10-04,222,14709,1887,11,16829
792,2019-10-05,2007,22086,1809,11,25913
792,2019-10-06,1963,18103,2515,11,22592
792,2019-10-07,1388,7434,2091,9,10922
792,2019-10-08,559,16789,1104,10,18462
792,2019-10-09,1087,24882,1433,9,27411
792,2019-10-10,683,11365,2021,13,14082
792,2019-10-11,1211,14241,1059,9,16520
792,2019-10-12,287,9018,2877,1,12183
792,2019-10-13,398,12292,1170,1,13861
792,2019-10-14,255,5731,2400,2,8388
792,2019-10-15,318,8662,1631,2,10613
792,2019-10-16,385,18576,1626,2,20589
792,2019-10-17,1176,8988,1621,0,11785
792,2019-10-18,320,9188,2409,1,11918
792,2019-10-19,405,5709,1387,0,7501
792,2019-10-20,290,3297,1812,4,5403
792,2019-10-21,1209,10769,1730,1,13709
792,2019-10-22,310,6673,1629,2,8614
792,2019-10-23,1254,9039,2511,1,12805
792,2019-10-24,621,13622,1479,1,15723
792,2019-10-25,488,11320,1504,2,13314
792,2019-10-26,648,13742,2286,1,16677
792,2019-10-27,738,14110,1339,0,16187
792,2019-10-28,313,14020,990,0,15323
792,2019-10-29,440,15736,1166,0,17342
792,2019-10-30,522,15787,1537,3,17849
792,2019-10-31,1236,12361,1694,1,15292
792,2019-11-01,1141,15095,1138,0,17374
792,2019-11-02,384,14075,1105,1,15565
792,2019-11-03,350,22370,642,0,23362
792,2019-11-04,530,10706,1612,2,12850
792,2019-11-05,590,3648,1621,0,5859
792,2019-11-06,589,8421,1337,2,10349
792,2019-11-07,1042,13818,1529,1,16390
792,2019-11-08,596,9902,2286,1,12785
792,2019-11-09,1549,9039,1701,2,12291
792,2019-11-10,374,25096,1194,2,26666
792,2019-11-11,816,17006,2248,1,20071
792,2019-11-12,399,18216,2419,2,21036
792,2019-11-13,420,15466,2078,2,17966
792,2019-11-14,406,8374,1782,4,10566
792,2019-11-15,289,3735,1814,3,5841
792,2019-11-16,323,2990,2697,0,6010
792,2019-11-17,864,3121,3328,0,7313
792,2019-11-18,413,3025,3190,1,6629
792,2019-11-19,806,5082,2741,3,8632
792,2019-11-20,319,1399,1680,0,3398
792,2019-11-21,961,6556,953,1,8471
792,2019-11-22,962,4642,1328,2,6934
792,2019-11-23,887,9428,2508,1,12824
792,2019-11-24,297,6350,3051,0,9698
792,2019-11-25,330,10687,1900,1,12918
792,2019-11-26,303,8128,1771,0,10202
792,2019-11-27,593,6738,1569,0,8900
792,2019-11-28,672,6635,833,0,8140
792,2019-11-29,114,337,3,0,454
792,2019-08-28,427,1512,1891,0,3830
792,2019-08-29,579,8956,2070,0,11605
792,2019-08-30,338,3153,546,0,4037
792,2019-08-31,92,88,12,0,192
792,2019-09-01,156,435,366,0,957
792,2019-09-02,129,1099,46,0,1274
792,2019-09-03,203,3272,1031,1,4507
792,2019-09-04,717,17557,2585,0,20859
792,2019-09-05,1925,5173,1619,3,8720
792,2019-09-06,1032,11421,1549,1,14003
792,2019-09-07,746,14406,2006,0,17158
792,2019-09-08,679,5972,1805,0,8456
792,2019-09-09,1353,11538,2084,1,14976
792,2019-09-10,491,7825,2467,0,10783
792,2019-09-11,1169,5786,2020,1,8976
792,2019-09-12,2011,7201,2266,2,11480
792,2019-09-13,739,5693,2485,3,8920
792,2019-09-14,729,7722,1839,1,10291
792,2019-09-15,393,6493,1718,0,8604
792,2019-09-16,1228,6743,2189,3,10163
792,2019-09-17,360,7256,1831,8,9455
792,2019-09-18,653,12368,1458,9,14488
792,2019-09-19,661,2575,1359,9,4604
792,2019-09-20,501,12310,1710,10,14531
792,2019-09-21,502,9537,2160,10,12209
792,2019-09-22,331,14643,1343,9,16326
792,2019-09-23,1694,14807,1296,11,17808
792,2019-09-24,875,11900,2395,13,15183
792,2019-09-25,703,7720,2469,13,10905
792,2019-09-26,1477,11658,1195,10,14340
792,2019-09-27,704,8288,1279,2,10273
792,2019-09-28,703,23950,1912,1,26566
792,2019-09-29,840,19427,1372,3,21642
792,2019-09-30,1624,15873,1677,3,19177
792,2019-10-01,617,17437,2285,1,20340
792,2019-10-02,665,11982,2105,9,14761
792,2019-10-03,743,22812,2255,9,25819
792,2019-10-04,222,14709,1887,11,16829
792,2019-10-05,2007,22086,1809,11,25913
792,2019-10-06,1963,18103,2515,11,22592
792,2019-10-07,1388,7434,2091,9,10922
792,2019-10-08,559,16789,1104,10,18462
792,2019-10-09,1087,24882,1433,9,27411
792,2019-10-10,683,11365,2021,13,14082
792,2019-10-11,1211,14241,1059,9,16520
792,2019-10-12,287,9018,2877,1,12183
792,2019-10-13,398,12292,1170,1,13861
792,2019-10-14,255,5731,2400,2,8388
792,2019-10-15,318,8662,1631,2,10613
792,2019-10-16,385,18576,1626,2,20589
792,2019-10-17,1176,8988,1621,0,11785
792,2019-10-18,320,9188,2409,1,11918
792,2019-10-19,405,5709,1387,0,7501
792,2019-10-20,290,3297,1812,4,5403
792,2019-10-21,1209,10769,1730,1,13709
792,2019-10-22,310,6673,1629,2,8614
792,2019-10-23,1254,9039,2511,1,12805
792,2019-10-24,621,13622,1479,1,15723
792,2019-10-25,488,11320,1504,2,13314
792,2019-10-26,648,13742,2286,1,16677
792,2019-10-27,738,14110,1339,0,16187
792,2019-10-28,313,14020,990,0,15323
792,2019-10-29,440,15736,1166,0,17342
792,2019-10-30,522,15787,1537,3,17849
792,2019-10-31,1236,12361,1694,1,15292
792,2019-11-01,1141,15095,1138,0,17374
792,2019-11-02,384,14075,1105,1,15565
792,2019-11-03,350,22370,642,0,23362
792,2019-11-04,530,10706,1612,2,12850
792,2019-11-05,590,3648,1621,0,5859
792,2019-11-06,589,8421,1337,2,10349
792,2019-11-07,1042,13818,1529,1,16390
792,2019-11-08,596,9902,2286,1,12785
792,2019-11-09,1549,9039,1701,2,12291
792,2019-11-10,374,25096,1194,2,26666
792,2019-11-11,816,17006,2248,1,20071
792,2019-11-12,399,18216,2419,2,21036
792,2019-11-13,420,15466,2078,2,17966
792,2019-11-14,406,8374,1782,4,10566
792,2019-11-15,289,3735,1814,3,5841
792,2019-11-16,323,2990,2697,0,6010
792,2019-11-17,864,3121,3328,0,7313
792,2019-11-18,413,3025,3190,1,6629
792,2019-11-19,806,5082,2741,3,8632
792,2019-11-20,319,1399,1680,0,3398
792,2019-11-21,961,6556,953,1,8471
792,2019-11-22,962,4642,1328,2,6934
792,2019-11-23,887,9428,2508,1,12824
792,2019-11-24,297,6350,3051,0,9698
792,2019-11-25,330,10687,1900,1,12918
792,2019-11-26,303,8128,1771,0,10202
792,2019-11-27,593,6738,1569,0,8900
792,2019-11-28,672,6635,833,0,8140
792,2019-11-29,114,337,3,0,454
792,2019-08-27,0,0,90,0,90
792,2019-08-28,427,1512,1891,0,3830
792,2019-08-29,579,8956,2070,0,11605
792,2019-08-30,338,3153,546,0,4037
792,2019-08-31,92,88,12,0,192
792,2019-09-01,156,435,366,0,957
792,2019-09-02,129,1099,46,0,1274
792,2019-09-03,203,3272,1031,1,4507
792,2019-09-04,717,17557,2585,0,20859
792,2019-09-05,1925,5173,1619,3,8720
792,2019-09-06,1032,11421,1549,1,14003
792,2019-09-07,746,14406,2006,0,17158
792,2019-09-08,679,5972,1805,0,8456
792,2019-09-09,1353,11538,2084,1,14976
792,2019-09-10,491,7825,2467,0,10783
792,2019-09-11,1169,5786,2020,1,8976
792,2019-09-12,2011,7201,2266,2,11480
792,2019-09-13,739,5693,2485,3,8920
792,2019-09-14,729,7722,1839,1,10291
792,2019-09-15,393,6493,1718,0,8604
792,2019-09-16,1228,6743,2189,3,10163
792,2019-09-17,360,7256,1831,8,9455
792,2019-09-18,653,12368,1458,9,14488
792,2019-09-19,661,2575,1359,9,4604
792,2019-09-20,501,12310,1710,10,14531
792,2019-09-21,502,9537,2160,10,12209
792,2019-09-22,331,14643,1343,9,16326
792,2019-09-23,1694,14807,1296,11,17808
792,2019-09-24,875,11900,2395,13,15183
792,2019-09-25,703,7720,2469,13,10905
792,2019-09-26,1477,11658,1195,10,14340
792,2019-09-27,704,8288,1279,2,10273
792,2019-09-28,703,23950,1912,1,26566
792,2019-09-29,840,19427,1372,3,21642
792,2019-09-30,1624,15873,1677,3,19177
792,2019-10-01,617,17437,2285,1,20340
792,2019-10-02,665,11982,2105,9,14761
792,2019-10-03,743,22812,2255,9,25819
792,2019-10-04,222,14709,1887,11,16829
792,2019-10-05,2007,22086,1809,11,25913
792,2019-10-06,1963,18103,2515,11,22592
792,2019-10-07,1388,7434,2091,9,10922
792,2019-10-08,559,16789,1104,10,18462
792,2019-10-09,1087,24882,1433,9,27411
792,2019-10-10,683,11365,2021,13,14082
792,2019-10-11,1211,14241,1059,9,16520
792,2019-10-12,287,9018,2877,1,12183
792,2019-10-13,398,12292,1170,1,13861
792,2019-10-14,255,5731,2400,2,8388
792,2019-10-15,318,8662,1631,2,10613
792,2019-10-16,385,18576,1626,2,20589
792,2019-10-17,1176,8988,1621,0,11785
792,2019-10-18,320,9188,2409,1,11918
792,2019-10-19,405,5709,1387,0,7501
792,2019-10-20,290,3297,1812,4,5403
792,2019-10-21,1209,10769,1730,1,13709
792,2019-10-22,310,6673,1629,2,8614
792,2019-10-23,1254,9039,2511,1,12805
792,2019-10-24,621,13622,1479,1,15723
792,2019-10-25,488,11320,1504,2,13314
792,2019-10-26,648,13742,2286,1,16677
792,2019-10-27,738,14110,1339,0,16187
792,2019-10-28,313,14020,990,0,15323
792,2019-10-29,440,15736,1166,0,17342
792,2019-10-30,522,15787,1537,3,17849
792,2019-10-31,1236,12361,1694,1,15292
792,2019-11-01,1141,15095,1138,0,17374
792,2019-11-02,384,14075,1105,1,15565
792,2019-11-03,350,22370,642,0,23362
792,2019-11-04,530,10706,1612,2,12850
792,2019-11-05,590,3648,1621,0,5859
792,2019-11-06,589,8421,1337,2,10349
792,2019-11-07,1042,13818,1529,1,16390
792,2019-11-08,596,9902,2286,1,12785
792,2019-11-09,1549,9039,1701,2,12291
792,2019-11-10,374,25096,1194,2,26666
792,2019-11-11,816,17006,2248,1,20071
792,2019-11-12,399,18216,2419,2,21036
792,2019-11-13,420,15466,2078,2,17966
792,2019-11-14,406,8374,1782,4,10566
792,2019-11-15,289,3735,1814,3,5841
792,2019-11-16,323,2990,2697,0,6010
792,2019-11-17,864,3121,3328,0,7313
792,2019-11-18,413,3025,3190,1,6629
792,2019-11-19,806,5082,2741,3,8632
792,2019-11-20,319,1399,1680,0,3398
792,2019-11-21,961,6556,953,1,8471
792,2019-11-22,962,4642,1328,2,6934
792,2019-11-23,887,9428,2508,1,12824
792,2019-11-24,297,6350,3051,0,9698
792,2019-11-25,330,10687,1900,1,12918
792,2019-11-26,303,8128,1771,0,10202
792,2019-11-27,593,6738,1569,0,8900
792,2019-11-28,672,6635,833,0,8140
792,2019-11-29,114,337,3,0,454
792,2019-09-03,203,3272,1031,1,4507
792,2019-09-04,717,17557,2585,0,20859
792,2019-09-05,1925,5173,1619,3,8720
792,2019-09-06,1032,11421,1549,1,14003
792,2019-09-07,746,14406,2006,0,17158
792,2019-09-08,679,5972,1805,0,8456
792,2019-09-09,1353,11538,2084,1,14976
792,2019-09-10,491,7825,2467,0,10783
792,2019-09-11,1169,5786,2020,1,8976
792,2019-09-12,2011,7201,2266,2,11480
792,2019-09-13,739,5693,2485,3,8920
792,2019-09-14,729,7722,1839,1,10291
792,2019-09-15,393,6493,1718,0,8604
792,2019-09-16,1228,6743,2189,3,10163
792,2019-09-17,360,7256,1831,8,9455
792,2019-09-18,653,12368,1458,9,14488
792,2019-09-19,661,2575,1359,9,4604
792,2019-09-20,501,12310,1710,10,14531
792,2019-09-21,502,9537,2160,10,12209
792,2019-09-22,331,14643,1343,9,16326
792,2019-09-23,1694,14807,1296,11,17808
792,2019-09-24,875,11900,2395,13,15183
792,2019-09-25,703,7720,2469,13,10905
792,2019-09-26,1477,11658,1195,10,14340
792,2019-09-27,704,8288,1279,2,10273
792,2019-09-28,703,23950,1912,1,26566
792,2019-09-29,840,19427,1372,3,21642
792,2019-09-30,1624,15873,1677,3,19177
792,2019-10-01,617,17437,2285,1,20340
792,2019-10-02,665,11982,2105,9,14761
792,2019-10-03,743,22812,2255,9,25819
792,2019-10-04,222,14709,1887,11,16829
792,2019-10-05,2007,22086,1809,11,25913
792,2019-10-06,1963,18103,2515,11,22592
792,2019-10-07,1388,7434,2091,9,10922
792,2019-10-08,559,16789,1104,10,18462
792,2019-10-09,1087,24882,1433,9,27411
792,2019-10-10,683,11365,2021,13,14082
792,2019-10-11,1211,14241,1059,9,16520
792,2019-10-12,287,9018,2877,1,12183
792,2019-10-13,398,12292,1170,1,13861
792,2019-10-14,255,5731,2400,2,8388
792,2019-10-15,318,8662,1631,2,10613
792,2019-10-16,385,18576,1626,2,20589
792,2019-10-17,1176,8988,1621,0,11785
792,2019-10-18,320,9188,2409,1,11918
792,2019-10-19,405,5709,1387,0,7501
792,2019-10-20,290,3297,1812,4,5403
792,2019-10-21,1209,10769,1730,1,13709
792,2019-10-22,310,6673,1629,2,8614
792,2019-10-23,1254,9039,2511,1,12805
792,2019-10-24,621,13622,1479,1,15723
792,2019-10-25,488,11320,1504,2,13314
792,2019-10-26,648,13742,2286,1,16677
792,2019-10-27,738,14110,1339,0,16187
792,2019-10-28,313,14020,990,0,15323
792,2019-10-29,440,15736,1166,0,17342
792,2019-10-30,522,15787,1537,3,17849
792,2019-10-31,1236,12361,1694,1,15292
792,2019-11-01,1141,15095,1138,0,17374
792,2019-11-02,384,14075,1105,1,15565
792,2019-11-03,350,22370,642,0,23362
792,2019-11-04,530,10706,1612,2,12850
792,2019-11-05,590,3648,1621,0,5859
792,2019-11-06,589,8421,1337,2,10349
792,2019-11-07,1042,13818,1529,1,16390
792,2019-11-08,596,9902,2286,1,12785
792,2019-11-09,1549,9039,1701,2,12291
792,2019-11-10,374,25096,1194,2,26666
792,2019-11-11,816,17006,2248,1,20071
792,2019-11-12,399,18216,2419,2,21036
792,2019-11-13,420,15466,2078,2,17966
792,2019-11-14,406,8374,1782,4,10566
792,2019-11-15,289,3735,1814,3,5841
792,2019-11-16,323,2990,2697,0,6010
792,2019-11-17,864,3121,3328,0,7313
792,2019-11-18,413,3025,3190,1,6629
792,2019-11-19,806,5082,2741,3,8632
792,2019-11-20,319,1399,1680,0,3398
792,2019-11-21,961,6556,953,1,8471
792,2019-11-22,962,4642,1328,2,6934
792,2019-11-23,887,9428,2508,1,12824
792,2019-11-24,297,6350,3051,0,9698
792,2019-11-25,330,10687,1900,1,12918
793,2019-08-28,405,1470,1817,3,3695
793,2019-08-29,169,9599,1374,2,11144
793,2019-08-30,222,2484,1835,0,4541
793,2019-08-31,137,43,36,0,216
793,2019-09-01,49,64,285,0,398
793,2019-09-02,78,890,74,0,1042
793,2019-09-03,982,243,2054,0,3279
793,2019-09-04,77,11554,2455,1,14087
793,2019-09-05,197,8172,980,2,9351
793,2019-09-06,112,11272,1646,1,13031
793,2019-09-07,1053,12046,2221,0,15320
793,2019-09-08,1107,6530,2088,0,9725
793,2019-09-09,56,15077,1691,1,16825
793,2019-09-10,937,11395,2203,0,14535
793,2019-09-11,94,9082,1350,931,11457
793,2019-09-12,146,8821,2088,3259,14314
793,2019-09-13,106,5726,1837,1,7670
793,2019-09-14,942,6188,2144,3,9277
793,2019-09-15,130,9887,2557,0,12574
793,2019-09-16,88,5755,2384,0,8227
793,2019-09-17,70,8472,1898,2,10442
793,2019-09-18,97,11243,1521,0,12861
793,2019-09-19,295,2524,2017,2,4838
793,2019-09-20,182,7672,1500,1,9355
793,2019-09-21,2186,6033,2340,1,10560
793,2019-09-22,114,15585,1838,0,17537
793,2019-09-23,153,11194,1696,2,13045
793,2019-09-24,89,9061,2016,3,11169
793,2019-09-25,75,7902,1735,0,9712
793,2019-09-26,102,10065,1389,5,11561
793,2019-09-27,72,8574,2031,2,10679
793,2019-09-28,75,17263,1829,0,19167
793,2019-09-29,44,26713,1400,5,28162
793,2019-09-30,93,22150,1906,1,24150
793,2019-10-01,64,16764,1886,2,18716
793,2019-10-02,107,12346,3116,0,15569
793,2019-10-03,208,14410,1117,2,15737
793,2019-10-04,961,13794,964,0,15719
793,2019-10-05,972,21568,1431,0,23971
793,2019-10-06,167,17268,1842,1,19278
793,2019-10-07,179,6891,1670,0,8740
793,2019-10-08,1379,18221,1640,1,21241
793,2019-10-09,997,17359,1471,0,19827
793,2019-10-10,1919,11827,1947,0,15693
793,2019-10-11,2703,13980,1614,3,18300
793,2019-10-12,1923,8762,2720,0,13405
793,2019-10-13,1209,12311,2160,1,15681
793,2019-10-14,91,5902,1412,0,7405
793,2019-10-15,575,9218,1080,0,10873
793,2019-10-16,128,18787,1520,3,20438
793,2019-10-17,950,9074,2161,0,12185
793,2019-10-18,92,14514,1979,0,16585
793,2019-10-19,46,8709,1598,1,10354
793,2019-10-20,195,2955,2004,0,5154
793,2019-10-21,94,11112,1398,4,12608
793,2019-10-22,129,6781,2111,0,9021
793,2019-10-23,86,8661,1668,1,10416
793,2019-10-24,699,15095,1629,2,17425
793,2019-10-25,175,15475,1814,2,17466
793,2019-10-26,120,25007,1736,1,26864
793,2019-10-27,986,19071,1454,0,21511
793,2019-10-28,690,13848,1684,0,16222
793,2019-10-29,869,15869,950,1,17689
793,2019-10-30,112,16377,910,1,17400
793,2019-10-31,55,21204,1488,2,22749
793,2019-11-01,59,16248,1076,711,18094
793,2019-11-02,402,32878,1523,3,34806
793,2019-11-03,1613,26877,1106,0,29596
793,2019-11-04,84,8572,1693,0,10349
793,2019-11-05,138,4013,1755,0,5906
793,2019-11-06,133,14933,1788,2,16856
793,2019-11-07,182,16975,934,0,18091
793,2019-11-08,122,16128,691,0,16941
793,2019-11-09,103,16266,1419,368,18156
793,2019-11-10,346,25448,874,2,26670
793,2019-11-11,954,17082,669,2,18707
793,2019-11-12,100,13107,3296,0,16503
793,2019-11-13,819,12486,1602,2,14909
793,2019-11-14,263,13058,1862,5,15188
793,2019-11-15,944,5073,3440,1,9458
793,2019-11-16,82,2668,2806,1,5557
793,2019-11-17,223,4520,3471,0,8214
793,2019-11-18,457,3362,3070,0,6889
793,2019-11-19,107,3754,2590,2,6453
793,2019-11-20,515,1268,1992,3,3778
793,2019-11-21,96,3594,1855,0,5545
793,2019-11-22,83,4652,1322,0,6057
793,2019-11-23,991,5887,1825,0,8703
793,2019-11-24,196,7913,1767,0,9876
793,2019-11-25,150,6937,1486,0,8573
793,2019-11-26,74,10026,1844,0,11944
793,2019-11-27,784,6708,1567,0,9059
793,2019-11-28,80,11771,882,0,12733
793,2019-11-29,15,669,1,0,685
793,2019-08-28,405,1470,1817,3,3695
793,2019-08-29,169,9599,1374,2,11144
793,2019-08-30,222,2484,1835,0,4541
793,2019-08-31,137,43,36,0,216
793,2019-09-01,49,64,285,0,398
793,2019-09-02,78,890,74,0,1042
793,2019-09-03,982,243,2054,0,3279
793,2019-09-04,77,11554,2455,1,14087
793,2019-09-05,197,8172,980,2,9351
793,2019-09-06,112,11272,1646,1,13031
793,2019-09-07,1053,12046,2221,0,15320
793,2019-09-08,1107,6530,2088,0,9725
793,2019-09-09,56,15077,1691,1,16825
793,2019-09-10,937,11395,2203,0,14535
793,2019-09-11,94,9082,1350,931,11457
793,2019-09-12,146,8821,2088,3259,14314
793,2019-09-13,106,5726,1837,1,7670
793,2019-09-14,942,6188,2144,3,9277
793,2019-09-15,130,9887,2557,0,12574
793,2019-09-16,88,5755,2384,0,8227
793,2019-09-17,70,8472,1898,2,10442
793,2019-09-18,97,11243,1521,0,12861
793,2019-09-19,295,2524,2017,2,4838
793,2019-09-20,182,7672,1500,1,9355
793,2019-09-21,2186,6033,2340,1,10560
793,2019-09-22,114,15585,1838,0,17537
793,2019-09-23,153,11194,1696,2,13045
793,2019-09-24,89,9061,2016,3,11169
793,2019-09-25,75,7902,1735,0,9712
793,2019-09-26,102,10065,1389,5,11561
793,2019-09-27,72,8574,2031,2,10679
793,2019-09-28,75,17263,1829,0,19167
793,2019-09-29,44,26713,1400,5,28162
793,2019-09-30,93,22150,1906,1,24150
793,2019-10-01,64,16764,1886,2,18716
793,2019-10-02,107,12346,3116,0,15569
793,2019-10-03,208,14410,1117,2,15737
793,2019-10-04,961,13794,964,0,15719
793,2019-10-05,972,21568,1431,0,23971
793,2019-10-06,167,17268,1842,1,19278
793,2019-10-07,179,6891,1670,0,8740
793,2019-10-08,1379,18221,1640,1,21241
793,2019-10-09,997,17359,1471,0,19827
793,2019-10-10,1919,11827,1947,0,15693
793,2019-10-11,2703,13980,1614,3,18300
793,2019-10-12,1923,8762,2720,0,13405
793,2019-10-13,1209,12311,2160,1,15681
793,2019-10-14,91,5902,1412,0,7405
793,2019-10-15,575,9218,1080,0,10873
793,2019-10-16,128,18787,1520,3,20438
793,2019-10-17,950,9074,2161,0,12185
793,2019-10-18,92,14514,1979,0,16585
793,2019-10-19,46,8709,1598,1,10354
793,2019-10-20,195,2955,2004,0,5154
793,2019-10-21,94,11112,1398,4,12608
793,2019-10-22,129,6781,2111,0,9021
793,2019-10-23,86,8661,1668,1,10416
793,2019-10-24,699,15095,1629,2,17425
793,2019-10-25,175,15475,1814,2,17466
793,2019-10-26,120,25007,1736,1,26864
793,2019-10-27,986,19071,1454,0,21511
793,2019-10-28,690,13848,1684,0,16222
793,2019-10-29,869,15869,950,1,17689
793,2019-10-30,112,16377,910,1,17400
793,2019-10-31,55,21204,1488,2,22749
793,2019-11-01,59,16248,1076,711,18094
793,2019-11-02,402,32878,1523,3,34806
793,2019-11-03,1613,26877,1106,0,29596
793,2019-11-04,84,8572,1693,0,10349
793,2019-11-05,138,4013,1755,0,5906
793,2019-11-06,133,14933,1788,2,16856
793,2019-11-07,182,16975,934,0,18091
793,2019-11-08,122,16128,691,0,16941
793,2019-11-09,103,16266,1419,368,18156
793,2019-11-10,346,25448,874,2,26670
793,2019-11-11,954,17082,669,2,18707
793,2019-11-12,100,13107,3296,0,16503
793,2019-11-13,819,12486,1602,2,14909
793,2019-11-14,263,13058,1862,5,15188
793,2019-11-15,944,5073,3440,1,9458
793,2019-11-16,82,2668,2806,1,5557
793,2019-11-17,223,4520,3471,0,8214
793,2019-11-18,457,3362,3070,0,6889
793,2019-11-19,107,3754,2590,2,6453
793,2019-11-20,515,1268,1992,3,3778
793,2019-11-21,96,3594,1855,0,5545
793,2019-11-22,83,4652,1322,0,6057
793,2019-11-23,991,5887,1825,0,8703
793,2019-11-24,196,7913,1767,0,9876
793,2019-11-25,150,6937,1486,0,8573
793,2019-11-26,74,10026,1844,0,11944
793,2019-11-27,784,6708,1567,0,9059
793,2019-11-28,80,11771,882,0,12733
793,2019-11-29,15,669,1,0,685
793,2019-08-27,0,0,360,0,360
793,2019-08-28,405,1470,1817,3,3695
793,2019-08-29,169,9599,1374,2,11144
793,2019-08-30,222,2484,1835,0,4541
793,2019-08-31,137,43,36,0,216
793,2019-09-01,49,64,285,0,398
793,2019-09-02,78,890,74,0,1042
793,2019-09-03,982,243,2054,0,3279
793,2019-09-04,77,11554,2455,1,14087
793,2019-09-05,197,8172,980,2,9351
793,2019-09-06,112,11272,1646,1,13031
793,2019-09-07,1053,12046,2221,0,15320
793,2019-09-08,1107,6530,2088,0,9725
793,2019-09-09,56,15077,1691,1,16825
793,2019-09-10,937,11395,2203,0,14535
793,2019-09-11,94,9082,1350,931,11457
793,2019-09-12,146,8821,2088,3259,14314
793,2019-09-13,106,5726,1837,1,7670
793,2019-09-14,942,6188,2144,3,9277
793,2019-09-15,130,9887,2557,0,12574
793,2019-09-16,88,5755,2384,0,8227
793,2019-09-17,70,8472,1898,2,10442
793,2019-09-18,97,11243,1521,0,12861
793,2019-09-19,295,2524,2017,2,4838
793,2019-09-20,182,7672,1500,1,9355
793,2019-09-21,2186,6033,2340,1,10560
793,2019-09-22,114,15585,1838,0,17537
793,2019-09-23,153,11194,1696,2,13045
793,2019-09-24,89,9061,2016,3,11169
793,2019-09-25,75,7902,1735,0,9712
793,2019-09-26,102,10065,1389,5,11561
793,2019-09-27,72,8574,2031,2,10679
793,2019-09-28,75,17263,1829,0,19167
793,2019-09-29,44,26713,1400,5,28162
793,2019-09-30,93,22150,1906,1,24150
793,2019-10-01,64,16764,1886,2,18716
793,2019-10-02,107,12346,3116,0,15569
793,2019-10-03,208,14410,1117,2,15737
793,2019-10-04,961,13794,964,0,15719
793,2019-10-05,972,21568,1431,0,23971
793,2019-10-06,167,17268,1842,1,19278
793,2019-10-07,179,6891,1670,0,8740
793,2019-10-08,1379,18221,1640,1,21241
793,2019-10-09,997,17359,1471,0,19827
793,2019-10-10,1919,11827,1947,0,15693
793,2019-10-11,2703,13980,1614,3,18300
793,2019-10-12,1923,8762,2720,0,13405
793,2019-10-13,1209,12311,2160,1,15681
793,2019-10-14,91,5902,1412,0,7405
793,2019-10-15,575,9218,1080,0,10873
793,2019-10-16,128,18787,1520,3,20438
793,2019-10-17,950,9074,2161,0,12185
793,2019-10-18,92,14514,1979,0,16585
793,2019-10-19,46,8709,1598,1,10354
793,2019-10-20,195,2955,2004,0,5154
793,2019-10-21,94,11112,1398,4,12608
793,2019-10-22,129,6781,2111,0,9021
793,2019-10-23,86,8661,1668,1,10416
793,2019-10-24,699,15095,1629,2,17425
793,2019-10-25,175,15475,1814,2,17466
793,2019-10-26,120,25007,1736,1,26864
793,2019-10-27,986,19071,1454,0,21511
793,2019-10-28,690,13848,1684,0,16222
793,2019-10-29,869,15869,950,1,17689
793,2019-10-30,112,16377,910,1,17400
793,2019-10-31,55,21204,1488,2,22749
793,2019-11-01,59,16248,1076,711,18094
793,2019-11-02,402,32878,1523,3,34806
793,2019-11-03,1613,26877,1106,0,29596
793,2019-11-04,84,8572,1693,0,10349
793,2019-11-05,138,4013,1755,0,5906
793,2019-11-06,133,14933,1788,2,16856
793,2019-11-07,182,16975,934,0,18091
793,2019-11-08,122,16128,691,0,16941
793,2019-11-09,103,16266,1419,368,18156
793,2019-11-10,346,25448,874,2,26670
793,2019-11-11,954,17082,669,2,18707
793,2019-11-12,100,13107,3296,0,16503
793,2019-11-13,819,12486,1602,2,14909
793,2019-11-14,263,13058,1862,5,15188
793,2019-11-15,944,5073,3440,1,9458
793,2019-11-16,82,2668,2806,1,5557
793,2019-11-17,223,4520,3471,0,8214
793,2019-11-18,457,3362,3070,0,6889
793,2019-11-19,107,3754,2590,2,6453
793,2019-11-20,515,1268,1992,3,3778
793,2019-11-21,96,3594,1855,0,5545
793,2019-11-22,83,4652,1322,0,6057
793,2019-11-23,991,5887,1825,0,8703
793,2019-11-24,196,7913,1767,0,9876
793,2019-11-25,150,6937,1486,0,8573
793,2019-11-26,74,10026,1844,0,11944
793,2019-11-27,784,6708,1567,0,9059
793,2019-11-28,80,11771,882,0,12733
793,2019-11-29,15,669,1,0,685
793,2019-08-28,405,1470,1817,3,3695
793,2019-08-29,169,9599,1374,2,11144
793,2019-08-30,222,2484,1835,0,4541
793,2019-08-31,137,43,36,0,216
793,2019-09-01,49,64,285,0,398
793,2019-09-02,78,890,74,0,1042
793,2019-09-03,982,243,2054,0,3279
793,2019-09-04,77,11554,2455,1,14087
793,2019-09-05,197,8172,980,2,9351
793,2019-09-06,112,11272,1646,1,13031
793,2019-09-07,1053,12046,2221,0,15320
793,2019-09-08,1107,6530,2088,0,9725
793,2019-09-09,56,15077,1691,1,16825
793,2019-09-10,937,11395,2203,0,14535
793,2019-09-11,94,9082,1350,931,11457
793,2019-09-12,146,8821,2088,3259,14314
793,2019-09-13,106,5726,1837,1,7670
793,2019-09-14,942,6188,2144,3,9277
793,2019-09-15,130,9887,2557,0,12574
793,2019-09-16,88,5755,2384,0,8227
793,2019-09-17,70,8472,1898,2,10442
793,2019-09-18,97,11243,1521,0,12861
793,2019-09-19,295,2524,2017,2,4838
793,2019-09-20,182,7672,1500,1,9355
793,2019-09-21,2186,6033,2340,1,10560
793,2019-09-22,114,15585,1838,0,17537
793,2019-09-23,153,11194,1696,2,13045
793,2019-09-24,89,9061,2016,3,11169
793,2019-09-25,75,7902,1735,0,9712
793,2019-09-26,102,10065,1389,5,11561
793,2019-09-27,72,8574,2031,2,10679
793,2019-09-28,75,17263,1829,0,19167
793,2019-09-29,44,26713,1400,5,28162
793,2019-09-30,93,22150,1906,1,24150
793,2019-10-01,64,16764,1886,2,18716
793,2019-10-02,107,12346,3116,0,15569
793,2019-10-03,208,14410,1117,2,15737
793,2019-10-04,961,13794,964,0,15719
793,2019-10-05,972,21568,1431,0,23971
793,2019-10-06,167,17268,1842,1,19278
793,2019-10-07,179,6891,1670,0,8740
793,2019-10-08,1379,18221,1640,1,21241
793,2019-10-09,997,17359,1471,0,19827
793,2019-10-10,1919,11827,1947,0,15693
793,2019-10-11,2703,13980,1614,3,18300
793,2019-10-12,1923,8762,2720,0,13405
793,2019-10-13,1209,12311,2160,1,15681
793,2019-10-14,91,5902,1412,0,7405
793,2019-10-15,575,9218,1080,0,10873
793,2019-10-16,128,18787,1520,3,20438
793,2019-10-17,950,9074,2161,0,12185
793,2019-10-18,92,14514,1979,0,16585
793,2019-10-19,46,8709,1598,1,10354
793,2019-10-20,195,2955,2004,0,5154
793,2019-10-21,94,11112,1398,4,12608
793,2019-10-22,129,6781,2111,0,9021
793,2019-10-23,86,8661,1668,1,10416
793,2019-10-24,699,15095,1629,2,17425
793,2019-10-25,175,15475,1814,2,17466
793,2019-10-26,120,25007,1736,1,26864
793,2019-10-27,986,19071,1454,0,21511
793,2019-10-28,690,13848,1684,0,16222
793,2019-10-29,869,15869,950,1,17689
793,2019-10-30,112,16377,910,1,17400
793,2019-10-31,55,21204,1488,2,22749
793,2019-11-01,59,16248,1076,711,18094
793,2019-11-02,402,32878,1523,3,34806
793,2019-11-03,1613,26877,1106,0,29596
793,2019-11-04,84,8572,1693,0,10349
793,2019-11-05,138,4013,1755,0,5906
793,2019-11-06,133,14933,1788,2,16856
793,2019-11-07,182,16975,934,0,18091
793,2019-11-08,122,16128,691,0,16941
793,2019-11-09,103,16266,1419,368,18156
793,2019-11-10,346,25448,874,2,26670
793,2019-11-11,954,17082,669,2,18707
793,2019-11-12,100,13107,3296,0,16503
793,2019-11-13,819,12486,1602,2,14909
793,2019-11-14,263,13058,1862,5,15188
793,2019-11-15,944,5073,3440,1,9458
793,2019-11-16,82,2668,2806,1,5557
793,2019-11-17,223,4520,3471,0,8214
793,2019-11-18,457,3362,3070,0,6889
793,2019-11-19,107,3754,2590,2,6453
793,2019-11-20,515,1268,1992,3,3778
794,2019-08-28,173,1258,2790,2,4223
794,2019-08-29,193,8704,2173,48,11118
794,2019-08-30,250,3072,631,1,3954
794,2019-08-31,191,81,6,1,279
794,2019-09-01,189,1059,632,0,1880
794,2019-09-02,202,796,0,0,998
794,2019-09-03,166,271,1793,0,2230
794,2019-09-04,993,13620,1702,1,16316
794,2019-09-05,507,11261,2244,1,14013
794,2019-09-06,284,13639,2421,1,16345
794,2019-09-07,340,13110,1786,0,15236
794,2019-09-08,1346,7568,1740,0,10654
794,2019-09-09,198,15181,1857,0,17236
794,2019-09-10,217,11708,1674,2,13601
794,2019-09-11,1004,10440,2086,1,13531
794,2019-09-12,967,9783,2147,0,12897
794,2019-09-13,173,5959,2551,0,8683
794,2019-09-14,1830,10755,2454,2,15041
794,2019-09-15,1010,9729,2078,0,12817
794,2019-09-16,1121,6000,2971,0,10092
794,2019-09-17,1053,12146,2251,0,15450
794,2019-09-18,756,11374,1324,1,13455
794,2019-09-19,379,3365,1980,0,5724
794,2019-09-20,1265,12911,1350,0,15526
794,2019-09-21,176,7943,1980,1,10100
794,2019-09-22,844,9452,1778,1,12075
794,2019-09-23,1039,12362,2545,0,15946
794,2019-09-24,1014,12040,1790,2,14846
794,2019-09-25,1096,10994,1643,2,13735
794,2019-09-26,184,12033,1914,3,14134
794,2019-09-27,1014,8788,1946,2,11750
794,2019-09-28,150,16892,1101,2,18145
794,2019-09-29,728,16756,1444,3,18931
794,2019-09-30,124,20086,1832,0,22042
794,2019-10-01,508,22218,1627,3,24356
794,2019-10-02,1071,14478,1814,0,17363
794,2019-10-03,147,16835,1491,0,18473
794,2019-10-04,272,12792,1179,1,14244
794,2019-10-05,337,21470,1547,0,23354
794,2019-10-06,635,18597,2198,3,21433
794,2019-10-07,159,8648,1933,1,10741
794,2019-10-08,476,18160,1710,0,20346
794,2019-10-09,1511,17328,1657,1,20497
794,2019-10-10,1583,10790,2029,1,14403
794,2019-10-11,240,9048,696,3,9987
794,2019-10-12,115,7169,2073,1,9358
794,2019-10-13,1877,12561,1831,0,16269
794,2019-10-14,310,5878,1762,3,7953
794,2019-10-15,303,9441,1677,0,11421
794,2019-10-16,149,18825,1860,3,20837
794,2019-10-17,143,8827,2069,1,11040
794,2019-10-18,134,8674,2032,0,10840
794,2019-10-19,1857,5674,1666,0,9197
794,2019-10-20,1124,3323,2172,1,6620
794,2019-10-21,793,15017,1669,4,17483
794,2019-10-22,194,6772,1742,1,8709
794,2019-10-23,995,8690,1061,1,10747
794,2019-10-24,862,20801,1320,1,22984
794,2019-10-25,218,15158,2330,1,17707
794,2019-10-26,132,13984,1138,0,15254
794,2019-10-27,238,28733,1594,0,30565
794,2019-10-28,503,25593,1927,0,28023
794,2019-10-29,180,18158,1583,1,19922
794,2019-10-30,111,27200,1633,1,28945
794,2019-10-31,993,15295,1423,2,17713
794,2019-11-01,135,25592,1982,2,27711
794,2019-11-02,94,27191,1859,1,29145
794,2019-11-03,112,39417,1746,1,41276
794,2019-11-04,133,10967,1337,1,12438
794,2019-11-05,1095,7432,1145,0,9672
794,2019-11-06,638,9027,1240,2,10907
794,2019-11-07,174,23040,1052,644,24910
794,2019-11-08,133,18122,1249,2,19506
794,2019-11-09,1531,11817,1328,0,14676
794,2019-11-10,1005,25478,1286,3,27772
794,2019-11-11,1233,17041,1436,3,19713
794,2019-11-12,118,18344,2410,0,20872
794,2019-11-13,653,14299,1754,4,16710
794,2019-11-14,105,9056,1331,1,10493
794,2019-11-15,210,4013,2844,1,7068
794,2019-11-16,111,2256,3368,1,5736
794,2019-11-17,131,3104,5114,0,8349
794,2019-11-18,126,2587,3569,2,6284
794,2019-11-19,150,5377,2639,893,9059
794,2019-11-20,192,1941,2240,3,4376
794,2019-11-21,565,3993,2982,0,7540
794,2019-11-22,174,8141,1960,1,10276
794,2019-11-23,168,6844,1954,90,9056
794,2019-11-24,759,5033,1806,1,7599
794,2019-11-25,1009,6969,1966,2,9946
794,2019-11-26,118,9763,1443,0,11324
794,2019-11-27,113,6692,1383,1,8189
794,2019-11-28,181,11907,596,0,12684
794,2019-11-29,61,285,4,0,350
794,2019-08-28,173,1258,2790,2,4223
794,2019-08-29,193,8704,2173,48,11118
794,2019-08-30,250,3072,631,1,3954
794,2019-08-31,191,81,6,1,279
794,2019-09-01,189,1059,632,0,1880
794,2019-09-02,202,796,0,0,998
794,2019-09-03,166,271,1793,0,2230
794,2019-09-04,993,13620,1702,1,16316
794,2019-09-05,507,11261,2244,1,14013
794,2019-09-06,284,13639,2421,1,16345
794,2019-09-07,340,13110,1786,0,15236
794,2019-09-08,1346,7568,1740,0,10654
794,2019-09-09,198,15181,1857,0,17236
794,2019-09-10,217,11708,1674,2,13601
794,2019-09-11,1004,10440,2086,1,13531
794,2019-09-12,967,9783,2147,0,12897
794,2019-09-13,173,5959,2551,0,8683
794,2019-09-14,1830,10755,2454,2,15041
794,2019-09-15,1010,9729,2078,0,12817
794,2019-09-16,1121,6000,2971,0,10092
794,2019-09-17,1053,12146,2251,0,15450
794,2019-09-18,756,11374,1324,1,13455
794,2019-09-19,379,3365,1980,0,5724
794,2019-09-20,1265,12911,1350,0,15526
794,2019-09-21,176,7943,1980,1,10100
794,2019-09-22,844,9452,1778,1,12075
794,2019-09-23,1039,12362,2545,0,15946
794,2019-09-24,1014,12040,1790,2,14846
794,2019-09-25,1096,10994,1643,2,13735
794,2019-09-26,184,12033,1914,3,14134
794,2019-09-27,1014,8788,1946,2,11750
794,2019-09-28,150,16892,1101,2,18145
794,2019-09-29,728,16756,1444,3,18931
794,2019-09-30,124,20086,1832,0,22042
794,2019-10-01,508,22218,1627,3,24356
794,2019-10-02,1071,14478,1814,0,17363
794,2019-10-03,147,16835,1491,0,18473
794,2019-10-04,272,12792,1179,1,14244
794,2019-10-05,337,21470,1547,0,23354
794,2019-10-06,635,18597,2198,3,21433
794,2019-10-07,159,8648,1933,1,10741
794,2019-10-08,476,18160,1710,0,20346
794,2019-10-09,1511,17328,1657,1,20497
794,2019-10-10,1583,10790,2029,1,14403
794,2019-10-11,240,9048,696,3,9987
794,2019-10-12,115,7169,2073,1,9358
794,2019-10-13,1877,12561,1831,0,16269
794,2019-10-14,310,5878,1762,3,7953
794,2019-10-15,303,9441,1677,0,11421
794,2019-10-16,149,18825,1860,3,20837
794,2019-10-17,143,8827,2069,1,11040
794,2019-10-18,134,8674,2032,0,10840
794,2019-10-19,1857,5674,1666,0,9197
794,2019-10-20,1124,3323,2172,1,6620
794,2019-10-21,793,15017,1669,4,17483
794,2019-10-22,194,6772,1742,1,8709
794,2019-10-23,995,8690,1061,1,10747
794,2019-10-24,862,20801,1320,1,22984
794,2019-10-25,218,15158,2330,1,17707
794,2019-10-26,132,13984,1138,0,15254
794,2019-10-27,238,28733,1594,0,30565
794,2019-10-28,503,25593,1927,0,28023
794,2019-10-29,180,18158,1583,1,19922
794,2019-10-30,111,27200,1633,1,28945
794,2019-10-31,993,15295,1423,2,17713
794,2019-11-01,135,25592,1982,2,27711
794,2019-11-02,94,27191,1859,1,29145
794,2019-11-03,112,39417,1746,1,41276
794,2019-11-04,133,10967,1337,1,12438
794,2019-11-05,1095,7432,1145,0,9672
794,2019-11-06,638,9027,1240,2,10907
794,2019-11-07,174,23040,1052,644,24910
794,2019-11-08,133,18122,1249,2,19506
794,2019-11-09,1531,11817,1328,0,14676
794,2019-11-10,1005,25478,1286,3,27772
794,2019-11-11,1233,17041,1436,3,19713
794,2019-11-12,118,18344,2410,0,20872
794,2019-11-13,653,14299,1754,4,16710
794,2019-11-14,105,9056,1331,1,10493
794,2019-11-15,210,4013,2844,1,7068
794,2019-11-16,111,2256,3368,1,5736
794,2019-11-17,131,3104,5114,0,8349
794,2019-11-18,126,2587,3569,2,6284
794,2019-11-19,150,5377,2639,893,9059
794,2019-11-20,192,1941,2240,3,4376
794,2019-11-21,565,3993,2982,0,7540
794,2019-11-22,174,8141,1960,1,10276
794,2019-11-23,168,6844,1954,90,9056
794,2019-11-24,759,5033,1806,1,7599
794,2019-11-25,1009,6969,1966,2,9946
794,2019-11-26,118,9763,1443,0,11324
794,2019-11-27,113,6692,1383,1,8189
794,2019-11-28,181,11907,596,0,12684
794,2019-11-29,61,285,4,0,350
794,2019-08-27,0,0,270,0,270
794,2019-08-28,173,1258,2790,2,4223
794,2019-08-29,193,8704,2173,48,11118
794,2019-08-30,250,3072,631,1,3954
794,2019-08-31,191,81,6,1,279
794,2019-09-01,189,1059,632,0,1880
794,2019-09-02,202,796,0,0,998
794,2019-09-03,166,271,1793,0,2230
794,2019-09-04,993,13620,1702,1,16316
794,2019-09-05,507,11261,2244,1,14013
794,2019-09-06,284,13639,2421,1,16345
794,2019-09-07,340,13110,1786,0,15236
794,2019-09-08,1346,7568,1740,0,10654
794,2019-09-09,198,15181,1857,0,17236
794,2019-09-10,217,11708,1674,2,13601
794,2019-09-11,1004,10440,2086,1,13531
794,2019-09-12,967,9783,2147,0,12897
794,2019-09-13,173,5959,2551,0,8683
794,2019-09-14,1830,10755,2454,2,15041
794,2019-09-15,1010,9729,2078,0,12817
794,2019-09-16,1121,6000,2971,0,10092
794,2019-09-17,1053,12146,2251,0,15450
794,2019-09-18,756,11374,1324,1,13455
794,2019-09-19,379,3365,1980,0,5724
794,2019-09-20,1265,12911,1350,0,15526
794,2019-09-21,176,7943,1980,1,10100
794,2019-09-22,844,9452,1778,1,12075
794,2019-09-23,1039,12362,2545,0,15946
794,2019-09-24,1014,12040,1790,2,14846
794,2019-09-25,1096,10994,1643,2,13735
794,2019-09-26,184,12033,1914,3,14134
794,2019-09-27,1014,8788,1946,2,11750
794,2019-09-28,150,16892,1101,2,18145
794,2019-09-29,728,16756,1444,3,18931
794,2019-09-30,124,20086,1832,0,22042
794,2019-10-01,508,22218,1627,3,24356
794,2019-10-02,1071,14478,1814,0,17363
794,2019-10-03,147,16835,1491,0,18473
794,2019-10-04,272,12792,1179,1,14244
794,2019-10-05,337,21470,1547,0,23354
794,2019-10-06,635,18597,2198,3,21433
794,2019-10-07,159,8648,1933,1,10741
794,2019-10-08,476,18160,1710,0,20346
794,2019-10-09,1511,17328,1657,1,20497
794,2019-10-10,1583,10790,2029,1,14403
794,2019-10-11,240,9048,696,3,9987
794,2019-10-12,115,7169,2073,1,9358
794,2019-10-13,1877,12561,1831,0,16269
794,2019-10-14,310,5878,1762,3,7953
794,2019-10-15,303,9441,1677,0,11421
794,2019-10-16,149,18825,1860,3,20837
794,2019-10-17,143,8827,2069,1,11040
794,2019-10-18,134,8674,2032,0,10840
794,2019-10-19,1857,5674,1666,0,9197
794,2019-10-20,1124,3323,2172,1,6620
794,2019-10-21,793,15017,1669,4,17483
794,2019-10-22,194,6772,1742,1,8709
794,2019-10-23,995,8690,1061,1,10747
794,2019-10-24,862,20801,1320,1,22984
794,2019-10-25,218,15158,2330,1,17707
794,2019-10-26,132,13984,1138,0,15254
794,2019-10-27,238,28733,1594,0,30565
794,2019-10-28,503,25593,1927,0,28023
794,2019-10-29,180,18158,1583,1,19922
794,2019-10-30,111,27200,1633,1,28945
794,2019-10-31,993,15295,1423,2,17713
794,2019-11-01,135,25592,1982,2,27711
794,2019-11-02,94,27191,1859,1,29145
794,2019-11-03,112,39417,1746,1,41276
794,2019-11-04,133,10967,1337,1,12438
794,2019-11-05,1095,7432,1145,0,9672
794,2019-11-06,638,9027,1240,2,10907
794,2019-11-07,174,23040,1052,644,24910
794,2019-11-08,133,18122,1249,2,19506
794,2019-11-09,1531,11817,1328,0,14676
794,2019-11-10,1005,25478,1286,3,27772
794,2019-11-11,1233,17041,1436,3,19713
794,2019-11-12,118,18344,2410,0,20872
794,2019-11-13,653,14299,1754,4,16710
794,2019-11-14,105,9056,1331,1,10493
794,2019-11-15,210,4013,2844,1,7068
794,2019-11-16,111,2256,3368,1,5736
794,2019-11-17,131,3104,5114,0,8349
794,2019-11-18,126,2587,3569,2,6284
794,2019-11-19,150,5377,2639,893,9059
794,2019-11-20,192,1941,2240,3,4376
794,2019-11-21,565,3993,2982,0,7540
794,2019-11-22,174,8141,1960,1,10276
794,2019-11-23,168,6844,1954,90,9056
794,2019-11-24,759,5033,1806,1,7599
794,2019-11-25,1009,6969,1966,2,9946
794,2019-11-26,118,9763,1443,0,11324
794,2019-11-27,113,6692,1383,1,8189
794,2019-11-28,181,11907,596,0,12684
794,2019-11-29,61,285,4,0,350
794,2019-08-28,173,1258,2790,2,4223
794,2019-08-29,193,8704,2173,48,11118
794,2019-08-30,250,3072,631,1,3954
794,2019-08-31,191,81,6,1,279
794,2019-09-01,189,1059,632,0,1880
794,2019-09-02,202,796,0,0,998
794,2019-09-03,166,271,1793,0,2230
794,2019-09-04,993,13620,1702,1,16316
794,2019-09-05,507,11261,2244,1,14013
794,2019-09-06,284,13639,2421,1,16345
794,2019-09-07,340,13110,1786,0,15236
794,2019-09-08,1346,7568,1740,0,10654
794,2019-09-09,198,15181,1857,0,17236
794,2019-09-10,217,11708,1674,2,13601
794,2019-09-11,1004,10440,2086,1,13531
794,2019-09-12,967,9783,2147,0,12897
794,2019-09-13,173,5959,2551,0,8683
794,2019-09-14,1830,10755,2454,2,15041
794,2019-09-15,1010,9729,2078,0,12817
794,2019-09-16,1121,6000,2971,0,10092
794,2019-09-17,1053,12146,2251,0,15450
794,2019-09-18,756,11374,1324,1,13455
794,2019-09-19,379,3365,1980,0,5724
794,2019-09-20,1265,12911,1350,0,15526
794,2019-09-21,176,7943,1980,1,10100
794,2019-09-22,844,9452,1778,1,12075
794,2019-09-23,1039,12362,2545,0,15946
794,2019-09-24,1014,12040,1790,2,14846
794,2019-09-25,1096,10994,1643,2,13735
794,2019-09-26,184,12033,1914,3,14134
794,2019-09-27,1014,8788,1946,2,11750
794,2019-09-28,150,16892,1101,2,18145
794,2019-09-29,728,16756,1444,3,18931
794,2019-09-30,124,20086,1832,0,22042
794,2019-10-01,508,22218,1627,3,24356
794,2019-10-02,1071,14478,1814,0,17363
794,2019-10-03,147,16835,1491,0,18473
794,2019-10-04,272,12792,1179,1,14244
794,2019-10-05,337,21470,1547,0,23354
794,2019-10-06,635,18597,2198,3,21433
794,2019-10-07,159,8648,1933,1,10741
794,2019-10-08,476,18160,1710,0,20346
794,2019-10-09,1511,17328,1657,1,20497
794,2019-10-10,1583,10790,2029,1,14403
794,2019-10-11,240,9048,696,3,9987
794,2019-10-12,115,7169,2073,1,9358
794,2019-10-13,1877,12561,1831,0,16269
794,2019-10-14,310,5878,1762,3,7953
794,2019-10-15,303,9441,1677,0,11421
794,2019-10-16,149,18825,1860,3,20837
794,2019-10-17,143,8827,2069,1,11040
794,2019-10-18,134,8674,2032,0,10840
794,2019-10-19,1857,5674,1666,0,9197
794,2019-10-20,1124,3323,2172,1,6620
794,2019-10-21,793,15017,1669,4,17483
794,2019-10-22,194,6772,1742,1,8709
794,2019-10-23,995,8690,1061,1,10747
794,2019-10-24,862,20801,1320,1,22984
794,2019-10-25,218,15158,2330,1,17707
794,2019-10-26,132,13984,1138,0,15254
794,2019-10-27,238,28733,1594,0,30565
794,2019-10-28,503,25593,1927,0,28023
794,2019-10-29,180,18158,1583,1,19922
794,2019-10-30,111,27200,1633,1,28945
794,2019-10-31,993,15295,1423,2,17713
794,2019-11-01,135,25592,1982,2,27711
794,2019-11-02,94,27191,1859,1,29145
794,2019-11-03,112,39417,1746,1,41276
794,2019-11-04,133,10967,1337,1,12438
794,2019-11-05,1095,7432,1145,0,9672
794,2019-11-06,638,9027,1240,2,10907
794,2019-11-07,174,23040,1052,644,24910
794,2019-11-08,133,18122,1249,2,19506
794,2019-11-09,1531,11817,1328,0,14676
794,2019-11-10,1005,25478,1286,3,27772
794,2019-11-11,1233,17041,1436,3,19713
794,2019-11-12,118,18344,2410,0,20872
794,2019-11-13,653,14299,1754,4,16710
794,2019-11-14,105,9056,1331,1,10493
794,2019-11-15,210,4013,2844,1,7068
794,2019-11-16,111,2256,3368,1,5736
794,2019-11-17,131,3104,5114,0,8349
794,2019-11-18,126,2587,3569,2,6284
794,2019-11-19,150,5377,2639,893,9059
794,2019-11-20,192,1941,2240,3,4376
794,2019-11-21,565,3993,2982,0,7540
794,2019-11-22,174,8141,1960,1,10276
794,2019-11-23,168,6844,1954,90,9056
794,2019-11-24,759,5033,1806,1,7599
794,2019-11-25,1009,6969,1966,2,9946
794,2019-11-26,118,9763,1443,0,11324
794,2019-11-27,113,6692,1383,1,8189
795,2019-08-28,25682,1515,1888,1,29086
795,2019-08-29,38795,8551,1456,1,48803
795,2019-08-30,34669,2991,896,1,38557
795,2019-08-31,12196,85,1,0,12282
795,2019-09-01,12925,10,666,0,13601
795,2019-09-02,15339,6,0,0,15345
795,2019-09-03,32537,111,1480,0,34128
795,2019-09-04,45315,5885,2658,0,53858
795,2019-09-05,54927,9771,1707,1,66406
795,2019-09-06,28091,7063,2642,0,37796
795,2019-09-07,90332,15270,1571,0,107173
795,2019-09-08,69462,6110,1885,0,77457
795,2019-09-09,108635,10292,1385,0,120312
795,2019-09-10,158701,6978,1623,0,167302
795,2019-09-11,98670,9075,2019,2,109766
795,2019-09-12,124350,6544,1875,1,132770
795,2019-09-13,140011,4297,1658,2,145968
795,2019-09-14,29074,7347,2038,1,38460
795,2019-09-15,34982,18800,2097,0,55879
795,2019-09-16,51067,5345,1937,1,58350
795,2019-09-17,59662,11597,2908,5795,79962
795,2019-09-18,26362,18545,1965,0,46872
795,2019-09-19,76926,2998,1170,1,81095
795,2019-09-20,74899,10792,1629,1,87321
795,2019-09-21,56128,5955,2241,2,64326
795,2019-09-22,34042,7754,1271,2,43069
795,2019-09-23,42506,8102,1533,2,52143
795,2019-09-24,42146,7800,2442,2,52390
795,2019-09-25,47555,7218,1658,2,56433
795,2019-09-26,35156,7902,1666,0,44724
795,2019-09-27,40192,12152,1715,4,54063
795,2019-09-28,37018,14032,1564,1,52615
795,2019-09-29,21952,16137,1174,1,39264
795,2019-09-30,27936,17114,2049,0,47099
795,2019-10-01,28770,14104,2011,3,44888
795,2019-10-02,24028,11260,1554,0,36842
795,2019-10-03,26682,13353,1543,0,41578
795,2019-10-04,30531,11401,1286,1,43219
795,2019-10-05,30495,13601,2160,0,46256
795,2019-10-06,26385,10967,1502,4,38858
795,2019-10-07,38263,5925,2063,3,46254
795,2019-10-08,24963,11180,1420,0,37563
795,2019-10-09,44553,22795,1676,0,69024
795,2019-10-10,80109,10996,1537,1,92643
795,2019-10-11,44663,6874,1738,1,53276
795,2019-10-12,28333,6360,1272,3,35968
795,2019-10-13,29723,8269,1642,2,39636
795,2019-10-14,52332,5432,1761,0,59525
795,2019-10-15,52011,8190,1544,2,61747
795,2019-10-16,32109,12255,1795,3,46162
795,2019-10-17,26175,5259,2077,2,33513
795,2019-10-18,25929,8120,1859,2,35910
795,2019-10-19,46445,5458,2545,0,54448
795,2019-10-20,41727,2976,1625,1,46329
795,2019-10-21,29033,9915,1600,0,40548
795,2019-10-22,40584,6841,2097,3,49525
795,2019-10-23,25308,7772,1610,3,34693
795,2019-10-24,27584,19299,1576,646,49105
795,2019-10-25,21316,18881,1472,3,41672
795,2019-10-26,19492,16654,1197,0,37343
795,2019-10-27,23268,15812,1241,1,40322
795,2019-10-28,32800,23120,1565,2,57487
795,2019-10-29,42006,17213,2226,2,61447
795,2019-10-30,33241,14701,1446,1,49389
795,2019-10-31,38004,19701,1437,1,59143
795,2019-11-01,49501,26450,1167,2,77120
795,2019-11-02,41224,16385,579,1,58189
795,2019-11-03,30392,22015,1108,0,53515
795,2019-11-04,43977,8589,2344,2,54912
795,2019-11-05,23944,2090,1336,0,27370
795,2019-11-06,35437,14166,909,4,50516
795,2019-11-07,40630,16582,1373,0,58585
795,2019-11-08,39712,9481,908,0,50101
795,2019-11-09,48547,17335,1508,0,67390
795,2019-11-10,62674,14664,1492,2,78832
795,2019-11-11,33540,9612,1956,4,45112
795,2019-11-12,38043,10298,2434,0,50775
795,2019-11-13,47563,22381,1432,1,71377
795,2019-11-14,34594,9963,1519,1,46077
795,2019-11-15,85314,3789,2786,2,91891
795,2019-11-16,56556,2125,3320,2,62003
795,2019-11-17,30862,2487,3670,0,37019
795,2019-11-18,23593,2076,4362,1,30032
795,2019-11-19,24588,4897,1569,0,31054
795,2019-11-20,26084,1798,2350,0,30232
795,2019-11-21,38321,4573,1624,3,44521
795,2019-11-22,31592,7439,1429,2,40462
795,2019-11-23,42968,6075,1744,1,50788
795,2019-11-24,40361,7251,1594,0,49206
795,2019-11-25,28808,6522,1906,0,37236
795,2019-11-26,22385,8267,1079,3,31734
795,2019-11-27,21750,6016,1941,0,29707
795,2019-11-28,26427,10730,255,1,37413
795,2019-11-29,2830,1063,1,0,3894
795,2019-08-28,25682,1515,1888,1,29086
795,2019-08-29,38795,8551,1456,1,48803
795,2019-08-30,34669,2991,896,1,38557
795,2019-08-31,12196,85,1,0,12282
795,2019-09-01,12925,10,666,0,13601
795,2019-09-02,15339,6,0,0,15345
795,2019-09-03,32537,111,1480,0,34128
795,2019-09-04,45315,5885,2658,0,53858
795,2019-09-05,54927,9771,1707,1,66406
795,2019-09-06,28091,7063,2642,0,37796
795,2019-09-07,90332,15270,1571,0,107173
795,2019-09-08,69462,6110,1885,0,77457
795,2019-09-09,108635,10292,1385,0,120312
795,2019-09-10,158701,6978,1623,0,167302
795,2019-09-11,98670,9075,2019,2,109766
795,2019-09-12,124350,6544,1875,1,132770
795,2019-09-13,140011,4297,1658,2,145968
795,2019-09-14,29074,7347,2038,1,38460
795,2019-09-15,34982,18800,2097,0,55879
795,2019-09-16,51067,5345,1937,1,58350
795,2019-09-17,59662,11597,2908,5795,79962
795,2019-09-18,26362,18545,1965,0,46872
795,2019-09-19,76926,2998,1170,1,81095
795,2019-09-20,74899,10792,1629,1,87321
795,2019-09-21,56128,5955,2241,2,64326
795,2019-09-22,34042,7754,1271,2,43069
795,2019-09-23,42506,8102,1533,2,52143
795,2019-09-24,42146,7800,2442,2,52390
795,2019-09-25,47555,7218,1658,2,56433
795,2019-09-26,35156,7902,1666,0,44724
795,2019-09-27,40192,12152,1715,4,54063
795,2019-09-28,37018,14032,1564,1,52615
795,2019-09-29,21952,16137,1174,1,39264
795,2019-09-30,27936,17114,2049,0,47099
795,2019-10-01,28770,14104,2011,3,44888
795,2019-10-02,24028,11260,1554,0,36842
795,2019-10-03,26682,13353,1543,0,41578
795,2019-10-04,30531,11401,1286,1,43219
795,2019-10-05,30495,13601,2160,0,46256
795,2019-10-06,26385,10967,1502,4,38858
795,2019-10-07,38263,5925,2063,3,46254
795,2019-10-08,24963,11180,1420,0,37563
795,2019-10-09,44553,22795,1676,0,69024
795,2019-10-10,80109,10996,1537,1,92643
795,2019-10-11,44663,6874,1738,1,53276
795,2019-10-12,28333,6360,1272,3,35968
795,2019-10-13,29723,8269,1642,2,39636
795,2019-10-14,52332,5432,1761,0,59525
795,2019-10-15,52011,8190,1544,2,61747
795,2019-10-16,32109,12255,1795,3,46162
795,2019-10-17,26175,5259,2077,2,33513
795,2019-10-18,25929,8120,1859,2,35910
795,2019-10-19,46445,5458,2545,0,54448
795,2019-10-20,41727,2976,1625,1,46329
795,2019-10-21,29033,9915,1600,0,40548
795,2019-10-22,40584,6841,2097,3,49525
795,2019-10-23,25308,7772,1610,3,34693
795,2019-10-24,27584,19299,1576,646,49105
795,2019-10-25,21316,18881,1472,3,41672
795,2019-10-26,19492,16654,1197,0,37343
795,2019-10-27,23268,15812,1241,1,40322
795,2019-10-28,32800,23120,1565,2,57487
795,2019-10-29,42006,17213,2226,2,61447
795,2019-10-30,33241,14701,1446,1,49389
795,2019-10-31,38004,19701,1437,1,59143
795,2019-11-01,49501,26450,1167,2,77120
795,2019-11-02,41224,16385,579,1,58189
795,2019-11-03,30392,22015,1108,0,53515
795,2019-11-04,43977,8589,2344,2,54912
795,2019-11-05,23944,2090,1336,0,27370
795,2019-11-06,35437,14166,909,4,50516
795,2019-11-07,40630,16582,1373,0,58585
795,2019-11-08,39712,9481,908,0,50101
795,2019-11-09,48547,17335,1508,0,67390
795,2019-11-10,62674,14664,1492,2,78832
795,2019-11-11,33540,9612,1956,4,45112
795,2019-11-12,38043,10298,2434,0,50775
795,2019-11-13,47563,22381,1432,1,71377
795,2019-11-14,34594,9963,1519,1,46077
795,2019-11-15,85314,3789,2786,2,91891
795,2019-11-16,56556,2125,3320,2,62003
795,2019-11-17,30862,2487,3670,0,37019
795,2019-11-18,23593,2076,4362,1,30032
795,2019-11-19,24588,4897,1569,0,31054
795,2019-11-20,26084,1798,2350,0,30232
795,2019-11-21,38321,4573,1624,3,44521
795,2019-11-22,31592,7439,1429,2,40462
795,2019-11-23,42968,6075,1744,1,50788
795,2019-11-24,40361,7251,1594,0,49206
795,2019-11-25,28808,6522,1906,0,37236
795,2019-11-26,22385,8267,1079,3,31734
795,2019-11-27,21750,6016,1941,0,29707
795,2019-11-28,26427,10730,255,1,37413
795,2019-11-29,2830,1063,1,0,3894
795,2019-08-27,0,0,720,0,720
795,2019-08-28,25682,1515,1888,1,29086
795,2019-08-29,38795,8551,1456,1,48803
795,2019-08-30,34669,2991,896,1,38557
795,2019-08-31,12196,85,1,0,12282
795,2019-09-01,12925,10,666,0,13601
795,2019-09-02,15339,6,0,0,15345
795,2019-09-03,32537,111,1480,0,34128
795,2019-09-04,45315,5885,2658,0,53858
795,2019-09-05,54927,9771,1707,1,66406
795,2019-09-06,28091,7063,2642,0,37796
795,2019-09-07,90332,15270,1571,0,107173
795,2019-09-08,69462,6110,1885,0,77457
795,2019-09-09,108635,10292,1385,0,120312
795,2019-09-10,158701,6978,1623,0,167302
795,2019-09-11,98670,9075,2019,2,109766
795,2019-09-12,124350,6544,1875,1,132770
795,2019-09-13,140011,4297,1658,2,145968
795,2019-09-14,29074,7347,2038,1,38460
795,2019-09-15,34982,18800,2097,0,55879
795,2019-09-16,51067,5345,1937,1,58350
795,2019-09-17,59662,11597,2908,5795,79962
795,2019-09-18,26362,18545,1965,0,46872
795,2019-09-19,76926,2998,1170,1,81095
795,2019-09-20,74899,10792,1629,1,87321
795,2019-09-21,56128,5955,2241,2,64326
795,2019-09-22,34042,7754,1271,2,43069
795,2019-09-23,42506,8102,1533,2,52143
795,2019-09-24,42146,7800,2442,2,52390
795,2019-09-25,47555,7218,1658,2,56433
795,2019-09-26,35156,7902,1666,0,44724
795,2019-09-27,40192,12152,1715,4,54063
795,2019-09-28,37018,14032,1564,1,52615
795,2019-09-29,21952,16137,1174,1,39264
795,2019-09-30,27936,17114,2049,0,47099
795,2019-10-01,28770,14104,2011,3,44888
795,2019-10-02,24028,11260,1554,0,36842
795,2019-10-03,26682,13353,1543,0,41578
795,2019-10-04,30531,11401,1286,1,43219
795,2019-10-05,30495,13601,2160,0,46256
795,2019-10-06,26385,10967,1502,4,38858
795,2019-10-07,38263,5925,2063,3,46254
795,2019-10-08,24963,11180,1420,0,37563
795,2019-10-09,44553,22795,1676,0,69024
795,2019-10-10,80109,10996,1537,1,92643
795,2019-10-11,44663,6874,1738,1,53276
795,2019-10-12,28333,6360,1272,3,35968
795,2019-10-13,29723,8269,1642,2,39636
795,2019-10-14,52332,5432,1761,0,59525
795,2019-10-15,52011,8190,1544,2,61747
795,2019-10-16,32109,12255,1795,3,46162
795,2019-10-17,26175,5259,2077,2,33513
795,2019-10-18,25929,8120,1859,2,35910
795,2019-10-19,46445,5458,2545,0,54448
795,2019-10-20,41727,2976,1625,1,46329
795,2019-10-21,29033,9915,1600,0,40548
795,2019-10-22,40584,6841,2097,3,49525
795,2019-10-23,25308,7772,1610,3,34693
795,2019-10-24,27584,19299,1576,646,49105
795,2019-10-25,21316,18881,1472,3,41672
795,2019-10-26,19492,16654,1197,0,37343
795,2019-10-27,23268,15812,1241,1,40322
795,2019-10-28,32800,23120,1565,2,57487
795,2019-10-29,42006,17213,2226,2,61447
795,2019-10-30,33241,14701,1446,1,49389
795,2019-10-31,38004,19701,1437,1,59143
795,2019-11-01,49501,26450,1167,2,77120
795,2019-11-02,41224,16385,579,1,58189
795,2019-11-03,30392,22015,1108,0,53515
795,2019-11-04,43977,8589,2344,2,54912
795,2019-11-05,23944,2090,1336,0,27370
795,2019-11-06,35437,14166,909,4,50516
795,2019-11-07,40630,16582,1373,0,58585
795,2019-11-08,39712,9481,908,0,50101
795,2019-11-09,48547,17335,1508,0,67390
795,2019-11-10,62674,14664,1492,2,78832
795,2019-11-11,33540,9612,1956,4,45112
795,2019-11-12,38043,10298,2434,0,50775
795,2019-11-13,47563,22381,1432,1,71377
795,2019-11-14,34594,9963,1519,1,46077
795,2019-11-15,85314,3789,2786,2,91891
795,2019-11-16,56556,2125,3320,2,62003
795,2019-11-17,30862,2487,3670,0,37019
795,2019-11-18,23593,2076,4362,1,30032
795,2019-11-19,24588,4897,1569,0,31054
795,2019-11-20,26084,1798,2350,0,30232
795,2019-11-21,38321,4573,1624,3,44521
795,2019-11-22,31592,7439,1429,2,40462
795,2019-11-23,42968,6075,1744,1,50788
795,2019-11-24,40361,7251,1594,0,49206
795,2019-11-25,28808,6522,1906,0,37236
795,2019-11-26,22385,8267,1079,3,31734
795,2019-11-27,21750,6016,1941,0,29707
795,2019-11-28,26427,10730,255,1,37413
795,2019-11-29,2830,1063,1,0,3894
795,2019-08-28,25682,1515,1888,1,29086
795,2019-08-29,38795,8551,1456,1,48803
795,2019-08-30,34669,2991,896,1,38557
795,2019-08-31,12196,85,1,0,12282
795,2019-09-01,12925,10,666,0,13601
795,2019-09-02,15339,6,0,0,15345
795,2019-09-03,32537,111,1480,0,34128
795,2019-09-04,45315,5885,2658,0,53858
795,2019-09-05,54927,9771,1707,1,66406
795,2019-09-06,28091,7063,2642,0,37796
795,2019-09-07,90332,15270,1571,0,107173
795,2019-09-08,69462,6110,1885,0,77457
795,2019-09-09,108635,10292,1385,0,120312
795,2019-09-10,158701,6978,1623,0,167302
795,2019-09-11,98670,9075,2019,2,109766
795,2019-09-12,124350,6544,1875,1,132770
795,2019-09-13,140011,4297,1658,2,145968
795,2019-09-14,29074,7347,2038,1,38460
795,2019-09-15,34982,18800,2097,0,55879
795,2019-09-16,51067,5345,1937,1,58350
795,2019-09-17,59662,11597,2908,5795,79962
795,2019-09-18,26362,18545,1965,0,46872
795,2019-09-19,76926,2998,1170,1,81095
795,2019-09-20,74899,10792,1629,1,87321
795,2019-09-21,56128,5955,2241,2,64326
795,2019-09-22,34042,7754,1271,2,43069
795,2019-09-23,42506,8102,1533,2,52143
795,2019-09-24,42146,7800,2442,2,52390
795,2019-09-25,47555,7218,1658,2,56433
795,2019-09-26,35156,7902,1666,0,44724
795,2019-09-27,40192,12152,1715,4,54063
795,2019-09-28,37018,14032,1564,1,52615
795,2019-09-29,21952,16137,1174,1,39264
795,2019-09-30,27936,17114,2049,0,47099
795,2019-10-01,28770,14104,2011,3,44888
795,2019-10-02,24028,11260,1554,0,36842
795,2019-10-03,26682,13353,1543,0,41578
795,2019-10-04,30531,11401,1286,1,43219
795,2019-10-05,30495,13601,2160,0,46256
795,2019-10-06,26385,10967,1502,4,38858
795,2019-10-07,38263,5925,2063,3,46254
795,2019-10-08,24963,11180,1420,0,37563
795,2019-10-09,44553,22795,1676,0,69024
795,2019-10-10,80109,10996,1537,1,92643
795,2019-10-11,44663,6874,1738,1,53276
795,2019-10-12,28333,6360,1272,3,35968
795,2019-10-13,29723,8269,1642,2,39636
795,2019-10-14,52332,5432,1761,0,59525
795,2019-10-15,52011,8190,1544,2,61747
795,2019-10-16,32109,12255,1795,3,46162
795,2019-10-17,26175,5259,2077,2,33513
795,2019-10-18,25929,8120,1859,2,35910
795,2019-10-19,46445,5458,2545,0,54448
795,2019-10-20,41727,2976,1625,1,46329
795,2019-10-21,29033,9915,1600,0,40548
795,2019-10-22,40584,6841,2097,3,49525
795,2019-10-23,25308,7772,1610,3,34693
795,2019-10-24,27584,19299,1576,646,49105
795,2019-10-25,21316,18881,1472,3,41672
795,2019-10-26,19492,16654,1197,0,37343
795,2019-10-27,23268,15812,1241,1,40322
795,2019-10-28,32800,23120,1565,2,57487
795,2019-10-29,42006,17213,2226,2,61447
795,2019-10-30,33241,14701,1446,1,49389
795,2019-10-31,38004,19701,1437,1,59143
795,2019-11-01,49501,26450,1167,2,77120
795,2019-11-02,41224,16385,579,1,58189
795,2019-11-03,30392,22015,1108,0,53515
795,2019-11-04,43977,8589,2344,2,54912
795,2019-11-05,23944,2090,1336,0,27370
795,2019-11-06,35437,14166,909,4,50516
795,2019-11-07,40630,16582,1373,0,58585
795,2019-11-08,39712,9481,908,0,50101
795,2019-11-09,48547,17335,1508,0,67390
795,2019-11-10,62674,14664,1492,2,78832
795,2019-11-11,33540,9612,1956,4,45112
795,2019-11-12,38043,10298,2434,0,50775
795,2019-11-13,47563,22381,1432,1,71377
795,2019-11-14,34594,9963,1519,1,46077
795,2019-11-15,85314,3789,2786,2,91891
795,2019-11-16,56556,2125,3320,2,62003
795,2019-11-17,30862,2487,3670,0,37019
795,2019-11-18,23593,2076,4362,1,30032
795,2019-11-19,24588,4897,1569,0,31054
795,2019-11-20,26084,1798,2350,0,30232
795,2019-11-21,38321,4573,1624,3,44521
795,2019-11-22,31592,7439,1429,2,40462
795,2019-11-23,42968,6075,1744,1,50788
795,2019-11-24,40361,7251,1594,0,49206
795,2019-11-25,28808,6522,1906,0,37236
795,2019-11-26,22385,8267,1079,3,31734
795,2019-11-27,21750,6016,1941,0,29707
795,2019-11-28,26427,10730,255,1,37413
796,2019-08-28,3836,1474,2160,1,7471
796,2019-08-29,3611,8636,1807,1,14055
796,2019-08-30,2318,3040,1087,2,6447
796,2019-08-31,840,54,7,0,901
796,2019-09-01,1518,1559,417,0,3494
796,2019-09-02,1566,97,100,0,1763
796,2019-09-03,3061,156,1662,3,4882
796,2019-09-04,4713,12630,2156,1,19500
796,2019-09-05,4662,9192,2459,2,16315
796,2019-09-06,4100,12096,1661,0,17857
796,2019-09-07,3717,18065,1781,0,23563
796,2019-09-08,5705,6858,2586,1,15150
796,2019-09-09,7012,14464,1725,2,23203
796,2019-09-10,4901,7929,1878,0,14708
796,2019-09-11,5068,9361,2249,2,16680
796,2019-09-12,4623,7198,2082,1,13904
796,2019-09-13,4294,7615,1592,0,13501
796,2019-09-14,3147,13575,1564,1,18287
796,2019-09-15,4064,6502,2231,0,12797
796,2019-09-16,4720,5611,1995,0,12326
796,2019-09-17,4685,9212,2325,0,16222
796,2019-09-18,4882,19780,1329,1,25992
796,2019-09-19,5200,4052,1330,1,10583
796,2019-09-20,4482,11647,1273,1,17403
796,2019-09-21,3699,8673,1711,1,14084
796,2019-09-22,3559,13441,1132,1,18133
796,2019-09-23,5422,12078,2685,1,20186
796,2019-09-24,4939,11817,2000,3,18759
796,2019-09-25,4791,7521,2096,4,14412
796,2019-09-26,4706,14270,1981,0,20957
796,2019-09-27,3392,8237,1400,2,13031
796,2019-09-28,2580,14493,1807,1,18881
796,2019-09-29,3028,14515,1785,1,19329
796,2019-09-30,3690,27293,1595,4,32582
796,2019-10-01,4008,20338,2329,0,26675
796,2019-10-02,4230,11892,2280,0,18402
796,2019-10-03,5321,22438,1947,0,29706
796,2019-10-04,3064,14885,1588,0,19537
796,2019-10-05,4175,21353,1217,1,26746
796,2019-10-06,3363,19185,1801,2,24351
796,2019-10-07,3735,5964,1664,0,11363
796,2019-10-08,3078,17640,1469,1,22188
796,2019-10-09,3147,16849,1179,1,21176
796,2019-10-10,3750,10310,2067,3,16130
796,2019-10-11,2818,9416,1986,3,14223
796,2019-10-12,4042,6943,2170,0,13155
796,2019-10-13,2877,8895,2005,0,13777
796,2019-10-14,4186,5924,1846,1,11957
796,2019-10-15,3966,8360,1456,2,13784
796,2019-10-16,3346,18253,1337,0,22936
796,2019-10-17,3074,9677,1523,0,14274
796,2019-10-18,2995,8520,1884,0,13399
796,2019-10-19,3384,5444,2051,1,10880
796,2019-10-20,4835,2909,1739,2,9485
796,2019-10-21,3386,10453,1190,0,15029
796,2019-10-22,3595,8659,2102,2,14358
796,2019-10-23,3077,8654,2212,2,13945
796,2019-10-24,2767,20015,1471,1,24254
796,2019-10-25,2893,15022,2088,3,20006
796,2019-10-26,2573,13715,1278,1,17567
796,2019-10-27,2822,16420,1325,0,20567
796,2019-10-28,2571,13881,1754,1,18207
796,2019-10-29,2977,15546,1476,0,19999
796,2019-10-30,2967,15646,1276,4,19893
796,2019-10-31,3089,12442,1588,1,17120
796,2019-11-01,2682,14416,1744,0,18842
796,2019-11-02,3048,13909,1051,1,18009
796,2019-11-03,3736,22481,1342,1,27560
796,2019-11-04,4182,8109,1655,2,13948
796,2019-11-05,4306,2941,2247,0,9494
796,2019-11-06,3711,8441,874,1,13027
796,2019-11-07,2914,13265,911,1,17091
796,2019-11-08,4042,9774,1114,2,14932
796,2019-11-09,2293,8884,1862,3,13042
796,2019-11-10,3042,17631,1111,0,21784
796,2019-11-11,4297,9558,866,2,14723
796,2019-11-12,3770,10198,2187,1,16156
796,2019-11-13,2935,14135,1876,1,18947
796,2019-11-14,3391,8650,2104,4,14149
796,2019-11-15,3936,3862,2202,479,10479
796,2019-11-16,3476,2655,2987,0,9118
796,2019-11-17,2878,2835,3466,0,9179
796,2019-11-18,3101,3035,3085,0,9221
796,2019-11-19,3070,3170,2153,3,8396
796,2019-11-20,4297,1393,1764,0,7454
796,2019-11-21,3006,5315,2013,0,10334
796,2019-11-22,2434,4463,1481,1,8379
796,2019-11-23,2165,5841,2152,1,10159
796,2019-11-24,2425,6931,1875,1,11232
796,2019-11-25,2929,6433,2134,0,11496
796,2019-11-26,1936,5069,1249,0,8254
796,2019-11-27,2543,8125,1930,0,12598
796,2019-11-28,1410,11300,463,0,13173
796,2019-11-29,154,229,2,0,385
796,2019-08-28,3836,1474,2160,1,7471
796,2019-08-29,3611,8636,1807,1,14055
796,2019-08-30,2318,3040,1087,2,6447
796,2019-08-31,840,54,7,0,901
796,2019-09-01,1518,1559,417,0,3494
796,2019-09-02,1566,97,100,0,1763
796,2019-09-03,3061,156,1662,3,4882
796,2019-09-04,4713,12630,2156,1,19500
796,2019-09-05,4662,9192,2459,2,16315
796,2019-09-06,4100,12096,1661,0,17857
796,2019-09-07,3717,18065,1781,0,23563
796,2019-09-08,5705,6858,2586,1,15150
796,2019-09-09,7012,14464,1725,2,23203
796,2019-09-10,4901,7929,1878,0,14708
796,2019-09-11,5068,9361,2249,2,16680
796,2019-09-12,4623,7198,2082,1,13904
796,2019-09-13,4294,7615,1592,0,13501
796,2019-09-14,3147,13575,1564,1,18287
796,2019-09-15,4064,6502,2231,0,12797
796,2019-09-16,4720,5611,1995,0,12326
796,2019-09-17,4685,9212,2325,0,16222
796,2019-09-18,4882,19780,1329,1,25992
796,2019-09-19,5200,4052,1330,1,10583
796,2019-09-20,4482,11647,1273,1,17403
796,2019-09-21,3699,8673,1711,1,14084
796,2019-09-22,3559,13441,1132,1,18133
796,2019-09-23,5422,12078,2685,1,20186
796,2019-09-24,4939,11817,2000,3,18759
796,2019-09-25,4791,7521,2096,4,14412
796,2019-09-26,4706,14270,1981,0,20957
796,2019-09-27,3392,8237,1400,2,13031
796,2019-09-28,2580,14493,1807,1,18881
796,2019-09-29,3028,14515,1785,1,19329
796,2019-09-30,3690,27293,1595,4,32582
796,2019-10-01,4008,20338,2329,0,26675
796,2019-10-02,4230,11892,2280,0,18402
796,2019-10-03,5321,22438,1947,0,29706
796,2019-10-04,3064,14885,1588,0,19537
796,2019-10-05,4175,21353,1217,1,26746
796,2019-10-06,3363,19185,1801,2,24351
796,2019-10-07,3735,5964,1664,0,11363
796,2019-10-08,3078,17640,1469,1,22188
796,2019-10-09,3147,16849,1179,1,21176
796,2019-10-10,3750,10310,2067,3,16130
796,2019-10-11,2818,9416,1986,3,14223
796,2019-10-12,4042,6943,2170,0,13155
796,2019-10-13,2877,8895,2005,0,13777
796,2019-10-14,4186,5924,1846,1,11957
796,2019-10-15,3966,8360,1456,2,13784
796,2019-10-16,3346,18253,1337,0,22936
796,2019-10-17,3074,9677,1523,0,14274
796,2019-10-18,2995,8520,1884,0,13399
796,2019-10-19,3384,5444,2051,1,10880
796,2019-10-20,4835,2909,1739,2,9485
796,2019-10-21,3386,10453,1190,0,15029
796,2019-10-22,3595,8659,2102,2,14358
796,2019-10-23,3077,8654,2212,2,13945
796,2019-10-24,2767,20015,1471,1,24254
796,2019-10-25,2893,15022,2088,3,20006
796,2019-10-26,2573,13715,1278,1,17567
796,2019-10-27,2822,16420,1325,0,20567
796,2019-10-28,2571,13881,1754,1,18207
796,2019-10-29,2977,15546,1476,0,19999
796,2019-10-30,2967,15646,1276,4,19893
796,2019-10-31,3089,12442,1588,1,17120
796,2019-11-01,2682,14416,1744,0,18842
796,2019-11-02,3048,13909,1051,1,18009
796,2019-11-03,3736,22481,1342,1,27560
796,2019-11-04,4182,8109,1655,2,13948
796,2019-11-05,4306,2941,2247,0,9494
796,2019-11-06,3711,8441,874,1,13027
796,2019-11-07,2914,13265,911,1,17091
796,2019-11-08,4042,9774,1114,2,14932
796,2019-11-09,2293,8884,1862,3,13042
796,2019-11-10,3042,17631,1111,0,21784
796,2019-11-11,4297,9558,866,2,14723
796,2019-11-12,3770,10198,2187,1,16156
796,2019-11-13,2935,14135,1876,1,18947
796,2019-11-14,3391,8650,2104,4,14149
796,2019-11-15,3936,3862,2202,479,10479
796,2019-11-16,3476,2655,2987,0,9118
796,2019-11-17,2878,2835,3466,0,9179
796,2019-11-18,3101,3035,3085,0,9221
796,2019-11-19,3070,3170,2153,3,8396
796,2019-11-20,4297,1393,1764,0,7454
796,2019-11-21,3006,5315,2013,0,10334
796,2019-11-22,2434,4463,1481,1,8379
796,2019-11-23,2165,5841,2152,1,10159
796,2019-11-24,2425,6931,1875,1,11232
796,2019-11-25,2929,6433,2134,0,11496
796,2019-11-26,1936,5069,1249,0,8254
796,2019-11-27,2543,8125,1930,0,12598
796,2019-11-28,1410,11300,463,0,13173
796,2019-11-29,154,229,2,0,385
796,2019-08-27,0,0,360,0,360
796,2019-08-28,3836,1474,2160,1,7471
796,2019-08-29,3611,8636,1807,1,14055
796,2019-08-30,2318,3040,1087,2,6447
796,2019-08-31,840,54,7,0,901
796,2019-09-01,1518,1559,417,0,3494
796,2019-09-02,1566,97,100,0,1763
796,2019-09-03,3061,156,1662,3,4882
796,2019-09-04,4713,12630,2156,1,19500
796,2019-09-05,4662,9192,2459,2,16315
796,2019-09-06,4100,12096,1661,0,17857
796,2019-09-07,3717,18065,1781,0,23563
796,2019-09-08,5705,6858,2586,1,15150
796,2019-09-09,7012,14464,1725,2,23203
796,2019-09-10,4901,7929,1878,0,14708
796,2019-09-11,5068,9361,2249,2,16680
796,2019-09-12,4623,7198,2082,1,13904
796,2019-09-13,4294,7615,1592,0,13501
796,2019-09-14,3147,13575,1564,1,18287
796,2019-09-15,4064,6502,2231,0,12797
796,2019-09-16,4720,5611,1995,0,12326
796,2019-09-17,4685,9212,2325,0,16222
796,2019-09-18,4882,19780,1329,1,25992
796,2019-09-19,5200,4052,1330,1,10583
796,2019-09-20,4482,11647,1273,1,17403
796,2019-09-21,3699,8673,1711,1,14084
796,2019-09-22,3559,13441,1132,1,18133
796,2019-09-23,5422,12078,2685,1,20186
796,2019-09-24,4939,11817,2000,3,18759
796,2019-09-25,4791,7521,2096,4,14412
796,2019-09-26,4706,14270,1981,0,20957
796,2019-09-27,3392,8237,1400,2,13031
796,2019-09-28,2580,14493,1807,1,18881
796,2019-09-29,3028,14515,1785,1,19329
796,2019-09-30,3690,27293,1595,4,32582
796,2019-10-01,4008,20338,2329,0,26675
796,2019-10-02,4230,11892,2280,0,18402
796,2019-10-03,5321,22438,1947,0,29706
796,2019-10-04,3064,14885,1588,0,19537
796,2019-10-05,4175,21353,1217,1,26746
796,2019-10-06,3363,19185,1801,2,24351
796,2019-10-07,3735,5964,1664,0,11363
796,2019-10-08,3078,17640,1469,1,22188
796,2019-10-09,3147,16849,1179,1,21176
796,2019-10-10,3750,10310,2067,3,16130
796,2019-10-11,2818,9416,1986,3,14223
796,2019-10-12,4042,6943,2170,0,13155
796,2019-10-13,2877,8895,2005,0,13777
796,2019-10-14,4186,5924,1846,1,11957
796,2019-10-15,3966,8360,1456,2,13784
796,2019-10-16,3346,18253,1337,0,22936
796,2019-10-17,3074,9677,1523,0,14274
796,2019-10-18,2995,8520,1884,0,13399
796,2019-10-19,3384,5444,2051,1,10880
796,2019-10-20,4835,2909,1739,2,9485
796,2019-10-21,3386,10453,1190,0,15029
796,2019-10-22,3595,8659,2102,2,14358
796,2019-10-23,3077,8654,2212,2,13945
796,2019-10-24,2767,20015,1471,1,24254
796,2019-10-25,2893,15022,2088,3,20006
796,2019-10-26,2573,13715,1278,1,17567
796,2019-10-27,2822,16420,1325,0,20567
796,2019-10-28,2571,13881,1754,1,18207
796,2019-10-29,2977,15546,1476,0,19999
796,2019-10-30,2967,15646,1276,4,19893
796,2019-10-31,3089,12442,1588,1,17120
796,2019-11-01,2682,14416,1744,0,18842
796,2019-11-02,3048,13909,1051,1,18009
796,2019-11-03,3736,22481,1342,1,27560
796,2019-11-04,4182,8109,1655,2,13948
796,2019-11-05,4306,2941,2247,0,9494
796,2019-11-06,3711,8441,874,1,13027
796,2019-11-07,2914,13265,911,1,17091
796,2019-11-08,4042,9774,1114,2,14932
796,2019-11-09,2293,8884,1862,3,13042
796,2019-11-10,3042,17631,1111,0,21784
796,2019-11-11,4297,9558,866,2,14723
796,2019-11-12,3770,10198,2187,1,16156
796,2019-11-13,2935,14135,1876,1,18947
796,2019-11-14,3391,8650,2104,4,14149
796,2019-11-15,3936,3862,2202,479,10479
796,2019-11-16,3476,2655,2987,0,9118
796,2019-11-17,2878,2835,3466,0,9179
796,2019-11-18,3101,3035,3085,0,9221
796,2019-11-19,3070,3170,2153,3,8396
796,2019-11-20,4297,1393,1764,0,7454
796,2019-11-21,3006,5315,2013,0,10334
796,2019-11-22,2434,4463,1481,1,8379
796,2019-11-23,2165,5841,2152,1,10159
796,2019-11-24,2425,6931,1875,1,11232
796,2019-11-25,2929,6433,2134,0,11496
796,2019-11-26,1936,5069,1249,0,8254
796,2019-11-27,2543,8125,1930,0,12598
796,2019-11-28,1410,11300,463,0,13173
796,2019-11-29,154,229,2,0,385
796,2019-08-28,3836,1474,2160,1,7471
796,2019-08-29,3611,8636,1807,1,14055
796,2019-08-30,2318,3040,1087,2,6447
796,2019-08-31,840,54,7,0,901
796,2019-09-01,1518,1559,417,0,3494
796,2019-09-02,1566,97,100,0,1763
796,2019-09-03,3061,156,1662,3,4882
796,2019-09-04,4713,12630,2156,1,19500
796,2019-09-05,4662,9192,2459,2,16315
796,2019-09-06,4100,12096,1661,0,17857
796,2019-09-07,3717,18065,1781,0,23563
796,2019-09-08,5705,6858,2586,1,15150
796,2019-09-09,7012,14464,1725,2,23203
796,2019-09-10,4901,7929,1878,0,14708
796,2019-09-11,5068,9361,2249,2,16680
796,2019-09-12,4623,7198,2082,1,13904
796,2019-09-13,4294,7615,1592,0,13501
796,2019-09-14,3147,13575,1564,1,18287
796,2019-09-15,4064,6502,2231,0,12797
796,2019-09-16,4720,5611,1995,0,12326
796,2019-09-17,4685,9212,2325,0,16222
796,2019-09-18,4882,19780,1329,1,25992
796,2019-09-19,5200,4052,1330,1,10583
796,2019-09-20,4482,11647,1273,1,17403
796,2019-09-21,3699,8673,1711,1,14084
796,2019-09-22,3559,13441,1132,1,18133
796,2019-09-23,5422,12078,2685,1,20186
796,2019-09-24,4939,11817,2000,3,18759
796,2019-09-25,4791,7521,2096,4,14412
796,2019-09-26,4706,14270,1981,0,20957
796,2019-09-27,3392,8237,1400,2,13031
796,2019-09-28,2580,14493,1807,1,18881
796,2019-09-29,3028,14515,1785,1,19329
796,2019-09-30,3690,27293,1595,4,32582
796,2019-10-01,4008,20338,2329,0,26675
796,2019-10-02,4230,11892,2280,0,18402
796,2019-10-03,5321,22438,1947,0,29706
796,2019-10-04,3064,14885,1588,0,19537
796,2019-10-05,4175,21353,1217,1,26746
796,2019-10-06,3363,19185,1801,2,24351
796,2019-10-07,3735,5964,1664,0,11363
796,2019-10-08,3078,17640,1469,1,22188
796,2019-10-09,3147,16849,1179,1,21176
796,2019-10-10,3750,10310,2067,3,16130
796,2019-10-11,2818,9416,1986,3,14223
796,2019-10-12,4042,6943,2170,0,13155
796,2019-10-13,2877,8895,2005,0,13777
796,2019-10-14,4186,5924,1846,1,11957
796,2019-10-15,3966,8360,1456,2,13784
796,2019-10-16,3346,18253,1337,0,22936
796,2019-10-17,3074,9677,1523,0,14274
796,2019-10-18,2995,8520,1884,0,13399
796,2019-10-19,3384,5444,2051,1,10880
796,2019-10-20,4835,2909,1739,2,9485
796,2019-10-21,3386,10453,1190,0,15029
796,2019-10-22,3595,8659,2102,2,14358
796,2019-10-23,3077,8654,2212,2,13945
796,2019-10-24,2767,20015,1471,1,24254
796,2019-10-25,2893,15022,2088,3,20006
796,2019-10-26,2573,13715,1278,1,17567
796,2019-10-27,2822,16420,1325,0,20567
796,2019-10-28,2571,13881,1754,1,18207
796,2019-10-29,2977,15546,1476,0,19999
796,2019-10-30,2967,15646,1276,4,19893
796,2019-10-31,3089,12442,1588,1,17120
796,2019-11-01,2682,14416,1744,0,18842
796,2019-11-02,3048,13909,1051,1,18009
796,2019-11-03,3736,22481,1342,1,27560
796,2019-11-04,4182,8109,1655,2,13948
796,2019-11-05,4306,2941,2247,0,9494
796,2019-11-06,3711,8441,874,1,13027
796,2019-11-07,2914,13265,911,1,17091
796,2019-11-08,4042,9774,1114,2,14932
796,2019-11-09,2293,8884,1862,3,13042
796,2019-11-10,3042,17631,1111,0,21784
796,2019-11-11,4297,9558,866,2,14723
796,2019-11-12,3770,10198,2187,1,16156
796,2019-11-13,2935,14135,1876,1,18947
796,2019-11-14,3391,8650,2104,4,14149
796,2019-11-15,3936,3862,2202,479,10479
796,2019-11-16,3476,2655,2987,0,9118
796,2019-11-17,2878,2835,3466,0,9179
796,2019-11-18,3101,3035,3085,0,9221
796,2019-11-19,3070,3170,2153,3,8396
796,2019-11-20,4297,1393,1764,0,7454
796,2019-11-21,3006,5315,2013,0,10334
796,2019-11-22,2434,4463,1481,1,8379
796,2019-11-23,2165,5841,2152,1,10159
796,2019-11-24,2425,6931,1875,1,11232
797,2019-08-28,291,1871,1800,1,3963
797,2019-08-29,311,9700,1048,0,11059
797,2019-08-30,1909,3045,187,1,5142
797,2019-08-31,78,190,3,0,271
797,2019-09-01,250,47,180,0,477
797,2019-09-02,235,261,195,0,691
797,2019-09-03,240,3230,1790,1,5261
797,2019-09-04,364,11601,2166,1,14132
797,2019-09-05,1125,9004,1537,0,11666
797,2019-09-06,1727,11744,2046,0,15517
797,2019-09-07,912,16146,1567,0,18625
797,2019-09-08,1679,6626,1753,0,10058
797,2019-09-09,1584,19487,2255,0,23326
797,2019-09-10,1143,12783,2273,0,16199
797,2019-09-11,988,5859,1405,1,8253
797,2019-09-12,1530,6611,1736,0,9877
797,2019-09-13,649,4739,2251,1,7640
797,2019-09-14,375,6541,1941,2,8859
797,2019-09-15,356,10752,2292,0,13400
797,2019-09-16,431,5405,2353,1,8190
797,2019-09-17,417,13264,1743,0,15424
797,2019-09-18,1192,30874,1257,0,33323
797,2019-09-19,1517,12809,1532,0,15858
797,2019-09-20,532,16051,1657,0,18240
797,2019-09-21,276,9318,1704,0,11298
797,2019-09-22,2089,10042,1442,2,13575
797,2019-09-23,1355,10119,1442,1,12917
797,2019-09-24,1187,9004,2061,3,12255
797,2019-09-25,311,7901,1629,2,9843
797,2019-09-26,255,10613,1402,4,12274
797,2019-09-27,696,8619,1635,1,10951
797,2019-09-28,305,14715,1452,3,16475
797,2019-09-29,247,17555,2007,2,19811
797,2019-09-30,345,17070,1496,0,18911
797,2019-10-01,346,15596,1509,1,17452
797,2019-10-02,426,11166,1156,0,12748
797,2019-10-03,852,14518,1987,1,17358
797,2019-10-04,697,14664,1068,1,16430
797,2019-10-05,408,14791,1394,0,16593
797,2019-10-06,1137,13099,2343,2,16581
797,2019-10-07,1268,7119,1901,1,10289
797,2019-10-08,824,12533,2005,1,15363
797,2019-10-09,614,24188,911,0,25713
797,2019-10-10,306,11867,1691,0,13864
797,2019-10-11,300,10224,1014,3,11541
797,2019-10-12,340,7254,1706,0,9300
797,2019-10-13,393,9824,1381,0,11598
797,2019-10-14,1045,5328,2240,1,8614
797,2019-10-15,368,8840,2037,2,11247
797,2019-10-16,276,13120,1681,3,15080
797,2019-10-17,2058,5898,1309,1,9266
797,2019-10-18,220,8524,1868,0,10612
797,2019-10-19,243,5720,1851,2,7816
797,2019-10-20,292,4040,1651,0,5983
797,2019-10-21,267,10888,1997,4,13156
797,2019-10-22,1170,6776,1784,1,9731
797,2019-10-23,297,9765,1531,1,11594
797,2019-10-24,630,20602,1265,1,22498
797,2019-10-25,314,15128,1727,1,17170
797,2019-10-26,284,13990,2096,1,16371
797,2019-10-27,425,28806,1271,1,30503
797,2019-10-28,388,25673,2435,0,28496
797,2019-10-29,265,17975,1467,1,19708
797,2019-10-30,523,24134,1342,2,26001
797,2019-10-31,1179,15136,2740,2,19057
797,2019-11-01,152,25614,1077,0,26843
797,2019-11-02,1034,16993,1426,0,19453
797,2019-11-03,3263,37927,1214,0,42404
797,2019-11-04,238,11402,1558,0,13198
797,2019-11-05,1164,3145,1465,1,5775
797,2019-11-06,184,16011,1281,1,17477
797,2019-11-07,786,17223,921,1,18931
797,2019-11-08,212,10365,1353,0,11930
797,2019-11-09,365,9322,1905,0,11592
797,2019-11-10,241,14523,820,775,16359
797,2019-11-11,256,10132,1136,2,11526
797,2019-11-12,262,10421,2981,0,13664
797,2019-11-13,850,15519,1853,572,18794
797,2019-11-14,204,8549,2256,2,11011
797,2019-11-15,220,3983,2374,1,6578
797,2019-11-16,265,3983,2197,1,6446
797,2019-11-17,357,2854,3464,0,6675
797,2019-11-18,355,3316,2594,2,6267
797,2019-11-19,1184,5165,2677,1,9027
797,2019-11-20,289,1670,2607,3,4569
797,2019-11-21,270,5490,2328,0,8088
797,2019-11-22,227,4940,1214,3,6384
797,2019-11-23,281,9938,1802,143,12164
797,2019-11-24,347,9139,1877,1,11364
797,2019-11-25,790,11407,1937,1,14135
797,2019-11-26,298,10012,1276,0,11586
797,2019-11-27,182,9426,2128,2,11738
797,2019-11-28,164,11927,536,0,12627
797,2019-11-29,36,1030,10,0,1076
797,2019-08-28,291,1871,1800,1,3963
797,2019-08-29,311,9700,1048,0,11059
797,2019-08-30,1909,3045,187,1,5142
797,2019-08-31,78,190,3,0,271
797,2019-09-01,250,47,180,0,477
797,2019-09-02,235,261,195,0,691
797,2019-09-03,240,3230,1790,1,5261
797,2019-09-04,364,11601,2166,1,14132
797,2019-09-05,1125,9004,1537,0,11666
797,2019-09-06,1727,11744,2046,0,15517
797,2019-09-07,912,16146,1567,0,18625
797,2019-09-08,1679,6626,1753,0,10058
797,2019-09-09,1584,19487,2255,0,23326
797,2019-09-10,1143,12783,2273,0,16199
797,2019-09-11,988,5859,1405,1,8253
797,2019-09-12,1530,6611,1736,0,9877
797,2019-09-13,649,4739,2251,1,7640
797,2019-09-14,375,6541,1941,2,8859
797,2019-09-15,356,10752,2292,0,13400
797,2019-09-16,431,5405,2353,1,8190
797,2019-09-17,417,13264,1743,0,15424
797,2019-09-18,1192,30874,1257,0,33323
797,2019-09-19,1517,12809,1532,0,15858
797,2019-09-20,532,16051,1657,0,18240
797,2019-09-21,276,9318,1704,0,11298
797,2019-09-22,2089,10042,1442,2,13575
797,2019-09-23,1355,10119,1442,1,12917
797,2019-09-24,1187,9004,2061,3,12255
797,2019-09-25,311,7901,1629,2,9843
797,2019-09-26,255,10613,1402,4,12274
797,2019-09-27,696,8619,1635,1,10951
797,2019-09-28,305,14715,1452,3,16475
797,2019-09-29,247,17555,2007,2,19811
797,2019-09-30,345,17070,1496,0,18911
797,2019-10-01,346,15596,1509,1,17452
797,2019-10-02,426,11166,1156,0,12748
797,2019-10-03,852,14518,1987,1,17358
797,2019-10-04,697,14664,1068,1,16430
797,2019-10-05,408,14791,1394,0,16593
797,2019-10-06,1137,13099,2343,2,16581
797,2019-10-07,1268,7119,1901,1,10289
797,2019-10-08,824,12533,2005,1,15363
797,2019-10-09,614,24188,911,0,25713
797,2019-10-10,306,11867,1691,0,13864
797,2019-10-11,300,10224,1014,3,11541
797,2019-10-12,340,7254,1706,0,9300
797,2019-10-13,393,9824,1381,0,11598
797,2019-10-14,1045,5328,2240,1,8614
797,2019-10-15,368,8840,2037,2,11247
797,2019-10-16,276,13120,1681,3,15080
797,2019-10-17,2058,5898,1309,1,9266
797,2019-10-18,220,8524,1868,0,10612
797,2019-10-19,243,5720,1851,2,7816
797,2019-10-20,292,4040,1651,0,5983
797,2019-10-21,267,10888,1997,4,13156
797,2019-10-22,1170,6776,1784,1,9731
797,2019-10-23,297,9765,1531,1,11594
797,2019-10-24,630,20602,1265,1,22498
797,2019-10-25,314,15128,1727,1,17170
797,2019-10-26,284,13990,2096,1,16371
797,2019-10-27,425,28806,1271,1,30503
797,2019-10-28,388,25673,2435,0,28496
797,2019-10-29,265,17975,1467,1,19708
797,2019-10-30,523,24134,1342,2,26001
797,2019-10-31,1179,15136,2740,2,19057
797,2019-11-01,152,25614,1077,0,26843
797,2019-11-02,1034,16993,1426,0,19453
797,2019-11-03,3263,37927,1214,0,42404
797,2019-11-04,238,11402,1558,0,13198
797,2019-11-05,1164,3145,1465,1,5775
797,2019-11-06,184,16011,1281,1,17477
797,2019-11-07,786,17223,921,1,18931
797,2019-11-08,212,10365,1353,0,11930
797,2019-11-09,365,9322,1905,0,11592
797,2019-11-10,241,14523,820,775,16359
797,2019-11-11,256,10132,1136,2,11526
797,2019-11-12,262,10421,2981,0,13664
797,2019-11-13,850,15519,1853,572,18794
797,2019-11-14,204,8549,2256,2,11011
797,2019-11-15,220,3983,2374,1,6578
797,2019-11-16,265,3983,2197,1,6446
797,2019-11-17,357,2854,3464,0,6675
797,2019-11-18,355,3316,2594,2,6267
797,2019-11-19,1184,5165,2677,1,9027
797,2019-11-20,289,1670,2607,3,4569
797,2019-11-21,270,5490,2328,0,8088
797,2019-11-22,227,4940,1214,3,6384
797,2019-11-23,281,9938,1802,143,12164
797,2019-11-24,347,9139,1877,1,11364
797,2019-11-25,790,11407,1937,1,14135
797,2019-11-26,298,10012,1276,0,11586
797,2019-11-27,182,9426,2128,2,11738
797,2019-11-28,164,11927,536,0,12627
797,2019-11-29,36,1030,10,0,1076
797,2019-08-27,0,0,270,0,270
797,2019-08-28,291,1871,1800,1,3963
797,2019-08-29,311,9700,1048,0,11059
797,2019-08-30,1909,3045,187,1,5142
797,2019-08-31,78,190,3,0,271
797,2019-09-01,250,47,180,0,477
797,2019-09-02,235,261,195,0,691
797,2019-09-03,240,3230,1790,1,5261
797,2019-09-04,364,11601,2166,1,14132
797,2019-09-05,1125,9004,1537,0,11666
797,2019-09-06,1727,11744,2046,0,15517
797,2019-09-07,912,16146,1567,0,18625
797,2019-09-08,1679,6626,1753,0,10058
797,2019-09-09,1584,19487,2255,0,23326
797,2019-09-10,1143,12783,2273,0,16199
797,2019-09-11,988,5859,1405,1,8253
797,2019-09-12,1530,6611,1736,0,9877
797,2019-09-13,649,4739,2251,1,7640
797,2019-09-14,375,6541,1941,2,8859
797,2019-09-15,356,10752,2292,0,13400
797,2019-09-16,431,5405,2353,1,8190
797,2019-09-17,417,13264,1743,0,15424
797,2019-09-18,1192,30874,1257,0,33323
797,2019-09-19,1517,12809,1532,0,15858
797,2019-09-20,532,16051,1657,0,18240
797,2019-09-21,276,9318,1704,0,11298
797,2019-09-22,2089,10042,1442,2,13575
797,2019-09-23,1355,10119,1442,1,12917
797,2019-09-24,1187,9004,2061,3,12255
797,2019-09-25,311,7901,1629,2,9843
797,2019-09-26,255,10613,1402,4,12274
797,2019-09-27,696,8619,1635,1,10951
797,2019-09-28,305,14715,1452,3,16475
797,2019-09-29,247,17555,2007,2,19811
797,2019-09-30,345,17070,1496,0,18911
797,2019-10-01,346,15596,1509,1,17452
797,2019-10-02,426,11166,1156,0,12748
797,2019-10-03,852,14518,1987,1,17358
797,2019-10-04,697,14664,1068,1,16430
797,2019-10-05,408,14791,1394,0,16593
797,2019-10-06,1137,13099,2343,2,16581
797,2019-10-07,1268,7119,1901,1,10289
797,2019-10-08,824,12533,2005,1,15363
797,2019-10-09,614,24188,911,0,25713
797,2019-10-10,306,11867,1691,0,13864
797,2019-10-11,300,10224,1014,3,11541
797,2019-10-12,340,7254,1706,0,9300
797,2019-10-13,393,9824,1381,0,11598
797,2019-10-14,1045,5328,2240,1,8614
797,2019-10-15,368,8840,2037,2,11247
797,2019-10-16,276,13120,1681,3,15080
797,2019-10-17,2058,5898,1309,1,9266
797,2019-10-18,220,8524,1868,0,10612
797,2019-10-19,243,5720,1851,2,7816
797,2019-10-20,292,4040,1651,0,5983
797,2019-10-21,267,10888,1997,4,13156
797,2019-10-22,1170,6776,1784,1,9731
797,2019-10-23,297,9765,1531,1,11594
797,2019-10-24,630,20602,1265,1,22498
797,2019-10-25,314,15128,1727,1,17170
797,2019-10-26,284,13990,2096,1,16371
797,2019-10-27,425,28806,1271,1,30503
797,2019-10-28,388,25673,2435,0,28496
797,2019-10-29,265,17975,1467,1,19708
797,2019-10-30,523,24134,1342,2,26001
797,2019-10-31,1179,15136,2740,2,19057
797,2019-11-01,152,25614,1077,0,26843
797,2019-11-02,1034,16993,1426,0,19453
797,2019-11-03,3263,37927,1214,0,42404
797,2019-11-04,238,11402,1558,0,13198
797,2019-11-05,1164,3145,1465,1,5775
797,2019-11-06,184,16011,1281,1,17477
797,2019-11-07,786,17223,921,1,18931
797,2019-11-08,212,10365,1353,0,11930
797,2019-11-09,365,9322,1905,0,11592
797,2019-11-10,241,14523,820,775,16359
797,2019-11-11,256,10132,1136,2,11526
797,2019-11-12,262,10421,2981,0,13664
797,2019-11-13,850,15519,1853,572,18794
797,2019-11-14,204,8549,2256,2,11011
797,2019-11-15,220,3983,2374,1,6578
797,2019-11-16,265,3983,2197,1,6446
797,2019-11-17,357,2854,3464,0,6675
797,2019-11-18,355,3316,2594,2,6267
797,2019-11-19,1184,5165,2677,1,9027
797,2019-11-20,289,1670,2607,3,4569
797,2019-11-21,270,5490,2328,0,8088
797,2019-11-22,227,4940,1214,3,6384
797,2019-11-23,281,9938,1802,143,12164
797,2019-11-24,347,9139,1877,1,11364
797,2019-11-25,790,11407,1937,1,14135
797,2019-11-26,298,10012,1276,0,11586
797,2019-11-27,182,9426,2128,2,11738
797,2019-11-28,164,11927,536,0,12627
797,2019-11-29,36,1030,10,0,1076
797,2019-08-28,291,1871,1800,1,3963
797,2019-08-29,311,9700,1048,0,11059
797,2019-08-30,1909,3045,187,1,5142
797,2019-08-31,78,190,3,0,271
797,2019-09-01,250,47,180,0,477
797,2019-09-02,235,261,195,0,691
797,2019-09-03,240,3230,1790,1,5261
797,2019-09-04,364,11601,2166,1,14132
797,2019-09-05,1125,9004,1537,0,11666
797,2019-09-06,1727,11744,2046,0,15517
797,2019-09-07,912,16146,1567,0,18625
797,2019-09-08,1679,6626,1753,0,10058
797,2019-09-09,1584,19487,2255,0,23326
797,2019-09-10,1143,12783,2273,0,16199
797,2019-09-11,988,5859,1405,1,8253
797,2019-09-12,1530,6611,1736,0,9877
797,2019-09-13,649,4739,2251,1,7640
797,2019-09-14,375,6541,1941,2,8859
797,2019-09-15,356,10752,2292,0,13400
797,2019-09-16,431,5405,2353,1,8190
797,2019-09-17,417,13264,1743,0,15424
797,2019-09-18,1192,30874,1257,0,33323
797,2019-09-19,1517,12809,1532,0,15858
797,2019-09-20,532,16051,1657,0,18240
797,2019-09-21,276,9318,1704,0,11298
797,2019-09-22,2089,10042,1442,2,13575
797,2019-09-23,1355,10119,1442,1,12917
797,2019-09-24,1187,9004,2061,3,12255
797,2019-09-25,311,7901,1629,2,9843
797,2019-09-26,255,10613,1402,4,12274
797,2019-09-27,696,8619,1635,1,10951
797,2019-09-28,305,14715,1452,3,16475
797,2019-09-29,247,17555,2007,2,19811
797,2019-09-30,345,17070,1496,0,18911
797,2019-10-01,346,15596,1509,1,17452
797,2019-10-02,426,11166,1156,0,12748
797,2019-10-03,852,14518,1987,1,17358
797,2019-10-04,697,14664,1068,1,16430
797,2019-10-05,408,14791,1394,0,16593
797,2019-10-06,1137,13099,2343,2,16581
797,2019-10-07,1268,7119,1901,1,10289
797,2019-10-08,824,12533,2005,1,15363
797,2019-10-09,614,24188,911,0,25713
797,2019-10-10,306,11867,1691,0,13864
797,2019-10-11,300,10224,1014,3,11541
797,2019-10-12,340,7254,1706,0,9300
797,2019-10-13,393,9824,1381,0,11598
797,2019-10-14,1045,5328,2240,1,8614
797,2019-10-15,368,8840,2037,2,11247
797,2019-10-16,276,13120,1681,3,15080
797,2019-10-17,2058,5898,1309,1,9266
797,2019-10-18,220,8524,1868,0,10612
797,2019-10-19,243,5720,1851,2,7816
797,2019-10-20,292,4040,1651,0,5983
797,2019-10-21,267,10888,1997,4,13156
797,2019-10-22,1170,6776,1784,1,9731
797,2019-10-23,297,9765,1531,1,11594
797,2019-10-24,630,20602,1265,1,22498
797,2019-10-25,314,15128,1727,1,17170
797,2019-10-26,284,13990,2096,1,16371
797,2019-10-27,425,28806,1271,1,30503
797,2019-10-28,388,25673,2435,0,28496
797,2019-10-29,265,17975,1467,1,19708
797,2019-10-30,523,24134,1342,2,26001
797,2019-10-31,1179,15136,2740,2,19057
797,2019-11-01,152,25614,1077,0,26843
797,2019-11-02,1034,16993,1426,0,19453
797,2019-11-03,3263,37927,1214,0,42404
797,2019-11-04,238,11402,1558,0,13198
797,2019-11-05,1164,3145,1465,1,5775
797,2019-11-06,184,16011,1281,1,17477
797,2019-11-07,786,17223,921,1,18931
797,2019-11-08,212,10365,1353,0,11930
797,2019-11-09,365,9322,1905,0,11592
797,2019-11-10,241,14523,820,775,16359
797,2019-11-11,256,10132,1136,2,11526
797,2019-11-12,262,10421,2981,0,13664
797,2019-11-13,850,15519,1853,572,18794
797,2019-11-14,204,8549,2256,2,11011
797,2019-11-15,220,3983,2374,1,6578
797,2019-11-16,265,3983,2197,1,6446
797,2019-11-17,357,2854,3464,0,6675
797,2019-11-18,355,3316,2594,2,6267
797,2019-11-19,1184,5165,2677,1,9027
797,2019-11-20,289,1670,2607,3,4569
797,2019-11-21,270,5490,2328,0,8088
797,2019-11-22,227,4940,1214,3,6384
797,2019-11-23,281,9938,1802,143,12164
797,2019-11-24,347,9139,1877,1,11364
797,2019-11-25,790,11407,1937,1,14135
797,2019-11-26,298,10012,1276,0,11586
797,2019-11-27,182,9426,2128,2,11738
798,2019-08-28,150,1722,1658,0,3530
798,2019-08-29,266,9762,1542,0,11570
798,2019-08-30,266,2929,640,0,3835
798,2019-08-31,44,276,0,0,320
798,2019-09-01,156,149,360,0,665
798,2019-09-02,122,1134,31,0,1287
798,2019-09-03,158,1058,1209,1,2426
798,2019-09-04,206,12605,1780,2,14593
798,2019-09-05,1121,5207,2561,2,8891
798,2019-09-06,1083,16991,2118,1450,21642
798,2019-09-07,266,14132,1501,1,15900
798,2019-09-08,256,7729,2111,1,10097
798,2019-09-09,1045,23679,1499,1,26224
798,2019-09-10,251,12151,2029,1,14432
798,2019-09-11,1009,9205,1268,2,11484
798,2019-09-12,150,15982,2421,4,18557
798,2019-09-13,146,5320,1827,3,7296
798,2019-09-14,187,7361,1933,2,9483
798,2019-09-15,1051,12289,2495,1,15836
798,2019-09-16,154,9363,1835,4,11356
798,2019-09-17,1043,6953,2265,7,10268
798,2019-09-18,1118,19913,1762,9,22802
798,2019-09-19,257,4714,1439,11,6421
798,2019-09-20,309,17783,2082,9,20183
798,2019-09-21,166,10086,2046,9,12307
798,2019-09-22,109,15322,1343,8,16782
798,2019-09-23,1078,13420,1975,10,16483
798,2019-09-24,1010,12527,1998,15,15550
798,2019-09-25,147,8266,1839,13,10265
798,2019-09-26,1000,13533,2000,11,16544
798,2019-09-27,133,10095,2310,4,12542
798,2019-09-28,140,33858,2250,4,36252
798,2019-09-29,1238,32510,1045,3,34796
798,2019-09-30,193,28330,1836,4,30363
798,2019-10-01,118,28930,1406,2,30456
798,2019-10-02,1656,18822,1763,6,22247
798,2019-10-03,824,23439,1086,10,25359
798,2019-10-04,1524,14383,1084,12,17003
798,2019-10-05,442,21484,1191,14,23131
798,2019-10-06,615,17370,1351,10,19346
798,2019-10-07,998,5854,1773,12,8637
798,2019-10-08,897,18141,998,13,20049
798,2019-10-09,889,16620,1459,13,18981
798,2019-10-10,831,10386,2266,12,13495
798,2019-10-11,129,14507,1152,9,15797
798,2019-10-12,896,9092,2127,72,12187
798,2019-10-13,547,9066,1164,3,10780
798,2019-10-14,1029,5857,2279,1,9166
798,2019-10-15,450,8444,1943,1,10838
798,2019-10-16,170,19149,1504,4,20827
798,2019-10-17,152,8989,1468,2,10611
798,2019-10-18,1010,15354,1335,3,17702
798,2019-10-19,133,8695,2387,2,11217
798,2019-10-20,1018,2994,1427,0,5439
798,2019-10-21,1124,10737,780,1,12642
798,2019-10-22,190,6557,2128,3,8878
798,2019-10-23,225,8840,1697,3,10765
798,2019-10-24,342,20491,1989,3,22825
798,2019-10-25,320,19106,1232,40,20698
798,2019-10-26,1560,17915,1566,0,21041
798,2019-10-27,364,16548,1286,1,18199
798,2019-10-28,1141,14446,1344,0,16931
798,2019-10-29,727,16030,1514,2,18273
798,2019-10-30,1485,15948,1176,1,18610
798,2019-10-31,539,20929,1753,1,23222
798,2019-11-01,287,26713,1265,0,28265
798,2019-11-02,321,16616,1396,4,18337
798,2019-11-03,2113,23145,1288,2,26548
798,2019-11-04,384,8152,1399,1,9936
798,2019-11-05,345,3396,1551,0,5292
798,2019-11-06,1300,14693,1282,0,17275
798,2019-11-07,356,16642,1072,4,18074
798,2019-11-08,290,9856,1401,1,11548
798,2019-11-09,861,9094,1364,0,11319
798,2019-11-10,271,24836,1307,0,26414
798,2019-11-11,395,17232,1090,0,18717
798,2019-11-12,274,17624,2982,3,20883
798,2019-11-13,787,22454,1756,4,25001
798,2019-11-14,275,10578,1694,1,12548
798,2019-11-15,1181,3922,1945,0,7048
798,2019-11-16,3908,3421,2460,1,9790
798,2019-11-17,1278,2901,3263,3,7445
798,2019-11-18,297,3146,2789,46,6278
798,2019-11-19,319,5209,2673,1,8202
798,2019-11-20,599,1573,1824,0,3996
798,2019-11-21,330,3433,1590,2,5355
798,2019-11-22,280,4795,1717,3,6795
798,2019-11-23,501,6204,1908,1,8614
798,2019-11-24,381,5528,1384,0,7293
798,2019-11-25,250,6699,1877,0,8826
798,2019-11-26,265,5840,1192,0,7297
798,2019-11-27,563,6432,1181,2,8178
798,2019-11-28,339,11064,857,1,12261
798,2019-11-29,99,462,1,0,562
798,2019-08-28,150,1722,1658,0,3530
798,2019-08-29,266,9762,1542,0,11570
798,2019-08-30,266,2929,640,0,3835
798,2019-08-31,44,276,0,0,320
798,2019-09-01,156,149,360,0,665
798,2019-09-02,122,1134,31,0,1287
798,2019-09-03,158,1058,1209,1,2426
798,2019-09-04,206,12605,1780,2,14593
798,2019-09-05,1121,5207,2561,2,8891
798,2019-09-06,1083,16991,2118,1450,21642
798,2019-09-07,266,14132,1501,1,15900
798,2019-09-08,256,7729,2111,1,10097
798,2019-09-09,1045,23679,1499,1,26224
798,2019-09-10,251,12151,2029,1,14432
798,2019-09-11,1009,9205,1268,2,11484
798,2019-09-12,150,15982,2421,4,18557
798,2019-09-13,146,5320,1827,3,7296
798,2019-09-14,187,7361,1933,2,9483
798,2019-09-15,1051,12289,2495,1,15836
798,2019-09-16,154,9363,1835,4,11356
798,2019-09-17,1043,6953,2265,7,10268
798,2019-09-18,1118,19913,1762,9,22802
798,2019-09-19,257,4714,1439,11,6421
798,2019-09-20,309,17783,2082,9,20183
798,2019-09-21,166,10086,2046,9,12307
798,2019-09-22,109,15322,1343,8,16782
798,2019-09-23,1078,13420,1975,10,16483
798,2019-09-24,1010,12527,1998,15,15550
798,2019-09-25,147,8266,1839,13,10265
798,2019-09-26,1000,13533,2000,11,16544
798,2019-09-27,133,10095,2310,4,12542
798,2019-09-28,140,33858,2250,4,36252
798,2019-09-29,1238,32510,1045,3,34796
798,2019-09-30,193,28330,1836,4,30363
798,2019-10-01,118,28930,1406,2,30456
798,2019-10-02,1656,18822,1763,6,22247
798,2019-10-03,824,23439,1086,10,25359
798,2019-10-04,1524,14383,1084,12,17003
798,2019-10-05,442,21484,1191,14,23131
798,2019-10-06,615,17370,1351,10,19346
798,2019-10-07,998,5854,1773,12,8637
798,2019-10-08,897,18141,998,13,20049
798,2019-10-09,889,16620,1459,13,18981
798,2019-10-10,831,10386,2266,12,13495
798,2019-10-11,129,14507,1152,9,15797
798,2019-10-12,896,9092,2127,72,12187
798,2019-10-13,547,9066,1164,3,10780
798,2019-10-14,1029,5857,2279,1,9166
798,2019-10-15,450,8444,1943,1,10838
798,2019-10-16,170,19149,1504,4,20827
798,2019-10-17,152,8989,1468,2,10611
798,2019-10-18,1010,15354,1335,3,17702
798,2019-10-19,133,8695,2387,2,11217
798,2019-10-20,1018,2994,1427,0,5439
798,2019-10-21,1124,10737,780,1,12642
798,2019-10-22,190,6557,2128,3,8878
798,2019-10-23,225,8840,1697,3,10765
798,2019-10-24,342,20491,1989,3,22825
798,2019-10-25,320,19106,1232,40,20698
798,2019-10-26,1560,17915,1566,0,21041
798,2019-10-27,364,16548,1286,1,18199
798,2019-10-28,1141,14446,1344,0,16931
798,2019-10-29,727,16030,1514,2,18273
798,2019-10-30,1485,15948,1176,1,18610
798,2019-10-31,539,20929,1753,1,23222
798,2019-11-01,287,26713,1265,0,28265
798,2019-11-02,321,16616,1396,4,18337
798,2019-11-03,2113,23145,1288,2,26548
798,2019-11-04,384,8152,1399,1,9936
798,2019-11-05,345,3396,1551,0,5292
798,2019-11-06,1300,14693,1282,0,17275
798,2019-11-07,356,16642,1072,4,18074
798,2019-11-08,290,9856,1401,1,11548
798,2019-11-09,861,9094,1364,0,11319
798,2019-11-10,271,24836,1307,0,26414
798,2019-11-11,395,17232,1090,0,18717
798,2019-11-12,274,17624,2982,3,20883
798,2019-11-13,787,22454,1756,4,25001
798,2019-11-14,275,10578,1694,1,12548
798,2019-11-15,1181,3922,1945,0,7048
798,2019-11-16,3908,3421,2460,1,9790
798,2019-11-17,1278,2901,3263,3,7445
798,2019-11-18,297,3146,2789,46,6278
798,2019-11-19,319,5209,2673,1,8202
798,2019-11-20,599,1573,1824,0,3996
798,2019-11-21,330,3433,1590,2,5355
798,2019-11-22,280,4795,1717,3,6795
798,2019-11-23,501,6204,1908,1,8614
798,2019-11-24,381,5528,1384,0,7293
798,2019-11-25,250,6699,1877,0,8826
798,2019-11-26,265,5840,1192,0,7297
798,2019-11-27,563,6432,1181,2,8178
798,2019-11-28,339,11064,857,1,12261
798,2019-11-29,99,462,1,0,562
798,2019-08-27,0,0,360,0,360
798,2019-08-28,150,1722,1658,0,3530
798,2019-08-29,266,9762,1542,0,11570
798,2019-08-30,266,2929,640,0,3835
798,2019-08-31,44,276,0,0,320
798,2019-09-01,156,149,360,0,665
798,2019-09-02,122,1134,31,0,1287
798,2019-09-03,158,1058,1209,1,2426
798,2019-09-04,206,12605,1780,2,14593
798,2019-09-05,1121,5207,2561,2,8891
798,2019-09-06,1083,16991,2118,1450,21642
798,2019-09-07,266,14132,1501,1,15900
798,2019-09-08,256,7729,2111,1,10097
798,2019-09-09,1045,23679,1499,1,26224
798,2019-09-10,251,12151,2029,1,14432
798,2019-09-11,1009,9205,1268,2,11484
798,2019-09-12,150,15982,2421,4,18557
798,2019-09-13,146,5320,1827,3,7296
798,2019-09-14,187,7361,1933,2,9483
798,2019-09-15,1051,12289,2495,1,15836
798,2019-09-16,154,9363,1835,4,11356
798,2019-09-17,1043,6953,2265,7,10268
798,2019-09-18,1118,19913,1762,9,22802
798,2019-09-19,257,4714,1439,11,6421
798,2019-09-20,309,17783,2082,9,20183
798,2019-09-21,166,10086,2046,9,12307
798,2019-09-22,109,15322,1343,8,16782
798,2019-09-23,1078,13420,1975,10,16483
798,2019-09-24,1010,12527,1998,15,15550
798,2019-09-25,147,8266,1839,13,10265
798,2019-09-26,1000,13533,2000,11,16544
798,2019-09-27,133,10095,2310,4,12542
798,2019-09-28,140,33858,2250,4,36252
798,2019-09-29,1238,32510,1045,3,34796
798,2019-09-30,193,28330,1836,4,30363
798,2019-10-01,118,28930,1406,2,30456
798,2019-10-02,1656,18822,1763,6,22247
798,2019-10-03,824,23439,1086,10,25359
798,2019-10-04,1524,14383,1084,12,17003
798,2019-10-05,442,21484,1191,14,23131
798,2019-10-06,615,17370,1351,10,19346
798,2019-10-07,998,5854,1773,12,8637
798,2019-10-08,897,18141,998,13,20049
798,2019-10-09,889,16620,1459,13,18981
798,2019-10-10,831,10386,2266,12,13495
798,2019-10-11,129,14507,1152,9,15797
798,2019-10-12,896,9092,2127,72,12187
798,2019-10-13,547,9066,1164,3,10780
798,2019-10-14,1029,5857,2279,1,9166
798,2019-10-15,450,8444,1943,1,10838
798,2019-10-16,170,19149,1504,4,20827
798,2019-10-17,152,8989,1468,2,10611
798,2019-10-18,1010,15354,1335,3,17702
798,2019-10-19,133,8695,2387,2,11217
798,2019-10-20,1018,2994,1427,0,5439
798,2019-10-21,1124,10737,780,1,12642
798,2019-10-22,190,6557,2128,3,8878
798,2019-10-23,225,8840,1697,3,10765
798,2019-10-24,342,20491,1989,3,22825
798,2019-10-25,320,19106,1232,40,20698
798,2019-10-26,1560,17915,1566,0,21041
798,2019-10-27,364,16548,1286,1,18199
798,2019-10-28,1141,14446,1344,0,16931
798,2019-10-29,727,16030,1514,2,18273
798,2019-10-30,1485,15948,1176,1,18610
798,2019-10-31,539,20929,1753,1,23222
798,2019-11-01,287,26713,1265,0,28265
798,2019-11-02,321,16616,1396,4,18337
798,2019-11-03,2113,23145,1288,2,26548
798,2019-11-04,384,8152,1399,1,9936
798,2019-11-05,345,3396,1551,0,5292
798,2019-11-06,1300,14693,1282,0,17275
798,2019-11-07,356,16642,1072,4,18074
798,2019-11-08,290,9856,1401,1,11548
798,2019-11-09,861,9094,1364,0,11319
798,2019-11-10,271,24836,1307,0,26414
798,2019-11-11,395,17232,1090,0,18717
798,2019-11-12,274,17624,2982,3,20883
798,2019-11-13,787,22454,1756,4,25001
798,2019-11-14,275,10578,1694,1,12548
798,2019-11-15,1181,3922,1945,0,7048
798,2019-11-16,3908,3421,2460,1,9790
798,2019-11-17,1278,2901,3263,3,7445
798,2019-11-18,297,3146,2789,46,6278
798,2019-11-19,319,5209,2673,1,8202
798,2019-11-20,599,1573,1824,0,3996
798,2019-11-21,330,3433,1590,2,5355
798,2019-11-22,280,4795,1717,3,6795
798,2019-11-23,501,6204,1908,1,8614
798,2019-11-24,381,5528,1384,0,7293
798,2019-11-25,250,6699,1877,0,8826
798,2019-11-26,265,5840,1192,0,7297
798,2019-11-27,563,6432,1181,2,8178
798,2019-11-28,339,11064,857,1,12261
798,2019-11-29,99,462,1,0,562
798,2019-09-03,158,1058,1209,1,2426
798,2019-09-04,206,12605,1780,2,14593
798,2019-09-05,1121,5207,2561,2,8891
798,2019-09-06,1083,16991,2118,1450,21642
798,2019-09-07,266,14132,1501,1,15900
798,2019-09-08,256,7729,2111,1,10097
798,2019-09-09,1045,23679,1499,1,26224
798,2019-09-10,251,12151,2029,1,14432
798,2019-09-11,1009,9205,1268,2,11484
798,2019-09-12,150,15982,2421,4,18557
798,2019-09-13,146,5320,1827,3,7296
798,2019-09-14,187,7361,1933,2,9483
798,2019-09-15,1051,12289,2495,1,15836
798,2019-09-16,154,9363,1835,4,11356
798,2019-09-17,1043,6953,2265,7,10268
798,2019-09-18,1118,19913,1762,9,22802
798,2019-09-19,257,4714,1439,11,6421
798,2019-09-20,309,17783,2082,9,20183
798,2019-09-21,166,10086,2046,9,12307
798,2019-09-22,109,15322,1343,8,16782
798,2019-09-23,1078,13420,1975,10,16483
798,2019-09-24,1010,12527,1998,15,15550
798,2019-09-25,147,8266,1839,13,10265
798,2019-09-26,1000,13533,2000,11,16544
798,2019-09-27,133,10095,2310,4,12542
798,2019-09-28,140,33858,2250,4,36252
798,2019-09-29,1238,32510,1045,3,34796
798,2019-09-30,193,28330,1836,4,30363
798,2019-10-01,118,28930,1406,2,30456
798,2019-10-02,1656,18822,1763,6,22247
798,2019-10-03,824,23439,1086,10,25359
798,2019-10-04,1524,14383,1084,12,17003
798,2019-10-05,442,21484,1191,14,23131
798,2019-10-06,615,17370,1351,10,19346
798,2019-10-07,998,5854,1773,12,8637
798,2019-10-08,897,18141,998,13,20049
798,2019-10-09,889,16620,1459,13,18981
798,2019-10-10,831,10386,2266,12,13495
798,2019-10-11,129,14507,1152,9,15797
798,2019-10-12,896,9092,2127,72,12187
798,2019-10-13,547,9066,1164,3,10780
798,2019-10-14,1029,5857,2279,1,9166
798,2019-10-15,450,8444,1943,1,10838
798,2019-10-16,170,19149,1504,4,20827
798,2019-10-17,152,8989,1468,2,10611
798,2019-10-18,1010,15354,1335,3,17702
798,2019-10-19,133,8695,2387,2,11217
798,2019-10-20,1018,2994,1427,0,5439
798,2019-10-21,1124,10737,780,1,12642
798,2019-10-22,190,6557,2128,3,8878
798,2019-10-23,225,8840,1697,3,10765
798,2019-10-24,342,20491,1989,3,22825
798,2019-10-25,320,19106,1232,40,20698
798,2019-10-26,1560,17915,1566,0,21041
798,2019-10-27,364,16548,1286,1,18199
798,2019-10-28,1141,14446,1344,0,16931
798,2019-10-29,727,16030,1514,2,18273
798,2019-10-30,1485,15948,1176,1,18610
798,2019-10-31,539,20929,1753,1,23222
798,2019-11-01,287,26713,1265,0,28265
798,2019-11-02,321,16616,1396,4,18337
798,2019-11-03,2113,23145,1288,2,26548
798,2019-11-04,384,8152,1399,1,9936
798,2019-11-05,345,3396,1551,0,5292
798,2019-11-06,1300,14693,1282,0,17275
798,2019-11-07,356,16642,1072,4,18074
798,2019-11-08,290,9856,1401,1,11548
798,2019-11-09,861,9094,1364,0,11319
798,2019-11-10,271,24836,1307,0,26414
798,2019-11-11,395,17232,1090,0,18717
798,2019-11-12,274,17624,2982,3,20883
798,2019-11-13,787,22454,1756,4,25001
798,2019-11-14,275,10578,1694,1,12548
798,2019-11-15,1181,3922,1945,0,7048
798,2019-11-16,3908,3421,2460,1,9790
798,2019-11-17,1278,2901,3263,3,7445
798,2019-11-18,297,3146,2789,46,6278
798,2019-11-19,319,5209,2673,1,8202
798,2019-11-20,599,1573,1824,0,3996
798,2019-11-21,330,3433,1590,2,5355
798,2019-11-22,280,4795,1717,3,6795
798,2019-11-23,501,6204,1908,1,8614
798,2019-11-24,381,5528,1384,0,7293
798,2019-11-25,250,6699,1877,0,8826
798,2019-11-26,265,5840,1192,0,7297
798,2019-11-27,563,6432,1181,2,8178
798,2019-11-28,339,11064,857,1,12261
799,2019-08-28,1769,1428,2046,1,5244
799,2019-08-29,786,8260,1621,2,10669
799,2019-08-30,453,2611,469,0,3533
799,2019-08-31,292,145,22,0,459
799,2019-09-01,269,171,281,1,722
799,2019-09-02,281,1076,4,0,1361
799,2019-09-03,471,994,1033,0,2498
799,2019-09-04,641,12472,2283,3,15399
799,2019-09-05,738,5558,1722,1,8019
799,2019-09-06,633,7977,1828,0,10438
799,2019-09-07,1401,12115,2125,0,15641
799,2019-09-08,2463,5465,2348,1,10277
799,2019-09-09,694,13544,2128,0,16366
799,2019-09-10,788,12053,2557,0,15398
799,2019-09-11,567,7254,2203,1,10025
799,2019-09-12,1384,8825,1384,57,11650
799,2019-09-13,1716,4570,2297,2,8585
799,2019-09-14,599,9557,1858,1,12015
799,2019-09-15,597,12503,2530,0,15630
799,2019-09-16,627,5874,1863,0,8364
799,2019-09-17,2870,9494,957,3,13324
799,2019-09-18,549,11423,1422,0,13394
799,2019-09-19,777,3690,1746,0,6213
799,2019-09-20,1150,15077,2211,0,18438
799,2019-09-21,449,8664,1980,1,11094
799,2019-09-22,463,15128,1641,1,17233
799,2019-09-23,581,12677,1963,2,15223
799,2019-09-24,1399,9028,2479,2,12908
799,2019-09-25,349,10067,2016,2,12434
799,2019-09-26,278,10214,1853,2,12347
799,2019-09-27,1126,9497,1900,2,12525
799,2019-09-28,265,15325,2160,2,17752
799,2019-09-29,227,16239,1724,0,18190
799,2019-09-30,218,25814,2540,0,28572
799,2019-10-01,338,22800,1579,2,24719
799,2019-10-02,1103,12588,1626,1,15318
799,2019-10-03,253,23312,1343,1,24909
799,2019-10-04,298,14535,1382,0,16215
799,2019-10-05,489,22190,1592,4,24275
799,2019-10-06,1905,18565,2316,0,22786
799,2019-10-07,369,7328,1650,4,9351
799,2019-10-08,322,18501,2276,0,21099
799,2019-10-09,296,17011,2015,2,19324
799,2019-10-10,493,10902,1107,1,12503
799,2019-10-11,421,11369,1474,1,13265
799,2019-10-12,483,7170,1890,2,9545
799,2019-10-13,1395,12700,1898,2,15995
799,2019-10-14,362,8349,1903,4,10618
799,2019-10-15,1069,14641,2018,1,17729
799,2019-10-16,326,18729,957,2,20014
799,2019-10-17,1240,6106,1728,4,9078
799,2019-10-18,580,10626,1409,0,12615
799,2019-10-19,482,6477,1778,29,8766
799,2019-10-20,557,2998,2462,0,6017
799,2019-10-21,346,10982,2250,0,13578
799,2019-10-22,452,6730,1580,5,8767
799,2019-10-23,393,9498,2054,1,11946
799,2019-10-24,339,21056,1469,2,22866
799,2019-10-25,1388,14681,1787,1,17857
799,2019-10-26,2222,22244,1978,0,26444
799,2019-10-27,2131,19158,2223,1,23513
799,2019-10-28,365,13608,2427,1,16401
799,2019-10-29,438,15414,1623,0,17475
799,2019-10-30,502,15327,1945,676,18450
799,2019-10-31,350,20350,1850,1,22551
799,2019-11-01,880,27065,1206,2,29153
799,2019-11-02,909,26121,1600,0,28630
799,2019-11-03,315,25449,1220,2,26986
799,2019-11-04,389,11244,1596,0,13229
799,2019-11-05,462,3909,2017,0,6388
799,2019-11-06,936,8783,1300,6,11025
799,2019-11-07,1776,13511,1517,296,17100
799,2019-11-08,409,15255,2583,1,18248
799,2019-11-09,2199,17361,2599,0,22159
799,2019-11-10,332,24318,1169,0,25819
799,2019-11-11,429,15295,0,0,15724
799,2019-11-12,266,9900,0,0,10166
799,2019-11-13,678,10799,0,0,11477
799,2019-11-14,426,11017,0,0,11443
799,2019-11-15,235,4780,0,0,5015
799,2019-11-16,19,32,0,0,51
799,2019-08-28,1769,1428,2046,1,5244
799,2019-08-29,786,8260,1621,2,10669
799,2019-08-30,453,2611,469,0,3533
799,2019-08-31,292,145,22,0,459
799,2019-09-01,269,171,281,1,722
799,2019-09-02,281,1076,4,0,1361
799,2019-09-03,471,994,1033,0,2498
799,2019-09-04,641,12472,2283,3,15399
799,2019-09-05,738,5558,1722,1,8019
799,2019-09-06,633,7977,1828,0,10438
799,2019-09-07,1401,12115,2125,0,15641
799,2019-09-08,2463,5465,2348,1,10277
799,2019-09-09,694,13544,2128,0,16366
799,2019-09-10,788,12053,2557,0,15398
799,2019-09-11,567,7254,2203,1,10025
799,2019-09-12,1384,8825,1384,57,11650
799,2019-09-13,1716,4570,2297,2,8585
799,2019-09-14,599,9557,1858,1,12015
799,2019-09-15,597,12503,2530,0,15630
799,2019-09-16,627,5874,1863,0,8364
799,2019-09-17,2870,9494,957,3,13324
799,2019-09-18,549,11423,1422,0,13394
799,2019-09-19,777,3690,1746,0,6213
799,2019-09-20,1150,15077,2211,0,18438
799,2019-09-21,449,8664,1980,1,11094
799,2019-09-22,463,15128,1641,1,17233
799,2019-09-23,581,12677,1963,2,15223
799,2019-09-24,1399,9028,2479,2,12908
799,2019-09-25,349,10067,2016,2,12434
799,2019-09-26,278,10214,1853,2,12347
799,2019-09-27,1126,9497,1900,2,12525
799,2019-09-28,265,15325,2160,2,17752
799,2019-09-29,227,16239,1724,0,18190
799,2019-09-30,218,25814,2540,0,28572
799,2019-10-01,338,22800,1579,2,24719
799,2019-10-02,1103,12588,1626,1,15318
799,2019-10-03,253,23312,1343,1,24909
799,2019-10-04,298,14535,1382,0,16215
799,2019-10-05,489,22190,1592,4,24275
799,2019-10-06,1905,18565,2316,0,22786
799,2019-10-07,369,7328,1650,4,9351
799,2019-10-08,322,18501,2276,0,21099
799,2019-10-09,296,17011,2015,2,19324
799,2019-10-10,493,10902,1107,1,12503
799,2019-10-11,421,11369,1474,1,13265
799,2019-10-12,483,7170,1890,2,9545
799,2019-10-13,1395,12700,1898,2,15995
799,2019-10-14,362,8349,1903,4,10618
799,2019-10-15,1069,14641,2018,1,17729
799,2019-10-16,326,18729,957,2,20014
799,2019-10-17,1240,6106,1728,4,9078
799,2019-10-18,580,10626,1409,0,12615
799,2019-10-19,482,6477,1778,29,8766
799,2019-10-20,557,2998,2462,0,6017
799,2019-10-21,346,10982,2250,0,13578
799,2019-10-22,452,6730,1580,5,8767
799,2019-10-23,393,9498,2054,1,11946
799,2019-10-24,339,21056,1469,2,22866
799,2019-10-25,1388,14681,1787,1,17857
799,2019-10-26,2222,22244,1978,0,26444
799,2019-10-27,2131,19158,2223,1,23513
799,2019-10-28,365,13608,2427,1,16401
799,2019-10-29,438,15414,1623,0,17475
799,2019-10-30,502,15327,1945,676,18450
799,2019-10-31,350,20350,1850,1,22551
799,2019-11-01,880,27065,1206,2,29153
799,2019-11-02,909,26121,1600,0,28630
799,2019-11-03,315,25449,1220,2,26986
799,2019-11-04,389,11244,1596,0,13229
799,2019-11-05,462,3909,2017,0,6388
799,2019-11-06,936,8783,1300,6,11025
799,2019-11-07,1776,13511,1517,296,17100
799,2019-11-08,409,15255,2583,1,18248
799,2019-11-09,2199,17361,2599,0,22159
799,2019-11-10,332,24318,1169,0,25819
799,2019-11-11,429,15295,0,0,15724
799,2019-11-12,266,9900,0,0,10166
799,2019-11-13,678,10799,0,0,11477
799,2019-11-14,426,11017,0,0,11443
799,2019-11-15,235,4780,0,0,5015
799,2019-11-16,19,32,0,0,51
799,2019-11-17,0,22,0,0,22
799,2019-08-27,0,0,180,0,180
799,2019-08-28,1769,1428,2046,1,5244
799,2019-08-29,786,8260,1621,2,10669
799,2019-08-30,453,2611,469,0,3533
799,2019-08-31,292,145,22,0,459
799,2019-09-01,269,171,281,1,722
799,2019-09-02,281,1076,4,0,1361
799,2019-09-03,471,994,1033,0,2498
799,2019-09-04,641,12472,2283,3,15399
799,2019-09-05,738,5558,1722,1,8019
799,2019-09-06,633,7977,1828,0,10438
799,2019-09-07,1401,12115,2125,0,15641
799,2019-09-08,2463,5465,2348,1,10277
799,2019-09-09,694,13544,2128,0,16366
799,2019-09-10,788,12053,2557,0,15398
799,2019-09-11,567,7254,2203,1,10025
799,2019-09-12,1384,8825,1384,57,11650
799,2019-09-13,1716,4570,2297,2,8585
799,2019-09-14,599,9557,1858,1,12015
799,2019-09-15,597,12503,2530,0,15630
799,2019-09-16,627,5874,1863,0,8364
799,2019-09-17,2870,9494,957,3,13324
799,2019-09-18,549,11423,1422,0,13394
799,2019-09-19,777,3690,1746,0,6213
799,2019-09-20,1150,15077,2211,0,18438
799,2019-09-21,449,8664,1980,1,11094
799,2019-09-22,463,15128,1641,1,17233
799,2019-09-23,581,12677,1963,2,15223
799,2019-09-24,1399,9028,2479,2,12908
799,2019-09-25,349,10067,2016,2,12434
799,2019-09-26,278,10214,1853,2,12347
799,2019-09-27,1126,9497,1900,2,12525
799,2019-09-28,265,15325,2160,2,17752
799,2019-09-29,227,16239,1724,0,18190
799,2019-09-30,218,25814,2540,0,28572
799,2019-10-01,338,22800,1579,2,24719
799,2019-10-02,1103,12588,1626,1,15318
799,2019-10-03,253,23312,1343,1,24909
799,2019-10-04,298,14535,1382,0,16215
799,2019-10-05,489,22190,1592,4,24275
799,2019-10-06,1905,18565,2316,0,22786
799,2019-10-07,369,7328,1650,4,9351
799,2019-10-08,322,18501,2276,0,21099
799,2019-10-09,296,17011,2015,2,19324
799,2019-10-10,493,10902,1107,1,12503
799,2019-10-11,421,11369,1474,1,13265
799,2019-10-12,483,7170,1890,2,9545
799,2019-10-13,1395,12700,1898,2,15995
799,2019-10-14,362,8349,1903,4,10618
799,2019-10-15,1069,14641,2018,1,17729
799,2019-10-16,326,18729,957,2,20014
799,2019-10-17,1240,6106,1728,4,9078
799,2019-10-18,580,10626,1409,0,12615
799,2019-10-19,482,6477,1778,29,8766
799,2019-10-20,557,2998,2462,0,6017
799,2019-10-21,346,10982,2250,0,13578
799,2019-10-22,452,6730,1580,5,8767
799,2019-10-23,393,9498,2054,1,11946
799,2019-10-24,339,21056,1469,2,22866
799,2019-10-25,1388,14681,1787,1,17857
799,2019-10-26,2222,22244,1978,0,26444
799,2019-10-27,2131,19158,2223,1,23513
799,2019-10-28,365,13608,2427,1,16401
799,2019-10-29,438,15414,1623,0,17475
799,2019-10-30,502,15327,1945,676,18450
799,2019-10-31,350,20350,1850,1,22551
799,2019-11-01,880,27065,1206,2,29153
799,2019-11-02,909,26121,1600,0,28630
799,2019-11-03,315,25449,1220,2,26986
799,2019-11-04,389,11244,1596,0,13229
799,2019-11-05,462,3909,2017,0,6388
799,2019-11-06,936,8783,1300,6,11025
799,2019-11-07,1776,13511,1517,296,17100
799,2019-11-08,409,15255,2583,1,18248
799,2019-11-09,2199,17361,2599,0,22159
799,2019-11-10,332,24318,1169,0,25819
799,2019-08-28,1769,1428,2046,1,5244
799,2019-08-29,786,8260,1621,2,10669
799,2019-08-30,453,2611,469,0,3533
799,2019-08-31,292,145,22,0,459
799,2019-09-01,269,171,281,1,722
799,2019-09-02,281,1076,4,0,1361
799,2019-09-03,471,994,1033,0,2498
799,2019-09-04,641,12472,2283,3,15399
799,2019-09-05,738,5558,1722,1,8019
799,2019-09-06,633,7977,1828,0,10438
799,2019-09-07,1401,12115,2125,0,15641
799,2019-09-08,2463,5465,2348,1,10277
799,2019-09-09,694,13544,2128,0,16366
799,2019-09-10,788,12053,2557,0,15398
799,2019-09-11,567,7254,2203,1,10025
799,2019-09-12,1384,8825,1384,57,11650
799,2019-09-13,1716,4570,2297,2,8585
799,2019-09-14,599,9557,1858,1,12015
799,2019-09-15,597,12503,2530,0,15630
799,2019-09-16,627,5874,1863,0,8364
799,2019-09-17,2870,9494,957,3,13324
799,2019-09-18,549,11423,1422,0,13394
799,2019-09-19,777,3690,1746,0,6213
799,2019-09-20,1150,15077,2211,0,18438
799,2019-09-21,449,8664,1980,1,11094
799,2019-09-22,463,15128,1641,1,17233
799,2019-09-23,581,12677,1963,2,15223
799,2019-09-24,1399,9028,2479,2,12908
799,2019-09-25,349,10067,2016,2,12434
799,2019-09-26,278,10214,1853,2,12347
799,2019-09-27,1126,9497,1900,2,12525
799,2019-09-28,265,15325,2160,2,17752
799,2019-09-29,227,16239,1724,0,18190
799,2019-09-30,218,25814,2540,0,28572
799,2019-10-01,338,22800,1579,2,24719
799,2019-10-02,1103,12588,1626,1,15318
799,2019-10-03,253,23312,1343,1,24909
799,2019-10-04,298,14535,1382,0,16215
799,2019-10-05,489,22190,1592,4,24275
799,2019-10-06,1905,18565,2316,0,22786
799,2019-10-07,369,7328,1650,4,9351
799,2019-10-08,322,18501,2276,0,21099
799,2019-10-09,296,17011,2015,2,19324
799,2019-10-10,493,10902,1107,1,12503
799,2019-10-11,421,11369,1474,1,13265
799,2019-10-12,483,7170,1890,2,9545
799,2019-10-13,1395,12700,1898,2,15995
799,2019-10-14,362,8349,1903,4,10618
799,2019-10-15,1069,14641,2018,1,17729
799,2019-10-16,326,18729,957,2,20014
799,2019-10-17,1240,6106,1728,4,9078
799,2019-10-18,580,10626,1409,0,12615
799,2019-10-19,482,6477,1778,29,8766
799,2019-10-20,557,2998,2462,0,6017
799,2019-10-21,346,10982,2250,0,13578
799,2019-10-22,452,6730,1580,5,8767
799,2019-10-23,393,9498,2054,1,11946
799,2019-10-24,339,21056,1469,2,22866
799,2019-10-25,1388,14681,1787,1,17857
799,2019-10-26,2222,22244,1978,0,26444
799,2019-10-27,2131,19158,2223,1,23513
799,2019-10-28,365,13608,2427,1,16401
799,2019-10-29,438,15414,1623,0,17475
799,2019-10-30,502,15327,1945,676,18450
799,2019-10-31,350,20350,1850,1,22551
799,2019-11-01,880,27065,1206,2,29153
799,2019-11-02,909,26121,1600,0,28630
799,2019-11-03,315,25449,1220,2,26986
799,2019-11-04,389,11244,1596,0,13229
799,2019-11-05,462,3909,2017,0,6388
799,2019-11-06,936,8783,1300,6,11025
799,2019-11-07,1776,13511,1517,296,17100
799,2019-11-08,409,15255,2583,1,18248
800,2019-08-28,409,1370,2874,1,4654
800,2019-08-29,1373,9866,2119,0,13358
800,2019-08-30,1121,4830,722,0,6673
800,2019-08-31,205,162,10,0,377
800,2019-09-01,785,142,211,0,1138
800,2019-09-02,282,52,0,0,334
800,2019-09-03,366,4345,1288,0,5999
800,2019-09-04,1233,12160,2643,1,16037
800,2019-09-05,2134,6811,1756,3,10704
800,2019-09-06,1921,12517,1437,1,15876
800,2019-09-07,1129,17168,1976,0,20273
800,2019-09-08,2224,5263,1619,1,9107
800,2019-09-09,1688,12404,1966,0,16058
800,2019-09-10,1111,11396,1517,0,14024
800,2019-09-11,915,9007,2396,2,12320
800,2019-09-12,2854,11239,1736,1,15830
800,2019-09-13,932,4309,1379,0,6620
800,2019-09-14,1475,9243,2155,0,12873
800,2019-09-15,1204,24083,1988,1,27276
800,2019-09-16,969,17562,1700,0,20231
800,2019-09-17,678,7286,2438,1,10403
800,2019-09-18,1319,27669,1982,1,30971
800,2019-09-19,2065,4513,2073,2,8653
800,2019-09-20,1133,10243,1394,0,12770
800,2019-09-21,1936,6722,2700,0,11358
800,2019-09-22,3224,13519,1365,2,18110
800,2019-09-23,3986,13086,1769,0,18841
800,2019-09-24,3732,14012,1692,2,19438
800,2019-09-25,3272,12396,1207,4,16879
800,2019-09-26,3378,8662,1250,0,13290
800,2019-09-27,1044,11289,1500,3,13836
800,2019-09-28,350,15418,1295,1,17064
800,2019-09-29,430,15925,2091,2,18448
800,2019-09-30,1606,18035,1758,0,21399
800,2019-10-01,1080,16532,1634,1,19247
800,2019-10-02,883,13593,1774,0,16250
800,2019-10-03,1421,14319,1792,0,17532
800,2019-10-04,837,18187,1507,1,20532
800,2019-10-05,783,23413,1319,2,25517
800,2019-10-06,2317,17017,1544,0,20878
800,2019-10-07,1748,8216,2012,3,11979
800,2019-10-08,700,18036,2144,0,20880
800,2019-10-09,1414,16722,1082,1,19219
800,2019-10-10,2573,17104,2342,2,22021
800,2019-10-11,1781,15399,1157,0,18337
800,2019-10-12,1283,8883,1589,2,11757
800,2019-10-13,933,9000,2029,2,11964
800,2019-10-14,1898,8064,2165,1,12128
800,2019-10-15,2068,14767,1596,0,18431
800,2019-10-16,926,23475,1123,2,25526
800,2019-10-17,471,8447,2295,4,11217
800,2019-10-18,1871,14868,1881,0,18620
800,2019-10-19,1582,9214,1914,0,12710
800,2019-10-20,553,3097,1664,0,5314
800,2019-10-21,2188,19017,1674,3,22882
800,2019-10-22,688,10310,1545,4,12547
800,2019-10-23,731,17695,1741,1,20168
800,2019-10-24,1415,20773,1686,1,23875
800,2019-10-25,1538,18779,1392,1,21710
800,2019-10-26,530,24649,1427,0,26606
800,2019-10-27,1090,19088,1540,2,21720
800,2019-10-28,861,23525,1349,1,25736
800,2019-10-29,1379,28396,1970,0,31745
800,2019-10-30,768,19504,1536,0,21808
800,2019-10-31,750,20343,1752,1,22846
800,2019-11-01,1468,26702,628,3,28801
800,2019-11-02,474,18002,2049,0,20525
800,2019-11-03,1045,23494,1207,0,25746
800,2019-11-04,1592,8054,871,0,10517
800,2019-11-05,613,4080,1068,1,5762
800,2019-11-06,1309,14718,972,4,17003
800,2019-11-07,688,25608,823,0,27119
800,2019-11-08,500,12418,1304,1,14223
800,2019-11-09,1697,9030,2161,0,12888
800,2019-11-10,607,14355,1679,0,16641
800,2019-11-11,539,10035,1888,4,12466
800,2019-11-12,1106,10317,2956,0,14379
800,2019-11-13,579,20453,1282,0,22314
800,2019-11-14,516,10642,2238,1,13397
800,2019-11-15,1040,3979,2105,0,7124
800,2019-11-16,542,2605,1989,2,5138
800,2019-11-17,805,3287,3213,0,7305
800,2019-11-18,1092,2446,3119,0,6657
800,2019-11-19,635,3078,3305,1,7019
800,2019-11-20,486,1536,2327,0,4349
800,2019-11-21,779,5250,1839,4,7872
800,2019-11-22,489,8223,1812,2,10526
800,2019-11-23,459,10450,2157,1,13067
800,2019-11-24,1091,7149,1070,0,9310
800,2019-11-25,455,10533,1808,0,12796
800,2019-11-26,711,9542,1267,4,11524
800,2019-11-27,1101,6649,1478,0,9228
800,2019-11-28,569,10360,833,0,11762
800,2019-11-29,172,509,3,0,684
800,2019-08-28,409,1370,2874,1,4654
800,2019-08-29,1373,9866,2119,0,13358
800,2019-08-30,1121,4830,722,0,6673
800,2019-08-31,205,162,10,0,377
800,2019-09-01,785,142,211,0,1138
800,2019-09-02,282,52,0,0,334
800,2019-09-03,366,4345,1288,0,5999
800,2019-09-04,1233,12160,2643,1,16037
800,2019-09-05,2134,6811,1756,3,10704
800,2019-09-06,1921,12517,1437,1,15876
800,2019-09-07,1129,17168,1976,0,20273
800,2019-09-08,2224,5263,1619,1,9107
800,2019-09-09,1688,12404,1966,0,16058
800,2019-09-10,1111,11396,1517,0,14024
800,2019-09-11,915,9007,2396,2,12320
800,2019-09-12,2854,11239,1736,1,15830
800,2019-09-13,932,4309,1379,0,6620
800,2019-09-14,1475,9243,2155,0,12873
800,2019-09-15,1204,24083,1988,1,27276
800,2019-09-16,969,17562,1700,0,20231
800,2019-09-17,678,7286,2438,1,10403
800,2019-09-18,1319,27669,1982,1,30971
800,2019-09-19,2065,4513,2073,2,8653
800,2019-09-20,1133,10243,1394,0,12770
800,2019-09-21,1936,6722,2700,0,11358
800,2019-09-22,3224,13519,1365,2,18110
800,2019-09-23,3986,13086,1769,0,18841
800,2019-09-24,3732,14012,1692,2,19438
800,2019-09-25,3272,12396,1207,4,16879
800,2019-09-26,3378,8662,1250,0,13290
800,2019-09-27,1044,11289,1500,3,13836
800,2019-09-28,350,15418,1295,1,17064
800,2019-09-29,430,15925,2091,2,18448
800,2019-09-30,1606,18035,1758,0,21399
800,2019-10-01,1080,16532,1634,1,19247
800,2019-10-02,883,13593,1774,0,16250
800,2019-10-03,1421,14319,1792,0,17532
800,2019-10-04,837,18187,1507,1,20532
800,2019-10-05,783,23413,1319,2,25517
800,2019-10-06,2317,17017,1544,0,20878
800,2019-10-07,1748,8216,2012,3,11979
800,2019-10-08,700,18036,2144,0,20880
800,2019-10-09,1414,16722,1082,1,19219
800,2019-10-10,2573,17104,2342,2,22021
800,2019-10-11,1781,15399,1157,0,18337
800,2019-10-12,1283,8883,1589,2,11757
800,2019-10-13,933,9000,2029,2,11964
800,2019-10-14,1898,8064,2165,1,12128
800,2019-10-15,2068,14767,1596,0,18431
800,2019-10-16,926,23475,1123,2,25526
800,2019-10-17,471,8447,2295,4,11217
800,2019-10-18,1871,14868,1881,0,18620
800,2019-10-19,1582,9214,1914,0,12710
800,2019-10-20,553,3097,1664,0,5314
800,2019-10-21,2188,19017,1674,3,22882
800,2019-10-22,688,10310,1545,4,12547
800,2019-10-23,731,17695,1741,1,20168
800,2019-10-24,1415,20773,1686,1,23875
800,2019-10-25,1538,18779,1392,1,21710
800,2019-10-26,530,24649,1427,0,26606
800,2019-10-27,1090,19088,1540,2,21720
800,2019-10-28,861,23525,1349,1,25736
800,2019-10-29,1379,28396,1970,0,31745
800,2019-10-30,768,19504,1536,0,21808
800,2019-10-31,750,20343,1752,1,22846
800,2019-11-01,1468,26702,628,3,28801
800,2019-11-02,474,18002,2049,0,20525
800,2019-11-03,1045,23494,1207,0,25746
800,2019-11-04,1592,8054,871,0,10517
800,2019-11-05,613,4080,1068,1,5762
800,2019-11-06,1309,14718,972,4,17003
800,2019-11-07,688,25608,823,0,27119
800,2019-11-08,500,12418,1304,1,14223
800,2019-11-09,1697,9030,2161,0,12888
800,2019-11-10,607,14355,1679,0,16641
800,2019-11-11,539,10035,1888,4,12466
800,2019-11-12,1106,10317,2956,0,14379
800,2019-11-13,579,20453,1282,0,22314
800,2019-11-14,516,10642,2238,1,13397
800,2019-11-15,1040,3979,2105,0,7124
800,2019-11-16,542,2605,1989,2,5138
800,2019-11-17,805,3287,3213,0,7305
800,2019-11-18,1092,2446,3119,0,6657
800,2019-11-19,635,3078,3305,1,7019
800,2019-11-20,486,1536,2327,0,4349
800,2019-11-21,779,5250,1839,4,7872
800,2019-11-22,489,8223,1812,2,10526
800,2019-11-23,459,10450,2157,1,13067
800,2019-11-24,1091,7149,1070,0,9310
800,2019-11-25,455,10533,1808,0,12796
800,2019-11-26,711,9542,1267,4,11524
800,2019-11-27,1101,6649,1478,0,9228
800,2019-11-28,569,10360,833,0,11762
800,2019-11-29,172,509,3,0,684
800,2019-08-27,0,0,270,0,270
800,2019-08-28,409,1370,2874,1,4654
800,2019-08-29,1373,9866,2119,0,13358
800,2019-08-30,1121,4830,722,0,6673
800,2019-08-31,205,162,10,0,377
800,2019-09-01,785,142,211,0,1138
800,2019-09-02,282,52,0,0,334
800,2019-09-03,366,4345,1288,0,5999
800,2019-09-04,1233,12160,2643,1,16037
800,2019-09-05,2134,6811,1756,3,10704
800,2019-09-06,1921,12517,1437,1,15876
800,2019-09-07,1129,17168,1976,0,20273
800,2019-09-08,2224,5263,1619,1,9107
800,2019-09-09,1688,12404,1966,0,16058
800,2019-09-10,1111,11396,1517,0,14024
800,2019-09-11,915,9007,2396,2,12320
800,2019-09-12,2854,11239,1736,1,15830
800,2019-09-13,932,4309,1379,0,6620
800,2019-09-14,1475,9243,2155,0,12873
800,2019-09-15,1204,24083,1988,1,27276
800,2019-09-16,969,17562,1700,0,20231
800,2019-09-17,678,7286,2438,1,10403
800,2019-09-18,1319,27669,1982,1,30971
800,2019-09-19,2065,4513,2073,2,8653
800,2019-09-20,1133,10243,1394,0,12770
800,2019-09-21,1936,6722,2700,0,11358
800,2019-09-22,3224,13519,1365,2,18110
800,2019-09-23,3986,13086,1769,0,18841
800,2019-09-24,3732,14012,1692,2,19438
800,2019-09-25,3272,12396,1207,4,16879
800,2019-09-26,3378,8662,1250,0,13290
800,2019-09-27,1044,11289,1500,3,13836
800,2019-09-28,350,15418,1295,1,17064
800,2019-09-29,430,15925,2091,2,18448
800,2019-09-30,1606,18035,1758,0,21399
800,2019-10-01,1080,16532,1634,1,19247
800,2019-10-02,883,13593,1774,0,16250
800,2019-10-03,1421,14319,1792,0,17532
800,2019-10-04,837,18187,1507,1,20532
800,2019-10-05,783,23413,1319,2,25517
800,2019-10-06,2317,17017,1544,0,20878
800,2019-10-07,1748,8216,2012,3,11979
800,2019-10-08,700,18036,2144,0,20880
800,2019-10-09,1414,16722,1082,1,19219
800,2019-10-10,2573,17104,2342,2,22021
800,2019-10-11,1781,15399,1157,0,18337
800,2019-10-12,1283,8883,1589,2,11757
800,2019-10-13,933,9000,2029,2,11964
800,2019-10-14,1898,8064,2165,1,12128
800,2019-10-15,2068,14767,1596,0,18431
800,2019-10-16,926,23475,1123,2,25526
800,2019-10-17,471,8447,2295,4,11217
800,2019-10-18,1871,14868,1881,0,18620
800,2019-10-19,1582,9214,1914,0,12710
800,2019-10-20,553,3097,1664,0,5314
800,2019-10-21,2188,19017,1674,3,22882
800,2019-10-22,688,10310,1545,4,12547
800,2019-10-23,731,17695,1741,1,20168
800,2019-10-24,1415,20773,1686,1,23875
800,2019-10-25,1538,18779,1392,1,21710
800,2019-10-26,530,24649,1427,0,26606
800,2019-10-27,1090,19088,1540,2,21720
800,2019-10-28,861,23525,1349,1,25736
800,2019-10-29,1379,28396,1970,0,31745
800,2019-10-30,768,19504,1536,0,21808
800,2019-10-31,750,20343,1752,1,22846
800,2019-11-01,1468,26702,628,3,28801
800,2019-11-02,474,18002,2049,0,20525
800,2019-11-03,1045,23494,1207,0,25746
800,2019-11-04,1592,8054,871,0,10517
800,2019-11-05,613,4080,1068,1,5762
800,2019-11-06,1309,14718,972,4,17003
800,2019-11-07,688,25608,823,0,27119
800,2019-11-08,500,12418,1304,1,14223
800,2019-11-09,1697,9030,2161,0,12888
800,2019-11-10,607,14355,1679,0,16641
800,2019-11-11,539,10035,1888,4,12466
800,2019-11-12,1106,10317,2956,0,14379
800,2019-11-13,579,20453,1282,0,22314
800,2019-11-14,516,10642,2238,1,13397
800,2019-11-15,1040,3979,2105,0,7124
800,2019-11-16,542,2605,1989,2,5138
800,2019-11-17,805,3287,3213,0,7305
800,2019-11-18,1092,2446,3119,0,6657
800,2019-11-19,635,3078,3305,1,7019
800,2019-11-20,486,1536,2327,0,4349
800,2019-11-21,779,5250,1839,4,7872
800,2019-11-22,489,8223,1812,2,10526
800,2019-11-23,459,10450,2157,1,13067
800,2019-11-24,1091,7149,1070,0,9310
800,2019-11-25,455,10533,1808,0,12796
800,2019-11-26,711,9542,1267,4,11524
800,2019-11-27,1101,6649,1478,0,9228
800,2019-11-28,569,10360,833,0,11762
800,2019-11-29,172,509,3,0,684
800,2019-08-28,409,1370,2874,1,4654
800,2019-08-29,1373,9866,2119,0,13358
800,2019-08-30,1121,4830,722,0,6673
800,2019-08-31,205,162,10,0,377
800,2019-09-01,785,142,211,0,1138
800,2019-09-02,282,52,0,0,334
800,2019-09-03,366,4345,1288,0,5999
800,2019-09-04,1233,12160,2643,1,16037
800,2019-09-05,2134,6811,1756,3,10704
800,2019-09-06,1921,12517,1437,1,15876
800,2019-09-07,1129,17168,1976,0,20273
800,2019-09-08,2224,5263,1619,1,9107
800,2019-09-09,1688,12404,1966,0,16058
800,2019-09-10,1111,11396,1517,0,14024
800,2019-09-11,915,9007,2396,2,12320
800,2019-09-12,2854,11239,1736,1,15830
800,2019-09-13,932,4309,1379,0,6620
800,2019-09-14,1475,9243,2155,0,12873
800,2019-09-15,1204,24083,1988,1,27276
800,2019-09-16,969,17562,1700,0,20231
800,2019-09-17,678,7286,2438,1,10403
800,2019-09-18,1319,27669,1982,1,30971
800,2019-09-19,2065,4513,2073,2,8653
800,2019-09-20,1133,10243,1394,0,12770
800,2019-09-21,1936,6722,2700,0,11358
800,2019-09-22,3224,13519,1365,2,18110
800,2019-09-23,3986,13086,1769,0,18841
800,2019-09-24,3732,14012,1692,2,19438
800,2019-09-25,3272,12396,1207,4,16879
800,2019-09-26,3378,8662,1250,0,13290
800,2019-09-27,1044,11289,1500,3,13836
800,2019-09-28,350,15418,1295,1,17064
800,2019-09-29,430,15925,2091,2,18448
800,2019-09-30,1606,18035,1758,0,21399
800,2019-10-01,1080,16532,1634,1,19247
800,2019-10-02,883,13593,1774,0,16250
800,2019-10-03,1421,14319,1792,0,17532
800,2019-10-04,837,18187,1507,1,20532
800,2019-10-05,783,23413,1319,2,25517
800,2019-10-06,2317,17017,1544,0,20878
800,2019-10-07,1748,8216,2012,3,11979
800,2019-10-08,700,18036,2144,0,20880
800,2019-10-09,1414,16722,1082,1,19219
800,2019-10-10,2573,17104,2342,2,22021
800,2019-10-11,1781,15399,1157,0,18337
800,2019-10-12,1283,8883,1589,2,11757
800,2019-10-13,933,9000,2029,2,11964
800,2019-10-14,1898,8064,2165,1,12128
800,2019-10-15,2068,14767,1596,0,18431
800,2019-10-16,926,23475,1123,2,25526
800,2019-10-17,471,8447,2295,4,11217
800,2019-10-18,1871,14868,1881,0,18620
800,2019-10-19,1582,9214,1914,0,12710
800,2019-10-20,553,3097,1664,0,5314
800,2019-10-21,2188,19017,1674,3,22882
800,2019-10-22,688,10310,1545,4,12547
800,2019-10-23,731,17695,1741,1,20168
800,2019-10-24,1415,20773,1686,1,23875
800,2019-10-25,1538,18779,1392,1,21710
800,2019-10-26,530,24649,1427,0,26606
800,2019-10-27,1090,19088,1540,2,21720
800,2019-10-28,861,23525,1349,1,25736
800,2019-10-29,1379,28396,1970,0,31745
800,2019-10-30,768,19504,1536,0,21808
800,2019-10-31,750,20343,1752,1,22846
800,2019-11-01,1468,26702,628,3,28801
800,2019-11-02,474,18002,2049,0,20525
800,2019-11-03,1045,23494,1207,0,25746
800,2019-11-04,1592,8054,871,0,10517
800,2019-11-05,613,4080,1068,1,5762
800,2019-11-06,1309,14718,972,4,17003
800,2019-11-07,688,25608,823,0,27119
800,2019-11-08,500,12418,1304,1,14223
800,2019-11-09,1697,9030,2161,0,12888
800,2019-11-10,607,14355,1679,0,16641
800,2019-11-11,539,10035,1888,4,12466
800,2019-11-12,1106,10317,2956,0,14379
800,2019-11-13,579,20453,1282,0,22314
800,2019-11-14,516,10642,2238,1,13397
800,2019-11-15,1040,3979,2105,0,7124
800,2019-11-16,542,2605,1989,2,5138
800,2019-11-17,805,3287,3213,0,7305
800,2019-11-18,1092,2446,3119,0,6657
800,2019-11-19,635,3078,3305,1,7019
800,2019-11-20,486,1536,2327,0,4349
800,2019-11-21,779,5250,1839,4,7872
800,2019-11-22,489,8223,1812,2,10526
800,2019-11-23,459,10450,2157,1,13067
800,2019-11-24,1091,7149,1070,0,9310
800,2019-11-25,455,10533,1808,0,12796
800,2019-11-26,711,9542,1267,4,11524
801,2019-08-28,655,1020,1440,1,3116
801,2019-08-29,765,8396,1237,0,10398
801,2019-08-30,768,2792,551,0,4111
801,2019-08-31,502,134,1,0,637
801,2019-09-01,489,1022,357,0,1868
801,2019-09-02,469,58,256,0,783
801,2019-09-03,405,445,1285,1,2136
801,2019-09-04,804,12186,2180,1,15171
801,2019-09-05,777,8063,1591,1,10432
801,2019-09-06,589,9324,1914,3,11830
801,2019-09-07,1261,15903,1921,0,19085
801,2019-09-08,2997,8043,1106,1,12147
801,2019-09-09,2423,17229,2004,0,21656
801,2019-09-10,1729,8113,1969,0,11811
801,2019-09-11,1095,8827,2073,2,11997
801,2019-09-12,1701,7823,2861,1,12386
801,2019-09-13,861,7745,1836,2,10444
801,2019-09-14,544,7085,2292,1,9922
801,2019-09-15,2542,8544,1929,0,13015
801,2019-09-16,2048,5520,1744,0,9312
801,2019-09-17,2336,6756,2588,0,11680
801,2019-09-18,3038,11669,1126,0,15833
801,2019-09-19,1692,4599,994,0,7285
801,2019-09-20,1451,12849,1739,0,16039
801,2019-09-21,535,11633,1620,0,13788
801,2019-09-22,427,15184,1871,0,17482
801,2019-09-23,1319,14133,2881,3,18336
801,2019-09-24,393,17138,2137,4,19672
801,2019-09-25,503,19461,1672,0,21636
801,2019-09-26,1260,11101,1732,4,14097
801,2019-09-27,1295,12657,1329,2,15283
801,2019-09-28,320,24172,1264,1,25757
801,2019-09-29,310,29011,1767,2,31090
801,2019-09-30,1132,21650,1701,0,24483
801,2019-10-01,293,16368,1348,3,18012
801,2019-10-02,387,11855,1322,0,13564
801,2019-10-03,456,14176,1778,2,16412
801,2019-10-04,299,12569,2472,2,15342
801,2019-10-05,1350,24530,1353,1,27234
801,2019-10-06,327,17305,1512,1,19145
801,2019-10-07,401,6959,1839,0,9199
801,2019-10-08,1115,18053,1443,0,20611
801,2019-10-09,1864,17731,1309,1,20905
801,2019-10-10,336,17805,1794,3,19938
801,2019-10-11,1124,10902,1508,3,13537
801,2019-10-12,2008,7097,1917,1,11023
801,2019-10-13,255,12247,1940,1,14443
801,2019-10-14,269,8064,1521,2,9856
801,2019-10-15,459,8404,1515,1,10379
801,2019-10-16,541,19279,1457,4,21281
801,2019-10-17,1148,9162,1096,2,11408
801,2019-10-18,412,8186,1216,1,9815
801,2019-10-19,376,5988,3000,1,9365
801,2019-10-20,242,3083,1538,0,4863
801,2019-10-21,1153,10830,1313,3,13299
801,2019-10-22,1382,15548,1644,2,18576
801,2019-10-23,2456,14680,1960,4,19100
801,2019-10-24,3469,13308,1341,0,18118
801,2019-10-25,1118,10405,976,1,12500
801,2019-10-26,1015,13637,1665,1,16318
801,2019-10-27,2823,16257,1982,1,21063
801,2019-10-28,1726,13473,1611,0,16810
801,2019-10-29,2046,26803,1221,1,30071
801,2019-10-30,2036,21250,1279,1,24566
801,2019-10-31,4300,12671,2116,2,19089
801,2019-11-01,6063,24936,1393,0,32392
801,2019-11-02,6542,16025,512,0,23079
801,2019-11-03,4542,21642,1834,0,28018
801,2019-11-04,5178,7831,1271,0,14280
801,2019-11-05,6857,4664,1953,0,13474
801,2019-11-06,2401,8346,1135,1,11883
801,2019-11-07,1996,13470,1636,2,17104
801,2019-11-08,28221,9685,994,0,38900
801,2019-11-09,7368,17492,1003,2,25865
801,2019-11-10,6453,24883,677,2,32015
801,2019-11-11,6645,16182,1600,2,24429
801,2019-11-12,5961,12336,2406,1,20704
801,2019-11-13,5884,11932,2116,3,19935
801,2019-11-14,6938,8731,2301,2,17972
801,2019-11-15,1407,3463,2725,1,7596
801,2019-11-16,2081,2580,1834,0,6495
801,2019-11-17,2112,3197,3610,0,8919
801,2019-11-18,1435,2650,2820,2,6907
801,2019-11-19,1426,3276,2652,0,7354
801,2019-11-20,1846,1775,1681,4,5306
801,2019-11-21,2247,3505,1092,0,6844
801,2019-11-22,2375,8076,1906,2,12359
801,2019-11-23,2333,6585,2461,1,11380
801,2019-11-24,1987,5044,1740,0,8771
801,2019-11-25,1984,6608,2259,1,10852
801,2019-11-26,1859,9857,1903,2,13621
801,2019-11-27,2640,6581,1173,0,10394
801,2019-11-28,1410,10900,809,1,13120
801,2019-11-29,81,799,3,0,883
801,2019-08-28,655,1020,1440,1,3116
801,2019-08-29,765,8396,1237,0,10398
801,2019-08-30,768,2792,551,0,4111
801,2019-08-31,502,134,1,0,637
801,2019-09-01,489,1022,357,0,1868
801,2019-09-02,469,58,256,0,783
801,2019-09-03,405,445,1285,1,2136
801,2019-09-04,804,12186,2180,1,15171
801,2019-09-05,777,8063,1591,1,10432
801,2019-09-06,589,9324,1914,3,11830
801,2019-09-07,1261,15903,1921,0,19085
801,2019-09-08,2997,8043,1106,1,12147
801,2019-09-09,2423,17229,2004,0,21656
801,2019-09-10,1729,8113,1969,0,11811
801,2019-09-11,1095,8827,2073,2,11997
801,2019-09-12,1701,7823,2861,1,12386
801,2019-09-13,861,7745,1836,2,10444
801,2019-09-14,544,7085,2292,1,9922
801,2019-09-15,2542,8544,1929,0,13015
801,2019-09-16,2048,5520,1744,0,9312
801,2019-09-17,2336,6756,2588,0,11680
801,2019-09-18,3038,11669,1126,0,15833
801,2019-09-19,1692,4599,994,0,7285
801,2019-09-20,1451,12849,1739,0,16039
801,2019-09-21,535,11633,1620,0,13788
801,2019-09-22,427,15184,1871,0,17482
801,2019-09-23,1319,14133,2881,3,18336
801,2019-09-24,393,17138,2137,4,19672
801,2019-09-25,503,19461,1672,0,21636
801,2019-09-26,1260,11101,1732,4,14097
801,2019-09-27,1295,12657,1329,2,15283
801,2019-09-28,320,24172,1264,1,25757
801,2019-09-29,310,29011,1767,2,31090
801,2019-09-30,1132,21650,1701,0,24483
801,2019-10-01,293,16368,1348,3,18012
801,2019-10-02,387,11855,1322,0,13564
801,2019-10-03,456,14176,1778,2,16412
801,2019-10-04,299,12569,2472,2,15342
801,2019-10-05,1350,24530,1353,1,27234
801,2019-10-06,327,17305,1512,1,19145
801,2019-10-07,401,6959,1839,0,9199
801,2019-10-08,1115,18053,1443,0,20611
801,2019-10-09,1864,17731,1309,1,20905
801,2019-10-10,336,17805,1794,3,19938
801,2019-10-11,1124,10902,1508,3,13537
801,2019-10-12,2008,7097,1917,1,11023
801,2019-10-13,255,12247,1940,1,14443
801,2019-10-14,269,8064,1521,2,9856
801,2019-10-15,459,8404,1515,1,10379
801,2019-10-16,541,19279,1457,4,21281
801,2019-10-17,1148,9162,1096,2,11408
801,2019-10-18,412,8186,1216,1,9815
801,2019-10-19,376,5988,3000,1,9365
801,2019-10-20,242,3083,1538,0,4863
801,2019-10-21,1153,10830,1313,3,13299
801,2019-10-22,1382,15548,1644,2,18576
801,2019-10-23,2456,14680,1960,4,19100
801,2019-10-24,3469,13308,1341,0,18118
801,2019-10-25,1118,10405,976,1,12500
801,2019-10-26,1015,13637,1665,1,16318
801,2019-10-27,2823,16257,1982,1,21063
801,2019-10-28,1726,13473,1611,0,16810
801,2019-10-29,2046,26803,1221,1,30071
801,2019-10-30,2036,21250,1279,1,24566
801,2019-10-31,4300,12671,2116,2,19089
801,2019-11-01,6063,24936,1393,0,32392
801,2019-11-02,6542,16025,512,0,23079
801,2019-11-03,4542,21642,1834,0,28018
801,2019-11-04,5178,7831,1271,0,14280
801,2019-11-05,6857,4664,1953,0,13474
801,2019-11-06,2401,8346,1135,1,11883
801,2019-11-07,1996,13470,1636,2,17104
801,2019-11-08,28221,9685,994,0,38900
801,2019-11-09,7368,17492,1003,2,25865
801,2019-11-10,6453,24883,677,2,32015
801,2019-11-11,6645,16182,1600,2,24429
801,2019-11-12,5961,12336,2406,1,20704
801,2019-11-13,5884,11932,2116,3,19935
801,2019-11-14,6938,8731,2301,2,17972
801,2019-11-15,1407,3463,2725,1,7596
801,2019-11-16,2081,2580,1834,0,6495
801,2019-11-17,2112,3197,3610,0,8919
801,2019-11-18,1435,2650,2820,2,6907
801,2019-11-19,1426,3276,2652,0,7354
801,2019-11-20,1846,1775,1681,4,5306
801,2019-11-21,2247,3505,1092,0,6844
801,2019-11-22,2375,8076,1906,2,12359
801,2019-11-23,2333,6585,2461,1,11380
801,2019-11-24,1987,5044,1740,0,8771
801,2019-11-25,1984,6608,2259,1,10852
801,2019-11-26,1859,9857,1903,2,13621
801,2019-11-27,2640,6581,1173,0,10394
801,2019-11-28,1410,10900,809,1,13120
801,2019-11-29,81,799,3,0,883
801,2019-08-27,0,0,360,0,360
801,2019-08-28,655,1020,1440,1,3116
801,2019-08-29,765,8396,1237,0,10398
801,2019-08-30,768,2792,551,0,4111
801,2019-08-31,502,134,1,0,637
801,2019-09-01,489,1022,357,0,1868
801,2019-09-02,469,58,256,0,783
801,2019-09-03,405,445,1285,1,2136
801,2019-09-04,804,12186,2180,1,15171
801,2019-09-05,777,8063,1591,1,10432
801,2019-09-06,589,9324,1914,3,11830
801,2019-09-07,1261,15903,1921,0,19085
801,2019-09-08,2997,8043,1106,1,12147
801,2019-09-09,2423,17229,2004,0,21656
801,2019-09-10,1729,8113,1969,0,11811
801,2019-09-11,1095,8827,2073,2,11997
801,2019-09-12,1701,7823,2861,1,12386
801,2019-09-13,861,7745,1836,2,10444
801,2019-09-14,544,7085,2292,1,9922
801,2019-09-15,2542,8544,1929,0,13015
801,2019-09-16,2048,5520,1744,0,9312
801,2019-09-17,2336,6756,2588,0,11680
801,2019-09-18,3038,11669,1126,0,15833
801,2019-09-19,1692,4599,994,0,7285
801,2019-09-20,1451,12849,1739,0,16039
801,2019-09-21,535,11633,1620,0,13788
801,2019-09-22,427,15184,1871,0,17482
801,2019-09-23,1319,14133,2881,3,18336
801,2019-09-24,393,17138,2137,4,19672
801,2019-09-25,503,19461,1672,0,21636
801,2019-09-26,1260,11101,1732,4,14097
801,2019-09-27,1295,12657,1329,2,15283
801,2019-09-28,320,24172,1264,1,25757
801,2019-09-29,310,29011,1767,2,31090
801,2019-09-30,1132,21650,1701,0,24483
801,2019-10-01,293,16368,1348,3,18012
801,2019-10-02,387,11855,1322,0,13564
801,2019-10-03,456,14176,1778,2,16412
801,2019-10-04,299,12569,2472,2,15342
801,2019-10-05,1350,24530,1353,1,27234
801,2019-10-06,327,17305,1512,1,19145
801,2019-10-07,401,6959,1839,0,9199
801,2019-10-08,1115,18053,1443,0,20611
801,2019-10-09,1864,17731,1309,1,20905
801,2019-10-10,336,17805,1794,3,19938
801,2019-10-11,1124,10902,1508,3,13537
801,2019-10-12,2008,7097,1917,1,11023
801,2019-10-13,255,12247,1940,1,14443
801,2019-10-14,269,8064,1521,2,9856
801,2019-10-15,459,8404,1515,1,10379
801,2019-10-16,541,19279,1457,4,21281
801,2019-10-17,1148,9162,1096,2,11408
801,2019-10-18,412,8186,1216,1,9815
801,2019-10-19,376,5988,3000,1,9365
801,2019-10-20,242,3083,1538,0,4863
801,2019-10-21,1153,10830,1313,3,13299
801,2019-10-22,1382,15548,1644,2,18576
801,2019-10-23,2456,14680,1960,4,19100
801,2019-10-24,3469,13308,1341,0,18118
801,2019-10-25,1118,10405,976,1,12500
801,2019-10-26,1015,13637,1665,1,16318
801,2019-10-27,2823,16257,1982,1,21063
801,2019-10-28,1726,13473,1611,0,16810
801,2019-10-29,2046,26803,1221,1,30071
801,2019-10-30,2036,21250,1279,1,24566
801,2019-10-31,4300,12671,2116,2,19089
801,2019-11-01,6063,24936,1393,0,32392
801,2019-11-02,6542,16025,512,0,23079
801,2019-11-03,4542,21642,1834,0,28018
801,2019-11-04,5178,7831,1271,0,14280
801,2019-11-05,6857,4664,1953,0,13474
801,2019-11-06,2401,8346,1135,1,11883
801,2019-11-07,1996,13470,1636,2,17104
801,2019-11-08,28221,9685,994,0,38900
801,2019-11-09,7368,17492,1003,2,25865
801,2019-11-10,6453,24883,677,2,32015
801,2019-11-11,6645,16182,1600,2,24429
801,2019-11-12,5961,12336,2406,1,20704
801,2019-11-13,5884,11932,2116,3,19935
801,2019-11-14,6938,8731,2301,2,17972
801,2019-11-15,1407,3463,2725,1,7596
801,2019-11-16,2081,2580,1834,0,6495
801,2019-11-17,2112,3197,3610,0,8919
801,2019-11-18,1435,2650,2820,2,6907
801,2019-11-19,1426,3276,2652,0,7354
801,2019-11-20,1846,1775,1681,4,5306
801,2019-11-21,2247,3505,1092,0,6844
801,2019-11-22,2375,8076,1906,2,12359
801,2019-11-23,2333,6585,2461,1,11380
801,2019-11-24,1987,5044,1740,0,8771
801,2019-11-25,1984,6608,2259,1,10852
801,2019-11-26,1859,9857,1903,2,13621
801,2019-11-27,2640,6581,1173,0,10394
801,2019-11-28,1410,10900,809,1,13120
801,2019-11-29,81,799,3,0,883
801,2019-08-28,655,1020,1440,1,3116
801,2019-08-29,765,8396,1237,0,10398
801,2019-08-30,768,2792,551,0,4111
801,2019-08-31,502,134,1,0,637
801,2019-09-01,489,1022,357,0,1868
801,2019-09-02,469,58,256,0,783
801,2019-09-03,405,445,1285,1,2136
801,2019-09-04,804,12186,2180,1,15171
801,2019-09-05,777,8063,1591,1,10432
801,2019-09-06,589,9324,1914,3,11830
801,2019-09-07,1261,15903,1921,0,19085
801,2019-09-08,2997,8043,1106,1,12147
801,2019-09-09,2423,17229,2004,0,21656
801,2019-09-10,1729,8113,1969,0,11811
801,2019-09-11,1095,8827,2073,2,11997
801,2019-09-12,1701,7823,2861,1,12386
801,2019-09-13,861,7745,1836,2,10444
801,2019-09-14,544,7085,2292,1,9922
801,2019-09-15,2542,8544,1929,0,13015
801,2019-09-16,2048,5520,1744,0,9312
801,2019-09-17,2336,6756,2588,0,11680
801,2019-09-18,3038,11669,1126,0,15833
801,2019-09-19,1692,4599,994,0,7285
801,2019-09-20,1451,12849,1739,0,16039
801,2019-09-21,535,11633,1620,0,13788
801,2019-09-22,427,15184,1871,0,17482
801,2019-09-23,1319,14133,2881,3,18336
801,2019-09-24,393,17138,2137,4,19672
801,2019-09-25,503,19461,1672,0,21636
801,2019-09-26,1260,11101,1732,4,14097
801,2019-09-27,1295,12657,1329,2,15283
801,2019-09-28,320,24172,1264,1,25757
801,2019-09-29,310,29011,1767,2,31090
801,2019-09-30,1132,21650,1701,0,24483
801,2019-10-01,293,16368,1348,3,18012
801,2019-10-02,387,11855,1322,0,13564
801,2019-10-03,456,14176,1778,2,16412
801,2019-10-04,299,12569,2472,2,15342
801,2019-10-05,1350,24530,1353,1,27234
801,2019-10-06,327,17305,1512,1,19145
801,2019-10-07,401,6959,1839,0,9199
801,2019-10-08,1115,18053,1443,0,20611
801,2019-10-09,1864,17731,1309,1,20905
801,2019-10-10,336,17805,1794,3,19938
801,2019-10-11,1124,10902,1508,3,13537
801,2019-10-12,2008,7097,1917,1,11023
801,2019-10-13,255,12247,1940,1,14443
801,2019-10-14,269,8064,1521,2,9856
801,2019-10-15,459,8404,1515,1,10379
801,2019-10-16,541,19279,1457,4,21281
801,2019-10-17,1148,9162,1096,2,11408
801,2019-10-18,412,8186,1216,1,9815
801,2019-10-19,376,5988,3000,1,9365
801,2019-10-20,242,3083,1538,0,4863
801,2019-10-21,1153,10830,1313,3,13299
801,2019-10-22,1382,15548,1644,2,18576
801,2019-10-23,2456,14680,1960,4,19100
801,2019-10-24,3469,13308,1341,0,18118
801,2019-10-25,1118,10405,976,1,12500
801,2019-10-26,1015,13637,1665,1,16318
801,2019-10-27,2823,16257,1982,1,21063
801,2019-10-28,1726,13473,1611,0,16810
801,2019-10-29,2046,26803,1221,1,30071
801,2019-10-30,2036,21250,1279,1,24566
801,2019-10-31,4300,12671,2116,2,19089
801,2019-11-01,6063,24936,1393,0,32392
801,2019-11-02,6542,16025,512,0,23079
801,2019-11-03,4542,21642,1834,0,28018
801,2019-11-04,5178,7831,1271,0,14280
801,2019-11-05,6857,4664,1953,0,13474
801,2019-11-06,2401,8346,1135,1,11883
801,2019-11-07,1996,13470,1636,2,17104
801,2019-11-08,28221,9685,994,0,38900
801,2019-11-09,7368,17492,1003,2,25865
801,2019-11-10,6453,24883,677,2,32015
801,2019-11-11,6645,16182,1600,2,24429
801,2019-11-12,5961,12336,2406,1,20704
801,2019-11-13,5884,11932,2116,3,19935
801,2019-11-14,6938,8731,2301,2,17972
801,2019-11-15,1407,3463,2725,1,7596
801,2019-11-16,2081,2580,1834,0,6495
801,2019-11-17,2112,3197,3610,0,8919
801,2019-11-18,1435,2650,2820,2,6907
801,2019-11-19,1426,3276,2652,0,7354
801,2019-11-20,1846,1775,1681,4,5306
801,2019-11-21,2247,3505,1092,0,6844
801,2019-11-22,2375,8076,1906,2,12359
801,2019-11-23,2333,6585,2461,1,11380
801,2019-11-24,1987,5044,1740,0,8771
801,2019-11-25,1984,6608,2259,1,10852
801,2019-11-26,1859,9857,1903,2,13621
801,2019-11-27,2640,6581,1173,0,10394
801,2019-11-28,1410,10900,809,1,13120
827,2019-08-29,90,635,1710,1,2436
827,2019-08-30,169,1192,90,2,1453
827,2019-08-31,124,29,1,2,156
827,2019-09-01,141,12,0,1,154
827,2019-09-02,114,0,83,2,199
827,2019-09-03,150,0,877,0,1027
827,2019-09-04,174,34,1965,3,2176
827,2019-09-05,1081,15,2136,1,3233
827,2019-09-06,228,144,1841,0,2213
827,2019-09-07,276,154,2110,1,2541
827,2019-09-08,236,1107,2170,1,3514
827,2019-09-09,193,1921,2226,1,4341
827,2019-09-10,114,656,2502,0,3272
827,2019-09-11,126,1076,1851,1,3054
827,2019-09-12,1048,1384,2526,2,4960
827,2019-09-13,103,1341,2467,0,3911
827,2019-09-14,88,140,2343,1,2572
827,2019-09-15,85,480,2365,2,2932
827,2019-09-16,202,31,2341,1,2575
827,2019-09-17,76,978,2981,1,4036
827,2019-09-18,98,33,2359,0,2490
827,2019-09-19,339,2353,2430,0,5122
827,2019-09-20,183,10967,2166,0,13316
827,2019-09-21,93,7002,2791,0,9886
827,2019-09-22,939,8696,1262,0,10897
827,2019-09-23,207,14165,1584,0,15956
827,2019-09-24,133,7047,1565,2,8747
827,2019-09-25,105,7783,1823,2,9713
827,2019-09-26,110,12300,2100,0,14510
827,2019-09-27,81,8454,1977,5,10517
827,2019-09-28,101,14808,2333,2,17244
827,2019-09-29,179,17780,965,2,18926
827,2019-09-30,89,18033,2491,1,20614
827,2019-10-01,86,14771,2216,2,17075
827,2019-10-02,564,11251,1835,0,13650
827,2019-10-03,181,12845,846,0,13872
827,2019-10-04,750,11396,1953,7,14106
827,2019-10-05,88,13838,1564,1,15491
827,2019-10-06,89,10660,2242,0,12991
827,2019-10-07,233,5024,2066,4,7327
827,2019-10-08,97,12805,1703,1,14606
827,2019-10-09,105,14077,1344,0,15526
827,2019-10-10,1210,12320,2007,3,15540
827,2019-10-11,509,9063,1733,3,11308
827,2019-10-12,967,5822,2046,1,8836
827,2019-10-13,84,7273,1612,1,8970
827,2019-10-14,1858,9467,1455,1,12781
827,2019-10-15,1091,10735,1542,1,13369
827,2019-10-16,104,12413,843,1,13361
827,2019-10-17,84,3586,1557,4,5231
827,2019-10-18,1875,8605,1158,1,11639
827,2019-10-19,959,3815,2481,0,7255
827,2019-10-20,75,4598,1232,0,5905
827,2019-10-21,317,17593,2043,1,19954
827,2019-10-22,3109,8544,1908,3,13564
827,2019-10-23,85,12969,2061,1,15116
827,2019-10-24,159,24753,1651,2,26565
827,2019-10-25,137,13706,1170,1,15014
827,2019-10-26,209,20341,942,0,21492
827,2019-10-27,1119,20188,1024,1,22332
827,2019-10-28,98,22332,1032,1,23463
827,2019-10-29,187,17473,2008,2,19670
827,2019-10-30,130,15033,1593,0,16756
827,2019-10-31,85,11638,1520,1,13244
827,2019-11-01,69,24544,1531,2,26146
827,2019-11-02,68,15976,1609,0,17653
827,2019-11-03,108,23905,1037,1,25051
827,2019-11-04,113,9916,1222,1,11252
827,2019-11-05,429,1043,1361,1,2834
827,2019-11-06,209,7477,1294,2,8982
827,2019-11-07,799,14743,1053,4,16599
827,2019-11-08,682,8845,1580,0,11107
827,2019-11-09,60,7759,1663,0,9482
827,2019-11-10,490,23267,950,0,24707
827,2019-11-11,97,14813,1282,4,16196
827,2019-11-12,143,17123,2512,1,19779
827,2019-11-13,975,12131,2058,0,15164
827,2019-11-14,82,7618,2065,484,10249
827,2019-11-15,209,4376,2102,2,6689
827,2019-11-16,77,2740,2233,372,5422
827,2019-11-17,184,5680,3253,0,9117
827,2019-11-18,215,2622,2974,0,5811
827,2019-11-19,124,3124,2907,0,6155
827,2019-11-20,97,1339,3130,0,4566
827,2019-11-21,108,3250,1859,0,5217
827,2019-11-22,105,5884,1106,0,7095
827,2019-11-23,388,6095,1596,0,8079
827,2019-11-24,110,8461,2124,0,10695
827,2019-11-25,310,6955,2002,0,9267
827,2019-11-26,101,5774,1451,0,7326
827,2019-11-27,585,6581,1510,0,8676
827,2019-11-28,728,12528,766,0,14022
827,2019-11-29,36,171,1,0,208
827,2019-08-29,90,635,1710,1,2436
827,2019-08-30,169,1192,90,2,1453
827,2019-08-31,124,29,1,2,156
827,2019-09-01,141,12,0,1,154
827,2019-09-02,114,0,83,2,199
827,2019-09-03,150,0,877,0,1027
827,2019-09-04,174,34,1965,3,2176
827,2019-09-05,1081,15,2136,1,3233
827,2019-09-06,228,144,1841,0,2213
827,2019-09-07,276,154,2110,1,2541
827,2019-09-08,236,1107,2170,1,3514
827,2019-09-09,193,1921,2226,1,4341
827,2019-09-10,114,656,2502,0,3272
827,2019-09-11,126,1076,1851,1,3054
827,2019-09-12,1048,1384,2526,2,4960
827,2019-09-13,103,1341,2467,0,3911
827,2019-09-14,88,140,2343,1,2572
827,2019-09-15,85,480,2365,2,2932
827,2019-09-16,202,31,2341,1,2575
827,2019-09-17,76,978,2981,1,4036
827,2019-09-18,98,33,2359,0,2490
827,2019-09-19,339,2353,2430,0,5122
827,2019-09-20,183,10967,2166,0,13316
827,2019-09-21,93,7002,2791,0,9886
827,2019-09-22,939,8696,1262,0,10897
827,2019-09-23,207,14165,1584,0,15956
827,2019-09-24,133,7047,1565,2,8747
827,2019-09-25,105,7783,1823,2,9713
827,2019-09-26,110,12300,2100,0,14510
827,2019-09-27,81,8454,1977,5,10517
827,2019-09-28,101,14808,2333,2,17244
827,2019-09-29,179,17780,965,2,18926
827,2019-09-30,89,18033,2491,1,20614
827,2019-10-01,86,14771,2216,2,17075
827,2019-10-02,564,11251,1835,0,13650
827,2019-10-03,181,12845,846,0,13872
827,2019-10-04,750,11396,1953,7,14106
827,2019-10-05,88,13838,1564,1,15491
827,2019-10-06,89,10660,2242,0,12991
827,2019-10-07,233,5024,2066,4,7327
827,2019-10-08,97,12805,1703,1,14606
827,2019-10-09,105,14077,1344,0,15526
827,2019-10-10,1210,12320,2007,3,15540
827,2019-10-11,509,9063,1733,3,11308
827,2019-10-12,967,5822,2046,1,8836
827,2019-10-13,84,7273,1612,1,8970
827,2019-10-14,1858,9467,1455,1,12781
827,2019-10-15,1091,10735,1542,1,13369
827,2019-10-16,104,12413,843,1,13361
827,2019-10-17,84,3586,1557,4,5231
827,2019-10-18,1875,8605,1158,1,11639
827,2019-10-19,959,3815,2481,0,7255
827,2019-10-20,75,4598,1232,0,5905
827,2019-10-21,317,17593,2043,1,19954
827,2019-10-22,3109,8544,1908,3,13564
827,2019-10-23,85,12969,2061,1,15116
827,2019-10-24,159,24753,1651,2,26565
827,2019-10-25,137,13706,1170,1,15014
827,2019-10-26,209,20341,942,0,21492
827,2019-10-27,1119,20188,1024,1,22332
827,2019-10-28,98,22332,1032,1,23463
827,2019-10-29,187,17473,2008,2,19670
827,2019-10-30,130,15033,1593,0,16756
827,2019-10-31,85,11638,1520,1,13244
827,2019-11-01,69,24544,1531,2,26146
827,2019-11-02,68,15976,1609,0,17653
827,2019-11-03,108,23905,1037,1,25051
827,2019-11-04,113,9916,1222,1,11252
827,2019-11-05,429,1043,1361,1,2834
827,2019-11-06,209,7477,1294,2,8982
827,2019-11-07,799,14743,1053,4,16599
827,2019-11-08,682,8845,1580,0,11107
827,2019-11-09,60,7759,1663,0,9482
827,2019-11-10,490,23267,950,0,24707
827,2019-11-11,97,14813,1282,4,16196
827,2019-11-12,143,17123,2512,1,19779
827,2019-11-13,975,12131,2058,0,15164
827,2019-11-14,82,7618,2065,484,10249
827,2019-11-15,209,4376,2102,2,6689
827,2019-11-16,77,2740,2233,372,5422
827,2019-11-17,184,5680,3253,0,9117
827,2019-11-18,215,2622,2974,0,5811
827,2019-11-19,124,3124,2907,0,6155
827,2019-11-20,97,1339,3130,0,4566
827,2019-11-21,108,3250,1859,0,5217
827,2019-11-22,105,5884,1106,0,7095
827,2019-11-23,388,6095,1596,0,8079
827,2019-11-24,110,8461,2124,0,10695
827,2019-11-25,310,6955,2002,0,9267
827,2019-11-26,101,5774,1451,0,7326
827,2019-11-27,585,6581,1510,0,8676
827,2019-11-28,728,12528,766,0,14022
827,2019-11-29,36,171,1,0,208
827,2019-08-29,90,635,1710,1,2436
827,2019-08-30,169,1192,90,2,1453
827,2019-08-31,124,29,1,2,156
827,2019-09-01,141,12,0,1,154
827,2019-09-02,114,0,83,2,199
827,2019-09-03,150,0,877,0,1027
827,2019-09-04,174,34,1965,3,2176
827,2019-09-05,1081,15,2136,1,3233
827,2019-09-06,228,144,1841,0,2213
827,2019-09-07,276,154,2110,1,2541
827,2019-09-08,236,1107,2170,1,3514
827,2019-09-09,193,1921,2226,1,4341
827,2019-09-10,114,656,2502,0,3272
827,2019-09-11,126,1076,1851,1,3054
827,2019-09-12,1048,1384,2526,2,4960
827,2019-09-13,103,1341,2467,0,3911
827,2019-09-14,88,140,2343,1,2572
827,2019-09-15,85,480,2365,2,2932
827,2019-09-16,202,31,2341,1,2575
827,2019-09-17,76,978,2981,1,4036
827,2019-09-18,98,33,2359,0,2490
827,2019-09-19,339,2353,2430,0,5122
827,2019-09-20,183,10967,2166,0,13316
827,2019-09-21,93,7002,2791,0,9886
827,2019-09-22,939,8696,1262,0,10897
827,2019-09-23,207,14165,1584,0,15956
827,2019-09-24,133,7047,1565,2,8747
827,2019-09-25,105,7783,1823,2,9713
827,2019-09-26,110,12300,2100,0,14510
827,2019-09-27,81,8454,1977,5,10517
827,2019-09-28,101,14808,2333,2,17244
827,2019-09-29,179,17780,965,2,18926
827,2019-09-30,89,18033,2491,1,20614
827,2019-10-01,86,14771,2216,2,17075
827,2019-10-02,564,11251,1835,0,13650
827,2019-10-03,181,12845,846,0,13872
827,2019-10-04,750,11396,1953,7,14106
827,2019-10-05,88,13838,1564,1,15491
827,2019-10-06,89,10660,2242,0,12991
827,2019-10-07,233,5024,2066,4,7327
827,2019-10-08,97,12805,1703,1,14606
827,2019-10-09,105,14077,1344,0,15526
827,2019-10-10,1210,12320,2007,3,15540
827,2019-10-11,509,9063,1733,3,11308
827,2019-10-12,967,5822,2046,1,8836
827,2019-10-13,84,7273,1612,1,8970
827,2019-10-14,1858,9467,1455,1,12781
827,2019-10-15,1091,10735,1542,1,13369
827,2019-10-16,104,12413,843,1,13361
827,2019-10-17,84,3586,1557,4,5231
827,2019-10-18,1875,8605,1158,1,11639
827,2019-10-19,959,3815,2481,0,7255
827,2019-10-20,75,4598,1232,0,5905
827,2019-10-21,317,17593,2043,1,19954
827,2019-10-22,3109,8544,1908,3,13564
827,2019-10-23,85,12969,2061,1,15116
827,2019-10-24,159,24753,1651,2,26565
827,2019-10-25,137,13706,1170,1,15014
827,2019-10-26,209,20341,942,0,21492
827,2019-10-27,1119,20188,1024,1,22332
827,2019-10-28,98,22332,1032,1,23463
827,2019-10-29,187,17473,2008,2,19670
827,2019-10-30,130,15033,1593,0,16756
827,2019-10-31,85,11638,1520,1,13244
827,2019-11-01,69,24544,1531,2,26146
827,2019-11-02,68,15976,1609,0,17653
827,2019-11-03,108,23905,1037,1,25051
827,2019-11-04,113,9916,1222,1,11252
827,2019-11-05,429,1043,1361,1,2834
827,2019-11-06,209,7477,1294,2,8982
827,2019-11-07,799,14743,1053,4,16599
827,2019-11-08,682,8845,1580,0,11107
827,2019-11-09,60,7759,1663,0,9482
827,2019-11-10,490,23267,950,0,24707
827,2019-11-11,97,14813,1282,4,16196
827,2019-11-12,143,17123,2512,1,19779
827,2019-11-13,975,12131,2058,0,15164
827,2019-11-14,82,7618,2065,484,10249
827,2019-11-15,209,4376,2102,2,6689
827,2019-11-16,77,2740,2233,372,5422
827,2019-11-17,184,5680,3253,0,9117
827,2019-11-18,215,2622,2974,0,5811
827,2019-11-19,124,3124,2907,0,6155
827,2019-11-20,97,1339,3130,0,4566
827,2019-11-21,108,3250,1859,0,5217
827,2019-11-22,105,5884,1106,0,7095
827,2019-11-23,388,6095,1596,0,8079
827,2019-11-24,110,8461,2124,0,10695
827,2019-11-25,310,6955,2002,0,9267
827,2019-11-26,101,5774,1451,0,7326
827,2019-11-27,585,6581,1510,0,8676
827,2019-11-28,728,12528,766,0,14022
827,2019-11-29,36,171,1,0,208
827,2019-08-29,90,635,1710,1,2436
827,2019-08-30,169,1192,90,2,1453
827,2019-08-31,124,29,1,2,156
827,2019-09-01,141,12,0,1,154
827,2019-09-02,114,0,83,2,199
827,2019-09-03,150,0,877,0,1027
827,2019-09-04,174,34,1965,3,2176
827,2019-09-05,1081,15,2136,1,3233
827,2019-09-06,228,144,1841,0,2213
827,2019-09-07,276,154,2110,1,2541
827,2019-09-08,236,1107,2170,1,3514
827,2019-09-09,193,1921,2226,1,4341
827,2019-09-10,114,656,2502,0,3272
827,2019-09-11,126,1076,1851,1,3054
827,2019-09-12,1048,1384,2526,2,4960
827,2019-09-13,103,1341,2467,0,3911
827,2019-09-14,88,140,2343,1,2572
827,2019-09-15,85,480,2365,2,2932
827,2019-09-16,202,31,2341,1,2575
827,2019-09-17,76,978,2981,1,4036
827,2019-09-18,98,33,2359,0,2490
827,2019-09-19,339,2353,2430,0,5122
827,2019-09-20,183,10967,2166,0,13316
827,2019-09-21,93,7002,2791,0,9886
827,2019-09-22,939,8696,1262,0,10897
827,2019-09-23,207,14165,1584,0,15956
827,2019-09-24,133,7047,1565,2,8747
827,2019-09-25,105,7783,1823,2,9713
827,2019-09-26,110,12300,2100,0,14510
827,2019-09-27,81,8454,1977,5,10517
827,2019-09-28,101,14808,2333,2,17244
827,2019-09-29,179,17780,965,2,18926
827,2019-09-30,89,18033,2491,1,20614
827,2019-10-01,86,14771,2216,2,17075
827,2019-10-02,564,11251,1835,0,13650
827,2019-10-03,181,12845,846,0,13872
827,2019-10-04,750,11396,1953,7,14106
827,2019-10-05,88,13838,1564,1,15491
827,2019-10-06,89,10660,2242,0,12991
827,2019-10-07,233,5024,2066,4,7327
827,2019-10-08,97,12805,1703,1,14606
827,2019-10-09,105,14077,1344,0,15526
827,2019-10-10,1210,12320,2007,3,15540
827,2019-10-11,509,9063,1733,3,11308
827,2019-10-12,967,5822,2046,1,8836
827,2019-10-13,84,7273,1612,1,8970
827,2019-10-14,1858,9467,1455,1,12781
827,2019-10-15,1091,10735,1542,1,13369
827,2019-10-16,104,12413,843,1,13361
827,2019-10-17,84,3586,1557,4,5231
827,2019-10-18,1875,8605,1158,1,11639
827,2019-10-19,959,3815,2481,0,7255
827,2019-10-20,75,4598,1232,0,5905
827,2019-10-21,317,17593,2043,1,19954
827,2019-10-22,3109,8544,1908,3,13564
827,2019-10-23,85,12969,2061,1,15116
827,2019-10-24,159,24753,1651,2,26565
827,2019-10-25,137,13706,1170,1,15014
827,2019-10-26,209,20341,942,0,21492
827,2019-10-27,1119,20188,1024,1,22332
827,2019-10-28,98,22332,1032,1,23463
827,2019-10-29,187,17473,2008,2,19670
827,2019-10-30,130,15033,1593,0,16756
827,2019-10-31,85,11638,1520,1,13244
827,2019-11-01,69,24544,1531,2,26146
827,2019-11-02,68,15976,1609,0,17653
827,2019-11-03,108,23905,1037,1,25051
827,2019-11-04,113,9916,1222,1,11252
827,2019-11-05,429,1043,1361,1,2834
827,2019-11-06,209,7477,1294,2,8982
827,2019-11-07,799,14743,1053,4,16599
827,2019-11-08,682,8845,1580,0,11107
827,2019-11-09,60,7759,1663,0,9482
827,2019-11-10,490,23267,950,0,24707
827,2019-11-11,97,14813,1282,4,16196
827,2019-11-12,143,17123,2512,1,19779
827,2019-11-13,975,12131,2058,0,15164
827,2019-11-14,82,7618,2065,484,10249
827,2019-11-15,209,4376,2102,2,6689
827,2019-11-16,77,2740,2233,372,5422
828,2019-08-29,94,818,1414,0,2326
828,2019-08-30,130,357,651,0,1138
828,2019-08-31,94,20,22,0,136
828,2019-09-01,191,6,90,0,287
828,2019-09-02,72,0,77,0,149
828,2019-09-03,137,0,1298,0,1435
828,2019-09-04,976,72,2320,1,3369
828,2019-09-05,509,83,2451,1,3044
828,2019-09-06,221,49,2001,2,2273
828,2019-09-07,310,58,1620,2,1990
828,2019-09-08,1055,478,1914,0,3447
828,2019-09-09,744,290,1539,2,2575
828,2019-09-10,936,291,1807,0,3034
828,2019-09-11,950,314,2242,2,3508
828,2019-09-12,1034,170,2224,2,3430
828,2019-09-13,66,29,2283,0,2378
828,2019-09-14,92,36,1276,0,1404
828,2019-09-15,146,56,1787,1,1990
828,2019-09-16,1240,39,1440,1,2720
828,2019-09-17,91,5211,1907,2,7211
828,2019-09-18,916,37,1166,0,2119
828,2019-09-19,1168,8228,1800,0,11196
828,2019-09-20,179,8343,1649,0,10171
828,2019-09-21,113,6322,1206,0,7641
828,2019-09-22,79,15366,1829,0,17274
828,2019-09-23,1104,12867,1410,1,15382
828,2019-09-24,976,10414,1739,4,13133
828,2019-09-25,106,9662,1643,1,11412
828,2019-09-26,136,15195,1866,0,17197
828,2019-09-27,89,8480,1841,5,10415
828,2019-09-28,162,22656,973,3,23794
828,2019-09-29,112,27836,1260,3,29211
828,2019-09-30,688,18962,1691,0,21341
828,2019-10-01,986,19186,1760,0,21932
828,2019-10-02,1481,12660,1373,0,15514
828,2019-10-03,163,21421,1639,0,23223
828,2019-10-04,83,19342,1287,3,20715
828,2019-10-05,255,23193,1293,2,24743
828,2019-10-06,144,15356,2000,0,17500
828,2019-10-07,292,4531,1298,1,6122
828,2019-10-08,311,17745,1374,1,19431
828,2019-10-09,139,25368,1871,3,27381
828,2019-10-10,146,16727,2867,0,19740
828,2019-10-11,128,16085,1180,0,17393
828,2019-10-12,177,7865,2017,0,10059
828,2019-10-13,1996,8790,1644,2,12432
828,2019-10-14,1587,4238,1647,2,7474
828,2019-10-15,1329,13444,1438,0,16211
828,2019-10-16,307,22759,1466,2,24534
828,2019-10-17,979,6626,1912,0,9517
828,2019-10-18,330,13524,1522,3,15379
828,2019-10-19,954,10682,1449,0,13085
828,2019-10-20,1005,2241,1615,1,4862
828,2019-10-21,166,10329,1481,0,11976
828,2019-10-22,124,4608,1844,2,6578
828,2019-10-23,106,12772,1512,0,14390
828,2019-10-24,186,18199,1435,2,19822
828,2019-10-25,122,14733,1771,2,16628
828,2019-10-26,1879,16090,1744,0,19713
828,2019-10-27,1084,15760,1760,1,18605
828,2019-10-28,455,22233,1668,0,24356
828,2019-10-29,212,28562,1621,3,30398
828,2019-10-30,554,28296,1288,2,30140
828,2019-10-31,921,13344,2595,1,16861
828,2019-11-01,88,26293,1966,0,28347
828,2019-11-02,97,16230,2068,0,18395
828,2019-11-03,85,21614,1731,5,23435
828,2019-11-04,119,9840,1696,1,11656
828,2019-11-05,226,2000,2254,1,4481
828,2019-11-06,183,13498,984,0,14665
828,2019-11-07,167,16286,972,3,17428
828,2019-11-08,115,8784,985,0,9884
828,2019-11-09,979,7610,1459,0,10048
828,2019-11-10,934,12165,869,0,13968
828,2019-11-11,1940,12351,1931,1,16223
828,2019-11-12,163,16156,2826,2,19147
828,2019-11-13,622,21365,2226,2,24215
828,2019-11-14,197,9763,1836,2,11798
828,2019-11-15,200,4277,1730,2,6209
828,2019-11-16,206,2872,3030,0,6108
828,2019-11-17,99,7123,3605,0,10827
828,2019-11-18,554,3351,4268,3,8176
828,2019-11-19,131,5415,2411,0,7957
828,2019-11-20,130,1572,2452,0,4154
828,2019-11-21,111,5485,1661,0,7257
828,2019-11-22,105,5891,1798,2,7796
828,2019-11-23,88,6045,1895,3,8031
828,2019-11-24,231,7019,1775,2,9027
828,2019-11-25,215,6748,2103,0,9066
828,2019-11-26,92,5669,1118,0,6879
828,2019-11-27,1017,6699,1497,2,9215
828,2019-11-28,319,7960,735,1,9015
828,2019-11-29,15,426,1,0,442
828,2019-08-29,94,818,1414,0,2326
828,2019-08-30,130,357,651,0,1138
828,2019-08-31,94,20,22,0,136
828,2019-09-01,191,6,90,0,287
828,2019-09-02,72,0,77,0,149
828,2019-09-03,137,0,1298,0,1435
828,2019-09-04,976,72,2320,1,3369
828,2019-09-05,509,83,2451,1,3044
828,2019-09-06,221,49,2001,2,2273
828,2019-09-07,310,58,1620,2,1990
828,2019-09-08,1055,478,1914,0,3447
828,2019-09-09,744,290,1539,2,2575
828,2019-09-10,936,291,1807,0,3034
828,2019-09-11,950,314,2242,2,3508
828,2019-09-12,1034,170,2224,2,3430
828,2019-09-13,66,29,2283,0,2378
828,2019-09-14,92,36,1276,0,1404
828,2019-09-15,146,56,1787,1,1990
828,2019-09-16,1240,39,1440,1,2720
828,2019-09-17,91,5211,1907,2,7211
828,2019-09-18,916,37,1166,0,2119
828,2019-09-19,1168,8228,1800,0,11196
828,2019-09-20,179,8343,1649,0,10171
828,2019-09-21,113,6322,1206,0,7641
828,2019-09-22,79,15366,1829,0,17274
828,2019-09-23,1104,12867,1410,1,15382
828,2019-09-24,976,10414,1739,4,13133
828,2019-09-25,106,9662,1643,1,11412
828,2019-09-26,136,15195,1866,0,17197
828,2019-09-27,89,8480,1841,5,10415
828,2019-09-28,162,22656,973,3,23794
828,2019-09-29,112,27836,1260,3,29211
828,2019-09-30,688,18962,1691,0,21341
828,2019-10-01,986,19186,1760,0,21932
828,2019-10-02,1481,12660,1373,0,15514
828,2019-10-03,163,21421,1639,0,23223
828,2019-10-04,83,19342,1287,3,20715
828,2019-10-05,255,23193,1293,2,24743
828,2019-10-06,144,15356,2000,0,17500
828,2019-10-07,292,4531,1298,1,6122
828,2019-10-08,311,17745,1374,1,19431
828,2019-10-09,139,25368,1871,3,27381
828,2019-10-10,146,16727,2867,0,19740
828,2019-10-11,128,16085,1180,0,17393
828,2019-10-12,177,7865,2017,0,10059
828,2019-10-13,1996,8790,1644,2,12432
828,2019-10-14,1587,4238,1647,2,7474
828,2019-10-15,1329,13444,1438,0,16211
828,2019-10-16,307,22759,1466,2,24534
828,2019-10-17,979,6626,1912,0,9517
828,2019-10-18,330,13524,1522,3,15379
828,2019-10-19,954,10682,1449,0,13085
828,2019-10-20,1005,2241,1615,1,4862
828,2019-10-21,166,10329,1481,0,11976
828,2019-10-22,124,4608,1844,2,6578
828,2019-10-23,106,12772,1512,0,14390
828,2019-10-24,186,18199,1435,2,19822
828,2019-10-25,122,14733,1771,2,16628
828,2019-10-26,1879,16090,1744,0,19713
828,2019-10-27,1084,15760,1760,1,18605
828,2019-10-28,455,22233,1668,0,24356
828,2019-10-29,212,28562,1621,3,30398
828,2019-10-30,554,28296,1288,2,30140
828,2019-10-31,921,13344,2595,1,16861
828,2019-11-01,88,26293,1966,0,28347
828,2019-11-02,97,16230,2068,0,18395
828,2019-11-03,85,21614,1731,5,23435
828,2019-11-04,119,9840,1696,1,11656
828,2019-11-05,226,2000,2254,1,4481
828,2019-11-06,183,13498,984,0,14665
828,2019-11-07,167,16286,972,3,17428
828,2019-11-08,115,8784,985,0,9884
828,2019-11-09,979,7610,1459,0,10048
828,2019-11-10,934,12165,869,0,13968
828,2019-11-11,1940,12351,1931,1,16223
828,2019-11-12,163,16156,2826,2,19147
828,2019-11-13,622,21365,2226,2,24215
828,2019-11-14,197,9763,1836,2,11798
828,2019-11-15,200,4277,1730,2,6209
828,2019-11-16,206,2872,3030,0,6108
828,2019-11-17,99,7123,3605,0,10827
828,2019-11-18,554,3351,4268,3,8176
828,2019-11-19,131,5415,2411,0,7957
828,2019-11-20,130,1572,2452,0,4154
828,2019-11-21,111,5485,1661,0,7257
828,2019-11-22,105,5891,1798,2,7796
828,2019-11-23,88,6045,1895,3,8031
828,2019-11-24,231,7019,1775,2,9027
828,2019-11-25,215,6748,2103,0,9066
828,2019-11-26,92,5669,1118,0,6879
828,2019-11-27,1017,6699,1497,2,9215
828,2019-11-28,319,7960,735,1,9015
828,2019-11-29,15,426,1,0,442
828,2019-08-29,94,818,1414,0,2326
828,2019-08-30,130,357,651,0,1138
828,2019-08-31,94,20,22,0,136
828,2019-09-01,191,6,90,0,287
828,2019-09-02,72,0,77,0,149
828,2019-09-03,137,0,1298,0,1435
828,2019-09-04,976,72,2320,1,3369
828,2019-09-05,509,83,2451,1,3044
828,2019-09-06,221,49,2001,2,2273
828,2019-09-07,310,58,1620,2,1990
828,2019-09-08,1055,478,1914,0,3447
828,2019-09-09,744,290,1539,2,2575
828,2019-09-10,936,291,1807,0,3034
828,2019-09-11,950,314,2242,2,3508
828,2019-09-12,1034,170,2224,2,3430
828,2019-09-13,66,29,2283,0,2378
828,2019-09-14,92,36,1276,0,1404
828,2019-09-15,146,56,1787,1,1990
828,2019-09-16,1240,39,1440,1,2720
828,2019-09-17,91,5211,1907,2,7211
828,2019-09-18,916,37,1166,0,2119
828,2019-09-19,1168,8228,1800,0,11196
828,2019-09-20,179,8343,1649,0,10171
828,2019-09-21,113,6322,1206,0,7641
828,2019-09-22,79,15366,1829,0,17274
828,2019-09-23,1104,12867,1410,1,15382
828,2019-09-24,976,10414,1739,4,13133
828,2019-09-25,106,9662,1643,1,11412
828,2019-09-26,136,15195,1866,0,17197
828,2019-09-27,89,8480,1841,5,10415
828,2019-09-28,162,22656,973,3,23794
828,2019-09-29,112,27836,1260,3,29211
828,2019-09-30,688,18962,1691,0,21341
828,2019-10-01,986,19186,1760,0,21932
828,2019-10-02,1481,12660,1373,0,15514
828,2019-10-03,163,21421,1639,0,23223
828,2019-10-04,83,19342,1287,3,20715
828,2019-10-05,255,23193,1293,2,24743
828,2019-10-06,144,15356,2000,0,17500
828,2019-10-07,292,4531,1298,1,6122
828,2019-10-08,311,17745,1374,1,19431
828,2019-10-09,139,25368,1871,3,27381
828,2019-10-10,146,16727,2867,0,19740
828,2019-10-11,128,16085,1180,0,17393
828,2019-10-12,177,7865,2017,0,10059
828,2019-10-13,1996,8790,1644,2,12432
828,2019-10-14,1587,4238,1647,2,7474
828,2019-10-15,1329,13444,1438,0,16211
828,2019-10-16,307,22759,1466,2,24534
828,2019-10-17,979,6626,1912,0,9517
828,2019-10-18,330,13524,1522,3,15379
828,2019-10-19,954,10682,1449,0,13085
828,2019-10-20,1005,2241,1615,1,4862
828,2019-10-21,166,10329,1481,0,11976
828,2019-10-22,124,4608,1844,2,6578
828,2019-10-23,106,12772,1512,0,14390
828,2019-10-24,186,18199,1435,2,19822
828,2019-10-25,122,14733,1771,2,16628
828,2019-10-26,1879,16090,1744,0,19713
828,2019-10-27,1084,15760,1760,1,18605
828,2019-10-28,455,22233,1668,0,24356
828,2019-10-29,212,28562,1621,3,30398
828,2019-10-30,554,28296,1288,2,30140
828,2019-10-31,921,13344,2595,1,16861
828,2019-11-01,88,26293,1966,0,28347
828,2019-11-02,97,16230,2068,0,18395
828,2019-11-03,85,21614,1731,5,23435
828,2019-11-04,119,9840,1696,1,11656
828,2019-11-05,226,2000,2254,1,4481
828,2019-11-06,183,13498,984,0,14665
828,2019-11-07,167,16286,972,3,17428
828,2019-11-08,115,8784,985,0,9884
828,2019-11-09,979,7610,1459,0,10048
828,2019-11-10,934,12165,869,0,13968
828,2019-11-11,1940,12351,1931,1,16223
828,2019-11-12,163,16156,2826,2,19147
828,2019-11-13,622,21365,2226,2,24215
828,2019-11-14,197,9763,1836,2,11798
828,2019-11-15,200,4277,1730,2,6209
828,2019-11-16,206,2872,3030,0,6108
828,2019-11-17,99,7123,3605,0,10827
828,2019-11-18,554,3351,4268,3,8176
828,2019-11-19,131,5415,2411,0,7957
828,2019-11-20,130,1572,2452,0,4154
828,2019-11-21,111,5485,1661,0,7257
828,2019-11-22,105,5891,1798,2,7796
828,2019-11-23,88,6045,1895,3,8031
828,2019-11-24,231,7019,1775,2,9027
828,2019-11-25,215,6748,2103,0,9066
828,2019-11-26,92,5669,1118,0,6879
828,2019-11-27,1017,6699,1497,2,9215
828,2019-11-28,319,7960,735,1,9015
828,2019-11-29,15,426,1,0,442
828,2019-09-04,976,72,2320,1,3369
828,2019-09-05,509,83,2451,1,3044
828,2019-09-06,221,49,2001,2,2273
828,2019-09-07,310,58,1620,2,1990
828,2019-09-08,1055,478,1914,0,3447
828,2019-09-09,744,290,1539,2,2575
828,2019-09-10,936,291,1807,0,3034
828,2019-09-11,950,314,2242,2,3508
828,2019-09-12,1034,170,2224,2,3430
828,2019-09-13,66,29,2283,0,2378
828,2019-09-14,92,36,1276,0,1404
828,2019-09-15,146,56,1787,1,1990
828,2019-09-16,1240,39,1440,1,2720
828,2019-09-17,91,5211,1907,2,7211
828,2019-09-18,916,37,1166,0,2119
828,2019-09-19,1168,8228,1800,0,11196
828,2019-09-20,179,8343,1649,0,10171
828,2019-09-21,113,6322,1206,0,7641
828,2019-09-22,79,15366,1829,0,17274
828,2019-09-23,1104,12867,1410,1,15382
828,2019-09-24,976,10414,1739,4,13133
828,2019-09-25,106,9662,1643,1,11412
828,2019-09-26,136,15195,1866,0,17197
828,2019-09-27,89,8480,1841,5,10415
828,2019-09-28,162,22656,973,3,23794
828,2019-09-29,112,27836,1260,3,29211
828,2019-09-30,688,18962,1691,0,21341
828,2019-10-01,986,19186,1760,0,21932
828,2019-10-02,1481,12660,1373,0,15514
828,2019-10-03,163,21421,1639,0,23223
828,2019-10-04,83,19342,1287,3,20715
828,2019-10-05,255,23193,1293,2,24743
828,2019-10-06,144,15356,2000,0,17500
828,2019-10-07,292,4531,1298,1,6122
828,2019-10-08,311,17745,1374,1,19431
828,2019-10-09,139,25368,1871,3,27381
828,2019-10-10,146,16727,2867,0,19740
828,2019-10-11,128,16085,1180,0,17393
828,2019-10-12,177,7865,2017,0,10059
828,2019-10-13,1996,8790,1644,2,12432
828,2019-10-14,1587,4238,1647,2,7474
828,2019-10-15,1329,13444,1438,0,16211
828,2019-10-16,307,22759,1466,2,24534
828,2019-10-17,979,6626,1912,0,9517
828,2019-10-18,330,13524,1522,3,15379
828,2019-10-19,954,10682,1449,0,13085
828,2019-10-20,1005,2241,1615,1,4862
828,2019-10-21,166,10329,1481,0,11976
828,2019-10-22,124,4608,1844,2,6578
828,2019-10-23,106,12772,1512,0,14390
828,2019-10-24,186,18199,1435,2,19822
828,2019-10-25,122,14733,1771,2,16628
828,2019-10-26,1879,16090,1744,0,19713
828,2019-10-27,1084,15760,1760,1,18605
828,2019-10-28,455,22233,1668,0,24356
828,2019-10-29,212,28562,1621,3,30398
828,2019-10-30,554,28296,1288,2,30140
828,2019-10-31,921,13344,2595,1,16861
828,2019-11-01,88,26293,1966,0,28347
828,2019-11-02,97,16230,2068,0,18395
828,2019-11-03,85,21614,1731,5,23435
828,2019-11-04,119,9840,1696,1,11656
828,2019-11-05,226,2000,2254,1,4481
828,2019-11-06,183,13498,984,0,14665
828,2019-11-07,167,16286,972,3,17428
828,2019-11-08,115,8784,985,0,9884
828,2019-11-09,979,7610,1459,0,10048
828,2019-11-10,934,12165,869,0,13968
828,2019-11-11,1940,12351,1931,1,16223
828,2019-11-12,163,16156,2826,2,19147
828,2019-11-13,622,21365,2226,2,24215
828,2019-11-14,197,9763,1836,2,11798
828,2019-11-15,200,4277,1730,2,6209
828,2019-11-16,206,2872,3030,0,6108
828,2019-11-17,99,7123,3605,0,10827
828,2019-11-18,554,3351,4268,3,8176
828,2019-11-19,131,5415,2411,0,7957
828,2019-11-20,130,1572,2452,0,4154
828,2019-11-21,111,5485,1661,0,7257
828,2019-11-22,105,5891,1798,2,7796
828,2019-11-23,88,6045,1895,3,8031
828,2019-11-24,231,7019,1775,2,9027
828,2019-11-25,215,6748,2103,0,9066
828,2019-11-26,92,5669,1118,0,6879
828,2019-11-27,1017,6699,1497,2,9215
828,2019-11-28,319,7960,735,1,9015
829,2019-08-29,106,804,1080,0,1990
829,2019-08-30,159,347,276,3,785
829,2019-08-31,80,38,9,0,127
829,2019-09-01,178,5,0,0,183
829,2019-09-02,196,7,129,1,333
829,2019-09-03,1806,25,1954,0,3785
829,2019-09-04,144,77,1928,2,2151
829,2019-09-05,1102,31,1547,0,2680
829,2019-09-06,189,4,1783,0,1976
829,2019-09-07,1000,2355,2602,2,5959
829,2019-09-08,1274,621,1776,0,3671
829,2019-09-09,991,1844,1177,0,4012
829,2019-09-10,105,1449,2196,0,3750
829,2019-09-11,993,474,1836,2,3305
829,2019-09-12,291,995,1423,1,2710
829,2019-09-13,143,700,1625,1,2469
829,2019-09-14,1238,98,2471,1,3808
829,2019-09-15,713,510,2076,1,3300
829,2019-09-16,883,54,1940,1,2878
829,2019-09-17,147,991,1803,1,2942
829,2019-09-18,486,165,1851,2,2504
829,2019-09-19,251,8517,1590,0,10358
829,2019-09-20,265,15762,1391,0,17418
829,2019-09-21,126,6400,1860,0,8386
829,2019-09-22,1355,8005,1752,0,11112
829,2019-09-23,135,7690,1693,2,9520
829,2019-09-24,134,7125,3182,2,10443
829,2019-09-25,115,6324,1962,5,8406
829,2019-09-26,166,9145,1446,4,10761
829,2019-09-27,85,8442,1904,3,10434
829,2019-09-28,246,15002,2288,2,17538
829,2019-09-29,95,18545,2380,1,21021
829,2019-09-30,482,17216,1660,3,19361
829,2019-10-01,638,15922,1753,2,18315
829,2019-10-02,183,12023,1200,0,13406
829,2019-10-03,171,12699,1722,1,14593
829,2019-10-04,108,10991,1526,2,12627
829,2019-10-05,555,13819,1556,1,15931
829,2019-10-06,156,14648,1874,1,16679
829,2019-10-07,741,4221,2338,1,7301
829,2019-10-08,310,11830,1700,1,13841
829,2019-10-09,1100,30041,1903,3,33047
829,2019-10-10,897,12494,1457,4,14852
829,2019-10-11,1750,9142,1171,0,12063
829,2019-10-12,997,5684,2480,0,9161
829,2019-10-13,79,7298,2117,3,9497
829,2019-10-14,139,5129,2468,2,7738
829,2019-10-15,117,7274,1901,2,9294
829,2019-10-16,122,18957,1497,2,20578
829,2019-10-17,941,7251,2092,1,10285
829,2019-10-18,189,7415,2155,1,9760
829,2019-10-19,147,3711,2552,1,6411
829,2019-10-20,986,807,1518,2,3313
829,2019-10-21,525,17563,1338,1,19427
829,2019-10-22,444,8291,1281,2,10018
829,2019-10-23,140,6824,1565,1,8530
829,2019-10-24,1114,12638,1958,661,16371
829,2019-10-25,110,14845,812,3,15770
829,2019-10-26,1011,24214,1754,0,26979
829,2019-10-27,1259,19473,1474,0,22206
829,2019-10-28,95,12679,756,1,13531
829,2019-10-29,175,26689,1916,2,28782
829,2019-10-30,98,28809,1946,3,30856
829,2019-10-31,87,22278,1424,0,23789
829,2019-11-01,93,26061,1169,1,27324
829,2019-11-02,384,26166,1830,20,28400
829,2019-11-03,117,52906,1018,0,54041
829,2019-11-04,556,12076,2489,3,15124
829,2019-11-05,211,1687,1966,0,3864
829,2019-11-06,102,7426,1457,2,8987
829,2019-11-07,1082,21772,1166,2,24022
829,2019-11-08,226,11054,1124,0,12404
829,2019-11-09,106,11563,1050,2,12721
829,2019-11-10,580,11925,1953,0,14458
829,2019-11-11,232,8040,1540,1,9813
829,2019-11-12,138,9792,3532,1,13463
829,2019-11-13,130,12646,1325,2,14103
829,2019-11-14,107,7190,1084,2,8383
829,2019-11-15,502,2704,2274,1,5481
829,2019-11-16,784,1022,2076,1,3883
829,2019-11-17,1728,7031,2710,0,11469
829,2019-11-18,111,1229,3271,1,4612
829,2019-11-19,123,2729,2604,3,5459
829,2019-11-20,1072,706,1896,455,4129
829,2019-11-21,148,2909,1717,0,4774
829,2019-11-22,676,8610,1937,0,11223
829,2019-11-23,1198,10716,2291,0,14205
829,2019-11-24,240,8245,2065,0,10550
829,2019-11-25,151,10108,1392,0,11651
829,2019-11-26,121,7461,1609,0,9191
829,2019-11-27,84,10547,1353,0,11984
829,2019-11-28,87,13297,300,0,13684
829,2019-11-29,30,837,2,0,869
829,2019-08-29,106,804,1080,0,1990
829,2019-08-30,159,347,276,3,785
829,2019-08-31,80,38,9,0,127
829,2019-09-01,178,5,0,0,183
829,2019-09-02,196,7,129,1,333
829,2019-09-03,1806,25,1954,0,3785
829,2019-09-04,144,77,1928,2,2151
829,2019-09-05,1102,31,1547,0,2680
829,2019-09-06,189,4,1783,0,1976
829,2019-09-07,1000,2355,2602,2,5959
829,2019-09-08,1274,621,1776,0,3671
829,2019-09-09,991,1844,1177,0,4012
829,2019-09-10,105,1449,2196,0,3750
829,2019-09-11,993,474,1836,2,3305
829,2019-09-12,291,995,1423,1,2710
829,2019-09-13,143,700,1625,1,2469
829,2019-09-14,1238,98,2471,1,3808
829,2019-09-15,713,510,2076,1,3300
829,2019-09-16,883,54,1940,1,2878
829,2019-09-17,147,991,1803,1,2942
829,2019-09-18,486,165,1851,2,2504
829,2019-09-19,251,8517,1590,0,10358
829,2019-09-20,265,15762,1391,0,17418
829,2019-09-21,126,6400,1860,0,8386
829,2019-09-22,1355,8005,1752,0,11112
829,2019-09-23,135,7690,1693,2,9520
829,2019-09-24,134,7125,3182,2,10443
829,2019-09-25,115,6324,1962,5,8406
829,2019-09-26,166,9145,1446,4,10761
829,2019-09-27,85,8442,1904,3,10434
829,2019-09-28,246,15002,2288,2,17538
829,2019-09-29,95,18545,2380,1,21021
829,2019-09-30,482,17216,1660,3,19361
829,2019-10-01,638,15922,1753,2,18315
829,2019-10-02,183,12023,1200,0,13406
829,2019-10-03,171,12699,1722,1,14593
829,2019-10-04,108,10991,1526,2,12627
829,2019-10-05,555,13819,1556,1,15931
829,2019-10-06,156,14648,1874,1,16679
829,2019-10-07,741,4221,2338,1,7301
829,2019-10-08,310,11830,1700,1,13841
829,2019-10-09,1100,30041,1903,3,33047
829,2019-10-10,897,12494,1457,4,14852
829,2019-10-11,1750,9142,1171,0,12063
829,2019-10-12,997,5684,2480,0,9161
829,2019-10-13,79,7298,2117,3,9497
829,2019-10-14,139,5129,2468,2,7738
829,2019-10-15,117,7274,1901,2,9294
829,2019-10-16,122,18957,1497,2,20578
829,2019-10-17,941,7251,2092,1,10285
829,2019-10-18,189,7415,2155,1,9760
829,2019-10-19,147,3711,2552,1,6411
829,2019-10-20,986,807,1518,2,3313
829,2019-10-21,525,17563,1338,1,19427
829,2019-10-22,444,8291,1281,2,10018
829,2019-10-23,140,6824,1565,1,8530
829,2019-10-24,1114,12638,1958,661,16371
829,2019-10-25,110,14845,812,3,15770
829,2019-10-26,1011,24214,1754,0,26979
829,2019-10-27,1259,19473,1474,0,22206
829,2019-10-28,95,12679,756,1,13531
829,2019-10-29,175,26689,1916,2,28782
829,2019-10-30,98,28809,1946,3,30856
829,2019-10-31,87,22278,1424,0,23789
829,2019-11-01,93,26061,1169,1,27324
829,2019-11-02,384,26166,1830,20,28400
829,2019-11-03,117,52906,1018,0,54041
829,2019-11-04,556,12076,2489,3,15124
829,2019-11-05,211,1687,1966,0,3864
829,2019-11-06,102,7426,1457,2,8987
829,2019-11-07,1082,21772,1166,2,24022
829,2019-11-08,226,11054,1124,0,12404
829,2019-11-09,106,11563,1050,2,12721
829,2019-11-10,580,11925,1953,0,14458
829,2019-11-11,232,8040,1540,1,9813
829,2019-11-12,138,9792,3532,1,13463
829,2019-11-13,130,12646,1325,2,14103
829,2019-11-14,107,7190,1084,2,8383
829,2019-11-15,502,2704,2274,1,5481
829,2019-11-16,784,1022,2076,1,3883
829,2019-11-17,1728,7031,2710,0,11469
829,2019-11-18,111,1229,3271,1,4612
829,2019-11-19,123,2729,2604,3,5459
829,2019-11-20,1072,706,1896,455,4129
829,2019-11-21,148,2909,1717,0,4774
829,2019-11-22,676,8610,1937,0,11223
829,2019-11-23,1198,10716,2291,0,14205
829,2019-11-24,240,8245,2065,0,10550
829,2019-11-25,151,10108,1392,0,11651
829,2019-11-26,121,7461,1609,0,9191
829,2019-11-27,84,10547,1353,0,11984
829,2019-11-28,87,13297,300,0,13684
829,2019-11-29,30,837,2,0,869
829,2019-08-29,106,804,1080,0,1990
829,2019-08-30,159,347,276,3,785
829,2019-08-31,80,38,9,0,127
829,2019-09-01,178,5,0,0,183
829,2019-09-02,196,7,129,1,333
829,2019-09-03,1806,25,1954,0,3785
829,2019-09-04,144,77,1928,2,2151
829,2019-09-05,1102,31,1547,0,2680
829,2019-09-06,189,4,1783,0,1976
829,2019-09-07,1000,2355,2602,2,5959
829,2019-09-08,1274,621,1776,0,3671
829,2019-09-09,991,1844,1177,0,4012
829,2019-09-10,105,1449,2196,0,3750
829,2019-09-11,993,474,1836,2,3305
829,2019-09-12,291,995,1423,1,2710
829,2019-09-13,143,700,1625,1,2469
829,2019-09-14,1238,98,2471,1,3808
829,2019-09-15,713,510,2076,1,3300
829,2019-09-16,883,54,1940,1,2878
829,2019-09-17,147,991,1803,1,2942
829,2019-09-18,486,165,1851,2,2504
829,2019-09-19,251,8517,1590,0,10358
829,2019-09-20,265,15762,1391,0,17418
829,2019-09-21,126,6400,1860,0,8386
829,2019-09-22,1355,8005,1752,0,11112
829,2019-09-23,135,7690,1693,2,9520
829,2019-09-24,134,7125,3182,2,10443
829,2019-09-25,115,6324,1962,5,8406
829,2019-09-26,166,9145,1446,4,10761
829,2019-09-27,85,8442,1904,3,10434
829,2019-09-28,246,15002,2288,2,17538
829,2019-09-29,95,18545,2380,1,21021
829,2019-09-30,482,17216,1660,3,19361
829,2019-10-01,638,15922,1753,2,18315
829,2019-10-02,183,12023,1200,0,13406
829,2019-10-03,171,12699,1722,1,14593
829,2019-10-04,108,10991,1526,2,12627
829,2019-10-05,555,13819,1556,1,15931
829,2019-10-06,156,14648,1874,1,16679
829,2019-10-07,741,4221,2338,1,7301
829,2019-10-08,310,11830,1700,1,13841
829,2019-10-09,1100,30041,1903,3,33047
829,2019-10-10,897,12494,1457,4,14852
829,2019-10-11,1750,9142,1171,0,12063
829,2019-10-12,997,5684,2480,0,9161
829,2019-10-13,79,7298,2117,3,9497
829,2019-10-14,139,5129,2468,2,7738
829,2019-10-15,117,7274,1901,2,9294
829,2019-10-16,122,18957,1497,2,20578
829,2019-10-17,941,7251,2092,1,10285
829,2019-10-18,189,7415,2155,1,9760
829,2019-10-19,147,3711,2552,1,6411
829,2019-10-20,986,807,1518,2,3313
829,2019-10-21,525,17563,1338,1,19427
829,2019-10-22,444,8291,1281,2,10018
829,2019-10-23,140,6824,1565,1,8530
829,2019-10-24,1114,12638,1958,661,16371
829,2019-10-25,110,14845,812,3,15770
829,2019-10-26,1011,24214,1754,0,26979
829,2019-10-27,1259,19473,1474,0,22206
829,2019-10-28,95,12679,756,1,13531
829,2019-10-29,175,26689,1916,2,28782
829,2019-10-30,98,28809,1946,3,30856
829,2019-10-31,87,22278,1424,0,23789
829,2019-11-01,93,26061,1169,1,27324
829,2019-11-02,384,26166,1830,20,28400
829,2019-11-03,117,52906,1018,0,54041
829,2019-11-04,556,12076,2489,3,15124
829,2019-11-05,211,1687,1966,0,3864
829,2019-11-06,102,7426,1457,2,8987
829,2019-11-07,1082,21772,1166,2,24022
829,2019-11-08,226,11054,1124,0,12404
829,2019-11-09,106,11563,1050,2,12721
829,2019-11-10,580,11925,1953,0,14458
829,2019-11-11,232,8040,1540,1,9813
829,2019-11-12,138,9792,3532,1,13463
829,2019-11-13,130,12646,1325,2,14103
829,2019-11-14,107,7190,1084,2,8383
829,2019-11-15,502,2704,2274,1,5481
829,2019-11-16,784,1022,2076,1,3883
829,2019-11-17,1728,7031,2710,0,11469
829,2019-11-18,111,1229,3271,1,4612
829,2019-11-19,123,2729,2604,3,5459
829,2019-11-20,1072,706,1896,455,4129
829,2019-11-21,148,2909,1717,0,4774
829,2019-11-22,676,8610,1937,0,11223
829,2019-11-23,1198,10716,2291,0,14205
829,2019-11-24,240,8245,2065,0,10550
829,2019-11-25,151,10108,1392,0,11651
829,2019-11-26,121,7461,1609,0,9191
829,2019-11-27,84,10547,1353,0,11984
829,2019-11-28,87,13297,300,0,13684
829,2019-11-29,30,837,2,0,869
829,2019-08-30,159,347,276,3,785
829,2019-08-31,80,38,9,0,127
829,2019-09-01,178,5,0,0,183
829,2019-09-02,196,7,129,1,333
829,2019-09-03,1806,25,1954,0,3785
829,2019-09-04,144,77,1928,2,2151
829,2019-09-05,1102,31,1547,0,2680
829,2019-09-06,189,4,1783,0,1976
829,2019-09-07,1000,2355,2602,2,5959
829,2019-09-08,1274,621,1776,0,3671
829,2019-09-09,991,1844,1177,0,4012
829,2019-09-10,105,1449,2196,0,3750
829,2019-09-11,993,474,1836,2,3305
829,2019-09-12,291,995,1423,1,2710
829,2019-09-13,143,700,1625,1,2469
829,2019-09-14,1238,98,2471,1,3808
829,2019-09-15,713,510,2076,1,3300
829,2019-09-16,883,54,1940,1,2878
829,2019-09-17,147,991,1803,1,2942
829,2019-09-18,486,165,1851,2,2504
829,2019-09-19,251,8517,1590,0,10358
829,2019-09-20,265,15762,1391,0,17418
829,2019-09-21,126,6400,1860,0,8386
829,2019-09-22,1355,8005,1752,0,11112
829,2019-09-23,135,7690,1693,2,9520
829,2019-09-24,134,7125,3182,2,10443
829,2019-09-25,115,6324,1962,5,8406
829,2019-09-26,166,9145,1446,4,10761
829,2019-09-27,85,8442,1904,3,10434
829,2019-09-28,246,15002,2288,2,17538
829,2019-09-29,95,18545,2380,1,21021
829,2019-09-30,482,17216,1660,3,19361
829,2019-10-01,638,15922,1753,2,18315
829,2019-10-02,183,12023,1200,0,13406
829,2019-10-03,171,12699,1722,1,14593
829,2019-10-04,108,10991,1526,2,12627
829,2019-10-05,555,13819,1556,1,15931
829,2019-10-06,156,14648,1874,1,16679
829,2019-10-07,741,4221,2338,1,7301
829,2019-10-08,310,11830,1700,1,13841
829,2019-10-09,1100,30041,1903,3,33047
829,2019-10-10,897,12494,1457,4,14852
829,2019-10-11,1750,9142,1171,0,12063
829,2019-10-12,997,5684,2480,0,9161
829,2019-10-13,79,7298,2117,3,9497
829,2019-10-14,139,5129,2468,2,7738
829,2019-10-15,117,7274,1901,2,9294
829,2019-10-16,122,18957,1497,2,20578
829,2019-10-17,941,7251,2092,1,10285
829,2019-10-18,189,7415,2155,1,9760
829,2019-10-19,147,3711,2552,1,6411
829,2019-10-20,986,807,1518,2,3313
829,2019-10-21,525,17563,1338,1,19427
829,2019-10-22,444,8291,1281,2,10018
829,2019-10-23,140,6824,1565,1,8530
829,2019-10-24,1114,12638,1958,661,16371
829,2019-10-25,110,14845,812,3,15770
829,2019-10-26,1011,24214,1754,0,26979
829,2019-10-27,1259,19473,1474,0,22206
829,2019-10-28,95,12679,756,1,13531
829,2019-10-29,175,26689,1916,2,28782
829,2019-10-30,98,28809,1946,3,30856
829,2019-10-31,87,22278,1424,0,23789
829,2019-11-01,93,26061,1169,1,27324
829,2019-11-02,384,26166,1830,20,28400
829,2019-11-03,117,52906,1018,0,54041
829,2019-11-04,556,12076,2489,3,15124
829,2019-11-05,211,1687,1966,0,3864
829,2019-11-06,102,7426,1457,2,8987
829,2019-11-07,1082,21772,1166,2,24022
829,2019-11-08,226,11054,1124,0,12404
829,2019-11-09,106,11563,1050,2,12721
829,2019-11-10,580,11925,1953,0,14458
829,2019-11-11,232,8040,1540,1,9813
829,2019-11-12,138,9792,3532,1,13463
829,2019-11-13,130,12646,1325,2,14103
829,2019-11-14,107,7190,1084,2,8383
829,2019-11-15,502,2704,2274,1,5481
829,2019-11-16,784,1022,2076,1,3883
829,2019-11-17,1728,7031,2710,0,11469
829,2019-11-18,111,1229,3271,1,4612
829,2019-11-19,123,2729,2604,3,5459
829,2019-11-20,1072,706,1896,455,4129
830,2019-08-29,123,2045,1242,0,3410
830,2019-08-30,110,607,451,1,1169
830,2019-08-31,138,27,16,0,181
830,2019-09-01,149,6,42,0,197
830,2019-09-02,107,0,5,0,112
830,2019-09-03,122,2,1293,1,1418
830,2019-09-04,136,22,2923,2,3083
830,2019-09-05,144,4,2188,1,2337
830,2019-09-06,186,136,2981,0,3303
830,2019-09-07,239,493,2193,0,2925
830,2019-09-08,308,152,1664,0,2124
830,2019-09-09,197,4225,1746,0,6168
830,2019-09-10,91,788,3076,1,3956
830,2019-09-11,272,854,1821,2,2949
830,2019-09-12,1099,857,2260,2,4218
830,2019-09-13,125,1274,1959,1,3359
830,2019-09-14,237,127,1658,3,2025
830,2019-09-15,938,475,1530,3,2946
830,2019-09-16,959,62,2563,5,3589
830,2019-09-17,887,1159,2324,8,4378
830,2019-09-18,936,134,1640,8,2718
830,2019-09-19,198,2349,1190,8,3745
830,2019-09-20,594,10887,2340,9,13830
830,2019-09-21,117,7019,2013,9,9158
830,2019-09-22,196,13382,1919,10,15507
830,2019-09-23,173,9929,1864,11,11977
830,2019-09-24,969,10380,2273,14,13636
830,2019-09-25,101,6288,1800,12,8201
830,2019-09-26,116,10537,2238,10,12901
830,2019-09-27,98,7230,1246,5,8579
830,2019-09-28,977,15022,2090,4,18093
830,2019-09-29,943,15821,998,0,17762
830,2019-09-30,134,26370,1801,1,28306
830,2019-10-01,195,21376,2004,1,23576
830,2019-10-02,667,15375,1740,6,17788
830,2019-10-03,1020,13356,1993,11,16380
830,2019-10-04,556,17193,1040,11,18800
830,2019-10-05,671,23255,1560,9,25495
830,2019-10-06,109,16136,2104,11,18360
830,2019-10-07,1027,4498,2305,13,7843
830,2019-10-08,578,16970,2105,10,19663
830,2019-10-09,1839,15982,1591,10,19422
830,2019-10-10,2612,12569,1811,12,17004
830,2019-10-11,633,14313,1451,9,16406
830,2019-10-12,983,10386,1581,3,12953
830,2019-10-13,1036,7372,1829,2,10239
830,2019-10-14,109,4359,2548,2,7018
830,2019-10-15,193,7035,1229,1,8458
830,2019-10-16,301,18019,1861,1,20182
830,2019-10-17,82,6810,1739,3,8634
830,2019-10-18,762,7933,1604,0,10299
830,2019-10-19,854,3809,1622,1,6286
830,2019-10-20,184,590,1914,0,2688
830,2019-10-21,525,17550,1461,1,19537
830,2019-10-22,88,9303,1835,1,11227
830,2019-10-23,78,13223,1232,0,14533
830,2019-10-24,132,27712,1289,1,29134
830,2019-10-25,996,18950,2115,2,22063
830,2019-10-26,1467,16089,1566,0,19122
830,2019-10-27,1504,15629,1267,1,18401
830,2019-10-28,693,13614,2095,3,16405
830,2019-10-29,737,14930,1155,0,16822
830,2019-10-30,65,15318,1226,1,16610
830,2019-10-31,982,19945,1076,1,22004
830,2019-11-01,66,27474,1618,3,29161
830,2019-11-02,514,26875,1663,0,29052
830,2019-11-03,75,24269,1845,0,26189
830,2019-11-04,832,9471,2329,0,12632
830,2019-11-05,1145,1695,1593,0,4433
830,2019-11-06,97,13772,1149,1,15019
830,2019-11-07,938,16207,1160,4,18309
830,2019-11-08,90,9015,1242,0,10347
830,2019-11-09,102,12870,1547,1,14520
830,2019-11-10,85,13456,1702,0,15243
830,2019-11-11,113,8343,1096,4,9556
830,2019-11-12,491,9644,2466,1,12602
830,2019-11-13,107,20060,1634,2,21803
830,2019-11-14,99,9045,1529,0,10673
830,2019-11-15,190,1927,2122,3,4242
830,2019-11-16,412,885,2365,4,3666
830,2019-11-17,170,3155,3496,0,6821
830,2019-11-18,111,1911,3127,0,5149
830,2019-11-19,120,2752,2510,1,5383
830,2019-11-20,118,1309,1970,0,3397
830,2019-11-21,1032,3274,2087,4,6397
830,2019-11-22,1260,8457,2244,0,11961
830,2019-11-23,840,6584,2329,0,9753
830,2019-11-24,483,6422,2215,0,9120
830,2019-11-25,92,5557,1297,0,6946
830,2019-11-26,434,7810,2099,0,10343
830,2019-11-27,90,5472,2239,0,7801
830,2019-11-28,79,13158,970,0,14207
830,2019-11-29,10,420,2,0,432
830,2019-08-29,123,2045,1242,0,3410
830,2019-08-30,110,607,451,1,1169
830,2019-08-31,138,27,16,0,181
830,2019-09-01,149,6,42,0,197
830,2019-09-02,107,0,5,0,112
830,2019-09-03,122,2,1293,1,1418
830,2019-09-04,136,22,2923,2,3083
830,2019-09-05,144,4,2188,1,2337
830,2019-09-06,186,136,2981,0,3303
830,2019-09-07,239,493,2193,0,2925
830,2019-09-08,308,152,1664,0,2124
830,2019-09-09,197,4225,1746,0,6168
830,2019-09-10,91,788,3076,1,3956
830,2019-09-11,272,854,1821,2,2949
830,2019-09-12,1099,857,2260,2,4218
830,2019-09-13,125,1274,1959,1,3359
830,2019-09-14,237,127,1658,3,2025
830,2019-09-15,938,475,1530,3,2946
830,2019-09-16,959,62,2563,5,3589
830,2019-09-17,887,1159,2324,8,4378
830,2019-09-18,936,134,1640,8,2718
830,2019-09-19,198,2349,1190,8,3745
830,2019-09-20,594,10887,2340,9,13830
830,2019-09-21,117,7019,2013,9,9158
830,2019-09-22,196,13382,1919,10,15507
830,2019-09-23,173,9929,1864,11,11977
830,2019-09-24,969,10380,2273,14,13636
830,2019-09-25,101,6288,1800,12,8201
830,2019-09-26,116,10537,2238,10,12901
830,2019-09-27,98,7230,1246,5,8579
830,2019-09-28,977,15022,2090,4,18093
830,2019-09-29,943,15821,998,0,17762
830,2019-09-30,134,26370,1801,1,28306
830,2019-10-01,195,21376,2004,1,23576
830,2019-10-02,667,15375,1740,6,17788
830,2019-10-03,1020,13356,1993,11,16380
830,2019-10-04,556,17193,1040,11,18800
830,2019-10-05,671,23255,1560,9,25495
830,2019-10-06,109,16136,2104,11,18360
830,2019-10-07,1027,4498,2305,13,7843
830,2019-10-08,578,16970,2105,10,19663
830,2019-10-09,1839,15982,1591,10,19422
830,2019-10-10,2612,12569,1811,12,17004
830,2019-10-11,633,14313,1451,9,16406
830,2019-10-12,983,10386,1581,3,12953
830,2019-10-13,1036,7372,1829,2,10239
830,2019-10-14,109,4359,2548,2,7018
830,2019-10-15,193,7035,1229,1,8458
830,2019-10-16,301,18019,1861,1,20182
830,2019-10-17,82,6810,1739,3,8634
830,2019-10-18,762,7933,1604,0,10299
830,2019-10-19,854,3809,1622,1,6286
830,2019-10-20,184,590,1914,0,2688
830,2019-10-21,525,17550,1461,1,19537
830,2019-10-22,88,9303,1835,1,11227
830,2019-10-23,78,13223,1232,0,14533
830,2019-10-24,132,27712,1289,1,29134
830,2019-10-25,996,18950,2115,2,22063
830,2019-10-26,1467,16089,1566,0,19122
830,2019-10-27,1504,15629,1267,1,18401
830,2019-10-28,693,13614,2095,3,16405
830,2019-10-29,737,14930,1155,0,16822
830,2019-10-30,65,15318,1226,1,16610
830,2019-10-31,982,19945,1076,1,22004
830,2019-11-01,66,27474,1618,3,29161
830,2019-11-02,514,26875,1663,0,29052
830,2019-11-03,75,24269,1845,0,26189
830,2019-11-04,832,9471,2329,0,12632
830,2019-11-05,1145,1695,1593,0,4433
830,2019-11-06,97,13772,1149,1,15019
830,2019-11-07,938,16207,1160,4,18309
830,2019-11-08,90,9015,1242,0,10347
830,2019-11-09,102,12870,1547,1,14520
830,2019-11-10,85,13456,1702,0,15243
830,2019-11-11,113,8343,1096,4,9556
830,2019-11-12,491,9644,2466,1,12602
830,2019-11-13,107,20060,1634,2,21803
830,2019-11-14,99,9045,1529,0,10673
830,2019-11-15,190,1927,2122,3,4242
830,2019-11-16,412,885,2365,4,3666
830,2019-11-17,170,3155,3496,0,6821
830,2019-11-18,111,1911,3127,0,5149
830,2019-11-19,120,2752,2510,1,5383
830,2019-11-20,118,1309,1970,0,3397
830,2019-11-21,1032,3274,2087,4,6397
830,2019-11-22,1260,8457,2244,0,11961
830,2019-11-23,840,6584,2329,0,9753
830,2019-11-24,483,6422,2215,0,9120
830,2019-11-25,92,5557,1297,0,6946
830,2019-11-26,434,7810,2099,0,10343
830,2019-11-27,90,5472,2239,0,7801
830,2019-11-28,79,13158,970,0,14207
830,2019-11-29,10,420,2,0,432
830,2019-08-29,123,2045,1242,0,3410
830,2019-08-30,110,607,451,1,1169
830,2019-08-31,138,27,16,0,181
830,2019-09-01,149,6,42,0,197
830,2019-09-02,107,0,5,0,112
830,2019-09-03,122,2,1293,1,1418
830,2019-09-04,136,22,2923,2,3083
830,2019-09-05,144,4,2188,1,2337
830,2019-09-06,186,136,2981,0,3303
830,2019-09-07,239,493,2193,0,2925
830,2019-09-08,308,152,1664,0,2124
830,2019-09-09,197,4225,1746,0,6168
830,2019-09-10,91,788,3076,1,3956
830,2019-09-11,272,854,1821,2,2949
830,2019-09-12,1099,857,2260,2,4218
830,2019-09-13,125,1274,1959,1,3359
830,2019-09-14,237,127,1658,3,2025
830,2019-09-15,938,475,1530,3,2946
830,2019-09-16,959,62,2563,5,3589
830,2019-09-17,887,1159,2324,8,4378
830,2019-09-18,936,134,1640,8,2718
830,2019-09-19,198,2349,1190,8,3745
830,2019-09-20,594,10887,2340,9,13830
830,2019-09-21,117,7019,2013,9,9158
830,2019-09-22,196,13382,1919,10,15507
830,2019-09-23,173,9929,1864,11,11977
830,2019-09-24,969,10380,2273,14,13636
830,2019-09-25,101,6288,1800,12,8201
830,2019-09-26,116,10537,2238,10,12901
830,2019-09-27,98,7230,1246,5,8579
830,2019-09-28,977,15022,2090,4,18093
830,2019-09-29,943,15821,998,0,17762
830,2019-09-30,134,26370,1801,1,28306
830,2019-10-01,195,21376,2004,1,23576
830,2019-10-02,667,15375,1740,6,17788
830,2019-10-03,1020,13356,1993,11,16380
830,2019-10-04,556,17193,1040,11,18800
830,2019-10-05,671,23255,1560,9,25495
830,2019-10-06,109,16136,2104,11,18360
830,2019-10-07,1027,4498,2305,13,7843
830,2019-10-08,578,16970,2105,10,19663
830,2019-10-09,1839,15982,1591,10,19422
830,2019-10-10,2612,12569,1811,12,17004
830,2019-10-11,633,14313,1451,9,16406
830,2019-10-12,983,10386,1581,3,12953
830,2019-10-13,1036,7372,1829,2,10239
830,2019-10-14,109,4359,2548,2,7018
830,2019-10-15,193,7035,1229,1,8458
830,2019-10-16,301,18019,1861,1,20182
830,2019-10-17,82,6810,1739,3,8634
830,2019-10-18,762,7933,1604,0,10299
830,2019-10-19,854,3809,1622,1,6286
830,2019-10-20,184,590,1914,0,2688
830,2019-10-21,525,17550,1461,1,19537
830,2019-10-22,88,9303,1835,1,11227
830,2019-10-23,78,13223,1232,0,14533
830,2019-10-24,132,27712,1289,1,29134
830,2019-10-25,996,18950,2115,2,22063
830,2019-10-26,1467,16089,1566,0,19122
830,2019-10-27,1504,15629,1267,1,18401
830,2019-10-28,693,13614,2095,3,16405
830,2019-10-29,737,14930,1155,0,16822
830,2019-10-30,65,15318,1226,1,16610
830,2019-10-31,982,19945,1076,1,22004
830,2019-11-01,66,27474,1618,3,29161
830,2019-11-02,514,26875,1663,0,29052
830,2019-11-03,75,24269,1845,0,26189
830,2019-11-04,832,9471,2329,0,12632
830,2019-11-05,1145,1695,1593,0,4433
830,2019-11-06,97,13772,1149,1,15019
830,2019-11-07,938,16207,1160,4,18309
830,2019-11-08,90,9015,1242,0,10347
830,2019-11-09,102,12870,1547,1,14520
830,2019-11-10,85,13456,1702,0,15243
830,2019-11-11,113,8343,1096,4,9556
830,2019-11-12,491,9644,2466,1,12602
830,2019-11-13,107,20060,1634,2,21803
830,2019-11-14,99,9045,1529,0,10673
830,2019-11-15,190,1927,2122,3,4242
830,2019-11-16,412,885,2365,4,3666
830,2019-11-17,170,3155,3496,0,6821
830,2019-11-18,111,1911,3127,0,5149
830,2019-11-19,120,2752,2510,1,5383
830,2019-11-20,118,1309,1970,0,3397
830,2019-11-21,1032,3274,2087,4,6397
830,2019-11-22,1260,8457,2244,0,11961
830,2019-11-23,840,6584,2329,0,9753
830,2019-11-24,483,6422,2215,0,9120
830,2019-11-25,92,5557,1297,0,6946
830,2019-11-26,434,7810,2099,0,10343
830,2019-11-27,90,5472,2239,0,7801
830,2019-11-28,79,13158,970,0,14207
830,2019-11-29,10,420,2,0,432
830,2019-08-30,110,607,451,1,1169
830,2019-08-31,138,27,16,0,181
830,2019-09-01,149,6,42,0,197
830,2019-09-02,107,0,5,0,112
830,2019-09-03,122,2,1293,1,1418
830,2019-09-04,136,22,2923,2,3083
830,2019-09-05,144,4,2188,1,2337
830,2019-09-06,186,136,2981,0,3303
830,2019-09-07,239,493,2193,0,2925
830,2019-09-08,308,152,1664,0,2124
830,2019-09-09,197,4225,1746,0,6168
830,2019-09-10,91,788,3076,1,3956
830,2019-09-11,272,854,1821,2,2949
830,2019-09-12,1099,857,2260,2,4218
830,2019-09-13,125,1274,1959,1,3359
830,2019-09-14,237,127,1658,3,2025
830,2019-09-15,938,475,1530,3,2946
830,2019-09-16,959,62,2563,5,3589
830,2019-09-17,887,1159,2324,8,4378
830,2019-09-18,936,134,1640,8,2718
830,2019-09-19,198,2349,1190,8,3745
830,2019-09-20,594,10887,2340,9,13830
830,2019-09-21,117,7019,2013,9,9158
830,2019-09-22,196,13382,1919,10,15507
830,2019-09-23,173,9929,1864,11,11977
830,2019-09-24,969,10380,2273,14,13636
830,2019-09-25,101,6288,1800,12,8201
830,2019-09-26,116,10537,2238,10,12901
830,2019-09-27,98,7230,1246,5,8579
830,2019-09-28,977,15022,2090,4,18093
830,2019-09-29,943,15821,998,0,17762
830,2019-09-30,134,26370,1801,1,28306
830,2019-10-01,195,21376,2004,1,23576
830,2019-10-02,667,15375,1740,6,17788
830,2019-10-03,1020,13356,1993,11,16380
830,2019-10-04,556,17193,1040,11,18800
830,2019-10-05,671,23255,1560,9,25495
830,2019-10-06,109,16136,2104,11,18360
830,2019-10-07,1027,4498,2305,13,7843
830,2019-10-08,578,16970,2105,10,19663
830,2019-10-09,1839,15982,1591,10,19422
830,2019-10-10,2612,12569,1811,12,17004
830,2019-10-11,633,14313,1451,9,16406
830,2019-10-12,983,10386,1581,3,12953
830,2019-10-13,1036,7372,1829,2,10239
830,2019-10-14,109,4359,2548,2,7018
830,2019-10-15,193,7035,1229,1,8458
830,2019-10-16,301,18019,1861,1,20182
830,2019-10-17,82,6810,1739,3,8634
830,2019-10-18,762,7933,1604,0,10299
830,2019-10-19,854,3809,1622,1,6286
830,2019-10-20,184,590,1914,0,2688
830,2019-10-21,525,17550,1461,1,19537
830,2019-10-22,88,9303,1835,1,11227
830,2019-10-23,78,13223,1232,0,14533
830,2019-10-24,132,27712,1289,1,29134
830,2019-10-25,996,18950,2115,2,22063
830,2019-10-26,1467,16089,1566,0,19122
830,2019-10-27,1504,15629,1267,1,18401
830,2019-10-28,693,13614,2095,3,16405
830,2019-10-29,737,14930,1155,0,16822
830,2019-10-30,65,15318,1226,1,16610
830,2019-10-31,982,19945,1076,1,22004
830,2019-11-01,66,27474,1618,3,29161
830,2019-11-02,514,26875,1663,0,29052
830,2019-11-03,75,24269,1845,0,26189
830,2019-11-04,832,9471,2329,0,12632
830,2019-11-05,1145,1695,1593,0,4433
830,2019-11-06,97,13772,1149,1,15019
830,2019-11-07,938,16207,1160,4,18309
830,2019-11-08,90,9015,1242,0,10347
830,2019-11-09,102,12870,1547,1,14520
830,2019-11-10,85,13456,1702,0,15243
830,2019-11-11,113,8343,1096,4,9556
830,2019-11-12,491,9644,2466,1,12602
830,2019-11-13,107,20060,1634,2,21803
830,2019-11-14,99,9045,1529,0,10673
830,2019-11-15,190,1927,2122,3,4242
830,2019-11-16,412,885,2365,4,3666
830,2019-11-17,170,3155,3496,0,6821
830,2019-11-18,111,1911,3127,0,5149
830,2019-11-19,120,2752,2510,1,5383
830,2019-11-20,118,1309,1970,0,3397
830,2019-11-21,1032,3274,2087,4,6397
831,2019-08-29,454,2066,1088,0,3608
831,2019-08-30,523,679,1032,1,2235
831,2019-08-31,316,164,2,0,482
831,2019-09-01,434,2,0,0,436
831,2019-09-02,606,0,2,1,609
831,2019-09-03,931,2,756,0,1689
831,2019-09-04,3227,49,2568,2,5846
831,2019-09-05,1519,8,1516,0,3043
831,2019-09-06,853,69,2246,0,3168
831,2019-09-07,2466,1769,2074,0,6309
831,2019-09-08,1569,1638,2464,1,5672
831,2019-09-09,3037,1120,1983,0,6140
831,2019-09-10,1515,754,1989,3,4261
831,2019-09-11,1016,703,1540,2,3261
831,2019-09-12,1073,364,1565,0,3002
831,2019-09-13,2093,2071,2108,1,6273
831,2019-09-14,611,138,2277,0,3026
831,2019-09-15,590,485,2395,3,3473
831,2019-09-16,1449,6,1876,1,3332
831,2019-09-17,847,895,2254,0,3996
831,2019-09-18,1410,57,1577,2,3046
831,2019-09-19,2579,7842,1711,0,12132
831,2019-09-20,1695,17522,1276,0,20493
831,2019-09-21,634,6652,1980,3,9269
831,2019-09-22,2497,8811,1582,0,12890
831,2019-09-23,1782,7426,2240,1,11449
831,2019-09-24,1791,6858,1965,1,10615
831,2019-09-25,2341,8177,1564,2,12084
831,2019-09-26,1528,10290,1224,0,13042
831,2019-09-27,1355,7263,1757,1,10376
831,2019-09-28,1319,14152,1779,2,17252
831,2019-09-29,462,16954,2247,1,19664
831,2019-09-30,423,16662,1506,0,18591
831,2019-10-01,2128,14940,1465,0,18533
831,2019-10-02,998,10430,1553,0,12981
831,2019-10-03,975,12567,1461,1,15004
831,2019-10-04,909,10720,1518,8,13155
831,2019-10-05,602,14392,1609,1,16604
831,2019-10-06,1901,10015,1366,2,13284
831,2019-10-07,2023,4741,2116,1,8881
831,2019-10-08,962,10984,1385,1,13332
831,2019-10-09,628,14143,1651,0,16422
831,2019-10-10,1575,8895,2215,342,13027
831,2019-10-11,743,8299,1243,0,10285
831,2019-10-12,736,5149,1682,2,7569
831,2019-10-13,1090,7180,1087,0,9357
831,2019-10-14,2397,5911,1966,1,10275
831,2019-10-15,788,7011,2215,2,10016
831,2019-10-16,687,17765,1142,1,19595
831,2019-10-17,1200,7056,2320,0,10576
831,2019-10-18,793,7340,1784,4,9921
831,2019-10-19,1508,3810,1995,0,7313
831,2019-10-20,3279,893,1667,2,5841
831,2019-10-21,1284,17748,1272,1,20305
831,2019-10-22,587,8580,2068,1,11236
831,2019-10-23,1319,6588,1581,2,9490
831,2019-10-24,885,19045,1298,2,21230
831,2019-10-25,705,18381,1942,2,21030
831,2019-10-26,3393,15844,1497,0,20734
831,2019-10-27,587,23819,1297,0,25703
831,2019-10-28,1127,24339,1571,1,27038
831,2019-10-29,1862,27767,1191,1,30821
831,2019-10-30,1075,19631,1092,4,21802
831,2019-10-31,876,11837,1113,0,13826
831,2019-11-01,2233,24130,1405,0,27768
831,2019-11-02,1484,25513,1685,715,29397
831,2019-11-03,701,37493,1407,475,40076
831,2019-11-04,1458,9016,1773,1,12248
831,2019-11-05,682,1893,2172,0,4747
831,2019-11-06,609,14439,1531,1,16580
831,2019-11-07,1494,15811,795,2,18102
831,2019-11-08,634,8821,1846,0,11301
831,2019-11-09,640,7706,2103,2,10451
831,2019-11-10,1521,14809,1989,1,18320
831,2019-11-11,1159,7737,2429,2,11327
831,2019-11-12,719,9436,3088,1,13244
831,2019-11-13,1492,12769,1644,0,15905
831,2019-11-14,531,8051,1553,2,10137
831,2019-11-15,550,3523,2440,0,6513
831,2019-11-16,1258,2609,2051,0,5918
831,2019-11-17,854,3596,2558,0,7008
831,2019-11-18,1889,3336,2918,0,8143
831,2019-11-19,1583,3045,1969,0,6597
831,2019-11-20,692,1334,1808,0,3834
831,2019-11-21,585,5348,1581,0,7514
831,2019-11-22,1722,8704,1194,0,11620
831,2019-11-23,622,10249,2048,0,12919
831,2019-11-24,664,9045,1502,0,11211
831,2019-11-25,709,12059,1450,0,14218
831,2019-11-26,2400,9540,1338,0,13278
831,2019-11-27,1510,10974,1424,0,13908
831,2019-11-28,515,9102,532,0,10149
831,2019-11-29,53,381,1,0,435
831,2019-08-29,454,2066,1088,0,3608
831,2019-08-30,523,679,1032,1,2235
831,2019-08-31,316,164,2,0,482
831,2019-09-01,434,2,0,0,436
831,2019-09-02,606,0,2,1,609
831,2019-09-03,931,2,756,0,1689
831,2019-09-04,3227,49,2568,2,5846
831,2019-09-05,1519,8,1516,0,3043
831,2019-09-06,853,69,2246,0,3168
831,2019-09-07,2466,1769,2074,0,6309
831,2019-09-08,1569,1638,2464,1,5672
831,2019-09-09,3037,1120,1983,0,6140
831,2019-09-10,1515,754,1989,3,4261
831,2019-09-11,1016,703,1540,2,3261
831,2019-09-12,1073,364,1565,0,3002
831,2019-09-13,2093,2071,2108,1,6273
831,2019-09-14,611,138,2277,0,3026
831,2019-09-15,590,485,2395,3,3473
831,2019-09-16,1449,6,1876,1,3332
831,2019-09-17,847,895,2254,0,3996
831,2019-09-18,1410,57,1577,2,3046
831,2019-09-19,2579,7842,1711,0,12132
831,2019-09-20,1695,17522,1276,0,20493
831,2019-09-21,634,6652,1980,3,9269
831,2019-09-22,2497,8811,1582,0,12890
831,2019-09-23,1782,7426,2240,1,11449
831,2019-09-24,1791,6858,1965,1,10615
831,2019-09-25,2341,8177,1564,2,12084
831,2019-09-26,1528,10290,1224,0,13042
831,2019-09-27,1355,7263,1757,1,10376
831,2019-09-28,1319,14152,1779,2,17252
831,2019-09-29,462,16954,2247,1,19664
831,2019-09-30,423,16662,1506,0,18591
831,2019-10-01,2128,14940,1465,0,18533
831,2019-10-02,998,10430,1553,0,12981
831,2019-10-03,975,12567,1461,1,15004
831,2019-10-04,909,10720,1518,8,13155
831,2019-10-05,602,14392,1609,1,16604
831,2019-10-06,1901,10015,1366,2,13284
831,2019-10-07,2023,4741,2116,1,8881
831,2019-10-08,962,10984,1385,1,13332
831,2019-10-09,628,14143,1651,0,16422
831,2019-10-10,1575,8895,2215,342,13027
831,2019-10-11,743,8299,1243,0,10285
831,2019-10-12,736,5149,1682,2,7569
831,2019-10-13,1090,7180,1087,0,9357
831,2019-10-14,2397,5911,1966,1,10275
831,2019-10-15,788,7011,2215,2,10016
831,2019-10-16,687,17765,1142,1,19595
831,2019-10-17,1200,7056,2320,0,10576
831,2019-10-18,793,7340,1784,4,9921
831,2019-10-19,1508,3810,1995,0,7313
831,2019-10-20,3279,893,1667,2,5841
831,2019-10-21,1284,17748,1272,1,20305
831,2019-10-22,587,8580,2068,1,11236
831,2019-10-23,1319,6588,1581,2,9490
831,2019-10-24,885,19045,1298,2,21230
831,2019-10-25,705,18381,1942,2,21030
831,2019-10-26,3393,15844,1497,0,20734
831,2019-10-27,587,23819,1297,0,25703
831,2019-10-28,1127,24339,1571,1,27038
831,2019-10-29,1862,27767,1191,1,30821
831,2019-10-30,1075,19631,1092,4,21802
831,2019-10-31,876,11837,1113,0,13826
831,2019-11-01,2233,24130,1405,0,27768
831,2019-11-02,1484,25513,1685,715,29397
831,2019-11-03,701,37493,1407,475,40076
831,2019-11-04,1458,9016,1773,1,12248
831,2019-11-05,682,1893,2172,0,4747
831,2019-11-06,609,14439,1531,1,16580
831,2019-11-07,1494,15811,795,2,18102
831,2019-11-08,634,8821,1846,0,11301
831,2019-11-09,640,7706,2103,2,10451
831,2019-11-10,1521,14809,1989,1,18320
831,2019-11-11,1159,7737,2429,2,11327
831,2019-11-12,719,9436,3088,1,13244
831,2019-11-13,1492,12769,1644,0,15905
831,2019-11-14,531,8051,1553,2,10137
831,2019-11-15,550,3523,2440,0,6513
831,2019-11-16,1258,2609,2051,0,5918
831,2019-11-17,854,3596,2558,0,7008
831,2019-11-18,1889,3336,2918,0,8143
831,2019-11-19,1583,3045,1969,0,6597
831,2019-11-20,692,1334,1808,0,3834
831,2019-11-21,585,5348,1581,0,7514
831,2019-11-22,1722,8704,1194,0,11620
831,2019-11-23,622,10249,2048,0,12919
831,2019-11-24,664,9045,1502,0,11211
831,2019-11-25,709,12059,1450,0,14218
831,2019-11-26,2400,9540,1338,0,13278
831,2019-11-27,1510,10974,1424,0,13908
831,2019-11-28,515,9102,532,0,10149
831,2019-11-29,53,381,1,0,435
831,2019-08-29,454,2066,1088,0,3608
831,2019-08-30,523,679,1032,1,2235
831,2019-08-31,316,164,2,0,482
831,2019-09-01,434,2,0,0,436
831,2019-09-02,606,0,2,1,609
831,2019-09-03,931,2,756,0,1689
831,2019-09-04,3227,49,2568,2,5846
831,2019-09-05,1519,8,1516,0,3043
831,2019-09-06,853,69,2246,0,3168
831,2019-09-07,2466,1769,2074,0,6309
831,2019-09-08,1569,1638,2464,1,5672
831,2019-09-09,3037,1120,1983,0,6140
831,2019-09-10,1515,754,1989,3,4261
831,2019-09-11,1016,703,1540,2,3261
831,2019-09-12,1073,364,1565,0,3002
831,2019-09-13,2093,2071,2108,1,6273
831,2019-09-14,611,138,2277,0,3026
831,2019-09-15,590,485,2395,3,3473
831,2019-09-16,1449,6,1876,1,3332
831,2019-09-17,847,895,2254,0,3996
831,2019-09-18,1410,57,1577,2,3046
831,2019-09-19,2579,7842,1711,0,12132
831,2019-09-20,1695,17522,1276,0,20493
831,2019-09-21,634,6652,1980,3,9269
831,2019-09-22,2497,8811,1582,0,12890
831,2019-09-23,1782,7426,2240,1,11449
831,2019-09-24,1791,6858,1965,1,10615
831,2019-09-25,2341,8177,1564,2,12084
831,2019-09-26,1528,10290,1224,0,13042
831,2019-09-27,1355,7263,1757,1,10376
831,2019-09-28,1319,14152,1779,2,17252
831,2019-09-29,462,16954,2247,1,19664
831,2019-09-30,423,16662,1506,0,18591
831,2019-10-01,2128,14940,1465,0,18533
831,2019-10-02,998,10430,1553,0,12981
831,2019-10-03,975,12567,1461,1,15004
831,2019-10-04,909,10720,1518,8,13155
831,2019-10-05,602,14392,1609,1,16604
831,2019-10-06,1901,10015,1366,2,13284
831,2019-10-07,2023,4741,2116,1,8881
831,2019-10-08,962,10984,1385,1,13332
831,2019-10-09,628,14143,1651,0,16422
831,2019-10-10,1575,8895,2215,342,13027
831,2019-10-11,743,8299,1243,0,10285
831,2019-10-12,736,5149,1682,2,7569
831,2019-10-13,1090,7180,1087,0,9357
831,2019-10-14,2397,5911,1966,1,10275
831,2019-10-15,788,7011,2215,2,10016
831,2019-10-16,687,17765,1142,1,19595
831,2019-10-17,1200,7056,2320,0,10576
831,2019-10-18,793,7340,1784,4,9921
831,2019-10-19,1508,3810,1995,0,7313
831,2019-10-20,3279,893,1667,2,5841
831,2019-10-21,1284,17748,1272,1,20305
831,2019-10-22,587,8580,2068,1,11236
831,2019-10-23,1319,6588,1581,2,9490
831,2019-10-24,885,19045,1298,2,21230
831,2019-10-25,705,18381,1942,2,21030
831,2019-10-26,3393,15844,1497,0,20734
831,2019-10-27,587,23819,1297,0,25703
831,2019-10-28,1127,24339,1571,1,27038
831,2019-10-29,1862,27767,1191,1,30821
831,2019-10-30,1075,19631,1092,4,21802
831,2019-10-31,876,11837,1113,0,13826
831,2019-11-01,2233,24130,1405,0,27768
831,2019-11-02,1484,25513,1685,715,29397
831,2019-11-03,701,37493,1407,475,40076
831,2019-11-04,1458,9016,1773,1,12248
831,2019-11-05,682,1893,2172,0,4747
831,2019-11-06,609,14439,1531,1,16580
831,2019-11-07,1494,15811,795,2,18102
831,2019-11-08,634,8821,1846,0,11301
831,2019-11-09,640,7706,2103,2,10451
831,2019-11-10,1521,14809,1989,1,18320
831,2019-11-11,1159,7737,2429,2,11327
831,2019-11-12,719,9436,3088,1,13244
831,2019-11-13,1492,12769,1644,0,15905
831,2019-11-14,531,8051,1553,2,10137
831,2019-11-15,550,3523,2440,0,6513
831,2019-11-16,1258,2609,2051,0,5918
831,2019-11-17,854,3596,2558,0,7008
831,2019-11-18,1889,3336,2918,0,8143
831,2019-11-19,1583,3045,1969,0,6597
831,2019-11-20,692,1334,1808,0,3834
831,2019-11-21,585,5348,1581,0,7514
831,2019-11-22,1722,8704,1194,0,11620
831,2019-11-23,622,10249,2048,0,12919
831,2019-11-24,664,9045,1502,0,11211
831,2019-11-25,709,12059,1450,0,14218
831,2019-11-26,2400,9540,1338,0,13278
831,2019-11-27,1510,10974,1424,0,13908
831,2019-11-28,515,9102,532,0,10149
831,2019-11-29,53,381,1,0,435
831,2019-08-30,523,679,1032,1,2235
831,2019-08-31,316,164,2,0,482
831,2019-09-01,434,2,0,0,436
831,2019-09-02,606,0,2,1,609
831,2019-09-03,931,2,756,0,1689
831,2019-09-04,3227,49,2568,2,5846
831,2019-09-05,1519,8,1516,0,3043
831,2019-09-06,853,69,2246,0,3168
831,2019-09-07,2466,1769,2074,0,6309
831,2019-09-08,1569,1638,2464,1,5672
831,2019-09-09,3037,1120,1983,0,6140
831,2019-09-10,1515,754,1989,3,4261
831,2019-09-11,1016,703,1540,2,3261
831,2019-09-12,1073,364,1565,0,3002
831,2019-09-13,2093,2071,2108,1,6273
831,2019-09-14,611,138,2277,0,3026
831,2019-09-15,590,485,2395,3,3473
831,2019-09-16,1449,6,1876,1,3332
831,2019-09-17,847,895,2254,0,3996
831,2019-09-18,1410,57,1577,2,3046
831,2019-09-19,2579,7842,1711,0,12132
831,2019-09-20,1695,17522,1276,0,20493
831,2019-09-21,634,6652,1980,3,9269
831,2019-09-22,2497,8811,1582,0,12890
831,2019-09-23,1782,7426,2240,1,11449
831,2019-09-24,1791,6858,1965,1,10615
831,2019-09-25,2341,8177,1564,2,12084
831,2019-09-26,1528,10290,1224,0,13042
831,2019-09-27,1355,7263,1757,1,10376
831,2019-09-28,1319,14152,1779,2,17252
831,2019-09-29,462,16954,2247,1,19664
831,2019-09-30,423,16662,1506,0,18591
831,2019-10-01,2128,14940,1465,0,18533
831,2019-10-02,998,10430,1553,0,12981
831,2019-10-03,975,12567,1461,1,15004
831,2019-10-04,909,10720,1518,8,13155
831,2019-10-05,602,14392,1609,1,16604
831,2019-10-06,1901,10015,1366,2,13284
831,2019-10-07,2023,4741,2116,1,8881
831,2019-10-08,962,10984,1385,1,13332
831,2019-10-09,628,14143,1651,0,16422
831,2019-10-10,1575,8895,2215,342,13027
831,2019-10-11,743,8299,1243,0,10285
831,2019-10-12,736,5149,1682,2,7569
831,2019-10-13,1090,7180,1087,0,9357
831,2019-10-14,2397,5911,1966,1,10275
831,2019-10-15,788,7011,2215,2,10016
831,2019-10-16,687,17765,1142,1,19595
831,2019-10-17,1200,7056,2320,0,10576
831,2019-10-18,793,7340,1784,4,9921
831,2019-10-19,1508,3810,1995,0,7313
831,2019-10-20,3279,893,1667,2,5841
831,2019-10-21,1284,17748,1272,1,20305
831,2019-10-22,587,8580,2068,1,11236
831,2019-10-23,1319,6588,1581,2,9490
831,2019-10-24,885,19045,1298,2,21230
831,2019-10-25,705,18381,1942,2,21030
831,2019-10-26,3393,15844,1497,0,20734
831,2019-10-27,587,23819,1297,0,25703
831,2019-10-28,1127,24339,1571,1,27038
831,2019-10-29,1862,27767,1191,1,30821
831,2019-10-30,1075,19631,1092,4,21802
831,2019-10-31,876,11837,1113,0,13826
831,2019-11-01,2233,24130,1405,0,27768
831,2019-11-02,1484,25513,1685,715,29397
831,2019-11-03,701,37493,1407,475,40076
831,2019-11-04,1458,9016,1773,1,12248
831,2019-11-05,682,1893,2172,0,4747
831,2019-11-06,609,14439,1531,1,16580
831,2019-11-07,1494,15811,795,2,18102
831,2019-11-08,634,8821,1846,0,11301
831,2019-11-09,640,7706,2103,2,10451
831,2019-11-10,1521,14809,1989,1,18320
831,2019-11-11,1159,7737,2429,2,11327
831,2019-11-12,719,9436,3088,1,13244
831,2019-11-13,1492,12769,1644,0,15905
831,2019-11-14,531,8051,1553,2,10137
832,2019-08-29,155,742,1720,0,2617
832,2019-08-30,289,280,202,1,772
832,2019-08-31,151,63,1,0,215
832,2019-09-01,183,0,4,0,187
832,2019-09-02,71,2,90,0,163
832,2019-09-03,161,8,1211,0,1380
832,2019-09-04,366,22,2692,1,3081
832,2019-09-05,399,51,2044,1,2495
832,2019-09-06,369,119,2771,1,3260
832,2019-09-07,447,44,1411,0,1902
832,2019-09-08,405,158,2359,1,2923
832,2019-09-09,463,741,2561,0,3765
832,2019-09-10,226,307,1584,1,2118
832,2019-09-11,154,291,1820,1,2266
832,2019-09-12,194,185,2259,4,2642
832,2019-09-13,490,37,1442,2,1971
832,2019-09-14,348,81,1916,1,2346
832,2019-09-15,250,31,2033,4,2318
832,2019-09-16,1088,29,2506,4,3627
832,2019-09-17,1082,14,2950,7,4053
832,2019-09-18,1146,82,1621,9,2858
832,2019-09-19,1016,8003,2094,10,11123
832,2019-09-20,365,19504,1405,10,21284
832,2019-09-21,270,8611,1980,9,10870
832,2019-09-22,258,14483,1521,12,16274
832,2019-09-23,289,12534,1793,13,14629
832,2019-09-24,382,11265,1814,12,13473
832,2019-09-25,154,8617,2235,12,11018
832,2019-09-26,147,12842,2059,10,15058
832,2019-09-27,970,9716,1754,4,12444
832,2019-09-28,205,14651,854,4,15714
832,2019-09-29,115,25297,1961,2,27375
832,2019-09-30,116,27968,1229,1,29314
832,2019-10-01,133,21610,1873,0,23616
832,2019-10-02,135,15368,2101,7,17611
832,2019-10-03,149,21257,1777,11,23194
832,2019-10-04,227,19223,1429,9,20888
832,2019-10-05,512,23559,731,10,24812
832,2019-10-06,646,15892,1717,11,18266
832,2019-10-07,1391,4311,1860,12,7574
832,2019-10-08,252,18176,1765,13,20206
832,2019-10-09,154,24830,1841,10,26835
832,2019-10-10,1233,16104,1858,11,19206
832,2019-10-11,463,8627,2193,8,11291
832,2019-10-12,228,5801,1647,1,7677
832,2019-10-13,229,7211,1890,2,9332
832,2019-10-14,628,6733,1816,3,9180
832,2019-10-15,1151,13100,1812,0,16063
832,2019-10-16,783,23077,1153,0,25013
832,2019-10-17,1157,7670,2811,1,11639
832,2019-10-18,467,13758,1797,4,16026
832,2019-10-19,297,6998,799,1,8095
832,2019-10-20,400,702,1781,0,2883
832,2019-10-21,725,9891,1718,0,12334
832,2019-10-22,769,4795,1266,3,6833
832,2019-10-23,217,6954,931,4,8106
832,2019-10-24,1027,13467,1185,0,15679
832,2019-10-25,311,10096,1424,1,11832
832,2019-10-26,294,12535,2539,0,15368
832,2019-10-27,1140,15691,2156,0,18987
832,2019-10-28,762,14011,1073,1,15847
832,2019-10-29,682,26384,1459,2,28527
832,2019-10-30,260,19835,1367,0,21462
832,2019-10-31,992,11987,1688,0,14667
832,2019-11-01,1689,13960,1063,1,16713
832,2019-11-02,630,14010,1331,5,15976
832,2019-11-03,830,36010,1661,0,38501
832,2019-11-04,257,12337,1908,0,14502
832,2019-11-05,290,1253,2811,0,4354
832,2019-11-06,258,6925,1644,0,8827
832,2019-11-07,880,13460,2109,2,16451
832,2019-11-08,288,8440,2152,1,10881
832,2019-11-09,266,7803,2761,0,10830
832,2019-11-10,655,12722,1984,0,15361
832,2019-11-11,298,8143,1290,1,9732
832,2019-11-12,346,14456,2442,1,17245
832,2019-11-13,859,12388,1200,0,14447
832,2019-11-14,1035,13437,2248,1,16721
832,2019-11-15,247,5225,1325,0,6797
832,2019-11-16,281,2808,2145,1,5235
832,2019-11-17,407,4139,3137,4,7687
832,2019-11-18,361,3517,3181,0,7059
832,2019-11-19,297,3401,2399,0,6097
832,2019-11-20,281,1346,2450,0,4077
832,2019-11-21,297,5469,2013,0,7779
832,2019-11-22,391,5274,1716,4,7385
832,2019-11-23,370,6121,2063,1,8555
832,2019-11-24,818,6431,1956,0,9205
832,2019-11-25,978,6632,2755,0,10365
832,2019-11-26,253,6214,1610,0,8077
832,2019-11-27,272,6193,2127,2,8594
832,2019-11-28,333,8138,720,1,9192
832,2019-11-29,158,446,2,0,606
832,2019-08-29,155,742,1720,0,2617
832,2019-08-30,289,280,202,1,772
832,2019-08-31,151,63,1,0,215
832,2019-09-01,183,0,4,0,187
832,2019-09-02,71,2,90,0,163
832,2019-09-03,161,8,1211,0,1380
832,2019-09-04,366,22,2692,1,3081
832,2019-09-05,399,51,2044,1,2495
832,2019-09-06,369,119,2771,1,3260
832,2019-09-07,447,44,1411,0,1902
832,2019-09-08,405,158,2359,1,2923
832,2019-09-09,463,741,2561,0,3765
832,2019-09-10,226,307,1584,1,2118
832,2019-09-11,154,291,1820,1,2266
832,2019-09-12,194,185,2259,4,2642
832,2019-09-13,490,37,1442,2,1971
832,2019-09-14,348,81,1916,1,2346
832,2019-09-15,250,31,2033,4,2318
832,2019-09-16,1088,29,2506,4,3627
832,2019-09-17,1082,14,2950,7,4053
832,2019-09-18,1146,82,1621,9,2858
832,2019-09-19,1016,8003,2094,10,11123
832,2019-09-20,365,19504,1405,10,21284
832,2019-09-21,270,8611,1980,9,10870
832,2019-09-22,258,14483,1521,12,16274
832,2019-09-23,289,12534,1793,13,14629
832,2019-09-24,382,11265,1814,12,13473
832,2019-09-25,154,8617,2235,12,11018
832,2019-09-26,147,12842,2059,10,15058
832,2019-09-27,970,9716,1754,4,12444
832,2019-09-28,205,14651,854,4,15714
832,2019-09-29,115,25297,1961,2,27375
832,2019-09-30,116,27968,1229,1,29314
832,2019-10-01,133,21610,1873,0,23616
832,2019-10-02,135,15368,2101,7,17611
832,2019-10-03,149,21257,1777,11,23194
832,2019-10-04,227,19223,1429,9,20888
832,2019-10-05,512,23559,731,10,24812
832,2019-10-06,646,15892,1717,11,18266
832,2019-10-07,1391,4311,1860,12,7574
832,2019-10-08,252,18176,1765,13,20206
832,2019-10-09,154,24830,1841,10,26835
832,2019-10-10,1233,16104,1858,11,19206
832,2019-10-11,463,8627,2193,8,11291
832,2019-10-12,228,5801,1647,1,7677
832,2019-10-13,229,7211,1890,2,9332
832,2019-10-14,628,6733,1816,3,9180
832,2019-10-15,1151,13100,1812,0,16063
832,2019-10-16,783,23077,1153,0,25013
832,2019-10-17,1157,7670,2811,1,11639
832,2019-10-18,467,13758,1797,4,16026
832,2019-10-19,297,6998,799,1,8095
832,2019-10-20,400,702,1781,0,2883
832,2019-10-21,725,9891,1718,0,12334
832,2019-10-22,769,4795,1266,3,6833
832,2019-10-23,217,6954,931,4,8106
832,2019-10-24,1027,13467,1185,0,15679
832,2019-10-25,311,10096,1424,1,11832
832,2019-10-26,294,12535,2539,0,15368
832,2019-10-27,1140,15691,2156,0,18987
832,2019-10-28,762,14011,1073,1,15847
832,2019-10-29,682,26384,1459,2,28527
832,2019-10-30,260,19835,1367,0,21462
832,2019-10-31,992,11987,1688,0,14667
832,2019-11-01,1689,13960,1063,1,16713
832,2019-11-02,630,14010,1331,5,15976
832,2019-11-03,830,36010,1661,0,38501
832,2019-11-04,257,12337,1908,0,14502
832,2019-11-05,290,1253,2811,0,4354
832,2019-11-06,258,6925,1644,0,8827
832,2019-11-07,880,13460,2109,2,16451
832,2019-11-08,288,8440,2152,1,10881
832,2019-11-09,266,7803,2761,0,10830
832,2019-11-10,655,12722,1984,0,15361
832,2019-11-11,298,8143,1290,1,9732
832,2019-11-12,346,14456,2442,1,17245
832,2019-11-13,859,12388,1200,0,14447
832,2019-11-14,1035,13437,2248,1,16721
832,2019-11-15,247,5225,1325,0,6797
832,2019-11-16,281,2808,2145,1,5235
832,2019-11-17,407,4139,3137,4,7687
832,2019-11-18,361,3517,3181,0,7059
832,2019-11-19,297,3401,2399,0,6097
832,2019-11-20,281,1346,2450,0,4077
832,2019-11-21,297,5469,2013,0,7779
832,2019-11-22,391,5274,1716,4,7385
832,2019-11-23,370,6121,2063,1,8555
832,2019-11-24,818,6431,1956,0,9205
832,2019-11-25,978,6632,2755,0,10365
832,2019-11-26,253,6214,1610,0,8077
832,2019-11-27,272,6193,2127,2,8594
832,2019-11-28,333,8138,720,1,9192
832,2019-11-29,158,446,2,0,606
832,2019-08-29,155,742,1720,0,2617
832,2019-08-30,289,280,202,1,772
832,2019-08-31,151,63,1,0,215
832,2019-09-01,183,0,4,0,187
832,2019-09-02,71,2,90,0,163
832,2019-09-03,161,8,1211,0,1380
832,2019-09-04,366,22,2692,1,3081
832,2019-09-05,399,51,2044,1,2495
832,2019-09-06,369,119,2771,1,3260
832,2019-09-07,447,44,1411,0,1902
832,2019-09-08,405,158,2359,1,2923
832,2019-09-09,463,741,2561,0,3765
832,2019-09-10,226,307,1584,1,2118
832,2019-09-11,154,291,1820,1,2266
832,2019-09-12,194,185,2259,4,2642
832,2019-09-13,490,37,1442,2,1971
832,2019-09-14,348,81,1916,1,2346
832,2019-09-15,250,31,2033,4,2318
832,2019-09-16,1088,29,2506,4,3627
832,2019-09-17,1082,14,2950,7,4053
832,2019-09-18,1146,82,1621,9,2858
832,2019-09-19,1016,8003,2094,10,11123
832,2019-09-20,365,19504,1405,10,21284
832,2019-09-21,270,8611,1980,9,10870
832,2019-09-22,258,14483,1521,12,16274
832,2019-09-23,289,12534,1793,13,14629
832,2019-09-24,382,11265,1814,12,13473
832,2019-09-25,154,8617,2235,12,11018
832,2019-09-26,147,12842,2059,10,15058
832,2019-09-27,970,9716,1754,4,12444
832,2019-09-28,205,14651,854,4,15714
832,2019-09-29,115,25297,1961,2,27375
832,2019-09-30,116,27968,1229,1,29314
832,2019-10-01,133,21610,1873,0,23616
832,2019-10-02,135,15368,2101,7,17611
832,2019-10-03,149,21257,1777,11,23194
832,2019-10-04,227,19223,1429,9,20888
832,2019-10-05,512,23559,731,10,24812
832,2019-10-06,646,15892,1717,11,18266
832,2019-10-07,1391,4311,1860,12,7574
832,2019-10-08,252,18176,1765,13,20206
832,2019-10-09,154,24830,1841,10,26835
832,2019-10-10,1233,16104,1858,11,19206
832,2019-10-11,463,8627,2193,8,11291
832,2019-10-12,228,5801,1647,1,7677
832,2019-10-13,229,7211,1890,2,9332
832,2019-10-14,628,6733,1816,3,9180
832,2019-10-15,1151,13100,1812,0,16063
832,2019-10-16,783,23077,1153,0,25013
832,2019-10-17,1157,7670,2811,1,11639
832,2019-10-18,467,13758,1797,4,16026
832,2019-10-19,297,6998,799,1,8095
832,2019-10-20,400,702,1781,0,2883
832,2019-10-21,725,9891,1718,0,12334
832,2019-10-22,769,4795,1266,3,6833
832,2019-10-23,217,6954,931,4,8106
832,2019-10-24,1027,13467,1185,0,15679
832,2019-10-25,311,10096,1424,1,11832
832,2019-10-26,294,12535,2539,0,15368
832,2019-10-27,1140,15691,2156,0,18987
832,2019-10-28,762,14011,1073,1,15847
832,2019-10-29,682,26384,1459,2,28527
832,2019-10-30,260,19835,1367,0,21462
832,2019-10-31,992,11987,1688,0,14667
832,2019-11-01,1689,13960,1063,1,16713
832,2019-11-02,630,14010,1331,5,15976
832,2019-11-03,830,36010,1661,0,38501
832,2019-11-04,257,12337,1908,0,14502
832,2019-11-05,290,1253,2811,0,4354
832,2019-11-06,258,6925,1644,0,8827
832,2019-11-07,880,13460,2109,2,16451
832,2019-11-08,288,8440,2152,1,10881
832,2019-11-09,266,7803,2761,0,10830
832,2019-11-10,655,12722,1984,0,15361
832,2019-11-11,298,8143,1290,1,9732
832,2019-11-12,346,14456,2442,1,17245
832,2019-11-13,859,12388,1200,0,14447
832,2019-11-14,1035,13437,2248,1,16721
832,2019-11-15,247,5225,1325,0,6797
832,2019-11-16,281,2808,2145,1,5235
832,2019-11-17,407,4139,3137,4,7687
832,2019-11-18,361,3517,3181,0,7059
832,2019-11-19,297,3401,2399,0,6097
832,2019-11-20,281,1346,2450,0,4077
832,2019-11-21,297,5469,2013,0,7779
832,2019-11-22,391,5274,1716,4,7385
832,2019-11-23,370,6121,2063,1,8555
832,2019-11-24,818,6431,1956,0,9205
832,2019-11-25,978,6632,2755,0,10365
832,2019-11-26,253,6214,1610,0,8077
832,2019-11-27,272,6193,2127,2,8594
832,2019-11-28,333,8138,720,1,9192
832,2019-11-29,158,446,2,0,606
832,2019-08-30,289,280,202,1,772
832,2019-08-31,151,63,1,0,215
832,2019-09-01,183,0,4,0,187
832,2019-09-02,71,2,90,0,163
832,2019-09-03,161,8,1211,0,1380
832,2019-09-04,366,22,2692,1,3081
832,2019-09-05,399,51,2044,1,2495
832,2019-09-06,369,119,2771,1,3260
832,2019-09-07,447,44,1411,0,1902
832,2019-09-08,405,158,2359,1,2923
832,2019-09-09,463,741,2561,0,3765
832,2019-09-10,226,307,1584,1,2118
832,2019-09-11,154,291,1820,1,2266
832,2019-09-12,194,185,2259,4,2642
832,2019-09-13,490,37,1442,2,1971
832,2019-09-14,348,81,1916,1,2346
832,2019-09-15,250,31,2033,4,2318
832,2019-09-16,1088,29,2506,4,3627
832,2019-09-17,1082,14,2950,7,4053
832,2019-09-18,1146,82,1621,9,2858
832,2019-09-19,1016,8003,2094,10,11123
832,2019-09-20,365,19504,1405,10,21284
832,2019-09-21,270,8611,1980,9,10870
832,2019-09-22,258,14483,1521,12,16274
832,2019-09-23,289,12534,1793,13,14629
832,2019-09-24,382,11265,1814,12,13473
832,2019-09-25,154,8617,2235,12,11018
832,2019-09-26,147,12842,2059,10,15058
832,2019-09-27,970,9716,1754,4,12444
832,2019-09-28,205,14651,854,4,15714
832,2019-09-29,115,25297,1961,2,27375
832,2019-09-30,116,27968,1229,1,29314
832,2019-10-01,133,21610,1873,0,23616
832,2019-10-02,135,15368,2101,7,17611
832,2019-10-03,149,21257,1777,11,23194
832,2019-10-04,227,19223,1429,9,20888
832,2019-10-05,512,23559,731,10,24812
832,2019-10-06,646,15892,1717,11,18266
832,2019-10-07,1391,4311,1860,12,7574
832,2019-10-08,252,18176,1765,13,20206
832,2019-10-09,154,24830,1841,10,26835
832,2019-10-10,1233,16104,1858,11,19206
832,2019-10-11,463,8627,2193,8,11291
832,2019-10-12,228,5801,1647,1,7677
832,2019-10-13,229,7211,1890,2,9332
832,2019-10-14,628,6733,1816,3,9180
832,2019-10-15,1151,13100,1812,0,16063
832,2019-10-16,783,23077,1153,0,25013
832,2019-10-17,1157,7670,2811,1,11639
832,2019-10-18,467,13758,1797,4,16026
832,2019-10-19,297,6998,799,1,8095
832,2019-10-20,400,702,1781,0,2883
832,2019-10-21,725,9891,1718,0,12334
832,2019-10-22,769,4795,1266,3,6833
832,2019-10-23,217,6954,931,4,8106
832,2019-10-24,1027,13467,1185,0,15679
832,2019-10-25,311,10096,1424,1,11832
832,2019-10-26,294,12535,2539,0,15368
832,2019-10-27,1140,15691,2156,0,18987
832,2019-10-28,762,14011,1073,1,15847
832,2019-10-29,682,26384,1459,2,28527
832,2019-10-30,260,19835,1367,0,21462
832,2019-10-31,992,11987,1688,0,14667
832,2019-11-01,1689,13960,1063,1,16713
832,2019-11-02,630,14010,1331,5,15976
832,2019-11-03,830,36010,1661,0,38501
832,2019-11-04,257,12337,1908,0,14502
832,2019-11-05,290,1253,2811,0,4354
832,2019-11-06,258,6925,1644,0,8827
832,2019-11-07,880,13460,2109,2,16451
832,2019-11-08,288,8440,2152,1,10881
832,2019-11-09,266,7803,2761,0,10830
832,2019-11-10,655,12722,1984,0,15361
832,2019-11-11,298,8143,1290,1,9732
832,2019-11-12,346,14456,2442,1,17245
832,2019-11-13,859,12388,1200,0,14447
832,2019-11-14,1035,13437,2248,1,16721
832,2019-11-15,247,5225,1325,0,6797
832,2019-11-16,281,2808,2145,1,5235
832,2019-11-17,407,4139,3137,4,7687
832,2019-11-18,361,3517,3181,0,7059
832,2019-11-19,297,3401,2399,0,6097
832,2019-11-20,281,1346,2450,0,4077
832,2019-11-21,297,5469,2013,0,7779
832,2019-11-22,391,5274,1716,4,7385
832,2019-11-23,370,6121,2063,1,8555
832,2019-11-24,818,6431,1956,0,9205
832,2019-11-25,978,6632,2755,0,10365
832,2019-11-26,253,6214,1610,0,8077
832,2019-11-27,272,6193,2127,2,8594
832,2019-11-28,333,8138,720,1,9192
833,2019-08-29,102054,1336,1800,0,105190
833,2019-08-30,232676,474,701,0,233851
833,2019-08-31,136446,90,2,0,136538
833,2019-09-01,85404,36,2,0,85442
833,2019-09-02,166783,0,1,0,166784
833,2019-09-03,183749,6,811,0,184566
833,2019-09-04,306378,24,2471,3,308876
833,2019-09-05,300210,33,2796,0,303039
833,2019-09-06,298818,56,2148,3,301025
833,2019-09-07,286121,39,1573,0,287733
833,2019-09-08,282612,96,1812,0,284520
833,2019-09-09,291849,1303,1674,0,294826
833,2019-09-10,279786,288,2455,2,282531
833,2019-09-11,287707,243,2443,58,290451
833,2019-09-12,291081,155,2656,1,293893
833,2019-09-13,287890,23,2100,1,290014
833,2019-09-14,279813,52,1890,0,281755
833,2019-09-15,276892,86,1795,1,278774
833,2019-09-16,285014,31,2187,0,287232
833,2019-09-17,285502,51,2384,0,287937
833,2019-09-18,284962,3,1547,0,286512
833,2019-09-19,285314,1486,1441,1,288242
833,2019-09-20,280458,6975,1341,3,288777
833,2019-09-21,271348,7682,1476,1,280507
833,2019-09-22,274324,8683,2158,0,285165
833,2019-09-23,280138,7048,2160,2,289348
833,2019-09-24,279334,4964,2000,3,286301
833,2019-09-25,275635,8025,1448,5,285113
833,2019-09-26,278925,9208,2370,0,290503
833,2019-09-27,273055,7315,1710,2,282082
833,2019-09-28,266957,13748,1772,2,282479
833,2019-09-29,267240,14275,1649,0,283164
833,2019-09-30,272039,24069,1655,4,297767
833,2019-10-01,269290,19614,1281,1,290186
833,2019-10-02,269541,14569,1952,0,286062
833,2019-10-03,273403,12126,1769,0,287298
833,2019-10-04,270169,10042,1188,3,281402
833,2019-10-05,264069,19994,2114,1,286178
833,2019-10-06,266317,14730,3128,5,284180
833,2019-10-07,269678,2733,1582,0,273993
833,2019-10-08,271471,10323,2403,2,284199
833,2019-10-09,267049,13981,1486,1,282517
833,2019-10-10,266994,8891,2023,3,277911
833,2019-10-11,260340,9205,1406,0,270951
833,2019-10-12,257292,5480,1615,1,264388
833,2019-10-13,254898,6748,1208,1,262855
833,2019-10-14,263229,4410,1858,0,269497
833,2019-10-15,260006,6854,1373,1,268234
833,2019-10-16,256696,11838,2325,0,270859
833,2019-10-17,257871,4078,956,0,262905
833,2019-10-18,257205,7362,1983,0,266550
833,2019-10-19,253136,4249,1684,20,259089
833,2019-10-20,254927,565,1512,2,257006
833,2019-10-21,254320,8720,1280,3,264323
833,2019-10-22,252879,4493,2076,0,259448
833,2019-10-23,250412,6397,1945,0,258754
833,2019-10-24,249713,12580,879,0,263172
833,2019-10-25,248291,13948,1034,2,263275
833,2019-10-26,245720,23219,1856,0,270795
833,2019-10-27,246341,28496,1162,0,275999
833,2019-10-28,248403,14660,1132,0,264195
833,2019-10-29,249808,14227,1705,0,265740
833,2019-10-30,243745,14429,1983,2,260159
833,2019-10-31,236367,18918,1712,0,256997
833,2019-11-01,234007,26192,1434,0,261633
833,2019-11-02,234602,16363,1172,1,252138
833,2019-11-03,230909,20991,1413,0,253313
833,2019-11-04,237269,6359,1280,2,244910
833,2019-11-05,236672,769,1343,0,238784
833,2019-11-06,237030,6810,809,0,244649
833,2019-11-07,231975,20415,934,3,253327
833,2019-11-08,231225,10795,1133,2,243155
833,2019-11-09,232570,11523,946,2,245041
833,2019-11-10,232927,12340,832,2,246101
833,2019-11-11,242601,6895,1226,2,250724
833,2019-11-12,237110,8441,2482,2,248035
833,2019-11-13,204111,17791,1862,1,223765
833,2019-11-14,219903,9264,1629,3,230799
833,2019-11-15,223135,3554,1539,1,228229
833,2019-11-16,225086,2700,1717,0,229503
833,2019-11-17,221525,3036,2713,30,227304
833,2019-11-18,220794,3177,2267,0,226238
833,2019-11-19,201194,3044,2256,1,206495
833,2019-11-20,197298,1809,2426,0,201533
833,2019-11-21,190677,3329,1458,0,195464
833,2019-11-22,192706,7563,1510,0,201779
833,2019-11-23,206335,5703,1869,0,213907
833,2019-11-24,208928,6793,1724,0,217445
833,2019-11-25,199840,6104,1747,0,207691
833,2019-11-26,121187,5254,811,0,127252
833,2019-11-27,206178,5788,1141,0,213107
833,2019-11-28,142518,10867,490,0,153875
833,2019-11-29,1844,893,1,0,2738
833,2019-08-29,102054,1336,1800,0,105190
833,2019-08-30,232676,474,701,0,233851
833,2019-08-31,136446,90,2,0,136538
833,2019-09-01,85404,36,2,0,85442
833,2019-09-02,166783,0,1,0,166784
833,2019-09-03,183749,6,811,0,184566
833,2019-09-04,306378,24,2471,3,308876
833,2019-09-05,300210,33,2796,0,303039
833,2019-09-06,298818,56,2148,3,301025
833,2019-09-07,286121,39,1573,0,287733
833,2019-09-08,282612,96,1812,0,284520
833,2019-09-09,291849,1303,1674,0,294826
833,2019-09-10,279786,288,2455,2,282531
833,2019-09-11,287707,243,2443,58,290451
833,2019-09-12,291081,155,2656,1,293893
833,2019-09-13,287890,23,2100,1,290014
833,2019-09-14,279813,52,1890,0,281755
833,2019-09-15,276892,86,1795,1,278774
833,2019-09-16,285014,31,2187,0,287232
833,2019-09-17,285502,51,2384,0,287937
833,2019-09-18,284962,3,1547,0,286512
833,2019-09-19,285314,1486,1441,1,288242
833,2019-09-20,280458,6975,1341,3,288777
833,2019-09-21,271348,7682,1476,1,280507
833,2019-09-22,274324,8683,2158,0,285165
833,2019-09-23,280138,7048,2160,2,289348
833,2019-09-24,279334,4964,2000,3,286301
833,2019-09-25,275635,8025,1448,5,285113
833,2019-09-26,278925,9208,2370,0,290503
833,2019-09-27,273055,7315,1710,2,282082
833,2019-09-28,266957,13748,1772,2,282479
833,2019-09-29,267240,14275,1649,0,283164
833,2019-09-30,272039,24069,1655,4,297767
833,2019-10-01,269290,19614,1281,1,290186
833,2019-10-02,269541,14569,1952,0,286062
833,2019-10-03,273403,12126,1769,0,287298
833,2019-10-04,270169,10042,1188,3,281402
833,2019-10-05,264069,19994,2114,1,286178
833,2019-10-06,266317,14730,3128,5,284180
833,2019-10-07,269678,2733,1582,0,273993
833,2019-10-08,271471,10323,2403,2,284199
833,2019-10-09,267049,13981,1486,1,282517
833,2019-10-10,266994,8891,2023,3,277911
833,2019-10-11,260340,9205,1406,0,270951
833,2019-10-12,257292,5480,1615,1,264388
833,2019-10-13,254898,6748,1208,1,262855
833,2019-10-14,263229,4410,1858,0,269497
833,2019-10-15,260006,6854,1373,1,268234
833,2019-10-16,256696,11838,2325,0,270859
833,2019-10-17,257871,4078,956,0,262905
833,2019-10-18,257205,7362,1983,0,266550
833,2019-10-19,253136,4249,1684,20,259089
833,2019-10-20,254927,565,1512,2,257006
833,2019-10-21,254320,8720,1280,3,264323
833,2019-10-22,252879,4493,2076,0,259448
833,2019-10-23,250412,6397,1945,0,258754
833,2019-10-24,249713,12580,879,0,263172
833,2019-10-25,248291,13948,1034,2,263275
833,2019-10-26,245720,23219,1856,0,270795
833,2019-10-27,246341,28496,1162,0,275999
833,2019-10-28,248403,14660,1132,0,264195
833,2019-10-29,249808,14227,1705,0,265740
833,2019-10-30,243745,14429,1983,2,260159
833,2019-10-31,236367,18918,1712,0,256997
833,2019-11-01,234007,26192,1434,0,261633
833,2019-11-02,234602,16363,1172,1,252138
833,2019-11-03,230909,20991,1413,0,253313
833,2019-11-04,237269,6359,1280,2,244910
833,2019-11-05,236672,769,1343,0,238784
833,2019-11-06,237030,6810,809,0,244649
833,2019-11-07,231975,20415,934,3,253327
833,2019-11-08,231225,10795,1133,2,243155
833,2019-11-09,232570,11523,946,2,245041
833,2019-11-10,232927,12340,832,2,246101
833,2019-11-11,242601,6895,1226,2,250724
833,2019-11-12,237110,8441,2482,2,248035
833,2019-11-13,204111,17791,1862,1,223765
833,2019-11-14,219903,9264,1629,3,230799
833,2019-11-15,223135,3554,1539,1,228229
833,2019-11-16,225086,2700,1717,0,229503
833,2019-11-17,221525,3036,2713,30,227304
833,2019-11-18,220794,3177,2267,0,226238
833,2019-11-19,201194,3044,2256,1,206495
833,2019-11-20,197298,1809,2426,0,201533
833,2019-11-21,190677,3329,1458,0,195464
833,2019-11-22,192706,7563,1510,0,201779
833,2019-11-23,206335,5703,1869,0,213907
833,2019-11-24,208928,6793,1724,0,217445
833,2019-11-25,199840,6104,1747,0,207691
833,2019-11-26,121187,5254,811,0,127252
833,2019-11-27,206178,5788,1141,0,213107
833,2019-11-28,142518,10867,490,0,153875
833,2019-11-29,1844,893,1,0,2738
833,2019-08-29,102054,1336,1800,0,105190
833,2019-08-30,232676,474,701,0,233851
833,2019-08-31,136446,90,2,0,136538
833,2019-09-01,85404,36,2,0,85442
833,2019-09-02,166783,0,1,0,166784
833,2019-09-03,183749,6,811,0,184566
833,2019-09-04,306378,24,2471,3,308876
833,2019-09-05,300210,33,2796,0,303039
833,2019-09-06,298818,56,2148,3,301025
833,2019-09-07,286121,39,1573,0,287733
833,2019-09-08,282612,96,1812,0,284520
833,2019-09-09,291849,1303,1674,0,294826
833,2019-09-10,279786,288,2455,2,282531
833,2019-09-11,287707,243,2443,58,290451
833,2019-09-12,291081,155,2656,1,293893
833,2019-09-13,287890,23,2100,1,290014
833,2019-09-14,279813,52,1890,0,281755
833,2019-09-15,276892,86,1795,1,278774
833,2019-09-16,285014,31,2187,0,287232
833,2019-09-17,285502,51,2384,0,287937
833,2019-09-18,284962,3,1547,0,286512
833,2019-09-19,285314,1486,1441,1,288242
833,2019-09-20,280458,6975,1341,3,288777
833,2019-09-21,271348,7682,1476,1,280507
833,2019-09-22,274324,8683,2158,0,285165
833,2019-09-23,280138,7048,2160,2,289348
833,2019-09-24,279334,4964,2000,3,286301
833,2019-09-25,275635,8025,1448,5,285113
833,2019-09-26,278925,9208,2370,0,290503
833,2019-09-27,273055,7315,1710,2,282082
833,2019-09-28,266957,13748,1772,2,282479
833,2019-09-29,267240,14275,1649,0,283164
833,2019-09-30,272039,24069,1655,4,297767
833,2019-10-01,269290,19614,1281,1,290186
833,2019-10-02,269541,14569,1952,0,286062
833,2019-10-03,273403,12126,1769,0,287298
833,2019-10-04,270169,10042,1188,3,281402
833,2019-10-05,264069,19994,2114,1,286178
833,2019-10-06,266317,14730,3128,5,284180
833,2019-10-07,269678,2733,1582,0,273993
833,2019-10-08,271471,10323,2403,2,284199
833,2019-10-09,267049,13981,1486,1,282517
833,2019-10-10,266994,8891,2023,3,277911
833,2019-10-11,260340,9205,1406,0,270951
833,2019-10-12,257292,5480,1615,1,264388
833,2019-10-13,254898,6748,1208,1,262855
833,2019-10-14,263229,4410,1858,0,269497
833,2019-10-15,260006,6854,1373,1,268234
833,2019-10-16,256696,11838,2325,0,270859
833,2019-10-17,257871,4078,956,0,262905
833,2019-10-18,257205,7362,1983,0,266550
833,2019-10-19,253136,4249,1684,20,259089
833,2019-10-20,254927,565,1512,2,257006
833,2019-10-21,254320,8720,1280,3,264323
833,2019-10-22,252879,4493,2076,0,259448
833,2019-10-23,250412,6397,1945,0,258754
833,2019-10-24,249713,12580,879,0,263172
833,2019-10-25,248291,13948,1034,2,263275
833,2019-10-26,245720,23219,1856,0,270795
833,2019-10-27,246341,28496,1162,0,275999
833,2019-10-28,248403,14660,1132,0,264195
833,2019-10-29,249808,14227,1705,0,265740
833,2019-10-30,243745,14429,1983,2,260159
833,2019-10-31,236367,18918,1712,0,256997
833,2019-11-01,234007,26192,1434,0,261633
833,2019-11-02,234602,16363,1172,1,252138
833,2019-11-03,230909,20991,1413,0,253313
833,2019-11-04,237269,6359,1280,2,244910
833,2019-11-05,236672,769,1343,0,238784
833,2019-11-06,237030,6810,809,0,244649
833,2019-11-07,231975,20415,934,3,253327
833,2019-11-08,231225,10795,1133,2,243155
833,2019-11-09,232570,11523,946,2,245041
833,2019-11-10,232927,12340,832,2,246101
833,2019-11-11,242601,6895,1226,2,250724
833,2019-11-12,237110,8441,2482,2,248035
833,2019-11-13,204111,17791,1862,1,223765
833,2019-11-14,219903,9264,1629,3,230799
833,2019-11-15,223135,3554,1539,1,228229
833,2019-11-16,225086,2700,1717,0,229503
833,2019-11-17,221525,3036,2713,30,227304
833,2019-11-18,220794,3177,2267,0,226238
833,2019-11-19,201194,3044,2256,1,206495
833,2019-11-20,197298,1809,2426,0,201533
833,2019-11-21,190677,3329,1458,0,195464
833,2019-11-22,192706,7563,1510,0,201779
833,2019-11-23,206335,5703,1869,0,213907
833,2019-11-24,208928,6793,1724,0,217445
833,2019-11-25,199840,6104,1747,0,207691
833,2019-11-26,121187,5254,811,0,127252
833,2019-11-27,206178,5788,1141,0,213107
833,2019-11-28,142518,10867,490,0,153875
833,2019-11-29,1844,893,1,0,2738
833,2019-09-04,306378,24,2471,3,308876
833,2019-09-05,300210,33,2796,0,303039
833,2019-09-06,298818,56,2148,3,301025
833,2019-09-07,286121,39,1573,0,287733
833,2019-09-08,282612,96,1812,0,284520
833,2019-09-09,291849,1303,1674,0,294826
833,2019-09-10,279786,288,2455,2,282531
833,2019-09-11,287707,243,2443,58,290451
833,2019-09-12,291081,155,2656,1,293893
833,2019-09-13,287890,23,2100,1,290014
833,2019-09-14,279813,52,1890,0,281755
833,2019-09-15,276892,86,1795,1,278774
833,2019-09-16,285014,31,2187,0,287232
833,2019-09-17,285502,51,2384,0,287937
833,2019-09-18,284962,3,1547,0,286512
833,2019-09-19,285314,1486,1441,1,288242
833,2019-09-20,280458,6975,1341,3,288777
833,2019-09-21,271348,7682,1476,1,280507
833,2019-09-22,274324,8683,2158,0,285165
833,2019-09-23,280138,7048,2160,2,289348
833,2019-09-24,279334,4964,2000,3,286301
833,2019-09-25,275635,8025,1448,5,285113
833,2019-09-26,278925,9208,2370,0,290503
833,2019-09-27,273055,7315,1710,2,282082
833,2019-09-28,266957,13748,1772,2,282479
833,2019-09-29,267240,14275,1649,0,283164
833,2019-09-30,272039,24069,1655,4,297767
833,2019-10-01,269290,19614,1281,1,290186
833,2019-10-02,269541,14569,1952,0,286062
833,2019-10-03,273403,12126,1769,0,287298
833,2019-10-04,270169,10042,1188,3,281402
833,2019-10-05,264069,19994,2114,1,286178
833,2019-10-06,266317,14730,3128,5,284180
833,2019-10-07,269678,2733,1582,0,273993
833,2019-10-08,271471,10323,2403,2,284199
833,2019-10-09,267049,13981,1486,1,282517
833,2019-10-10,266994,8891,2023,3,277911
833,2019-10-11,260340,9205,1406,0,270951
833,2019-10-12,257292,5480,1615,1,264388
833,2019-10-13,254898,6748,1208,1,262855
833,2019-10-14,263229,4410,1858,0,269497
833,2019-10-15,260006,6854,1373,1,268234
833,2019-10-16,256696,11838,2325,0,270859
833,2019-10-17,257871,4078,956,0,262905
833,2019-10-18,257205,7362,1983,0,266550
833,2019-10-19,253136,4249,1684,20,259089
833,2019-10-20,254927,565,1512,2,257006
833,2019-10-21,254320,8720,1280,3,264323
833,2019-10-22,252879,4493,2076,0,259448
833,2019-10-23,250412,6397,1945,0,258754
833,2019-10-24,249713,12580,879,0,263172
833,2019-10-25,248291,13948,1034,2,263275
833,2019-10-26,245720,23219,1856,0,270795
833,2019-10-27,246341,28496,1162,0,275999
833,2019-10-28,248403,14660,1132,0,264195
833,2019-10-29,249808,14227,1705,0,265740
833,2019-10-30,243745,14429,1983,2,260159
833,2019-10-31,236367,18918,1712,0,256997
833,2019-11-01,234007,26192,1434,0,261633
833,2019-11-02,234602,16363,1172,1,252138
833,2019-11-03,230909,20991,1413,0,253313
833,2019-11-04,237269,6359,1280,2,244910
833,2019-11-05,236672,769,1343,0,238784
833,2019-11-06,237030,6810,809,0,244649
833,2019-11-07,231975,20415,934,3,253327
833,2019-11-08,231225,10795,1133,2,243155
833,2019-11-09,232570,11523,946,2,245041
833,2019-11-10,232927,12340,832,2,246101
833,2019-11-11,242601,6895,1226,2,250724
833,2019-11-12,237110,8441,2482,2,248035
833,2019-11-13,204111,17791,1862,1,223765
833,2019-11-14,219903,9264,1629,3,230799
833,2019-11-15,223135,3554,1539,1,228229
833,2019-11-16,225086,2700,1717,0,229503
833,2019-11-17,221525,3036,2713,30,227304
833,2019-11-18,220794,3177,2267,0,226238
833,2019-11-19,201194,3044,2256,1,206495
834,2019-08-29,204,1063,1290,1,2558
834,2019-08-30,592,507,630,0,1729
834,2019-08-31,243,54,0,0,297
834,2019-09-01,310,18,90,0,418
834,2019-09-02,122,0,27,0,149
834,2019-09-03,189,0,1486,0,1675
834,2019-09-04,687,48,2308,1,3044
834,2019-09-05,660,60,2393,1,3114
834,2019-09-06,721,41,1538,0,2300
834,2019-09-07,740,49,2645,1,3435
834,2019-09-08,2351,133,1721,0,4205
834,2019-09-09,617,437,2077,0,3131
834,2019-09-10,560,403,2025,0,2988
834,2019-09-11,183,271,2309,1,2764
834,2019-09-12,1198,112,1725,2,3037
834,2019-09-13,1737,10,2220,1,3968
834,2019-09-14,1398,29,2229,0,3656
834,2019-09-15,492,14,2469,2,2977
834,2019-09-16,518,6,1890,0,2414
834,2019-09-17,426,2785,1843,0,5054
834,2019-09-18,704,6,1814,1,2525
834,2019-09-19,789,4074,1800,0,6663
834,2019-09-20,639,5778,1555,1,7973
834,2019-09-21,768,6320,2412,2,9502
834,2019-09-22,1310,8308,1366,2,10986
834,2019-09-23,557,11401,1612,0,13570
834,2019-09-24,696,7200,1678,1,9575
834,2019-09-25,237,8608,1923,4,10772
834,2019-09-26,222,7925,1994,1,10142
834,2019-09-27,1052,7408,1260,3,9723
834,2019-09-28,197,14558,1223,2,15980
834,2019-09-29,1099,17229,2129,2,20459
834,2019-09-30,1061,17125,1996,3,20185
834,2019-10-01,188,15681,1495,1,17365
834,2019-10-02,187,11582,1600,0,13369
834,2019-10-03,208,12959,1742,0,14909
834,2019-10-04,896,12517,1478,1,14892
834,2019-10-05,680,14399,1145,3,16227
834,2019-10-06,200,18374,951,1,19526
834,2019-10-07,1076,5047,2117,2,8242
834,2019-10-08,208,11624,2067,1,13900
834,2019-10-09,198,15275,1650,1,17124
834,2019-10-10,1303,9028,2232,3,12566
834,2019-10-11,1407,10859,1538,1,13805
834,2019-10-12,435,5846,2049,1,8331
834,2019-10-13,735,5399,2586,3,8723
834,2019-10-14,398,4936,2014,0,7348
834,2019-10-15,1283,7084,1510,4,9881
834,2019-10-16,1788,17921,1785,0,21494
834,2019-10-17,2051,6889,1539,1,10480
834,2019-10-18,507,7780,1092,0,9379
834,2019-10-19,605,3747,1831,2,6185
834,2019-10-20,563,590,3084,2,4239
834,2019-10-21,438,9466,660,1,10565
834,2019-10-22,561,4581,1960,1,7103
834,2019-10-23,441,12932,1504,2,14879
834,2019-10-24,1040,18144,1244,0,20428
834,2019-10-25,437,14530,1201,4,16172
834,2019-10-26,429,15748,873,0,17050
834,2019-10-27,838,15044,2325,1,18208
834,2019-10-28,950,22232,1550,0,24732
834,2019-10-29,548,27934,1252,0,29734
834,2019-10-30,478,19273,1392,3,21146
834,2019-10-31,539,19896,2088,0,22523
834,2019-11-01,452,26264,1439,1,28156
834,2019-11-02,416,16329,1555,1,18301
834,2019-11-03,878,36208,904,0,37990
834,2019-11-04,1447,12309,1370,2,15128
834,2019-11-05,1200,1463,1922,0,4585
834,2019-11-06,464,13349,1208,1,15022
834,2019-11-07,1239,16299,647,2,18187
834,2019-11-08,535,9060,1088,0,10683
834,2019-11-09,468,7797,1426,2,9693
834,2019-11-10,425,12687,2059,0,15171
834,2019-11-11,1378,12108,2641,3,16130
834,2019-11-12,409,11965,3111,0,15485
834,2019-11-13,427,12965,1393,2,14787
834,2019-11-14,475,7074,1873,4,9426
834,2019-11-15,433,2887,1968,0,5288
834,2019-11-16,473,935,2547,0,3955
834,2019-11-17,506,2794,3556,0,6856
834,2019-11-18,442,3958,2929,1,7330
834,2019-11-19,502,2759,2753,4,6018
834,2019-11-20,516,849,2172,0,3537
834,2019-11-21,429,2808,1442,0,4679
834,2019-11-22,1230,5162,1117,3,7512
834,2019-11-23,1487,7821,2005,0,11313
834,2019-11-24,506,6914,2393,2,9815
834,2019-11-25,1203,5224,1670,1,8098
834,2019-11-26,2046,6503,1089,0,9638
834,2019-11-27,414,5394,1231,0,7039
834,2019-11-28,446,8009,470,0,8925
834,2019-11-29,75,24,335,0,434
834,2019-08-29,204,1063,1290,1,2558
834,2019-08-30,592,507,630,0,1729
834,2019-08-31,243,54,0,0,297
834,2019-09-01,310,18,90,0,418
834,2019-09-02,122,0,27,0,149
834,2019-09-03,189,0,1486,0,1675
834,2019-09-04,687,48,2308,1,3044
834,2019-09-05,660,60,2393,1,3114
834,2019-09-06,721,41,1538,0,2300
834,2019-09-07,740,49,2645,1,3435
834,2019-09-08,2351,133,1721,0,4205
834,2019-09-09,617,437,2077,0,3131
834,2019-09-10,560,403,2025,0,2988
834,2019-09-11,183,271,2309,1,2764
834,2019-09-12,1198,112,1725,2,3037
834,2019-09-13,1737,10,2220,1,3968
834,2019-09-14,1398,29,2229,0,3656
834,2019-09-15,492,14,2469,2,2977
834,2019-09-16,518,6,1890,0,2414
834,2019-09-17,426,2785,1843,0,5054
834,2019-09-18,704,6,1814,1,2525
834,2019-09-19,789,4074,1800,0,6663
834,2019-09-20,639,5778,1555,1,7973
834,2019-09-21,768,6320,2412,2,9502
834,2019-09-22,1310,8308,1366,2,10986
834,2019-09-23,557,11401,1612,0,13570
834,2019-09-24,696,7200,1678,1,9575
834,2019-09-25,237,8608,1923,4,10772
834,2019-09-26,222,7925,1994,1,10142
834,2019-09-27,1052,7408,1260,3,9723
834,2019-09-28,197,14558,1223,2,15980
834,2019-09-29,1099,17229,2129,2,20459
834,2019-09-30,1061,17125,1996,3,20185
834,2019-10-01,188,15681,1495,1,17365
834,2019-10-02,187,11582,1600,0,13369
834,2019-10-03,208,12959,1742,0,14909
834,2019-10-04,896,12517,1478,1,14892
834,2019-10-05,680,14399,1145,3,16227
834,2019-10-06,200,18374,951,1,19526
834,2019-10-07,1076,5047,2117,2,8242
834,2019-10-08,208,11624,2067,1,13900
834,2019-10-09,198,15275,1650,1,17124
834,2019-10-10,1303,9028,2232,3,12566
834,2019-10-11,1407,10859,1538,1,13805
834,2019-10-12,435,5846,2049,1,8331
834,2019-10-13,735,5399,2586,3,8723
834,2019-10-14,398,4936,2014,0,7348
834,2019-10-15,1283,7084,1510,4,9881
834,2019-10-16,1788,17921,1785,0,21494
834,2019-10-17,2051,6889,1539,1,10480
834,2019-10-18,507,7780,1092,0,9379
834,2019-10-19,605,3747,1831,2,6185
834,2019-10-20,563,590,3084,2,4239
834,2019-10-21,438,9466,660,1,10565
834,2019-10-22,561,4581,1960,1,7103
834,2019-10-23,441,12932,1504,2,14879
834,2019-10-24,1040,18144,1244,0,20428
834,2019-10-25,437,14530,1201,4,16172
834,2019-10-26,429,15748,873,0,17050
834,2019-10-27,838,15044,2325,1,18208
834,2019-10-28,950,22232,1550,0,24732
834,2019-10-29,548,27934,1252,0,29734
834,2019-10-30,478,19273,1392,3,21146
834,2019-10-31,539,19896,2088,0,22523
834,2019-11-01,452,26264,1439,1,28156
834,2019-11-02,416,16329,1555,1,18301
834,2019-11-03,878,36208,904,0,37990
834,2019-11-04,1447,12309,1370,2,15128
834,2019-11-05,1200,1463,1922,0,4585
834,2019-11-06,464,13349,1208,1,15022
834,2019-11-07,1239,16299,647,2,18187
834,2019-11-08,535,9060,1088,0,10683
834,2019-11-09,468,7797,1426,2,9693
834,2019-11-10,425,12687,2059,0,15171
834,2019-11-11,1378,12108,2641,3,16130
834,2019-11-12,409,11965,3111,0,15485
834,2019-11-13,427,12965,1393,2,14787
834,2019-11-14,475,7074,1873,4,9426
834,2019-11-15,433,2887,1968,0,5288
834,2019-11-16,473,935,2547,0,3955
834,2019-11-17,506,2794,3556,0,6856
834,2019-11-18,442,3958,2929,1,7330
834,2019-11-19,502,2759,2753,4,6018
834,2019-11-20,516,849,2172,0,3537
834,2019-11-21,429,2808,1442,0,4679
834,2019-11-22,1230,5162,1117,3,7512
834,2019-11-23,1487,7821,2005,0,11313
834,2019-11-24,506,6914,2393,2,9815
834,2019-11-25,1203,5224,1670,1,8098
834,2019-11-26,2046,6503,1089,0,9638
834,2019-11-27,414,5394,1231,0,7039
834,2019-11-28,446,8009,470,0,8925
834,2019-11-29,75,24,335,0,434
834,2019-08-29,204,1063,1290,1,2558
834,2019-08-30,592,507,630,0,1729
834,2019-08-31,243,54,0,0,297
834,2019-09-01,310,18,90,0,418
834,2019-09-02,122,0,27,0,149
834,2019-09-03,189,0,1486,0,1675
834,2019-09-04,687,48,2308,1,3044
834,2019-09-05,660,60,2393,1,3114
834,2019-09-06,721,41,1538,0,2300
834,2019-09-07,740,49,2645,1,3435
834,2019-09-08,2351,133,1721,0,4205
834,2019-09-09,617,437,2077,0,3131
834,2019-09-10,560,403,2025,0,2988
834,2019-09-11,183,271,2309,1,2764
834,2019-09-12,1198,112,1725,2,3037
834,2019-09-13,1737,10,2220,1,3968
834,2019-09-14,1398,29,2229,0,3656
834,2019-09-15,492,14,2469,2,2977
834,2019-09-16,518,6,1890,0,2414
834,2019-09-17,426,2785,1843,0,5054
834,2019-09-18,704,6,1814,1,2525
834,2019-09-19,789,4074,1800,0,6663
834,2019-09-20,639,5778,1555,1,7973
834,2019-09-21,768,6320,2412,2,9502
834,2019-09-22,1310,8308,1366,2,10986
834,2019-09-23,557,11401,1612,0,13570
834,2019-09-24,696,7200,1678,1,9575
834,2019-09-25,237,8608,1923,4,10772
834,2019-09-26,222,7925,1994,1,10142
834,2019-09-27,1052,7408,1260,3,9723
834,2019-09-28,197,14558,1223,2,15980
834,2019-09-29,1099,17229,2129,2,20459
834,2019-09-30,1061,17125,1996,3,20185
834,2019-10-01,188,15681,1495,1,17365
834,2019-10-02,187,11582,1600,0,13369
834,2019-10-03,208,12959,1742,0,14909
834,2019-10-04,896,12517,1478,1,14892
834,2019-10-05,680,14399,1145,3,16227
834,2019-10-06,200,18374,951,1,19526
834,2019-10-07,1076,5047,2117,2,8242
834,2019-10-08,208,11624,2067,1,13900
834,2019-10-09,198,15275,1650,1,17124
834,2019-10-10,1303,9028,2232,3,12566
834,2019-10-11,1407,10859,1538,1,13805
834,2019-10-12,435,5846,2049,1,8331
834,2019-10-13,735,5399,2586,3,8723
834,2019-10-14,398,4936,2014,0,7348
834,2019-10-15,1283,7084,1510,4,9881
834,2019-10-16,1788,17921,1785,0,21494
834,2019-10-17,2051,6889,1539,1,10480
834,2019-10-18,507,7780,1092,0,9379
834,2019-10-19,605,3747,1831,2,6185
834,2019-10-20,563,590,3084,2,4239
834,2019-10-21,438,9466,660,1,10565
834,2019-10-22,561,4581,1960,1,7103
834,2019-10-23,441,12932,1504,2,14879
834,2019-10-24,1040,18144,1244,0,20428
834,2019-10-25,437,14530,1201,4,16172
834,2019-10-26,429,15748,873,0,17050
834,2019-10-27,838,15044,2325,1,18208
834,2019-10-28,950,22232,1550,0,24732
834,2019-10-29,548,27934,1252,0,29734
834,2019-10-30,478,19273,1392,3,21146
834,2019-10-31,539,19896,2088,0,22523
834,2019-11-01,452,26264,1439,1,28156
834,2019-11-02,416,16329,1555,1,18301
834,2019-11-03,878,36208,904,0,37990
834,2019-11-04,1447,12309,1370,2,15128
834,2019-11-05,1200,1463,1922,0,4585
834,2019-11-06,464,13349,1208,1,15022
834,2019-11-07,1239,16299,647,2,18187
834,2019-11-08,535,9060,1088,0,10683
834,2019-11-09,468,7797,1426,2,9693
834,2019-11-10,425,12687,2059,0,15171
834,2019-11-11,1378,12108,2641,3,16130
834,2019-11-12,409,11965,3111,0,15485
834,2019-11-13,427,12965,1393,2,14787
834,2019-11-14,475,7074,1873,4,9426
834,2019-11-15,433,2887,1968,0,5288
834,2019-11-16,473,935,2547,0,3955
834,2019-11-17,506,2794,3556,0,6856
834,2019-11-18,442,3958,2929,1,7330
834,2019-11-19,502,2759,2753,4,6018
834,2019-11-20,516,849,2172,0,3537
834,2019-11-21,429,2808,1442,0,4679
834,2019-11-22,1230,5162,1117,3,7512
834,2019-11-23,1487,7821,2005,0,11313
834,2019-11-24,506,6914,2393,2,9815
834,2019-11-25,1203,5224,1670,1,8098
834,2019-11-26,2046,6503,1089,0,9638
834,2019-11-27,414,5394,1231,0,7039
834,2019-11-28,446,8009,470,0,8925
834,2019-11-29,75,24,335,0,434
834,2019-08-29,204,1063,1290,1,2558
834,2019-08-30,592,507,630,0,1729
834,2019-08-31,243,54,0,0,297
834,2019-09-01,310,18,90,0,418
834,2019-09-02,122,0,27,0,149
834,2019-09-03,189,0,1486,0,1675
834,2019-09-04,687,48,2308,1,3044
834,2019-09-05,660,60,2393,1,3114
834,2019-09-06,721,41,1538,0,2300
834,2019-09-07,740,49,2645,1,3435
834,2019-09-08,2351,133,1721,0,4205
834,2019-09-09,617,437,2077,0,3131
834,2019-09-10,560,403,2025,0,2988
834,2019-09-11,183,271,2309,1,2764
834,2019-09-12,1198,112,1725,2,3037
834,2019-09-13,1737,10,2220,1,3968
834,2019-09-14,1398,29,2229,0,3656
834,2019-09-15,492,14,2469,2,2977
834,2019-09-16,518,6,1890,0,2414
834,2019-09-17,426,2785,1843,0,5054
834,2019-09-18,704,6,1814,1,2525
834,2019-09-19,789,4074,1800,0,6663
834,2019-09-20,639,5778,1555,1,7973
834,2019-09-21,768,6320,2412,2,9502
834,2019-09-22,1310,8308,1366,2,10986
834,2019-09-23,557,11401,1612,0,13570
834,2019-09-24,696,7200,1678,1,9575
834,2019-09-25,237,8608,1923,4,10772
834,2019-09-26,222,7925,1994,1,10142
834,2019-09-27,1052,7408,1260,3,9723
834,2019-09-28,197,14558,1223,2,15980
834,2019-09-29,1099,17229,2129,2,20459
834,2019-09-30,1061,17125,1996,3,20185
834,2019-10-01,188,15681,1495,1,17365
834,2019-10-02,187,11582,1600,0,13369
834,2019-10-03,208,12959,1742,0,14909
834,2019-10-04,896,12517,1478,1,14892
834,2019-10-05,680,14399,1145,3,16227
834,2019-10-06,200,18374,951,1,19526
834,2019-10-07,1076,5047,2117,2,8242
834,2019-10-08,208,11624,2067,1,13900
834,2019-10-09,198,15275,1650,1,17124
834,2019-10-10,1303,9028,2232,3,12566
834,2019-10-11,1407,10859,1538,1,13805
834,2019-10-12,435,5846,2049,1,8331
834,2019-10-13,735,5399,2586,3,8723
834,2019-10-14,398,4936,2014,0,7348
834,2019-10-15,1283,7084,1510,4,9881
834,2019-10-16,1788,17921,1785,0,21494
834,2019-10-17,2051,6889,1539,1,10480
834,2019-10-18,507,7780,1092,0,9379
834,2019-10-19,605,3747,1831,2,6185
834,2019-10-20,563,590,3084,2,4239
834,2019-10-21,438,9466,660,1,10565
834,2019-10-22,561,4581,1960,1,7103
834,2019-10-23,441,12932,1504,2,14879
834,2019-10-24,1040,18144,1244,0,20428
834,2019-10-25,437,14530,1201,4,16172
834,2019-10-26,429,15748,873,0,17050
834,2019-10-27,838,15044,2325,1,18208
834,2019-10-28,950,22232,1550,0,24732
834,2019-10-29,548,27934,1252,0,29734
834,2019-10-30,478,19273,1392,3,21146
834,2019-10-31,539,19896,2088,0,22523
834,2019-11-01,452,26264,1439,1,28156
834,2019-11-02,416,16329,1555,1,18301
834,2019-11-03,878,36208,904,0,37990
834,2019-11-04,1447,12309,1370,2,15128
834,2019-11-05,1200,1463,1922,0,4585
834,2019-11-06,464,13349,1208,1,15022
834,2019-11-07,1239,16299,647,2,18187
834,2019-11-08,535,9060,1088,0,10683
834,2019-11-09,468,7797,1426,2,9693
834,2019-11-10,425,12687,2059,0,15171
834,2019-11-11,1378,12108,2641,3,16130
834,2019-11-12,409,11965,3111,0,15485
834,2019-11-13,427,12965,1393,2,14787
834,2019-11-14,475,7074,1873,4,9426
834,2019-11-15,433,2887,1968,0,5288
834,2019-11-16,473,935,2547,0,3955
834,2019-11-17,506,2794,3556,0,6856
834,2019-11-18,442,3958,2929,1,7330
834,2019-11-19,502,2759,2753,4,6018
834,2019-11-20,516,849,2172,0,3537
834,2019-11-21,429,2808,1442,0,4679
834,2019-11-22,1230,5162,1117,3,7512
834,2019-11-23,1487,7821,2005,0,11313
834,2019-11-24,506,6914,2393,2,9815
834,2019-11-25,1203,5224,1670,1,8098
835,2019-08-29,449,243,991,0,1683
835,2019-08-30,513,1316,803,0,2632
835,2019-08-31,165,12168,1,0,12334
835,2019-09-01,384,2752,0,0,3136
835,2019-09-02,365,0,125,0,490
835,2019-09-03,527,37,1175,0,1739
835,2019-09-04,634,22,1683,1,2340
835,2019-09-05,771,66,2022,2,2861
835,2019-09-06,655,13,1930,1,2599
835,2019-09-07,833,294,1899,0,3026
835,2019-09-08,714,599,2596,1,3910
835,2019-09-09,604,1487,2378,0,4469
835,2019-09-10,2012,1202,2262,1,5477
835,2019-09-11,412,1035,2068,2,3517
835,2019-09-12,1475,1529,2010,0,5014
835,2019-09-13,1481,1870,1995,1,5347
835,2019-09-14,1050,98,1934,0,3082
835,2019-09-15,517,472,2250,2,3241
835,2019-09-16,487,91,1643,0,2221
835,2019-09-17,1341,991,2043,1,4376
835,2019-09-18,644,66,1555,1,2266
835,2019-09-19,1624,2421,2162,2,6209
835,2019-09-20,528,6413,1595,1,8537
835,2019-09-21,507,6056,2294,1,8858
835,2019-09-22,843,8387,1107,0,10337
835,2019-09-23,1008,7574,1966,1,10549
835,2019-09-24,654,7229,2158,6,10047
835,2019-09-25,360,6488,1980,4,8832
835,2019-09-26,263,9822,943,0,11028
835,2019-09-27,225,7105,1586,1,8917
835,2019-09-28,269,14272,1459,2,16002
835,2019-09-29,1975,15635,1839,1,19450
835,2019-09-30,246,16580,1212,3,18041
835,2019-10-01,240,15161,1554,1,16956
835,2019-10-02,1118,10833,1618,1,13570
835,2019-10-03,1139,12538,718,1,14396
835,2019-10-04,337,11051,1810,2,13200
835,2019-10-05,796,14251,1773,0,16820
835,2019-10-06,1133,10398,1710,1,13242
835,2019-10-07,1180,4712,1680,0,7572
835,2019-10-08,257,10557,1636,0,12450
835,2019-10-09,782,14214,1185,0,16181
835,2019-10-10,614,9256,1875,3,11748
835,2019-10-11,604,9218,1841,1,11664
835,2019-10-12,1333,5587,1350,1,8271
835,2019-10-13,485,5469,1653,1,7608
835,2019-10-14,1392,5153,2502,0,9047
835,2019-10-15,598,6982,2080,2,9662
835,2019-10-16,506,12479,1379,2,14366
835,2019-10-17,654,4144,1823,1,6622
835,2019-10-18,590,7215,1957,1,9763
835,2019-10-19,564,3681,1998,1,6244
835,2019-10-20,521,663,1170,2,2356
835,2019-10-21,2373,9053,2124,1,13551
835,2019-10-22,1558,5158,1834,1,8551
835,2019-10-23,973,13019,1256,0,15248
835,2019-10-24,495,24786,1713,1,26995
835,2019-10-25,496,13611,1574,5,15686
835,2019-10-26,1711,14354,1126,2,17193
835,2019-10-27,994,15064,1575,0,17633
835,2019-10-28,499,12781,1560,0,14840
835,2019-10-29,2363,15728,1736,2,19829
835,2019-10-30,525,14978,1520,2,17025
835,2019-10-31,480,11770,1312,0,13562
835,2019-11-01,490,13407,1315,0,15212
835,2019-11-02,1425,13698,1449,1,16573
835,2019-11-03,1437,21570,827,0,23834
835,2019-11-04,650,9525,1116,3,11294
835,2019-11-05,546,3804,1960,0,6310
835,2019-11-06,815,14182,845,0,15842
835,2019-11-07,646,15777,1478,3,17904
835,2019-11-08,601,8825,873,0,10299
835,2019-11-09,526,7778,1539,3,9846
835,2019-11-10,677,21793,1650,0,24120
835,2019-11-11,523,14407,1724,3,16657
835,2019-11-12,474,16276,2793,1,19544
835,2019-11-13,610,14034,1386,2,16032
835,2019-11-14,511,11919,1659,3,14092
835,2019-11-15,458,4685,2193,0,7336
835,2019-11-16,533,5457,2788,0,8778
835,2019-11-17,628,6213,3627,0,10468
835,2019-11-18,1429,2627,2646,0,6702
835,2019-11-19,1000,3161,1995,0,6156
835,2019-11-20,562,1374,2459,0,4395
835,2019-11-21,576,5494,1869,0,7939
835,2019-11-22,790,9055,1567,0,11412
835,2019-11-23,986,10097,1456,0,12539
835,2019-11-24,523,10694,2578,0,13795
835,2019-11-25,555,7201,2173,0,9929
835,2019-11-26,503,10410,1748,0,12661
835,2019-11-27,518,10528,2231,0,13277
835,2019-11-28,368,12709,445,0,13522
835,2019-11-29,83,320,1,0,404
835,2019-08-29,449,243,991,0,1683
835,2019-08-30,513,1316,803,0,2632
835,2019-08-31,165,12168,1,0,12334
835,2019-09-01,384,2752,0,0,3136
835,2019-09-02,365,0,125,0,490
835,2019-09-03,527,37,1175,0,1739
835,2019-09-04,634,22,1683,1,2340
835,2019-09-05,771,66,2022,2,2861
835,2019-09-06,655,13,1930,1,2599
835,2019-09-07,833,294,1899,0,3026
835,2019-09-08,714,599,2596,1,3910
835,2019-09-09,604,1487,2378,0,4469
835,2019-09-10,2012,1202,2262,1,5477
835,2019-09-11,412,1035,2068,2,3517
835,2019-09-12,1475,1529,2010,0,5014
835,2019-09-13,1481,1870,1995,1,5347
835,2019-09-14,1050,98,1934,0,3082
835,2019-09-15,517,472,2250,2,3241
835,2019-09-16,487,91,1643,0,2221
835,2019-09-17,1341,991,2043,1,4376
835,2019-09-18,644,66,1555,1,2266
835,2019-09-19,1624,2421,2162,2,6209
835,2019-09-20,528,6413,1595,1,8537
835,2019-09-21,507,6056,2294,1,8858
835,2019-09-22,843,8387,1107,0,10337
835,2019-09-23,1008,7574,1966,1,10549
835,2019-09-24,654,7229,2158,6,10047
835,2019-09-25,360,6488,1980,4,8832
835,2019-09-26,263,9822,943,0,11028
835,2019-09-27,225,7105,1586,1,8917
835,2019-09-28,269,14272,1459,2,16002
835,2019-09-29,1975,15635,1839,1,19450
835,2019-09-30,246,16580,1212,3,18041
835,2019-10-01,240,15161,1554,1,16956
835,2019-10-02,1118,10833,1618,1,13570
835,2019-10-03,1139,12538,718,1,14396
835,2019-10-04,337,11051,1810,2,13200
835,2019-10-05,796,14251,1773,0,16820
835,2019-10-06,1133,10398,1710,1,13242
835,2019-10-07,1180,4712,1680,0,7572
835,2019-10-08,257,10557,1636,0,12450
835,2019-10-09,782,14214,1185,0,16181
835,2019-10-10,614,9256,1875,3,11748
835,2019-10-11,604,9218,1841,1,11664
835,2019-10-12,1333,5587,1350,1,8271
835,2019-10-13,485,5469,1653,1,7608
835,2019-10-14,1392,5153,2502,0,9047
835,2019-10-15,598,6982,2080,2,9662
835,2019-10-16,506,12479,1379,2,14366
835,2019-10-17,654,4144,1823,1,6622
835,2019-10-18,590,7215,1957,1,9763
835,2019-10-19,564,3681,1998,1,6244
835,2019-10-20,521,663,1170,2,2356
835,2019-10-21,2373,9053,2124,1,13551
835,2019-10-22,1558,5158,1834,1,8551
835,2019-10-23,973,13019,1256,0,15248
835,2019-10-24,495,24786,1713,1,26995
835,2019-10-25,496,13611,1574,5,15686
835,2019-10-26,1711,14354,1126,2,17193
835,2019-10-27,994,15064,1575,0,17633
835,2019-10-28,499,12781,1560,0,14840
835,2019-10-29,2363,15728,1736,2,19829
835,2019-10-30,525,14978,1520,2,17025
835,2019-10-31,480,11770,1312,0,13562
835,2019-11-01,490,13407,1315,0,15212
835,2019-11-02,1425,13698,1449,1,16573
835,2019-11-03,1437,21570,827,0,23834
835,2019-11-04,650,9525,1116,3,11294
835,2019-11-05,546,3804,1960,0,6310
835,2019-11-06,815,14182,845,0,15842
835,2019-11-07,646,15777,1478,3,17904
835,2019-11-08,601,8825,873,0,10299
835,2019-11-09,526,7778,1539,3,9846
835,2019-11-10,677,21793,1650,0,24120
835,2019-11-11,523,14407,1724,3,16657
835,2019-11-12,474,16276,2793,1,19544
835,2019-11-13,610,14034,1386,2,16032
835,2019-11-14,511,11919,1659,3,14092
835,2019-11-15,458,4685,2193,0,7336
835,2019-11-16,533,5457,2788,0,8778
835,2019-11-17,628,6213,3627,0,10468
835,2019-11-18,1429,2627,2646,0,6702
835,2019-11-19,1000,3161,1995,0,6156
835,2019-11-20,562,1374,2459,0,4395
835,2019-11-21,576,5494,1869,0,7939
835,2019-11-22,790,9055,1567,0,11412
835,2019-11-23,986,10097,1456,0,12539
835,2019-11-24,523,10694,2578,0,13795
835,2019-11-25,555,7201,2173,0,9929
835,2019-11-26,503,10410,1748,0,12661
835,2019-11-27,518,10528,2231,0,13277
835,2019-11-28,368,12709,445,0,13522
835,2019-11-29,83,320,1,0,404
835,2019-08-29,449,243,991,0,1683
835,2019-08-30,513,1316,803,0,2632
835,2019-08-31,165,12168,1,0,12334
835,2019-09-01,384,2752,0,0,3136
835,2019-09-02,365,0,125,0,490
835,2019-09-03,527,37,1175,0,1739
835,2019-09-04,634,22,1683,1,2340
835,2019-09-05,771,66,2022,2,2861
835,2019-09-06,655,13,1930,1,2599
835,2019-09-07,833,294,1899,0,3026
835,2019-09-08,714,599,2596,1,3910
835,2019-09-09,604,1487,2378,0,4469
835,2019-09-10,2012,1202,2262,1,5477
835,2019-09-11,412,1035,2068,2,3517
835,2019-09-12,1475,1529,2010,0,5014
835,2019-09-13,1481,1870,1995,1,5347
835,2019-09-14,1050,98,1934,0,3082
835,2019-09-15,517,472,2250,2,3241
835,2019-09-16,487,91,1643,0,2221
835,2019-09-17,1341,991,2043,1,4376
835,2019-09-18,644,66,1555,1,2266
835,2019-09-19,1624,2421,2162,2,6209
835,2019-09-20,528,6413,1595,1,8537
835,2019-09-21,507,6056,2294,1,8858
835,2019-09-22,843,8387,1107,0,10337
835,2019-09-23,1008,7574,1966,1,10549
835,2019-09-24,654,7229,2158,6,10047
835,2019-09-25,360,6488,1980,4,8832
835,2019-09-26,263,9822,943,0,11028
835,2019-09-27,225,7105,1586,1,8917
835,2019-09-28,269,14272,1459,2,16002
835,2019-09-29,1975,15635,1839,1,19450
835,2019-09-30,246,16580,1212,3,18041
835,2019-10-01,240,15161,1554,1,16956
835,2019-10-02,1118,10833,1618,1,13570
835,2019-10-03,1139,12538,718,1,14396
835,2019-10-04,337,11051,1810,2,13200
835,2019-10-05,796,14251,1773,0,16820
835,2019-10-06,1133,10398,1710,1,13242
835,2019-10-07,1180,4712,1680,0,7572
835,2019-10-08,257,10557,1636,0,12450
835,2019-10-09,782,14214,1185,0,16181
835,2019-10-10,614,9256,1875,3,11748
835,2019-10-11,604,9218,1841,1,11664
835,2019-10-12,1333,5587,1350,1,8271
835,2019-10-13,485,5469,1653,1,7608
835,2019-10-14,1392,5153,2502,0,9047
835,2019-10-15,598,6982,2080,2,9662
835,2019-10-16,506,12479,1379,2,14366
835,2019-10-17,654,4144,1823,1,6622
835,2019-10-18,590,7215,1957,1,9763
835,2019-10-19,564,3681,1998,1,6244
835,2019-10-20,521,663,1170,2,2356
835,2019-10-21,2373,9053,2124,1,13551
835,2019-10-22,1558,5158,1834,1,8551
835,2019-10-23,973,13019,1256,0,15248
835,2019-10-24,495,24786,1713,1,26995
835,2019-10-25,496,13611,1574,5,15686
835,2019-10-26,1711,14354,1126,2,17193
835,2019-10-27,994,15064,1575,0,17633
835,2019-10-28,499,12781,1560,0,14840
835,2019-10-29,2363,15728,1736,2,19829
835,2019-10-30,525,14978,1520,2,17025
835,2019-10-31,480,11770,1312,0,13562
835,2019-11-01,490,13407,1315,0,15212
835,2019-11-02,1425,13698,1449,1,16573
835,2019-11-03,1437,21570,827,0,23834
835,2019-11-04,650,9525,1116,3,11294
835,2019-11-05,546,3804,1960,0,6310
835,2019-11-06,815,14182,845,0,15842
835,2019-11-07,646,15777,1478,3,17904
835,2019-11-08,601,8825,873,0,10299
835,2019-11-09,526,7778,1539,3,9846
835,2019-11-10,677,21793,1650,0,24120
835,2019-11-11,523,14407,1724,3,16657
835,2019-11-12,474,16276,2793,1,19544
835,2019-11-13,610,14034,1386,2,16032
835,2019-11-14,511,11919,1659,3,14092
835,2019-11-15,458,4685,2193,0,7336
835,2019-11-16,533,5457,2788,0,8778
835,2019-11-17,628,6213,3627,0,10468
835,2019-11-18,1429,2627,2646,0,6702
835,2019-11-19,1000,3161,1995,0,6156
835,2019-11-20,562,1374,2459,0,4395
835,2019-11-21,576,5494,1869,0,7939
835,2019-11-22,790,9055,1567,0,11412
835,2019-11-23,986,10097,1456,0,12539
835,2019-11-24,523,10694,2578,0,13795
835,2019-11-25,555,7201,2173,0,9929
835,2019-11-26,503,10410,1748,0,12661
835,2019-11-27,518,10528,2231,0,13277
835,2019-11-28,368,12709,445,0,13522
835,2019-11-29,83,320,1,0,404
835,2019-09-04,634,22,1683,1,2340
835,2019-09-05,771,66,2022,2,2861
835,2019-09-06,655,13,1930,1,2599
835,2019-09-07,833,294,1899,0,3026
835,2019-09-08,714,599,2596,1,3910
835,2019-09-09,604,1487,2378,0,4469
835,2019-09-10,2012,1202,2262,1,5477
835,2019-09-11,412,1035,2068,2,3517
835,2019-09-12,1475,1529,2010,0,5014
835,2019-09-13,1481,1870,1995,1,5347
835,2019-09-14,1050,98,1934,0,3082
835,2019-09-15,517,472,2250,2,3241
835,2019-09-16,487,91,1643,0,2221
835,2019-09-17,1341,991,2043,1,4376
835,2019-09-18,644,66,1555,1,2266
835,2019-09-19,1624,2421,2162,2,6209
835,2019-09-20,528,6413,1595,1,8537
835,2019-09-21,507,6056,2294,1,8858
835,2019-09-22,843,8387,1107,0,10337
835,2019-09-23,1008,7574,1966,1,10549
835,2019-09-24,654,7229,2158,6,10047
835,2019-09-25,360,6488,1980,4,8832
835,2019-09-26,263,9822,943,0,11028
835,2019-09-27,225,7105,1586,1,8917
835,2019-09-28,269,14272,1459,2,16002
835,2019-09-29,1975,15635,1839,1,19450
835,2019-09-30,246,16580,1212,3,18041
835,2019-10-01,240,15161,1554,1,16956
835,2019-10-02,1118,10833,1618,1,13570
835,2019-10-03,1139,12538,718,1,14396
835,2019-10-04,337,11051,1810,2,13200
835,2019-10-05,796,14251,1773,0,16820
835,2019-10-06,1133,10398,1710,1,13242
835,2019-10-07,1180,4712,1680,0,7572
835,2019-10-08,257,10557,1636,0,12450
835,2019-10-09,782,14214,1185,0,16181
835,2019-10-10,614,9256,1875,3,11748
835,2019-10-11,604,9218,1841,1,11664
835,2019-10-12,1333,5587,1350,1,8271
835,2019-10-13,485,5469,1653,1,7608
835,2019-10-14,1392,5153,2502,0,9047
835,2019-10-15,598,6982,2080,2,9662
835,2019-10-16,506,12479,1379,2,14366
835,2019-10-17,654,4144,1823,1,6622
835,2019-10-18,590,7215,1957,1,9763
835,2019-10-19,564,3681,1998,1,6244
835,2019-10-20,521,663,1170,2,2356
835,2019-10-21,2373,9053,2124,1,13551
835,2019-10-22,1558,5158,1834,1,8551
835,2019-10-23,973,13019,1256,0,15248
835,2019-10-24,495,24786,1713,1,26995
835,2019-10-25,496,13611,1574,5,15686
835,2019-10-26,1711,14354,1126,2,17193
835,2019-10-27,994,15064,1575,0,17633
835,2019-10-28,499,12781,1560,0,14840
835,2019-10-29,2363,15728,1736,2,19829
835,2019-10-30,525,14978,1520,2,17025
835,2019-10-31,480,11770,1312,0,13562
835,2019-11-01,490,13407,1315,0,15212
835,2019-11-02,1425,13698,1449,1,16573
835,2019-11-03,1437,21570,827,0,23834
835,2019-11-04,650,9525,1116,3,11294
835,2019-11-05,546,3804,1960,0,6310
835,2019-11-06,815,14182,845,0,15842
835,2019-11-07,646,15777,1478,3,17904
835,2019-11-08,601,8825,873,0,10299
835,2019-11-09,526,7778,1539,3,9846
835,2019-11-10,677,21793,1650,0,24120
835,2019-11-11,523,14407,1724,3,16657
835,2019-11-12,474,16276,2793,1,19544
835,2019-11-13,610,14034,1386,2,16032
835,2019-11-14,511,11919,1659,3,14092
837,2019-08-30,223759,0,0,0,223759
837,2019-08-31,543902,0,0,0,543902
837,2019-09-01,247211,0,0,0,247211
837,2019-09-02,0,0,0,0,0
837,2019-09-03,631279,0,0,0,631279
837,2019-09-04,1765499,0,0,0,1765499
837,2019-09-05,2237487,0,0,0,2237487
837,2019-09-06,1787393,0,0,0,1787393
837,2019-09-07,1691344,0,0,0,1691344
837,2019-09-08,1654432,0,0,0,1654432
837,2019-09-09,1707041,0,0,0,1707041
837,2019-09-10,1617987,0,0,0,1617987
837,2019-09-11,1720725,0,0,0,1720725
837,2019-09-12,1674169,0,0,0,1674169
837,2019-09-13,1687600,0,0,0,1687600
837,2019-09-14,1935613,0,0,0,1935613
837,2019-09-15,1983975,0,0,0,1983975
837,2019-09-16,2040579,0,0,0,2040579
837,2019-09-17,1982884,0,0,0,1982884
837,2019-09-18,1743966,0,0,0,1743966
837,2019-09-19,2001074,0,0,0,2001074
837,2019-09-20,1932854,0,0,0,1932854
837,2019-09-21,1952608,0,0,0,1952608
837,2019-09-22,1825170,0,0,0,1825170
837,2019-09-23,1949328,0,0,0,1949328
837,2019-09-24,2162749,0,0,0,2162749
837,2019-09-25,2142195,0,0,0,2142195
837,2019-09-26,2062931,0,0,0,2062931
837,2019-09-27,2067183,0,0,0,2067183
837,2019-09-28,1893135,0,0,0,1893135
837,2019-09-29,1852379,0,0,0,1852379
837,2019-09-30,1868192,0,0,0,1868192
837,2019-10-01,1769569,0,0,0,1769569
837,2019-10-02,1825934,0,0,0,1825934
837,2019-10-03,1700222,0,0,0,1700222
837,2019-10-04,1677419,0,0,0,1677419
837,2019-10-05,1623149,0,0,0,1623149
837,2019-10-06,1760711,0,0,0,1760711
837,2019-10-07,1884601,0,0,0,1884601
837,2019-10-08,1688846,0,0,0,1688846
837,2019-10-09,1640387,0,0,0,1640387
837,2019-10-10,1862432,0,0,0,1862432
837,2019-10-11,1683507,0,0,0,1683507
837,2019-10-12,1789655,0,0,0,1789655
837,2019-10-13,1763237,0,0,0,1763237
837,2019-10-14,1898952,0,0,0,1898952
837,2019-10-15,1688124,0,0,0,1688124
837,2019-10-16,1513256,0,0,0,1513256
837,2019-10-17,2102672,0,0,0,2102672
837,2019-10-18,1794712,0,0,0,1794712
837,2019-10-19,1772662,0,0,0,1772662
837,2019-10-20,1850988,0,0,0,1850988
837,2019-10-21,1653509,0,0,0,1653509
837,2019-10-22,1727813,0,0,0,1727813
837,2019-10-23,1644310,0,0,0,1644310
837,2019-10-24,1607049,0,0,0,1607049
837,2019-10-25,1543423,0,0,0,1543423
837,2019-10-26,1574709,0,0,0,1574709
837,2019-10-27,1549838,0,0,0,1549838
837,2019-10-28,1594660,0,0,0,1594660
837,2019-10-29,1540035,0,0,0,1540035
837,2019-10-30,1469230,0,0,0,1469230
837,2019-10-31,1621390,0,0,0,1621390
837,2019-11-01,1553814,0,0,0,1553814
837,2019-11-02,1444162,0,0,0,1444162
837,2019-11-03,1416565,0,0,0,1416565
837,2019-11-04,1706208,0,0,0,1706208
837,2019-11-05,1623080,0,0,0,1623080
837,2019-11-06,1440284,0,0,0,1440284
837,2019-11-07,1291335,0,0,0,1291335
837,2019-11-08,1376842,0,0,0,1376842
837,2019-11-09,1509915,0,0,0,1509915
837,2019-11-10,1478960,0,0,0,1478960
837,2019-11-11,1487287,0,0,0,1487287
837,2019-11-12,1341124,0,0,0,1341124
837,2019-11-13,1158310,0,0,0,1158310
837,2019-11-14,1732568,0,0,0,1732568
837,2019-11-15,1550677,0,0,0,1550677
837,2019-11-16,1577432,0,0,0,1577432
837,2019-11-17,1541427,0,0,0,1541427
837,2019-11-18,1430508,0,0,0,1430508
837,2019-11-19,1643445,0,0,0,1643445
837,2019-11-20,1441617,0,0,0,1441617
837,2019-11-21,1338972,0,0,0,1338972
837,2019-11-22,1126866,0,0,0,1126866
837,2019-11-23,1268426,0,0,0,1268426
837,2019-11-24,1299564,0,0,0,1299564
837,2019-11-25,1070975,0,0,0,1070975
837,2019-11-26,674242,0,0,0,674242
837,2019-11-27,1251322,0,0,0,1251322
837,2019-11-28,760742,0,0,0,760742
837,2019-11-29,26542,0,0,0,26542
839,2019-08-30,186,176,765,0,1127
839,2019-08-31,415,2415,2,0,2832
839,2019-09-01,780,548,3,0,1331
839,2019-09-02,613,0,133,1,747
839,2019-09-03,676,2,1574,2,2254
839,2019-09-04,814,50,2439,0,3303
839,2019-09-05,1999,81,1965,0,4045
839,2019-09-06,1311,73,1673,0,3057
839,2019-09-07,1852,90,2258,3,4203
839,2019-09-08,4527,556,2275,1,7359
839,2019-09-09,3763,285,1423,2,5473
839,2019-09-10,1998,212,1568,2,3780
839,2019-09-11,419,399,2250,3,3071
839,2019-09-12,1558,177,2372,3,4110
839,2019-09-13,314,110,2451,1,2876
839,2019-09-14,135,52,2242,3,2432
839,2019-09-15,331,14,2011,2,2358
839,2019-09-16,282,4,1746,3,2035
839,2019-09-17,1029,3995,2249,2,7275
839,2019-09-18,230,53,1434,2,1719
839,2019-09-19,642,5928,1573,2,8145
839,2019-09-20,435,10763,1980,1,13179
839,2019-09-21,292,6886,1587,3,8768
839,2019-09-22,161,10796,1530,1,12488
839,2019-09-23,379,10325,2135,0,12839
839,2019-09-24,1188,11966,1163,7,14324
839,2019-09-25,200,9896,1351,2,11449
839,2019-09-26,1083,10276,1956,2,13317
839,2019-09-27,402,6934,1227,3,8566
839,2019-09-28,258,14477,1609,3,16347
839,2019-09-29,268,25140,2328,4,27740
839,2019-09-30,1284,26239,2169,459,30151
839,2019-10-01,173,21223,1698,2,23096
839,2019-10-02,342,13315,1242,0,14899
839,2019-10-03,740,13241,1276,0,15257
839,2019-10-04,242,11100,1435,4,12781
839,2019-10-05,883,14235,1124,2,16244
839,2019-10-06,264,9844,1712,0,11820
839,2019-10-07,1845,5110,763,1,7719
839,2019-10-08,964,17089,1787,3,19843
839,2019-10-09,2353,23831,1878,3,28065
839,2019-10-10,1125,10384,1705,0,13214
839,2019-10-11,696,10544,876,3,12119
839,2019-10-12,231,6409,2244,1,8885
839,2019-10-13,1070,7132,1552,4,9758
839,2019-10-14,398,4250,1542,2,6192
839,2019-10-15,1124,6779,2289,1,10193
839,2019-10-16,237,22150,1669,4,24060
839,2019-10-17,161,10426,1511,1,12099
839,2019-10-18,228,7270,1912,2,9412
839,2019-10-19,196,3983,1409,0,5588
839,2019-10-20,1737,593,1655,1,3986
839,2019-10-21,715,9385,1658,2,11760
839,2019-10-22,363,4632,2475,0,7470
839,2019-10-23,294,7029,1909,1,9233
839,2019-10-24,641,12990,1714,3,15348
839,2019-10-25,1050,14428,1481,4,16963
839,2019-10-26,460,15688,1664,2,17814
839,2019-10-27,374,16960,1355,1,18690
839,2019-10-28,584,22524,1316,0,24424
839,2019-10-29,595,16405,1250,4,18254
839,2019-10-30,546,14801,2025,314,17686
839,2019-10-31,290,20036,766,0,21092
839,2019-11-01,252,26293,1404,0,27949
839,2019-11-02,647,15061,1272,2,16982
839,2019-11-03,539,49890,1082,3,51514
839,2019-11-04,504,16265,1822,2,18593
839,2019-11-05,556,1509,2332,1,4398
839,2019-11-06,1702,13230,742,1,15675
839,2019-11-07,432,16280,1279,3,17994
839,2019-11-08,1024,10323,961,0,12308
839,2019-11-09,1826,10179,1790,0,13795
839,2019-11-10,2111,22310,2341,0,26762
839,2019-11-11,664,17686,1689,1,20040
839,2019-11-12,1656,16478,3200,4,21338
839,2019-11-13,1036,11814,1353,3,14206
839,2019-11-14,1296,9031,1321,1,11649
839,2019-11-15,726,7502,2078,0,10306
839,2019-11-16,750,3808,2471,0,7029
839,2019-11-17,779,3575,3163,235,7752
839,2019-11-18,980,2736,2318,4,6038
839,2019-11-19,1268,5186,2517,1,8972
839,2019-11-20,517,1316,2459,0,4292
839,2019-11-21,569,5241,1723,3,7536
839,2019-11-22,268,5892,1908,3,8071
839,2019-11-23,1349,6517,2544,3,10413
839,2019-11-24,761,6409,1954,1,9125
839,2019-11-25,243,6612,1555,1,8411
839,2019-11-26,372,5660,928,1,6961
839,2019-11-27,305,6621,1601,0,8527
839,2019-11-28,330,7684,746,0,8760
839,2019-11-29,45,0,2,0,47
839,2019-08-30,186,176,765,0,1127
839,2019-08-31,415,2415,2,0,2832
839,2019-09-01,780,548,3,0,1331
839,2019-09-02,613,0,133,1,747
839,2019-09-03,676,2,1574,2,2254
839,2019-09-04,814,50,2439,0,3303
839,2019-09-05,1999,81,1965,0,4045
839,2019-09-06,1311,73,1673,0,3057
839,2019-09-07,1852,90,2258,3,4203
839,2019-09-08,4527,556,2275,1,7359
839,2019-09-09,3763,285,1423,2,5473
839,2019-09-10,1998,212,1568,2,3780
839,2019-09-11,419,399,2250,3,3071
839,2019-09-12,1558,177,2372,3,4110
839,2019-09-13,314,110,2451,1,2876
839,2019-09-14,135,52,2242,3,2432
839,2019-09-15,331,14,2011,2,2358
839,2019-09-16,282,4,1746,3,2035
839,2019-09-17,1029,3995,2249,2,7275
839,2019-09-18,230,53,1434,2,1719
839,2019-09-19,642,5928,1573,2,8145
839,2019-09-20,435,10763,1980,1,13179
839,2019-09-21,292,6886,1587,3,8768
839,2019-09-22,161,10796,1530,1,12488
839,2019-09-23,379,10325,2135,0,12839
839,2019-09-24,1188,11966,1163,7,14324
839,2019-09-25,200,9896,1351,2,11449
839,2019-09-26,1083,10276,1956,2,13317
839,2019-09-27,402,6934,1227,3,8566
839,2019-09-28,258,14477,1609,3,16347
839,2019-09-29,268,25140,2328,4,27740
839,2019-09-30,1284,26239,2169,459,30151
839,2019-10-01,173,21223,1698,2,23096
839,2019-10-02,342,13315,1242,0,14899
839,2019-10-03,740,13241,1276,0,15257
839,2019-10-04,242,11100,1435,4,12781
839,2019-10-05,883,14235,1124,2,16244
839,2019-10-06,264,9844,1712,0,11820
839,2019-10-07,1845,5110,763,1,7719
839,2019-10-08,964,17089,1787,3,19843
839,2019-10-09,2353,23831,1878,3,28065
839,2019-10-10,1125,10384,1705,0,13214
839,2019-10-11,696,10544,876,3,12119
839,2019-10-12,231,6409,2244,1,8885
839,2019-10-13,1070,7132,1552,4,9758
839,2019-10-14,398,4250,1542,2,6192
839,2019-10-15,1124,6779,2289,1,10193
839,2019-10-16,237,22150,1669,4,24060
839,2019-10-17,161,10426,1511,1,12099
839,2019-10-18,228,7270,1912,2,9412
839,2019-10-19,196,3983,1409,0,5588
839,2019-10-20,1737,593,1655,1,3986
839,2019-10-21,715,9385,1658,2,11760
839,2019-10-22,363,4632,2475,0,7470
839,2019-10-23,294,7029,1909,1,9233
839,2019-10-24,641,12990,1714,3,15348
839,2019-10-25,1050,14428,1481,4,16963
839,2019-10-26,460,15688,1664,2,17814
839,2019-10-27,374,16960,1355,1,18690
839,2019-10-28,584,22524,1316,0,24424
839,2019-10-29,595,16405,1250,4,18254
839,2019-10-30,546,14801,2025,314,17686
839,2019-10-31,290,20036,766,0,21092
839,2019-11-01,252,26293,1404,0,27949
839,2019-11-02,647,15061,1272,2,16982
839,2019-11-03,539,49890,1082,3,51514
839,2019-11-04,504,16265,1822,2,18593
839,2019-11-05,556,1509,2332,1,4398
839,2019-11-06,1702,13230,742,1,15675
839,2019-11-07,432,16280,1279,3,17994
839,2019-11-08,1024,10323,961,0,12308
839,2019-11-09,1826,10179,1790,0,13795
839,2019-11-10,2111,22310,2341,0,26762
839,2019-11-11,664,17686,1689,1,20040
839,2019-11-12,1656,16478,3200,4,21338
839,2019-11-13,1036,11814,1353,3,14206
839,2019-11-14,1296,9031,1321,1,11649
839,2019-11-15,726,7502,2078,0,10306
839,2019-11-16,750,3808,2471,0,7029
839,2019-11-17,779,3575,3163,235,7752
839,2019-11-18,980,2736,2318,4,6038
839,2019-11-19,1268,5186,2517,1,8972
839,2019-11-20,517,1316,2459,0,4292
839,2019-11-21,569,5241,1723,3,7536
839,2019-11-22,268,5892,1908,3,8071
839,2019-11-23,1349,6517,2544,3,10413
839,2019-11-24,761,6409,1954,1,9125
839,2019-11-25,243,6612,1555,1,8411
839,2019-11-26,372,5660,928,1,6961
839,2019-11-27,305,6621,1601,0,8527
839,2019-11-28,330,7684,746,0,8760
839,2019-08-30,186,176,765,0,1127
839,2019-08-31,415,2415,2,0,2832
839,2019-09-01,780,548,3,0,1331
839,2019-09-02,613,0,133,1,747
839,2019-09-03,676,2,1574,2,2254
839,2019-09-04,814,50,2439,0,3303
839,2019-09-05,1999,81,1965,0,4045
839,2019-09-06,1311,73,1673,0,3057
839,2019-09-07,1852,90,2258,3,4203
839,2019-09-08,4527,556,2275,1,7359
839,2019-09-09,3763,285,1423,2,5473
839,2019-09-10,1998,212,1568,2,3780
839,2019-09-11,419,399,2250,3,3071
839,2019-09-12,1558,177,2372,3,4110
839,2019-09-13,314,110,2451,1,2876
839,2019-09-14,135,52,2242,3,2432
839,2019-09-15,331,14,2011,2,2358
839,2019-09-16,282,4,1746,3,2035
839,2019-09-17,1029,3995,2249,2,7275
839,2019-09-18,230,53,1434,2,1719
839,2019-09-19,642,5928,1573,2,8145
839,2019-09-20,435,10763,1980,1,13179
839,2019-09-21,292,6886,1587,3,8768
839,2019-09-22,161,10796,1530,1,12488
839,2019-09-23,379,10325,2135,0,12839
839,2019-09-24,1188,11966,1163,7,14324
839,2019-09-25,200,9896,1351,2,11449
839,2019-09-26,1083,10276,1956,2,13317
839,2019-09-27,402,6934,1227,3,8566
839,2019-09-28,258,14477,1609,3,16347
839,2019-09-29,268,25140,2328,4,27740
839,2019-09-30,1284,26239,2169,459,30151
839,2019-10-01,173,21223,1698,2,23096
839,2019-10-02,342,13315,1242,0,14899
839,2019-10-03,740,13241,1276,0,15257
839,2019-10-04,242,11100,1435,4,12781
839,2019-10-05,883,14235,1124,2,16244
839,2019-10-06,264,9844,1712,0,11820
839,2019-10-07,1845,5110,763,1,7719
839,2019-10-08,964,17089,1787,3,19843
839,2019-10-09,2353,23831,1878,3,28065
839,2019-10-10,1125,10384,1705,0,13214
839,2019-10-11,696,10544,876,3,12119
839,2019-10-12,231,6409,2244,1,8885
839,2019-10-13,1070,7132,1552,4,9758
839,2019-10-14,398,4250,1542,2,6192
839,2019-10-15,1124,6779,2289,1,10193
839,2019-10-16,237,22150,1669,4,24060
839,2019-10-17,161,10426,1511,1,12099
839,2019-10-18,228,7270,1912,2,9412
839,2019-10-19,196,3983,1409,0,5588
839,2019-10-20,1737,593,1655,1,3986
839,2019-10-21,715,9385,1658,2,11760
839,2019-10-22,363,4632,2475,0,7470
839,2019-10-23,294,7029,1909,1,9233
839,2019-10-24,641,12990,1714,3,15348
839,2019-10-25,1050,14428,1481,4,16963
839,2019-10-26,460,15688,1664,2,17814
839,2019-10-27,374,16960,1355,1,18690
839,2019-10-28,584,22524,1316,0,24424
839,2019-10-29,595,16405,1250,4,18254
839,2019-10-30,546,14801,2025,314,17686
839,2019-10-31,290,20036,766,0,21092
839,2019-11-01,252,26293,1404,0,27949
839,2019-11-02,647,15061,1272,2,16982
839,2019-11-03,539,49890,1082,3,51514
839,2019-11-04,504,16265,1822,2,18593
839,2019-11-05,556,1509,2332,1,4398
839,2019-11-06,1702,13230,742,1,15675
839,2019-11-07,432,16280,1279,3,17994
839,2019-11-08,1024,10323,961,0,12308
839,2019-11-09,1826,10179,1790,0,13795
839,2019-11-10,2111,22310,2341,0,26762
839,2019-11-11,664,17686,1689,1,20040
839,2019-11-12,1656,16478,3200,4,21338
839,2019-11-13,1036,11814,1353,3,14206
839,2019-11-14,1296,9031,1321,1,11649
839,2019-11-15,726,7502,2078,0,10306
839,2019-11-16,750,3808,2471,0,7029
839,2019-11-17,779,3575,3163,235,7752
839,2019-11-18,980,2736,2318,4,6038
839,2019-11-19,1268,5186,2517,1,8972
839,2019-11-20,517,1316,2459,0,4292
839,2019-11-21,569,5241,1723,3,7536
839,2019-11-22,268,5892,1908,3,8071
839,2019-11-23,1349,6517,2544,3,10413
839,2019-11-24,761,6409,1954,1,9125
839,2019-11-25,243,6612,1555,1,8411
839,2019-11-26,372,5660,928,1,6961
839,2019-11-27,305,6621,1601,0,8527
839,2019-11-28,330,7684,746,0,8760
839,2019-11-29,45,0,2,0,47
839,2019-09-02,613,0,133,1,747
839,2019-09-03,676,2,1574,2,2254
839,2019-09-04,814,50,2439,0,3303
839,2019-09-05,1999,81,1965,0,4045
839,2019-09-06,1311,73,1673,0,3057
839,2019-09-07,1852,90,2258,3,4203
839,2019-09-08,4527,556,2275,1,7359
839,2019-09-09,3763,285,1423,2,5473
839,2019-09-10,1998,212,1568,2,3780
839,2019-09-11,419,399,2250,3,3071
839,2019-09-12,1558,177,2372,3,4110
839,2019-09-13,314,110,2451,1,2876
839,2019-09-14,135,52,2242,3,2432
839,2019-09-15,331,14,2011,2,2358
839,2019-09-16,282,4,1746,3,2035
839,2019-09-17,1029,3995,2249,2,7275
839,2019-09-18,230,53,1434,2,1719
839,2019-09-19,642,5928,1573,2,8145
839,2019-09-20,435,10763,1980,1,13179
839,2019-09-21,292,6886,1587,3,8768
839,2019-09-22,161,10796,1530,1,12488
839,2019-09-23,379,10325,2135,0,12839
839,2019-09-24,1188,11966,1163,7,14324
839,2019-09-25,200,9896,1351,2,11449
839,2019-09-26,1083,10276,1956,2,13317
839,2019-09-27,402,6934,1227,3,8566
839,2019-09-28,258,14477,1609,3,16347
839,2019-09-29,268,25140,2328,4,27740
839,2019-09-30,1284,26239,2169,459,30151
839,2019-10-01,173,21223,1698,2,23096
839,2019-10-02,342,13315,1242,0,14899
839,2019-10-03,740,13241,1276,0,15257
839,2019-10-04,242,11100,1435,4,12781
839,2019-10-05,883,14235,1124,2,16244
839,2019-10-06,264,9844,1712,0,11820
839,2019-10-07,1845,5110,763,1,7719
839,2019-10-08,964,17089,1787,3,19843
839,2019-10-09,2353,23831,1878,3,28065
839,2019-10-10,1125,10384,1705,0,13214
839,2019-10-11,696,10544,876,3,12119
839,2019-10-12,231,6409,2244,1,8885
839,2019-10-13,1070,7132,1552,4,9758
839,2019-10-14,398,4250,1542,2,6192
839,2019-10-15,1124,6779,2289,1,10193
839,2019-10-16,237,22150,1669,4,24060
839,2019-10-17,161,10426,1511,1,12099
839,2019-10-18,228,7270,1912,2,9412
839,2019-10-19,196,3983,1409,0,5588
839,2019-10-20,1737,593,1655,1,3986
839,2019-10-21,715,9385,1658,2,11760
839,2019-10-22,363,4632,2475,0,7470
839,2019-10-23,294,7029,1909,1,9233
839,2019-10-24,641,12990,1714,3,15348
839,2019-10-25,1050,14428,1481,4,16963
839,2019-10-26,460,15688,1664,2,17814
839,2019-10-27,374,16960,1355,1,18690
839,2019-10-28,584,22524,1316,0,24424
839,2019-10-29,595,16405,1250,4,18254
839,2019-10-30,546,14801,2025,314,17686
839,2019-10-31,290,20036,766,0,21092
839,2019-11-01,252,26293,1404,0,27949
839,2019-11-02,647,15061,1272,2,16982
839,2019-11-03,539,49890,1082,3,51514
839,2019-11-04,504,16265,1822,2,18593
839,2019-11-05,556,1509,2332,1,4398
839,2019-11-06,1702,13230,742,1,15675
839,2019-11-07,432,16280,1279,3,17994
839,2019-11-08,1024,10323,961,0,12308
839,2019-11-09,1826,10179,1790,0,13795
839,2019-11-10,2111,22310,2341,0,26762
839,2019-11-11,664,17686,1689,1,20040
839,2019-11-12,1656,16478,3200,4,21338
839,2019-11-13,1036,11814,1353,3,14206
839,2019-11-14,1296,9031,1321,1,11649
839,2019-11-15,726,7502,2078,0,10306
839,2019-11-16,750,3808,2471,0,7029
839,2019-11-17,779,3575,3163,235,7752
839,2019-11-18,980,2736,2318,4,6038
839,2019-11-19,1268,5186,2517,1,8972
839,2019-11-20,517,1316,2459,0,4292
839,2019-11-21,569,5241,1723,3,7536
839,2019-11-22,268,5892,1908,3,8071
839,2019-11-23,1349,6517,2544,3,10413
839,2019-11-24,761,6409,1954,1,9125
839,2019-11-25,243,6612,1555,1,8411
839,2019-11-26,372,5660,928,1,6961
840,2019-08-30,193,201,698,0,1092
840,2019-08-31,153,2181,1,0,2335
840,2019-09-01,234,505,15,0,754
840,2019-09-02,186,2,31,0,219
840,2019-09-03,1225,0,1658,0,2883
840,2019-09-04,1387,49,1958,0,3394
840,2019-09-05,2924,6,2982,1,5913
840,2019-09-06,2165,121,1840,0,4126
840,2019-09-07,1800,560,2447,0,4807
840,2019-09-08,627,358,2058,0,3043
840,2019-09-09,487,373,1823,1,2684
840,2019-09-10,316,237,1705,1,2259
840,2019-09-11,1246,289,1391,2,2928
840,2019-09-12,1280,215,1404,3,2902
840,2019-09-13,586,135,1390,3,2114
840,2019-09-14,442,110,2112,0,2664
840,2019-09-15,1287,56,2430,2,3775
840,2019-09-16,421,62,1837,1,2321
840,2019-09-17,703,295,2250,1,3249
840,2019-09-18,701,98,1821,0,2620
840,2019-09-19,1391,7425,1498,1,10315
840,2019-09-20,565,11248,2337,1,14151
840,2019-09-21,459,6800,2064,0,9323
840,2019-09-22,825,14644,1573,0,17042
840,2019-09-23,557,12232,1450,3,14242
840,2019-09-24,568,10705,1805,4,13082
840,2019-09-25,1198,7250,1476,3,9927
840,2019-09-26,411,13162,1508,0,15081
840,2019-09-27,807,7713,1992,2,10514
840,2019-09-28,349,23877,1726,5,25957
840,2019-09-29,1197,27118,1498,2,29815
840,2019-09-30,300,17457,2318,1,20076
840,2019-10-01,1324,15071,1127,0,17522
840,2019-10-02,325,8920,1542,0,10787
840,2019-10-03,406,12689,2244,0,15339
840,2019-10-04,393,10794,1109,0,12296
840,2019-10-05,1253,21174,1715,0,24142
840,2019-10-06,1566,15367,2329,1,19263
840,2019-10-07,497,4874,1558,1,6930
840,2019-10-08,482,16842,1316,4,18644
840,2019-10-09,879,24908,1592,1,27380
840,2019-10-10,485,10177,3040,0,13702
840,2019-10-11,1406,11736,2020,0,15162
840,2019-10-12,1367,4242,1859,3,7471
840,2019-10-13,1288,7254,2280,3,10825
840,2019-10-14,1289,4681,2429,2,8401
840,2019-10-15,1300,6981,1968,0,10249
840,2019-10-16,1361,12439,2315,0,16115
840,2019-10-17,1763,3797,2581,0,8141
840,2019-10-18,426,7973,979,2,9380
840,2019-10-19,1363,3755,1545,0,6663
840,2019-10-20,475,574,2506,0,3555
840,2019-10-21,368,17263,1851,1,19483
840,2019-10-22,1291,8292,1556,0,11139
840,2019-10-23,424,6646,1938,4,9012
840,2019-10-24,492,13188,878,2,14560
840,2019-10-25,506,9900,1502,3,11911
840,2019-10-26,575,12413,1813,1,14802
840,2019-10-27,1356,15064,2177,0,18597
840,2019-10-28,1300,12975,2412,2,16689
840,2019-10-29,508,14438,1911,1,16858
840,2019-10-30,472,14288,1718,1,16479
840,2019-10-31,1258,11895,1912,0,15065
840,2019-11-01,451,14022,1683,0,16156
840,2019-11-02,498,13850,830,2,15180
840,2019-11-03,866,35715,1508,0,38089
840,2019-11-04,430,9379,1828,1,11638
840,2019-11-05,460,4825,2154,0,7439
840,2019-11-06,1200,12785,1585,0,15570
840,2019-11-07,888,15346,1757,2,17993
840,2019-11-08,462,8569,1864,0,10895
840,2019-11-09,429,7420,2392,0,10241
840,2019-11-10,422,22457,852,1,23732
840,2019-11-11,1735,14621,1526,0,17882
840,2019-11-12,538,17689,2442,2,20671
840,2019-11-13,1255,12257,1892,2,15406
840,2019-11-14,501,11270,2322,0,14093
840,2019-11-15,538,3680,2584,2,6804
840,2019-11-16,519,1172,2110,0,3801
840,2019-11-17,1426,2462,3099,4,6991
840,2019-11-18,2276,1994,3091,0,7361
840,2019-11-19,575,2547,2277,2,5401
840,2019-11-20,453,2389,2552,0,5394
840,2019-11-21,496,4866,1738,1,7101
840,2019-11-22,600,4727,1586,4,6917
840,2019-11-23,487,5507,2159,0,8153
840,2019-11-24,531,6091,1962,2,8586
840,2019-11-25,461,5362,1908,1,7732
840,2019-11-26,436,3985,754,0,5175
840,2019-11-27,1402,5421,1368,2,8193
840,2019-11-28,732,7987,744,1,9464
840,2019-11-29,212,474,3,0,689
840,2019-08-30,193,201,698,0,1092
840,2019-08-31,153,2181,1,0,2335
840,2019-09-01,234,505,15,0,754
840,2019-09-02,186,2,31,0,219
840,2019-09-03,1225,0,1658,0,2883
840,2019-09-04,1387,49,1958,0,3394
840,2019-09-05,2924,6,2982,1,5913
840,2019-09-06,2165,121,1840,0,4126
840,2019-09-07,1800,560,2447,0,4807
840,2019-09-08,627,358,2058,0,3043
840,2019-09-09,487,373,1823,1,2684
840,2019-09-10,316,237,1705,1,2259
840,2019-09-11,1246,289,1391,2,2928
840,2019-09-12,1280,215,1404,3,2902
840,2019-09-13,586,135,1390,3,2114
840,2019-09-14,442,110,2112,0,2664
840,2019-09-15,1287,56,2430,2,3775
840,2019-09-16,421,62,1837,1,2321
840,2019-09-17,703,295,2250,1,3249
840,2019-09-18,701,98,1821,0,2620
840,2019-09-19,1391,7425,1498,1,10315
840,2019-09-20,565,11248,2337,1,14151
840,2019-09-21,459,6800,2064,0,9323
840,2019-09-22,825,14644,1573,0,17042
840,2019-09-23,557,12232,1450,3,14242
840,2019-09-24,568,10705,1805,4,13082
840,2019-09-25,1198,7250,1476,3,9927
840,2019-09-26,411,13162,1508,0,15081
840,2019-09-27,807,7713,1992,2,10514
840,2019-09-28,349,23877,1726,5,25957
840,2019-09-29,1197,27118,1498,2,29815
840,2019-09-30,300,17457,2318,1,20076
840,2019-10-01,1324,15071,1127,0,17522
840,2019-10-02,325,8920,1542,0,10787
840,2019-10-03,406,12689,2244,0,15339
840,2019-10-04,393,10794,1109,0,12296
840,2019-10-05,1253,21174,1715,0,24142
840,2019-10-06,1566,15367,2329,1,19263
840,2019-10-07,497,4874,1558,1,6930
840,2019-10-08,482,16842,1316,4,18644
840,2019-10-09,879,24908,1592,1,27380
840,2019-10-10,485,10177,3040,0,13702
840,2019-10-11,1406,11736,2020,0,15162
840,2019-10-12,1367,4242,1859,3,7471
840,2019-10-13,1288,7254,2280,3,10825
840,2019-10-14,1289,4681,2429,2,8401
840,2019-10-15,1300,6981,1968,0,10249
840,2019-10-16,1361,12439,2315,0,16115
840,2019-10-17,1763,3797,2581,0,8141
840,2019-10-18,426,7973,979,2,9380
840,2019-10-19,1363,3755,1545,0,6663
840,2019-10-20,475,574,2506,0,3555
840,2019-10-21,368,17263,1851,1,19483
840,2019-10-22,1291,8292,1556,0,11139
840,2019-10-23,424,6646,1938,4,9012
840,2019-10-24,492,13188,878,2,14560
840,2019-10-25,506,9900,1502,3,11911
840,2019-10-26,575,12413,1813,1,14802
840,2019-10-27,1356,15064,2177,0,18597
840,2019-10-28,1300,12975,2412,2,16689
840,2019-10-29,508,14438,1911,1,16858
840,2019-10-30,472,14288,1718,1,16479
840,2019-10-31,1258,11895,1912,0,15065
840,2019-11-01,451,14022,1683,0,16156
840,2019-11-02,498,13850,830,2,15180
840,2019-11-03,866,35715,1508,0,38089
840,2019-11-04,430,9379,1828,1,11638
840,2019-11-05,460,4825,2154,0,7439
840,2019-11-06,1200,12785,1585,0,15570
840,2019-11-07,888,15346,1757,2,17993
840,2019-11-08,462,8569,1864,0,10895
840,2019-11-09,429,7420,2392,0,10241
840,2019-11-10,422,22457,852,1,23732
840,2019-11-11,1735,14621,1526,0,17882
840,2019-11-12,538,17689,2442,2,20671
840,2019-11-13,1255,12257,1892,2,15406
840,2019-11-14,501,11270,2322,0,14093
840,2019-11-15,538,3680,2584,2,6804
840,2019-11-16,519,1172,2110,0,3801
840,2019-11-17,1426,2462,3099,4,6991
840,2019-11-18,2276,1994,3091,0,7361
840,2019-11-19,575,2547,2277,2,5401
840,2019-11-20,453,2389,2552,0,5394
840,2019-11-21,496,4866,1738,1,7101
840,2019-11-22,600,4727,1586,4,6917
840,2019-11-23,487,5507,2159,0,8153
840,2019-11-24,531,6091,1962,2,8586
840,2019-11-25,461,5362,1908,1,7732
840,2019-11-26,436,3985,754,0,5175
840,2019-11-27,1402,5421,1368,2,8193
840,2019-11-28,732,7987,744,1,9464
840,2019-11-29,212,474,3,0,689
840,2019-08-30,193,201,698,0,1092
840,2019-08-31,153,2181,1,0,2335
840,2019-09-01,234,505,15,0,754
840,2019-09-02,186,2,31,0,219
840,2019-09-03,1225,0,1658,0,2883
840,2019-09-04,1387,49,1958,0,3394
840,2019-09-05,2924,6,2982,1,5913
840,2019-09-06,2165,121,1840,0,4126
840,2019-09-07,1800,560,2447,0,4807
840,2019-09-08,627,358,2058,0,3043
840,2019-09-09,487,373,1823,1,2684
840,2019-09-10,316,237,1705,1,2259
840,2019-09-11,1246,289,1391,2,2928
840,2019-09-12,1280,215,1404,3,2902
840,2019-09-13,586,135,1390,3,2114
840,2019-09-14,442,110,2112,0,2664
840,2019-09-15,1287,56,2430,2,3775
840,2019-09-16,421,62,1837,1,2321
840,2019-09-17,703,295,2250,1,3249
840,2019-09-18,701,98,1821,0,2620
840,2019-09-19,1391,7425,1498,1,10315
840,2019-09-20,565,11248,2337,1,14151
840,2019-09-21,459,6800,2064,0,9323
840,2019-09-22,825,14644,1573,0,17042
840,2019-09-23,557,12232,1450,3,14242
840,2019-09-24,568,10705,1805,4,13082
840,2019-09-25,1198,7250,1476,3,9927
840,2019-09-26,411,13162,1508,0,15081
840,2019-09-27,807,7713,1992,2,10514
840,2019-09-28,349,23877,1726,5,25957
840,2019-09-29,1197,27118,1498,2,29815
840,2019-09-30,300,17457,2318,1,20076
840,2019-10-01,1324,15071,1127,0,17522
840,2019-10-02,325,8920,1542,0,10787
840,2019-10-03,406,12689,2244,0,15339
840,2019-10-04,393,10794,1109,0,12296
840,2019-10-05,1253,21174,1715,0,24142
840,2019-10-06,1566,15367,2329,1,19263
840,2019-10-07,497,4874,1558,1,6930
840,2019-10-08,482,16842,1316,4,18644
840,2019-10-09,879,24908,1592,1,27380
840,2019-10-10,485,10177,3040,0,13702
840,2019-10-11,1406,11736,2020,0,15162
840,2019-10-12,1367,4242,1859,3,7471
840,2019-10-13,1288,7254,2280,3,10825
840,2019-10-14,1289,4681,2429,2,8401
840,2019-10-15,1300,6981,1968,0,10249
840,2019-10-16,1361,12439,2315,0,16115
840,2019-10-17,1763,3797,2581,0,8141
840,2019-10-18,426,7973,979,2,9380
840,2019-10-19,1363,3755,1545,0,6663
840,2019-10-20,475,574,2506,0,3555
840,2019-10-21,368,17263,1851,1,19483
840,2019-10-22,1291,8292,1556,0,11139
840,2019-10-23,424,6646,1938,4,9012
840,2019-10-24,492,13188,878,2,14560
840,2019-10-25,506,9900,1502,3,11911
840,2019-10-26,575,12413,1813,1,14802
840,2019-10-27,1356,15064,2177,0,18597
840,2019-10-28,1300,12975,2412,2,16689
840,2019-10-29,508,14438,1911,1,16858
840,2019-10-30,472,14288,1718,1,16479
840,2019-10-31,1258,11895,1912,0,15065
840,2019-11-01,451,14022,1683,0,16156
840,2019-11-02,498,13850,830,2,15180
840,2019-11-03,866,35715,1508,0,38089
840,2019-11-04,430,9379,1828,1,11638
840,2019-11-05,460,4825,2154,0,7439
840,2019-11-06,1200,12785,1585,0,15570
840,2019-11-07,888,15346,1757,2,17993
840,2019-11-08,462,8569,1864,0,10895
840,2019-11-09,429,7420,2392,0,10241
840,2019-11-10,422,22457,852,1,23732
840,2019-11-11,1735,14621,1526,0,17882
840,2019-11-12,538,17689,2442,2,20671
840,2019-11-13,1255,12257,1892,2,15406
840,2019-11-14,501,11270,2322,0,14093
840,2019-11-15,538,3680,2584,2,6804
840,2019-11-16,519,1172,2110,0,3801
840,2019-11-17,1426,2462,3099,4,6991
840,2019-11-18,2276,1994,3091,0,7361
840,2019-11-19,575,2547,2277,2,5401
840,2019-11-20,453,2389,2552,0,5394
840,2019-11-21,496,4866,1738,1,7101
840,2019-11-22,600,4727,1586,4,6917
840,2019-11-23,487,5507,2159,0,8153
840,2019-11-24,531,6091,1962,2,8586
840,2019-11-25,461,5362,1908,1,7732
840,2019-11-26,436,3985,754,0,5175
840,2019-11-27,1402,5421,1368,2,8193
840,2019-11-28,732,7987,744,1,9464
840,2019-11-29,212,474,3,0,689
840,2019-09-05,2924,6,2982,1,5913
840,2019-09-06,2165,121,1840,0,4126
840,2019-09-07,1800,560,2447,0,4807
840,2019-09-08,627,358,2058,0,3043
840,2019-09-09,487,373,1823,1,2684
840,2019-09-10,316,237,1705,1,2259
840,2019-09-11,1246,289,1391,2,2928
840,2019-09-12,1280,215,1404,3,2902
840,2019-09-13,586,135,1390,3,2114
840,2019-09-14,442,110,2112,0,2664
840,2019-09-15,1287,56,2430,2,3775
840,2019-09-16,421,62,1837,1,2321
840,2019-09-17,703,295,2250,1,3249
840,2019-09-18,701,98,1821,0,2620
840,2019-09-19,1391,7425,1498,1,10315
840,2019-09-20,565,11248,2337,1,14151
840,2019-09-21,459,6800,2064,0,9323
840,2019-09-22,825,14644,1573,0,17042
840,2019-09-23,557,12232,1450,3,14242
840,2019-09-24,568,10705,1805,4,13082
840,2019-09-25,1198,7250,1476,3,9927
840,2019-09-26,411,13162,1508,0,15081
840,2019-09-27,807,7713,1992,2,10514
840,2019-09-28,349,23877,1726,5,25957
840,2019-09-29,1197,27118,1498,2,29815
840,2019-09-30,300,17457,2318,1,20076
840,2019-10-01,1324,15071,1127,0,17522
840,2019-10-02,325,8920,1542,0,10787
840,2019-10-03,406,12689,2244,0,15339
840,2019-10-04,393,10794,1109,0,12296
840,2019-10-05,1253,21174,1715,0,24142
840,2019-10-06,1566,15367,2329,1,19263
840,2019-10-07,497,4874,1558,1,6930
840,2019-10-08,482,16842,1316,4,18644
840,2019-10-09,879,24908,1592,1,27380
840,2019-10-10,485,10177,3040,0,13702
840,2019-10-11,1406,11736,2020,0,15162
840,2019-10-12,1367,4242,1859,3,7471
840,2019-10-13,1288,7254,2280,3,10825
840,2019-10-14,1289,4681,2429,2,8401
840,2019-10-15,1300,6981,1968,0,10249
840,2019-10-16,1361,12439,2315,0,16115
840,2019-10-17,1763,3797,2581,0,8141
840,2019-10-18,426,7973,979,2,9380
840,2019-10-19,1363,3755,1545,0,6663
840,2019-10-20,475,574,2506,0,3555
840,2019-10-21,368,17263,1851,1,19483
840,2019-10-22,1291,8292,1556,0,11139
840,2019-10-23,424,6646,1938,4,9012
840,2019-10-24,492,13188,878,2,14560
840,2019-10-25,506,9900,1502,3,11911
840,2019-10-26,575,12413,1813,1,14802
840,2019-10-27,1356,15064,2177,0,18597
840,2019-10-28,1300,12975,2412,2,16689
840,2019-10-29,508,14438,1911,1,16858
840,2019-10-30,472,14288,1718,1,16479
840,2019-10-31,1258,11895,1912,0,15065
840,2019-11-01,451,14022,1683,0,16156
840,2019-11-02,498,13850,830,2,15180
840,2019-11-03,866,35715,1508,0,38089
840,2019-11-04,430,9379,1828,1,11638
840,2019-11-05,460,4825,2154,0,7439
840,2019-11-06,1200,12785,1585,0,15570
840,2019-11-07,888,15346,1757,2,17993
840,2019-11-08,462,8569,1864,0,10895
840,2019-11-09,429,7420,2392,0,10241
840,2019-11-10,422,22457,852,1,23732
840,2019-11-11,1735,14621,1526,0,17882
840,2019-11-12,538,17689,2442,2,20671
840,2019-11-13,1255,12257,1892,2,15406
840,2019-11-14,501,11270,2322,0,14093
840,2019-11-15,538,3680,2584,2,6804
840,2019-11-16,519,1172,2110,0,3801
840,2019-11-17,1426,2462,3099,4,6991
840,2019-11-18,2276,1994,3091,0,7361
840,2019-11-19,575,2547,2277,2,5401
840,2019-11-20,453,2389,2552,0,5394
840,2019-11-21,496,4866,1738,1,7101
840,2019-11-22,600,4727,1586,4,6917
840,2019-11-23,487,5507,2159,0,8153
840,2019-11-24,531,6091,1962,2,8586
840,2019-11-25,461,5362,1908,1,7732
840,2019-11-26,436,3985,754,0,5175
840,2019-11-27,1402,5421,1368,2,8193
840,2019-11-28,732,7987,744,1,9464
841,2019-08-30,906,382,180,0,1468
841,2019-08-31,58,244,44,0,346
841,2019-09-01,135,11,0,0,146
841,2019-09-02,78,2,96,0,176
841,2019-09-03,1028,4,1551,0,2583
841,2019-09-04,986,52,2665,2,3705
841,2019-09-05,123,31,2269,4,2427
841,2019-09-06,177,110,1903,0,2190
841,2019-09-07,1045,616,2055,1,3717
841,2019-09-08,1017,151,2124,0,3292
841,2019-09-09,191,528,1555,0,2274
841,2019-09-10,87,329,1967,0,2383
841,2019-09-11,131,279,2676,1,3087
841,2019-09-12,1078,152,1841,1,3072
841,2019-09-13,964,147,1813,0,2924
841,2019-09-14,80,541,1951,0,2572
841,2019-09-15,60,52,2523,1,2636
841,2019-09-16,99,27,2191,3,2320
841,2019-09-17,116,60,1675,0,1851
841,2019-09-18,106,41,1484,1,1632
841,2019-09-19,264,8536,990,1,9791
841,2019-09-20,223,17426,2160,0,19809
841,2019-09-21,177,5772,1801,0,7750
841,2019-09-22,88,12434,2086,0,14608
841,2019-09-23,163,10377,1339,1,11880
841,2019-09-24,119,6905,2598,3,9625
841,2019-09-25,96,6215,1848,4,8163
841,2019-09-26,128,9295,2762,0,12185
841,2019-09-27,122,7620,2642,2,10386
841,2019-09-28,115,17345,2223,598,20281
841,2019-09-29,78,15687,2134,1,17900
841,2019-09-30,703,14608,1822,4,17137
841,2019-10-01,688,15373,1256,0,17317
841,2019-10-02,162,11884,1440,1,13487
841,2019-10-03,174,13090,1263,1,14528
841,2019-10-04,390,11078,1352,2,12822
841,2019-10-05,728,18874,1442,1,21045
841,2019-10-06,1301,15762,1093,1,18157
841,2019-10-07,254,5087,2125,1,7467
841,2019-10-08,100,10991,1672,0,12763
841,2019-10-09,952,12942,2037,2,15933
841,2019-10-10,1224,8999,1857,3,12083
841,2019-10-11,912,11046,1509,1,13468
841,2019-10-12,173,3391,1953,1,5518
841,2019-10-13,209,7147,2539,1,9896
841,2019-10-14,82,7908,1882,2,9874
841,2019-10-15,232,6802,1688,3,8725
841,2019-10-16,94,17846,1060,3,19003
841,2019-10-17,1045,7285,1761,1,10092
841,2019-10-18,1046,7430,2390,1,10867
841,2019-10-19,774,3861,2095,1,6731
841,2019-10-20,79,858,1404,3,2344
841,2019-10-21,101,17471,1732,6,19310
841,2019-10-22,83,8592,1537,2,10214
841,2019-10-23,68,8408,1649,0,10125
841,2019-10-24,124,19318,1181,2,20625
841,2019-10-25,913,20366,1918,2,23199
841,2019-10-26,1133,15888,1379,0,18400
841,2019-10-27,704,15433,956,0,17093
841,2019-10-28,64,22742,1555,0,24361
841,2019-10-29,143,28401,1678,1,30223
841,2019-10-30,580,19838,1900,4,22322
841,2019-10-31,988,11970,1547,0,14505
841,2019-11-01,94,24645,2218,0,26957
841,2019-11-02,89,25833,1681,1,27604
841,2019-11-03,91,52383,937,0,53411
841,2019-11-04,1025,18036,1491,0,20552
841,2019-11-05,130,1565,1954,0,3649
841,2019-11-06,235,13389,468,0,14092
841,2019-11-07,175,24682,1065,0,25922
841,2019-11-08,198,17257,975,0,18430
841,2019-11-09,995,14783,1287,0,17065
841,2019-11-10,110,12182,1978,0,14270
841,2019-11-11,578,11787,2085,0,14450
841,2019-11-12,834,18322,2933,0,22089
841,2019-11-13,494,25235,1544,0,27273
841,2019-11-14,78,14351,2113,0,16542
841,2019-11-15,104,4802,2112,0,7018
841,2019-11-16,104,2722,2652,0,5478
841,2019-11-17,187,3937,3160,0,7284
841,2019-11-18,94,4530,2657,0,7281
841,2019-11-19,1096,5236,2296,0,8628
841,2019-11-20,135,1515,2375,0,4025
841,2019-11-21,208,3475,2179,0,5862
841,2019-11-22,127,5755,1356,0,7238
841,2019-11-23,121,6395,2556,0,9072
841,2019-11-24,104,6069,1864,0,8037
841,2019-11-25,151,6776,1469,0,8396
841,2019-11-26,74,9096,1470,0,10640
841,2019-11-27,1090,6295,1881,0,9266
841,2019-11-28,90,12607,680,0,13377
841,2019-11-29,16,461,109,0,586
841,2019-08-30,906,382,180,0,1468
841,2019-08-31,58,244,44,0,346
841,2019-09-01,135,11,0,0,146
841,2019-09-02,78,2,96,0,176
841,2019-09-03,1028,4,1551,0,2583
841,2019-09-04,986,52,2665,2,3705
841,2019-09-05,123,31,2269,4,2427
841,2019-09-06,177,110,1903,0,2190
841,2019-09-07,1045,616,2055,1,3717
841,2019-09-08,1017,151,2124,0,3292
841,2019-09-09,191,528,1555,0,2274
841,2019-09-10,87,329,1967,0,2383
841,2019-09-11,131,279,2676,1,3087
841,2019-09-12,1078,152,1841,1,3072
841,2019-09-13,964,147,1813,0,2924
841,2019-09-14,80,541,1951,0,2572
841,2019-09-15,60,52,2523,1,2636
841,2019-09-16,99,27,2191,3,2320
841,2019-09-17,116,60,1675,0,1851
841,2019-09-18,106,41,1484,1,1632
841,2019-09-19,264,8536,990,1,9791
841,2019-09-20,223,17426,2160,0,19809
841,2019-09-21,177,5772,1801,0,7750
841,2019-09-22,88,12434,2086,0,14608
841,2019-09-23,163,10377,1339,1,11880
841,2019-09-24,119,6905,2598,3,9625
841,2019-09-25,96,6215,1848,4,8163
841,2019-09-26,128,9295,2762,0,12185
841,2019-09-27,122,7620,2642,2,10386
841,2019-09-28,115,17345,2223,598,20281
841,2019-09-29,78,15687,2134,1,17900
841,2019-09-30,703,14608,1822,4,17137
841,2019-10-01,688,15373,1256,0,17317
841,2019-10-02,162,11884,1440,1,13487
841,2019-10-03,174,13090,1263,1,14528
841,2019-10-04,390,11078,1352,2,12822
841,2019-10-05,728,18874,1442,1,21045
841,2019-10-06,1301,15762,1093,1,18157
841,2019-10-07,254,5087,2125,1,7467
841,2019-10-08,100,10991,1672,0,12763
841,2019-10-09,952,12942,2037,2,15933
841,2019-10-10,1224,8999,1857,3,12083
841,2019-10-11,912,11046,1509,1,13468
841,2019-10-12,173,3391,1953,1,5518
841,2019-10-13,209,7147,2539,1,9896
841,2019-10-14,82,7908,1882,2,9874
841,2019-10-15,232,6802,1688,3,8725
841,2019-10-16,94,17846,1060,3,19003
841,2019-10-17,1045,7285,1761,1,10092
841,2019-10-18,1046,7430,2390,1,10867
841,2019-10-19,774,3861,2095,1,6731
841,2019-10-20,79,858,1404,3,2344
841,2019-10-21,101,17471,1732,6,19310
841,2019-10-22,83,8592,1537,2,10214
841,2019-10-23,68,8408,1649,0,10125
841,2019-10-24,124,19318,1181,2,20625
841,2019-10-25,913,20366,1918,2,23199
841,2019-10-26,1133,15888,1379,0,18400
841,2019-10-27,704,15433,956,0,17093
841,2019-10-28,64,22742,1555,0,24361
841,2019-10-29,143,28401,1678,1,30223
841,2019-10-30,580,19838,1900,4,22322
841,2019-10-31,988,11970,1547,0,14505
841,2019-11-01,94,24645,2218,0,26957
841,2019-11-02,89,25833,1681,1,27604
841,2019-11-03,91,52383,937,0,53411
841,2019-11-04,1025,18036,1491,0,20552
841,2019-11-05,130,1565,1954,0,3649
841,2019-11-06,235,13389,468,0,14092
841,2019-11-07,175,24682,1065,0,25922
841,2019-11-08,198,17257,975,0,18430
841,2019-11-09,995,14783,1287,0,17065
841,2019-11-10,110,12182,1978,0,14270
841,2019-11-11,578,11787,2085,0,14450
841,2019-11-12,834,18322,2933,0,22089
841,2019-11-13,494,25235,1544,0,27273
841,2019-11-14,78,14351,2113,0,16542
841,2019-11-15,104,4802,2112,0,7018
841,2019-11-16,104,2722,2652,0,5478
841,2019-11-17,187,3937,3160,0,7284
841,2019-11-18,94,4530,2657,0,7281
841,2019-11-19,1096,5236,2296,0,8628
841,2019-11-20,135,1515,2375,0,4025
841,2019-11-21,208,3475,2179,0,5862
841,2019-11-22,127,5755,1356,0,7238
841,2019-11-23,121,6395,2556,0,9072
841,2019-11-24,104,6069,1864,0,8037
841,2019-11-25,151,6776,1469,0,8396
841,2019-11-26,74,9096,1470,0,10640
841,2019-11-27,1090,6295,1881,0,9266
841,2019-11-28,90,12607,680,0,13377
841,2019-11-29,16,461,109,0,586
841,2019-08-30,906,382,180,0,1468
841,2019-08-31,58,244,44,0,346
841,2019-09-01,135,11,0,0,146
841,2019-09-02,78,2,96,0,176
841,2019-09-03,1028,4,1551,0,2583
841,2019-09-04,986,52,2665,2,3705
841,2019-09-05,123,31,2269,4,2427
841,2019-09-06,177,110,1903,0,2190
841,2019-09-07,1045,616,2055,1,3717
841,2019-09-08,1017,151,2124,0,3292
841,2019-09-09,191,528,1555,0,2274
841,2019-09-10,87,329,1967,0,2383
841,2019-09-11,131,279,2676,1,3087
841,2019-09-12,1078,152,1841,1,3072
841,2019-09-13,964,147,1813,0,2924
841,2019-09-14,80,541,1951,0,2572
841,2019-09-15,60,52,2523,1,2636
841,2019-09-16,99,27,2191,3,2320
841,2019-09-17,116,60,1675,0,1851
841,2019-09-18,106,41,1484,1,1632
841,2019-09-19,264,8536,990,1,9791
841,2019-09-20,223,17426,2160,0,19809
841,2019-09-21,177,5772,1801,0,7750
841,2019-09-22,88,12434,2086,0,14608
841,2019-09-23,163,10377,1339,1,11880
841,2019-09-24,119,6905,2598,3,9625
841,2019-09-25,96,6215,1848,4,8163
841,2019-09-26,128,9295,2762,0,12185
841,2019-09-27,122,7620,2642,2,10386
841,2019-09-28,115,17345,2223,598,20281
841,2019-09-29,78,15687,2134,1,17900
841,2019-09-30,703,14608,1822,4,17137
841,2019-10-01,688,15373,1256,0,17317
841,2019-10-02,162,11884,1440,1,13487
841,2019-10-03,174,13090,1263,1,14528
841,2019-10-04,390,11078,1352,2,12822
841,2019-10-05,728,18874,1442,1,21045
841,2019-10-06,1301,15762,1093,1,18157
841,2019-10-07,254,5087,2125,1,7467
841,2019-10-08,100,10991,1672,0,12763
841,2019-10-09,952,12942,2037,2,15933
841,2019-10-10,1224,8999,1857,3,12083
841,2019-10-11,912,11046,1509,1,13468
841,2019-10-12,173,3391,1953,1,5518
841,2019-10-13,209,7147,2539,1,9896
841,2019-10-14,82,7908,1882,2,9874
841,2019-10-15,232,6802,1688,3,8725
841,2019-10-16,94,17846,1060,3,19003
841,2019-10-17,1045,7285,1761,1,10092
841,2019-10-18,1046,7430,2390,1,10867
841,2019-10-19,774,3861,2095,1,6731
841,2019-10-20,79,858,1404,3,2344
841,2019-10-21,101,17471,1732,6,19310
841,2019-10-22,83,8592,1537,2,10214
841,2019-10-23,68,8408,1649,0,10125
841,2019-10-24,124,19318,1181,2,20625
841,2019-10-25,913,20366,1918,2,23199
841,2019-10-26,1133,15888,1379,0,18400
841,2019-10-27,704,15433,956,0,17093
841,2019-10-28,64,22742,1555,0,24361
841,2019-10-29,143,28401,1678,1,30223
841,2019-10-30,580,19838,1900,4,22322
841,2019-10-31,988,11970,1547,0,14505
841,2019-11-01,94,24645,2218,0,26957
841,2019-11-02,89,25833,1681,1,27604
841,2019-11-03,91,52383,937,0,53411
841,2019-11-04,1025,18036,1491,0,20552
841,2019-11-05,130,1565,1954,0,3649
841,2019-11-06,235,13389,468,0,14092
841,2019-11-07,175,24682,1065,0,25922
841,2019-11-08,198,17257,975,0,18430
841,2019-11-09,995,14783,1287,0,17065
841,2019-11-10,110,12182,1978,0,14270
841,2019-11-11,578,11787,2085,0,14450
841,2019-11-12,834,18322,2933,0,22089
841,2019-11-13,494,25235,1544,0,27273
841,2019-11-14,78,14351,2113,0,16542
841,2019-11-15,104,4802,2112,0,7018
841,2019-11-16,104,2722,2652,0,5478
841,2019-11-17,187,3937,3160,0,7284
841,2019-11-18,94,4530,2657,0,7281
841,2019-11-19,1096,5236,2296,0,8628
841,2019-11-20,135,1515,2375,0,4025
841,2019-11-21,208,3475,2179,0,5862
841,2019-11-22,127,5755,1356,0,7238
841,2019-11-23,121,6395,2556,0,9072
841,2019-11-24,104,6069,1864,0,8037
841,2019-11-25,151,6776,1469,0,8396
841,2019-11-26,74,9096,1470,0,10640
841,2019-11-27,1090,6295,1881,0,9266
841,2019-11-28,90,12607,680,0,13377
841,2019-11-29,16,461,109,0,586
841,2019-09-04,986,52,2665,2,3705
841,2019-09-05,123,31,2269,4,2427
841,2019-09-06,177,110,1903,0,2190
841,2019-09-07,1045,616,2055,1,3717
841,2019-09-08,1017,151,2124,0,3292
841,2019-09-09,191,528,1555,0,2274
841,2019-09-10,87,329,1967,0,2383
841,2019-09-11,131,279,2676,1,3087
841,2019-09-12,1078,152,1841,1,3072
841,2019-09-13,964,147,1813,0,2924
841,2019-09-14,80,541,1951,0,2572
841,2019-09-15,60,52,2523,1,2636
841,2019-09-16,99,27,2191,3,2320
841,2019-09-17,116,60,1675,0,1851
841,2019-09-18,106,41,1484,1,1632
841,2019-09-19,264,8536,990,1,9791
841,2019-09-20,223,17426,2160,0,19809
841,2019-09-21,177,5772,1801,0,7750
841,2019-09-22,88,12434,2086,0,14608
841,2019-09-23,163,10377,1339,1,11880
841,2019-09-24,119,6905,2598,3,9625
841,2019-09-25,96,6215,1848,4,8163
841,2019-09-26,128,9295,2762,0,12185
841,2019-09-27,122,7620,2642,2,10386
841,2019-09-28,115,17345,2223,598,20281
841,2019-09-29,78,15687,2134,1,17900
841,2019-09-30,703,14608,1822,4,17137
841,2019-10-01,688,15373,1256,0,17317
841,2019-10-02,162,11884,1440,1,13487
841,2019-10-03,174,13090,1263,1,14528
841,2019-10-04,390,11078,1352,2,12822
841,2019-10-05,728,18874,1442,1,21045
841,2019-10-06,1301,15762,1093,1,18157
841,2019-10-07,254,5087,2125,1,7467
841,2019-10-08,100,10991,1672,0,12763
841,2019-10-09,952,12942,2037,2,15933
841,2019-10-10,1224,8999,1857,3,12083
841,2019-10-11,912,11046,1509,1,13468
841,2019-10-12,173,3391,1953,1,5518
841,2019-10-13,209,7147,2539,1,9896
841,2019-10-14,82,7908,1882,2,9874
841,2019-10-15,232,6802,1688,3,8725
841,2019-10-16,94,17846,1060,3,19003
841,2019-10-17,1045,7285,1761,1,10092
841,2019-10-18,1046,7430,2390,1,10867
841,2019-10-19,774,3861,2095,1,6731
841,2019-10-20,79,858,1404,3,2344
841,2019-10-21,101,17471,1732,6,19310
841,2019-10-22,83,8592,1537,2,10214
841,2019-10-23,68,8408,1649,0,10125
841,2019-10-24,124,19318,1181,2,20625
841,2019-10-25,913,20366,1918,2,23199
841,2019-10-26,1133,15888,1379,0,18400
841,2019-10-27,704,15433,956,0,17093
841,2019-10-28,64,22742,1555,0,24361
841,2019-10-29,143,28401,1678,1,30223
841,2019-10-30,580,19838,1900,4,22322
841,2019-10-31,988,11970,1547,0,14505
841,2019-11-01,94,24645,2218,0,26957
841,2019-11-02,89,25833,1681,1,27604
843,2019-08-30,43,138,454,0,635
843,2019-08-31,116,21,5,0,142
843,2019-09-01,112,23,8,0,143
843,2019-09-02,102,24,1,0,127
843,2019-09-03,133,2,1597,0,1732
843,2019-09-04,182,59,2653,1,2895
843,2019-09-05,169,68,1625,0,1862
843,2019-09-06,133,53,1648,1,1835
843,2019-09-07,209,35,2653,1,2898
843,2019-09-08,201,361,1948,0,2510
843,2019-09-09,990,360,2135,1,3486
843,2019-09-10,194,354,2019,0,2567
843,2019-09-11,173,322,2267,3,2765
843,2019-09-12,91,96,1212,0,1399
843,2019-09-13,86,112,2106,1,2305
843,2019-09-14,106,32,2202,0,2340
843,2019-09-15,923,81,2281,5,3290
843,2019-09-16,1028,2,2288,1,3319
843,2019-09-17,82,1291,1648,1,3022
843,2019-09-18,81,33,1709,2,1825
843,2019-09-19,193,8300,1530,1,10024
843,2019-09-20,1026,23593,1998,1,26618
843,2019-09-21,65,4867,1668,2,6602
843,2019-09-22,931,13771,1871,0,16573
843,2019-09-23,108,14395,1488,2,15993
843,2019-09-24,979,11038,1964,2,13983
843,2019-09-25,317,8887,1508,2,10714
843,2019-09-26,90,10668,1093,4,11855
843,2019-09-27,66,11084,1848,2,13000
843,2019-09-28,78,24449,1628,4,26159
843,2019-09-29,82,18075,1167,0,19324
843,2019-09-30,52,24893,1208,0,26153
843,2019-10-01,78,21347,1729,5,23159
843,2019-10-02,145,15566,1533,1,17245
843,2019-10-03,212,22040,1769,0,24021
843,2019-10-04,71,19299,724,1,20095
843,2019-10-05,82,16562,1744,0,18388
843,2019-10-06,164,10193,1725,3,12085
843,2019-10-07,1051,5116,2112,0,8279
843,2019-10-08,77,17854,2007,1,19939
843,2019-10-09,410,24942,1317,1,26670
843,2019-10-10,140,16415,2622,1,19178
843,2019-10-11,67,10399,1099,3,11568
843,2019-10-12,71,3414,2147,0,5632
843,2019-10-13,105,10608,1032,1,11746
843,2019-10-14,966,7464,2025,0,10455
843,2019-10-15,807,14687,1686,2,17182
843,2019-10-16,512,22886,1231,3,24632
843,2019-10-17,1768,7314,1032,0,10114
843,2019-10-18,147,7654,2075,2,9878
843,2019-10-19,56,3775,2026,0,5857
843,2019-10-20,87,799,1891,1,2778
843,2019-10-21,972,9621,1504,5,12102
843,2019-10-22,963,5166,1995,0,8124
843,2019-10-23,266,12993,1723,1,14983
843,2019-10-24,121,19168,1530,1,20820
843,2019-10-25,92,12913,1440,1,14446
843,2019-10-26,92,12231,3119,1,15443
843,2019-10-27,591,14903,2726,0,18220
843,2019-10-28,468,12863,2392,1,15724
843,2019-10-29,200,27636,1646,0,29482
843,2019-10-30,60,30804,1452,2,32318
843,2019-10-31,62,13989,916,3,14970
843,2019-11-01,47,14124,1242,0,15413
843,2019-11-02,570,13894,1819,0,16283
843,2019-11-03,52,36069,1689,0,37810
843,2019-11-04,80,12387,1925,0,14392
843,2019-11-05,994,1356,1958,1,4309
843,2019-11-06,74,7021,1416,1,8512
843,2019-11-07,177,21127,1942,4,23250
843,2019-11-08,755,10900,2094,0,13749
843,2019-11-09,72,7551,1035,2,8660
843,2019-11-10,66,12964,833,2,13865
843,2019-11-11,208,12261,1862,2,14333
843,2019-11-12,493,16280,2697,0,19470
843,2019-11-13,78,13920,1338,4,15340
843,2019-11-14,348,8221,1958,1,10528
843,2019-11-15,62,5685,2953,2,8702
843,2019-11-16,94,1062,2619,1,3776
843,2019-11-17,183,1983,3726,0,5892
843,2019-11-18,105,1245,3521,1,4872
843,2019-11-19,342,2534,3066,2,5944
843,2019-11-20,132,856,2055,3,3046
843,2019-11-21,782,5072,1356,0,7210
843,2019-11-22,318,8615,1385,2,10320
843,2019-11-23,133,6977,1735,0,8845
843,2019-11-24,192,5808,1685,1,7686
843,2019-11-25,87,5398,1432,0,6917
843,2019-11-26,81,6008,1174,0,7263
843,2019-11-27,73,5442,1833,0,7348
843,2019-11-28,74,11493,649,0,12216
843,2019-11-29,17,672,4,0,693
843,2019-08-30,43,138,454,0,635
843,2019-08-31,116,21,5,0,142
843,2019-09-01,112,23,8,0,143
843,2019-09-02,102,24,1,0,127
843,2019-09-03,133,2,1597,0,1732
843,2019-09-04,182,59,2653,1,2895
843,2019-09-05,169,68,1625,0,1862
843,2019-09-06,133,53,1648,1,1835
843,2019-09-07,209,35,2653,1,2898
843,2019-09-08,201,361,1948,0,2510
843,2019-09-09,990,360,2135,1,3486
843,2019-09-10,194,354,2019,0,2567
843,2019-09-11,173,322,2267,3,2765
843,2019-09-12,91,96,1212,0,1399
843,2019-09-13,86,112,2106,1,2305
843,2019-09-14,106,32,2202,0,2340
843,2019-09-15,923,81,2281,5,3290
843,2019-09-16,1028,2,2288,1,3319
843,2019-09-17,82,1291,1648,1,3022
843,2019-09-18,81,33,1709,2,1825
843,2019-09-19,193,8300,1530,1,10024
843,2019-09-20,1026,23593,1998,1,26618
843,2019-09-21,65,4867,1668,2,6602
843,2019-09-22,931,13771,1871,0,16573
843,2019-09-23,108,14395,1488,2,15993
843,2019-09-24,979,11038,1964,2,13983
843,2019-09-25,317,8887,1508,2,10714
843,2019-09-26,90,10668,1093,4,11855
843,2019-09-27,66,11084,1848,2,13000
843,2019-09-28,78,24449,1628,4,26159
843,2019-09-29,82,18075,1167,0,19324
843,2019-09-30,52,24893,1208,0,26153
843,2019-10-01,78,21347,1729,5,23159
843,2019-10-02,145,15566,1533,1,17245
843,2019-10-03,212,22040,1769,0,24021
843,2019-10-04,71,19299,724,1,20095
843,2019-10-05,82,16562,1744,0,18388
843,2019-10-06,164,10193,1725,3,12085
843,2019-10-07,1051,5116,2112,0,8279
843,2019-10-08,77,17854,2007,1,19939
843,2019-10-09,410,24942,1317,1,26670
843,2019-10-10,140,16415,2622,1,19178
843,2019-10-11,67,10399,1099,3,11568
843,2019-10-12,71,3414,2147,0,5632
843,2019-10-13,105,10608,1032,1,11746
843,2019-10-14,966,7464,2025,0,10455
843,2019-10-15,807,14687,1686,2,17182
843,2019-10-16,512,22886,1231,3,24632
843,2019-10-17,1768,7314,1032,0,10114
843,2019-10-18,147,7654,2075,2,9878
843,2019-10-19,56,3775,2026,0,5857
843,2019-10-20,87,799,1891,1,2778
843,2019-10-21,972,9621,1504,5,12102
843,2019-10-22,963,5166,1995,0,8124
843,2019-10-23,266,12993,1723,1,14983
843,2019-10-24,121,19168,1530,1,20820
843,2019-10-25,92,12913,1440,1,14446
843,2019-10-26,92,12231,3119,1,15443
843,2019-10-27,591,14903,2726,0,18220
843,2019-10-28,468,12863,2392,1,15724
843,2019-10-29,200,27636,1646,0,29482
843,2019-10-30,60,30804,1452,2,32318
843,2019-10-31,62,13989,916,3,14970
843,2019-11-01,47,14124,1242,0,15413
843,2019-11-02,570,13894,1819,0,16283
843,2019-11-03,52,36069,1689,0,37810
843,2019-11-04,80,12387,1925,0,14392
843,2019-11-05,994,1356,1958,1,4309
843,2019-11-06,74,7021,1416,1,8512
843,2019-11-07,177,21127,1942,4,23250
843,2019-11-08,755,10900,2094,0,13749
843,2019-11-09,72,7551,1035,2,8660
843,2019-11-10,66,12964,833,2,13865
843,2019-11-11,208,12261,1862,2,14333
843,2019-11-12,493,16280,2697,0,19470
843,2019-11-13,78,13920,1338,4,15340
843,2019-11-14,348,8221,1958,1,10528
843,2019-11-15,62,5685,2953,2,8702
843,2019-11-16,94,1062,2619,1,3776
843,2019-11-17,183,1983,3726,0,5892
843,2019-11-18,105,1245,3521,1,4872
843,2019-11-19,342,2534,3066,2,5944
843,2019-11-20,132,856,2055,3,3046
843,2019-11-21,782,5072,1356,0,7210
843,2019-11-22,318,8615,1385,2,10320
843,2019-11-23,133,6977,1735,0,8845
843,2019-11-24,192,5808,1685,1,7686
843,2019-11-25,87,5398,1432,0,6917
843,2019-11-26,81,6008,1174,0,7263
843,2019-11-27,73,5442,1833,0,7348
843,2019-11-28,74,11493,649,0,12216
843,2019-11-29,17,672,4,0,693
843,2019-08-30,43,138,454,0,635
843,2019-08-31,116,21,5,0,142
843,2019-09-01,112,23,8,0,143
843,2019-09-02,102,24,1,0,127
843,2019-09-03,133,2,1597,0,1732
843,2019-09-04,182,59,2653,1,2895
843,2019-09-05,169,68,1625,0,1862
843,2019-09-06,133,53,1648,1,1835
843,2019-09-07,209,35,2653,1,2898
843,2019-09-08,201,361,1948,0,2510
843,2019-09-09,990,360,2135,1,3486
843,2019-09-10,194,354,2019,0,2567
843,2019-09-11,173,322,2267,3,2765
843,2019-09-12,91,96,1212,0,1399
843,2019-09-13,86,112,2106,1,2305
843,2019-09-14,106,32,2202,0,2340
843,2019-09-15,923,81,2281,5,3290
843,2019-09-16,1028,2,2288,1,3319
843,2019-09-17,82,1291,1648,1,3022
843,2019-09-18,81,33,1709,2,1825
843,2019-09-19,193,8300,1530,1,10024
843,2019-09-20,1026,23593,1998,1,26618
843,2019-09-21,65,4867,1668,2,6602
843,2019-09-22,931,13771,1871,0,16573
843,2019-09-23,108,14395,1488,2,15993
843,2019-09-24,979,11038,1964,2,13983
843,2019-09-25,317,8887,1508,2,10714
843,2019-09-26,90,10668,1093,4,11855
843,2019-09-27,66,11084,1848,2,13000
843,2019-09-28,78,24449,1628,4,26159
843,2019-09-29,82,18075,1167,0,19324
843,2019-09-30,52,24893,1208,0,26153
843,2019-10-01,78,21347,1729,5,23159
843,2019-10-02,145,15566,1533,1,17245
843,2019-10-03,212,22040,1769,0,24021
843,2019-10-04,71,19299,724,1,20095
843,2019-10-05,82,16562,1744,0,18388
843,2019-10-06,164,10193,1725,3,12085
843,2019-10-07,1051,5116,2112,0,8279
843,2019-10-08,77,17854,2007,1,19939
843,2019-10-09,410,24942,1317,1,26670
843,2019-10-10,140,16415,2622,1,19178
843,2019-10-11,67,10399,1099,3,11568
843,2019-10-12,71,3414,2147,0,5632
843,2019-10-13,105,10608,1032,1,11746
843,2019-10-14,966,7464,2025,0,10455
843,2019-10-15,807,14687,1686,2,17182
843,2019-10-16,512,22886,1231,3,24632
843,2019-10-17,1768,7314,1032,0,10114
843,2019-10-18,147,7654,2075,2,9878
843,2019-10-19,56,3775,2026,0,5857
843,2019-10-20,87,799,1891,1,2778
843,2019-10-21,972,9621,1504,5,12102
843,2019-10-22,963,5166,1995,0,8124
843,2019-10-23,266,12993,1723,1,14983
843,2019-10-24,121,19168,1530,1,20820
843,2019-10-25,92,12913,1440,1,14446
843,2019-10-26,92,12231,3119,1,15443
843,2019-10-27,591,14903,2726,0,18220
843,2019-10-28,468,12863,2392,1,15724
843,2019-10-29,200,27636,1646,0,29482
843,2019-10-30,60,30804,1452,2,32318
843,2019-10-31,62,13989,916,3,14970
843,2019-11-01,47,14124,1242,0,15413
843,2019-11-02,570,13894,1819,0,16283
843,2019-11-03,52,36069,1689,0,37810
843,2019-11-04,80,12387,1925,0,14392
843,2019-11-05,994,1356,1958,1,4309
843,2019-11-06,74,7021,1416,1,8512
843,2019-11-07,177,21127,1942,4,23250
843,2019-11-08,755,10900,2094,0,13749
843,2019-11-09,72,7551,1035,2,8660
843,2019-11-10,66,12964,833,2,13865
843,2019-11-11,208,12261,1862,2,14333
843,2019-11-12,493,16280,2697,0,19470
843,2019-11-13,78,13920,1338,4,15340
843,2019-11-14,348,8221,1958,1,10528
843,2019-11-15,62,5685,2953,2,8702
843,2019-11-16,94,1062,2619,1,3776
843,2019-11-17,183,1983,3726,0,5892
843,2019-11-18,105,1245,3521,1,4872
843,2019-11-19,342,2534,3066,2,5944
843,2019-11-20,132,856,2055,3,3046
843,2019-11-21,782,5072,1356,0,7210
843,2019-11-22,318,8615,1385,2,10320
843,2019-11-23,133,6977,1735,0,8845
843,2019-11-24,192,5808,1685,1,7686
843,2019-11-25,87,5398,1432,0,6917
843,2019-11-26,81,6008,1174,0,7263
843,2019-11-27,73,5442,1833,0,7348
843,2019-11-28,74,11493,649,0,12216
843,2019-11-29,17,672,4,0,693
843,2019-09-04,182,59,2653,1,2895
843,2019-09-05,169,68,1625,0,1862
843,2019-09-06,133,53,1648,1,1835
843,2019-09-07,209,35,2653,1,2898
843,2019-09-08,201,361,1948,0,2510
843,2019-09-09,990,360,2135,1,3486
843,2019-09-10,194,354,2019,0,2567
843,2019-09-11,173,322,2267,3,2765
843,2019-09-12,91,96,1212,0,1399
843,2019-09-13,86,112,2106,1,2305
843,2019-09-14,106,32,2202,0,2340
843,2019-09-15,923,81,2281,5,3290
843,2019-09-16,1028,2,2288,1,3319
843,2019-09-17,82,1291,1648,1,3022
843,2019-09-18,81,33,1709,2,1825
843,2019-09-19,193,8300,1530,1,10024
843,2019-09-20,1026,23593,1998,1,26618
843,2019-09-21,65,4867,1668,2,6602
843,2019-09-22,931,13771,1871,0,16573
843,2019-09-23,108,14395,1488,2,15993
843,2019-09-24,979,11038,1964,2,13983
843,2019-09-25,317,8887,1508,2,10714
843,2019-09-26,90,10668,1093,4,11855
843,2019-09-27,66,11084,1848,2,13000
843,2019-09-28,78,24449,1628,4,26159
843,2019-09-29,82,18075,1167,0,19324
843,2019-09-30,52,24893,1208,0,26153
843,2019-10-01,78,21347,1729,5,23159
843,2019-10-02,145,15566,1533,1,17245
843,2019-10-03,212,22040,1769,0,24021
843,2019-10-04,71,19299,724,1,20095
843,2019-10-05,82,16562,1744,0,18388
843,2019-10-06,164,10193,1725,3,12085
843,2019-10-07,1051,5116,2112,0,8279
843,2019-10-08,77,17854,2007,1,19939
843,2019-10-09,410,24942,1317,1,26670
843,2019-10-10,140,16415,2622,1,19178
843,2019-10-11,67,10399,1099,3,11568
843,2019-10-12,71,3414,2147,0,5632
843,2019-10-13,105,10608,1032,1,11746
843,2019-10-14,966,7464,2025,0,10455
843,2019-10-15,807,14687,1686,2,17182
843,2019-10-16,512,22886,1231,3,24632
843,2019-10-17,1768,7314,1032,0,10114
843,2019-10-18,147,7654,2075,2,9878
843,2019-10-19,56,3775,2026,0,5857
843,2019-10-20,87,799,1891,1,2778
843,2019-10-21,972,9621,1504,5,12102
843,2019-10-22,963,5166,1995,0,8124
843,2019-10-23,266,12993,1723,1,14983
843,2019-10-24,121,19168,1530,1,20820
843,2019-10-25,92,12913,1440,1,14446
843,2019-10-26,92,12231,3119,1,15443
843,2019-10-27,591,14903,2726,0,18220
843,2019-10-28,468,12863,2392,1,15724
843,2019-10-29,200,27636,1646,0,29482
843,2019-10-30,60,30804,1452,2,32318
843,2019-10-31,62,13989,916,3,14970
843,2019-11-01,47,14124,1242,0,15413
843,2019-11-02,570,13894,1819,0,16283
843,2019-11-03,52,36069,1689,0,37810
843,2019-11-04,80,12387,1925,0,14392
843,2019-11-05,994,1356,1958,1,4309
843,2019-11-06,74,7021,1416,1,8512
843,2019-11-07,177,21127,1942,4,23250
843,2019-11-08,755,10900,2094,0,13749
843,2019-11-09,72,7551,1035,2,8660
843,2019-11-10,66,12964,833,2,13865
843,2019-11-11,208,12261,1862,2,14333
843,2019-11-12,493,16280,2697,0,19470
843,2019-11-13,78,13920,1338,4,15340
843,2019-11-14,348,8221,1958,1,10528
843,2019-11-15,62,5685,2953,2,8702
843,2019-11-16,94,1062,2619,1,3776
843,2019-11-17,183,1983,3726,0,5892
843,2019-11-18,105,1245,3521,1,4872
843,2019-11-19,342,2534,3066,2,5944
843,2019-11-20,132,856,2055,3,3046
843,2019-11-21,782,5072,1356,0,7210
843,2019-11-22,318,8615,1385,2,10320
843,2019-11-23,133,6977,1735,0,8845
843,2019-11-24,192,5808,1685,1,7686
844,2019-08-30,198,0,0,0,198
844,2019-08-31,63,22,1,0,86
844,2019-09-01,171,11,0,0,182
844,2019-09-02,234,0,31,0,265
844,2019-09-03,274,0,826,0,1100
844,2019-09-04,311,2919,2457,2,5689
844,2019-09-05,1373,14205,2751,1,18330
844,2019-09-06,575,17286,2082,0,19943
844,2019-09-07,522,16912,2207,2,19643
844,2019-09-08,368,66320,1721,2,68411
844,2019-09-09,1221,5746,1607,0,8574
844,2019-09-10,1092,11304,1430,0,13826
844,2019-09-11,322,5467,2260,1,8050
844,2019-09-12,146,7927,1669,3,9745
844,2019-09-13,1020,6806,1914,4,9744
844,2019-09-14,980,6489,1246,1,8716
844,2019-09-15,1826,11771,2889,1,16487
844,2019-09-16,151,7964,1984,1,10100
844,2019-09-17,977,13273,2002,0,16252
844,2019-09-18,163,11000,1411,1,12575
844,2019-09-19,351,2966,1260,0,4577
844,2019-09-20,1111,18746,1480,2,21339
844,2019-09-21,228,6243,2071,0,8542
844,2019-09-22,481,8572,2183,0,11236
844,2019-09-23,202,9296,1700,3,11201
844,2019-09-24,197,10010,2901,1,13109
844,2019-09-25,191,7977,1294,4,9466
844,2019-09-26,1062,12121,1791,0,14974
844,2019-09-27,262,10651,1967,2,12882
844,2019-09-28,807,15726,1664,3,18200
844,2019-09-29,781,16575,2314,1,19671
844,2019-09-30,1306,17904,1213,1,20424
844,2019-10-01,1036,16593,2216,1,19846
844,2019-10-02,1404,12845,2250,0,16499
844,2019-10-03,229,14102,2035,1,16367
844,2019-10-04,304,12196,1621,3,14124
844,2019-10-05,207,22789,1367,1,24364
844,2019-10-06,481,17556,1866,0,19903
844,2019-10-07,1130,6535,1683,979,10327
844,2019-10-08,808,13418,1535,4,15765
844,2019-10-09,237,16233,1919,0,18389
844,2019-10-10,1120,11052,1582,0,13754
844,2019-10-11,478,12586,1767,0,14831
844,2019-10-12,1049,7457,2174,1,10681
844,2019-10-13,1046,7292,1486,3,9827
844,2019-10-14,1029,6708,2227,2,9966
844,2019-10-15,179,9023,1723,1,10926
844,2019-10-16,215,13042,1492,2,14751
844,2019-10-17,145,6501,2073,1,8720
844,2019-10-18,1654,8887,1280,4,11825
844,2019-10-19,298,6438,2018,2,8756
844,2019-10-20,2209,2978,2141,0,7328
844,2019-10-21,783,10506,922,1,12212
844,2019-10-22,522,6592,1847,2,8963
844,2019-10-23,195,11082,1699,4,12980
844,2019-10-24,411,14224,1035,1,15671
844,2019-10-25,181,11535,1353,1,13070
844,2019-10-26,160,14043,1109,1,15313
844,2019-10-27,185,28239,936,0,29360
844,2019-10-28,159,26436,1939,2,28536
844,2019-10-29,473,29499,1677,1,31650
844,2019-10-30,166,29695,936,0,30797
844,2019-10-31,145,15513,3076,0,18734
844,2019-11-01,259,25663,1176,0,27098
844,2019-11-02,1473,17566,2123,3,21165
844,2019-11-03,164,36992,1426,0,38582
844,2019-11-04,167,11514,1131,0,12812
844,2019-11-05,186,3736,1732,0,5654
844,2019-11-06,880,14902,1508,1,17291
844,2019-11-07,295,16735,1319,4,18353
844,2019-11-08,240,9966,950,0,11156
844,2019-11-09,123,9343,1688,0,11154
844,2019-11-10,154,14134,1893,0,16181
844,2019-11-11,186,10085,2412,2,12685
844,2019-11-12,971,11012,2547,2,14532
844,2019-11-13,245,14252,1627,2,16126
844,2019-11-14,157,13113,1677,1,14948
844,2019-11-15,121,4906,2570,2,7599
844,2019-11-16,1517,2659,2882,0,7058
844,2019-11-17,518,4112,3655,4,8289
844,2019-11-18,222,2665,3741,1,6629
844,2019-11-19,223,5365,3303,0,8891
844,2019-11-20,1043,1962,1783,0,4788
844,2019-11-21,789,5137,1383,1,7310
844,2019-11-22,159,6148,1552,4,7863
844,2019-11-23,114,6082,1885,1,8082
844,2019-11-24,251,7311,1636,0,9198
844,2019-11-25,143,7219,2206,1,9569
844,2019-11-26,257,9662,1854,0,11773
844,2019-11-27,80,6995,1283,3,8361
844,2019-11-28,113,13330,790,1,14234
844,2019-11-29,27,703,2,0,732
844,2019-08-31,63,22,1,0,86
844,2019-09-01,171,11,0,0,182
844,2019-09-02,234,0,31,0,265
844,2019-09-03,274,0,826,0,1100
844,2019-09-04,311,2919,2457,2,5689
844,2019-09-05,1373,14205,2751,1,18330
844,2019-09-06,575,17286,2082,0,19943
844,2019-09-07,522,16912,2207,2,19643
844,2019-09-08,368,66320,1721,2,68411
844,2019-09-09,1221,5746,1607,0,8574
844,2019-09-10,1092,11304,1430,0,13826
844,2019-09-11,322,5467,2260,1,8050
844,2019-09-12,146,7927,1669,3,9745
844,2019-09-13,1020,6806,1914,4,9744
844,2019-09-14,980,6489,1246,1,8716
844,2019-09-15,1826,11771,2889,1,16487
844,2019-09-16,151,7964,1984,1,10100
844,2019-09-17,977,13273,2002,0,16252
844,2019-09-18,163,11000,1411,1,12575
844,2019-09-19,351,2966,1260,0,4577
844,2019-09-20,1111,18746,1480,2,21339
844,2019-09-21,228,6243,2071,0,8542
844,2019-09-22,481,8572,2183,0,11236
844,2019-09-23,202,9296,1700,3,11201
844,2019-09-24,197,10010,2901,1,13109
844,2019-09-25,191,7977,1294,4,9466
844,2019-09-26,1062,12121,1791,0,14974
844,2019-09-27,262,10651,1967,2,12882
844,2019-09-28,807,15726,1664,3,18200
844,2019-09-29,781,16575,2314,1,19671
844,2019-09-30,1306,17904,1213,1,20424
844,2019-10-01,1036,16593,2216,1,19846
844,2019-10-02,1404,12845,2250,0,16499
844,2019-10-03,229,14102,2035,1,16367
844,2019-10-04,304,12196,1621,3,14124
844,2019-10-05,207,22789,1367,1,24364
844,2019-10-06,481,17556,1866,0,19903
844,2019-10-07,1130,6535,1683,979,10327
844,2019-10-08,808,13418,1535,4,15765
844,2019-10-09,237,16233,1919,0,18389
844,2019-10-10,1120,11052,1582,0,13754
844,2019-10-11,478,12586,1767,0,14831
844,2019-10-12,1049,7457,2174,1,10681
844,2019-10-13,1046,7292,1486,3,9827
844,2019-10-14,1029,6708,2227,2,9966
844,2019-10-15,179,9023,1723,1,10926
844,2019-10-16,215,13042,1492,2,14751
844,2019-10-17,145,6501,2073,1,8720
844,2019-10-18,1654,8887,1280,4,11825
844,2019-10-19,298,6438,2018,2,8756
844,2019-10-20,2209,2978,2141,0,7328
844,2019-10-21,783,10506,922,1,12212
844,2019-10-22,522,6592,1847,2,8963
844,2019-10-23,195,11082,1699,4,12980
844,2019-10-24,411,14224,1035,1,15671
844,2019-10-25,181,11535,1353,1,13070
844,2019-10-26,160,14043,1109,1,15313
844,2019-10-27,185,28239,936,0,29360
844,2019-10-28,159,26436,1939,2,28536
844,2019-10-29,473,29499,1677,1,31650
844,2019-10-30,166,29695,936,0,30797
844,2019-10-31,145,15513,3076,0,18734
844,2019-11-01,259,25663,1176,0,27098
844,2019-11-02,1473,17566,2123,3,21165
844,2019-11-03,164,36992,1426,0,38582
844,2019-11-04,167,11514,1131,0,12812
844,2019-11-05,186,3736,1732,0,5654
844,2019-11-06,880,14902,1508,1,17291
844,2019-11-07,295,16735,1319,4,18353
844,2019-11-08,240,9966,950,0,11156
844,2019-11-09,123,9343,1688,0,11154
844,2019-11-10,154,14134,1893,0,16181
844,2019-11-11,186,10085,2412,2,12685
844,2019-11-12,971,11012,2547,2,14532
844,2019-11-13,245,14252,1627,2,16126
844,2019-11-14,157,13113,1677,1,14948
844,2019-11-15,121,4906,2570,2,7599
844,2019-11-16,1517,2659,2882,0,7058
844,2019-11-17,518,4112,3655,4,8289
844,2019-11-18,222,2665,3741,1,6629
844,2019-11-19,223,5365,3303,0,8891
844,2019-11-20,1043,1962,1783,0,4788
844,2019-11-21,789,5137,1383,1,7310
844,2019-11-22,159,6148,1552,4,7863
844,2019-11-23,114,6082,1885,1,8082
844,2019-11-24,251,7311,1636,0,9198
844,2019-11-25,143,7219,2206,1,9569
844,2019-11-26,257,9662,1854,0,11773
844,2019-11-27,80,6995,1283,3,8361
844,2019-11-28,113,13330,790,1,14234
844,2019-11-29,27,703,2,0,732
844,2019-08-31,63,22,1,0,86
844,2019-09-01,171,11,0,0,182
844,2019-09-02,234,0,31,0,265
844,2019-09-03,274,0,826,0,1100
844,2019-09-04,311,2919,2457,2,5689
844,2019-09-05,1373,14205,2751,1,18330
844,2019-09-06,575,17286,2082,0,19943
844,2019-09-07,522,16912,2207,2,19643
844,2019-09-08,368,66320,1721,2,68411
844,2019-09-09,1221,5746,1607,0,8574
844,2019-09-10,1092,11304,1430,0,13826
844,2019-09-11,322,5467,2260,1,8050
844,2019-09-12,146,7927,1669,3,9745
844,2019-09-13,1020,6806,1914,4,9744
844,2019-09-14,980,6489,1246,1,8716
844,2019-09-15,1826,11771,2889,1,16487
844,2019-09-16,151,7964,1984,1,10100
844,2019-09-17,977,13273,2002,0,16252
844,2019-09-18,163,11000,1411,1,12575
844,2019-09-19,351,2966,1260,0,4577
844,2019-09-20,1111,18746,1480,2,21339
844,2019-09-21,228,6243,2071,0,8542
844,2019-09-22,481,8572,2183,0,11236
844,2019-09-23,202,9296,1700,3,11201
844,2019-09-24,197,10010,2901,1,13109
844,2019-09-25,191,7977,1294,4,9466
844,2019-09-26,1062,12121,1791,0,14974
844,2019-09-27,262,10651,1967,2,12882
844,2019-09-28,807,15726,1664,3,18200
844,2019-09-29,781,16575,2314,1,19671
844,2019-09-30,1306,17904,1213,1,20424
844,2019-10-01,1036,16593,2216,1,19846
844,2019-10-02,1404,12845,2250,0,16499
844,2019-10-03,229,14102,2035,1,16367
844,2019-10-04,304,12196,1621,3,14124
844,2019-10-05,207,22789,1367,1,24364
844,2019-10-06,481,17556,1866,0,19903
844,2019-10-07,1130,6535,1683,979,10327
844,2019-10-08,808,13418,1535,4,15765
844,2019-10-09,237,16233,1919,0,18389
844,2019-10-10,1120,11052,1582,0,13754
844,2019-10-11,478,12586,1767,0,14831
844,2019-10-12,1049,7457,2174,1,10681
844,2019-10-13,1046,7292,1486,3,9827
844,2019-10-14,1029,6708,2227,2,9966
844,2019-10-15,179,9023,1723,1,10926
844,2019-10-16,215,13042,1492,2,14751
844,2019-10-17,145,6501,2073,1,8720
844,2019-10-18,1654,8887,1280,4,11825
844,2019-10-19,298,6438,2018,2,8756
844,2019-10-20,2209,2978,2141,0,7328
844,2019-10-21,783,10506,922,1,12212
844,2019-10-22,522,6592,1847,2,8963
844,2019-10-23,195,11082,1699,4,12980
844,2019-10-24,411,14224,1035,1,15671
844,2019-10-25,181,11535,1353,1,13070
844,2019-10-26,160,14043,1109,1,15313
844,2019-10-27,185,28239,936,0,29360
844,2019-10-28,159,26436,1939,2,28536
844,2019-10-29,473,29499,1677,1,31650
844,2019-10-30,166,29695,936,0,30797
844,2019-10-31,145,15513,3076,0,18734
844,2019-11-01,259,25663,1176,0,27098
844,2019-11-02,1473,17566,2123,3,21165
844,2019-11-03,164,36992,1426,0,38582
844,2019-11-04,167,11514,1131,0,12812
844,2019-11-05,186,3736,1732,0,5654
844,2019-11-06,880,14902,1508,1,17291
844,2019-11-07,295,16735,1319,4,18353
844,2019-11-08,240,9966,950,0,11156
844,2019-11-09,123,9343,1688,0,11154
844,2019-11-10,154,14134,1893,0,16181
844,2019-11-11,186,10085,2412,2,12685
844,2019-11-12,971,11012,2547,2,14532
844,2019-11-13,245,14252,1627,2,16126
844,2019-11-14,157,13113,1677,1,14948
844,2019-11-15,121,4906,2570,2,7599
844,2019-11-16,1517,2659,2882,0,7058
844,2019-11-17,518,4112,3655,4,8289
844,2019-11-18,222,2665,3741,1,6629
844,2019-11-19,223,5365,3303,0,8891
844,2019-11-20,1043,1962,1783,0,4788
844,2019-11-21,789,5137,1383,1,7310
844,2019-11-22,159,6148,1552,4,7863
844,2019-11-23,114,6082,1885,1,8082
844,2019-11-24,251,7311,1636,0,9198
844,2019-11-25,143,7219,2206,1,9569
844,2019-11-26,257,9662,1854,0,11773
844,2019-11-27,80,6995,1283,3,8361
844,2019-11-28,113,13330,790,1,14234
844,2019-11-29,27,703,2,0,732
844,2019-09-04,311,2919,2457,2,5689
844,2019-09-05,1373,14205,2751,1,18330
844,2019-09-06,575,17286,2082,0,19943
844,2019-09-07,522,16912,2207,2,19643
844,2019-09-08,368,66320,1721,2,68411
844,2019-09-09,1221,5746,1607,0,8574
844,2019-09-10,1092,11304,1430,0,13826
844,2019-09-11,322,5467,2260,1,8050
844,2019-09-12,146,7927,1669,3,9745
844,2019-09-13,1020,6806,1914,4,9744
844,2019-09-14,980,6489,1246,1,8716
844,2019-09-15,1826,11771,2889,1,16487
844,2019-09-16,151,7964,1984,1,10100
844,2019-09-17,977,13273,2002,0,16252
844,2019-09-18,163,11000,1411,1,12575
844,2019-09-19,351,2966,1260,0,4577
844,2019-09-20,1111,18746,1480,2,21339
844,2019-09-21,228,6243,2071,0,8542
844,2019-09-22,481,8572,2183,0,11236
844,2019-09-23,202,9296,1700,3,11201
844,2019-09-24,197,10010,2901,1,13109
844,2019-09-25,191,7977,1294,4,9466
844,2019-09-26,1062,12121,1791,0,14974
844,2019-09-27,262,10651,1967,2,12882
844,2019-09-28,807,15726,1664,3,18200
844,2019-09-29,781,16575,2314,1,19671
844,2019-09-30,1306,17904,1213,1,20424
844,2019-10-01,1036,16593,2216,1,19846
844,2019-10-02,1404,12845,2250,0,16499
844,2019-10-03,229,14102,2035,1,16367
844,2019-10-04,304,12196,1621,3,14124
844,2019-10-05,207,22789,1367,1,24364
844,2019-10-06,481,17556,1866,0,19903
844,2019-10-07,1130,6535,1683,979,10327
844,2019-10-08,808,13418,1535,4,15765
844,2019-10-09,237,16233,1919,0,18389
844,2019-10-10,1120,11052,1582,0,13754
844,2019-10-11,478,12586,1767,0,14831
844,2019-10-12,1049,7457,2174,1,10681
844,2019-10-13,1046,7292,1486,3,9827
844,2019-10-14,1029,6708,2227,2,9966
844,2019-10-15,179,9023,1723,1,10926
844,2019-10-16,215,13042,1492,2,14751
844,2019-10-17,145,6501,2073,1,8720
844,2019-10-18,1654,8887,1280,4,11825
844,2019-10-19,298,6438,2018,2,8756
844,2019-10-20,2209,2978,2141,0,7328
844,2019-10-21,783,10506,922,1,12212
844,2019-10-22,522,6592,1847,2,8963
844,2019-10-23,195,11082,1699,4,12980
844,2019-10-24,411,14224,1035,1,15671
844,2019-10-25,181,11535,1353,1,13070
844,2019-10-26,160,14043,1109,1,15313
844,2019-10-27,185,28239,936,0,29360
844,2019-10-28,159,26436,1939,2,28536
844,2019-10-29,473,29499,1677,1,31650
844,2019-10-30,166,29695,936,0,30797
844,2019-10-31,145,15513,3076,0,18734
844,2019-11-01,259,25663,1176,0,27098
844,2019-11-02,1473,17566,2123,3,21165
844,2019-11-03,164,36992,1426,0,38582
844,2019-11-04,167,11514,1131,0,12812
844,2019-11-05,186,3736,1732,0,5654
844,2019-11-06,880,14902,1508,1,17291
844,2019-11-07,295,16735,1319,4,18353
844,2019-11-08,240,9966,950,0,11156
844,2019-11-09,123,9343,1688,0,11154
844,2019-11-10,154,14134,1893,0,16181
844,2019-11-11,186,10085,2412,2,12685
844,2019-11-12,971,11012,2547,2,14532
844,2019-11-13,245,14252,1627,2,16126
844,2019-11-14,157,13113,1677,1,14948
844,2019-11-15,121,4906,2570,2,7599
844,2019-11-16,1517,2659,2882,0,7058
844,2019-11-17,518,4112,3655,4,8289
844,2019-11-18,222,2665,3741,1,6629
844,2019-11-19,223,5365,3303,0,8891
844,2019-11-20,1043,1962,1783,0,4788
844,2019-11-21,789,5137,1383,1,7310
844,2019-11-22,159,6148,1552,4,7863
844,2019-11-23,114,6082,1885,1,8082
844,2019-11-24,251,7311,1636,0,9198
844,2019-11-25,143,7219,2206,1,9569
844,2019-11-26,257,9662,1854,0,11773
844,2019-11-27,80,6995,1283,3,8361
844,2019-11-28,113,13330,790,1,14234
845,2019-08-30,6,0,0,0,6
845,2019-08-31,96,60,0,0,156
845,2019-09-01,372,46,2,0,420
845,2019-09-02,486,0,47,0,533
845,2019-09-03,528,2,1443,2,1975
845,2019-09-04,1715,3089,2305,1,7110
845,2019-09-05,1881,4781,2221,0,8883
845,2019-09-06,1189,9245,1542,1,11977
845,2019-09-07,1348,10825,1558,0,13731
845,2019-09-08,1266,4900,1730,0,7896
845,2019-09-09,2366,9609,2490,1,14466
845,2019-09-10,1504,6364,2022,2,9892
845,2019-09-11,1405,5816,3205,2,10428
845,2019-09-12,1841,11609,2542,2,15994
845,2019-09-13,2058,6572,2388,0,11018
845,2019-09-14,1188,6326,2492,0,10006
845,2019-09-15,1056,5617,1944,2,8619
845,2019-09-16,1960,7450,2432,0,11842
845,2019-09-17,1081,9315,2147,3,12546
845,2019-09-18,1023,10648,1494,1,13166
845,2019-09-19,1147,15061,1700,0,17908
845,2019-09-20,1217,17847,2396,1,21461
845,2019-09-21,1136,5450,2051,0,8637
845,2019-09-22,1953,10740,1452,1,14146
845,2019-09-23,1844,7573,2524,1,11942
845,2019-09-24,1046,6934,1800,2,9782
845,2019-09-25,1619,6259,2169,3,10050
845,2019-09-26,1272,12604,2246,1,16123
845,2019-09-27,1065,12544,1465,2,15076
845,2019-09-28,1010,14152,1375,2,16539
845,2019-09-29,2242,15974,1584,1,19801
845,2019-09-30,1263,16535,1832,3,19633
845,2019-10-01,1242,15637,2084,0,18963
845,2019-10-02,2132,9084,2383,0,13599
845,2019-10-03,2145,12515,1745,1,16406
845,2019-10-04,1109,8951,1471,4,11535
845,2019-10-05,1612,13771,1428,1,16812
845,2019-10-06,1565,10051,1663,1,13280
845,2019-10-07,1009,4379,1753,0,7141
845,2019-10-08,946,10989,1817,0,13752
845,2019-10-09,982,13788,1440,3,16213
845,2019-10-10,1177,8907,1352,3,11439
845,2019-10-11,1207,18266,1557,0,21030
845,2019-10-12,1101,7928,1948,1,10978
845,2019-10-13,1222,15125,1947,2,18296
845,2019-10-14,2870,6461,1478,0,10809
845,2019-10-15,1907,12808,1651,2,16368
845,2019-10-16,990,22781,1192,0,24963
845,2019-10-17,910,7464,1983,0,10357
845,2019-10-18,1258,19171,1668,2,22099
845,2019-10-19,1143,10180,2436,0,13759
845,2019-10-20,1611,652,1617,2,3882
845,2019-10-21,1436,17192,1509,2,20139
845,2019-10-22,2363,8223,1967,1,12554
845,2019-10-23,1577,14390,1792,0,17759
845,2019-10-24,1270,24849,1191,1,27311
845,2019-10-25,1068,13755,1165,2,15990
845,2019-10-26,1115,12145,2430,0,15690
845,2019-10-27,1801,15076,1667,1,18545
845,2019-10-28,1027,13200,2272,0,16499
845,2019-10-29,942,14552,1343,0,16837
845,2019-10-30,919,14872,1077,5,16873
845,2019-10-31,1511,11437,1627,1,14576
845,2019-11-01,1081,25291,1343,0,27715
845,2019-11-02,1962,16812,1800,0,20574
845,2019-11-03,979,36029,1437,0,38445
845,2019-11-04,991,13041,1777,2,15811
845,2019-11-05,1923,1512,1843,0,5278
845,2019-11-06,1052,6986,1787,1,9826
845,2019-11-07,1492,12817,1110,3,15422
845,2019-11-08,1028,14213,1326,0,16567
845,2019-11-09,991,19123,1010,4,21128
845,2019-11-10,909,12289,2033,39,15270
845,2019-11-11,1417,11890,1829,0,15136
845,2019-11-12,1212,16692,2787,1,20692
845,2019-11-13,944,11485,1685,2,14116
845,2019-11-14,1018,7914,1536,4,10472
845,2019-11-15,1797,3533,1871,1,7202
845,2019-11-16,1044,2768,2338,0,6150
845,2019-11-17,1827,3928,3492,2,9249
845,2019-11-18,1874,3282,2775,1,7932
845,2019-11-19,1507,4671,2474,3,8655
845,2019-11-20,1117,1547,1718,2,4384
845,2019-11-21,1109,5508,1626,1,8244
845,2019-11-22,1595,5137,1270,2,8004
845,2019-11-23,1512,5988,2423,1,9924
845,2019-11-24,988,9886,1575,2,12451
845,2019-11-25,957,7439,2630,1,11027
845,2019-11-26,1146,5523,1241,0,7910
845,2019-11-27,1785,7501,1861,1,11148
845,2019-11-28,1012,7681,677,1,9371
845,2019-11-29,354,390,1,0,745
845,2019-08-31,96,60,0,0,156
845,2019-09-01,372,46,2,0,420
845,2019-09-02,486,0,47,0,533
845,2019-09-03,528,2,1443,2,1975
845,2019-09-04,1715,3089,2305,1,7110
845,2019-09-05,1881,4781,2221,0,8883
845,2019-09-06,1189,9245,1542,1,11977
845,2019-09-07,1348,10825,1558,0,13731
845,2019-09-08,1266,4900,1730,0,7896
845,2019-09-09,2366,9609,2490,1,14466
845,2019-09-10,1504,6364,2022,2,9892
845,2019-09-11,1405,5816,3205,2,10428
845,2019-09-12,1841,11609,2542,2,15994
845,2019-09-13,2058,6572,2388,0,11018
845,2019-09-14,1188,6326,2492,0,10006
845,2019-09-15,1056,5617,1944,2,8619
845,2019-09-16,1960,7450,2432,0,11842
845,2019-09-17,1081,9315,2147,3,12546
845,2019-09-18,1023,10648,1494,1,13166
845,2019-09-19,1147,15061,1700,0,17908
845,2019-09-20,1217,17847,2396,1,21461
845,2019-09-21,1136,5450,2051,0,8637
845,2019-09-22,1953,10740,1452,1,14146
845,2019-09-23,1844,7573,2524,1,11942
845,2019-09-24,1046,6934,1800,2,9782
845,2019-09-25,1619,6259,2169,3,10050
845,2019-09-26,1272,12604,2246,1,16123
845,2019-09-27,1065,12544,1465,2,15076
845,2019-09-28,1010,14152,1375,2,16539
845,2019-09-29,2242,15974,1584,1,19801
845,2019-09-30,1263,16535,1832,3,19633
845,2019-10-01,1242,15637,2084,0,18963
845,2019-10-02,2132,9084,2383,0,13599
845,2019-10-03,2145,12515,1745,1,16406
845,2019-10-04,1109,8951,1471,4,11535
845,2019-10-05,1612,13771,1428,1,16812
845,2019-10-06,1565,10051,1663,1,13280
845,2019-10-07,1009,4379,1753,0,7141
845,2019-10-08,946,10989,1817,0,13752
845,2019-10-09,982,13788,1440,3,16213
845,2019-10-10,1177,8907,1352,3,11439
845,2019-10-11,1207,18266,1557,0,21030
845,2019-10-12,1101,7928,1948,1,10978
845,2019-10-13,1222,15125,1947,2,18296
845,2019-10-14,2870,6461,1478,0,10809
845,2019-10-15,1907,12808,1651,2,16368
845,2019-10-16,990,22781,1192,0,24963
845,2019-10-17,910,7464,1983,0,10357
845,2019-10-18,1258,19171,1668,2,22099
845,2019-10-19,1143,10180,2436,0,13759
845,2019-10-20,1611,652,1617,2,3882
845,2019-10-21,1436,17192,1509,2,20139
845,2019-10-22,2363,8223,1967,1,12554
845,2019-10-23,1577,14390,1792,0,17759
845,2019-10-24,1270,24849,1191,1,27311
845,2019-10-25,1068,13755,1165,2,15990
845,2019-10-26,1115,12145,2430,0,15690
845,2019-10-27,1801,15076,1667,1,18545
845,2019-10-28,1027,13200,2272,0,16499
845,2019-10-29,942,14552,1343,0,16837
845,2019-10-30,919,14872,1077,5,16873
845,2019-10-31,1511,11437,1627,1,14576
845,2019-11-01,1081,25291,1343,0,27715
845,2019-11-02,1962,16812,1800,0,20574
845,2019-11-03,979,36029,1437,0,38445
845,2019-11-04,991,13041,1777,2,15811
845,2019-11-05,1923,1512,1843,0,5278
845,2019-11-06,1052,6986,1787,1,9826
845,2019-11-07,1492,12817,1110,3,15422
845,2019-11-08,1028,14213,1326,0,16567
845,2019-11-09,991,19123,1010,4,21128
845,2019-11-10,909,12289,2033,39,15270
845,2019-11-11,1417,11890,1829,0,15136
845,2019-11-12,1212,16692,2787,1,20692
845,2019-11-13,944,11485,1685,2,14116
845,2019-11-14,1018,7914,1536,4,10472
845,2019-11-15,1797,3533,1871,1,7202
845,2019-11-16,1044,2768,2338,0,6150
845,2019-11-17,1827,3928,3492,2,9249
845,2019-11-18,1874,3282,2775,1,7932
845,2019-11-19,1507,4671,2474,3,8655
845,2019-11-20,1117,1547,1718,2,4384
845,2019-11-21,1109,5508,1626,1,8244
845,2019-11-22,1595,5137,1270,2,8004
845,2019-11-23,1512,5988,2423,1,9924
845,2019-11-24,988,9886,1575,2,12451
845,2019-11-25,957,7439,2630,1,11027
845,2019-11-26,1146,5523,1241,0,7910
845,2019-11-27,1785,7501,1861,1,11148
845,2019-11-28,1012,7681,677,1,9371
845,2019-11-29,354,390,1,0,745
845,2019-09-01,372,46,2,0,420
845,2019-09-02,486,0,47,0,533
845,2019-09-03,528,2,1443,2,1975
845,2019-09-04,1715,3089,2305,1,7110
845,2019-09-05,1881,4781,2221,0,8883
845,2019-09-06,1189,9245,1542,1,11977
845,2019-09-07,1348,10825,1558,0,13731
845,2019-09-08,1266,4900,1730,0,7896
845,2019-09-09,2366,9609,2490,1,14466
845,2019-09-10,1504,6364,2022,2,9892
845,2019-09-11,1405,5816,3205,2,10428
845,2019-09-12,1841,11609,2542,2,15994
845,2019-09-13,2058,6572,2388,0,11018
845,2019-09-14,1188,6326,2492,0,10006
845,2019-09-15,1056,5617,1944,2,8619
845,2019-09-16,1960,7450,2432,0,11842
845,2019-09-17,1081,9315,2147,3,12546
845,2019-09-18,1023,10648,1494,1,13166
845,2019-09-19,1147,15061,1700,0,17908
845,2019-09-20,1217,17847,2396,1,21461
845,2019-09-21,1136,5450,2051,0,8637
845,2019-09-22,1953,10740,1452,1,14146
845,2019-09-23,1844,7573,2524,1,11942
845,2019-09-24,1046,6934,1800,2,9782
845,2019-09-25,1619,6259,2169,3,10050
845,2019-09-26,1272,12604,2246,1,16123
845,2019-09-27,1065,12544,1465,2,15076
845,2019-09-28,1010,14152,1375,2,16539
845,2019-09-29,2242,15974,1584,1,19801
845,2019-09-30,1263,16535,1832,3,19633
845,2019-10-01,1242,15637,2084,0,18963
845,2019-10-02,2132,9084,2383,0,13599
845,2019-10-03,2145,12515,1745,1,16406
845,2019-10-04,1109,8951,1471,4,11535
845,2019-10-05,1612,13771,1428,1,16812
845,2019-10-06,1565,10051,1663,1,13280
845,2019-10-07,1009,4379,1753,0,7141
845,2019-10-08,946,10989,1817,0,13752
845,2019-10-09,982,13788,1440,3,16213
845,2019-10-10,1177,8907,1352,3,11439
845,2019-10-11,1207,18266,1557,0,21030
845,2019-10-12,1101,7928,1948,1,10978
845,2019-10-13,1222,15125,1947,2,18296
845,2019-10-14,2870,6461,1478,0,10809
845,2019-10-15,1907,12808,1651,2,16368
845,2019-10-16,990,22781,1192,0,24963
845,2019-10-17,910,7464,1983,0,10357
845,2019-10-18,1258,19171,1668,2,22099
845,2019-10-19,1143,10180,2436,0,13759
845,2019-10-20,1611,652,1617,2,3882
845,2019-10-21,1436,17192,1509,2,20139
845,2019-10-22,2363,8223,1967,1,12554
845,2019-10-23,1577,14390,1792,0,17759
845,2019-10-24,1270,24849,1191,1,27311
845,2019-10-25,1068,13755,1165,2,15990
845,2019-10-26,1115,12145,2430,0,15690
845,2019-10-27,1801,15076,1667,1,18545
845,2019-10-28,1027,13200,2272,0,16499
845,2019-10-29,942,14552,1343,0,16837
845,2019-10-30,919,14872,1077,5,16873
845,2019-10-31,1511,11437,1627,1,14576
845,2019-11-01,1081,25291,1343,0,27715
845,2019-11-02,1962,16812,1800,0,20574
845,2019-11-03,979,36029,1437,0,38445
845,2019-11-04,991,13041,1777,2,15811
845,2019-11-05,1923,1512,1843,0,5278
845,2019-11-06,1052,6986,1787,1,9826
845,2019-11-07,1492,12817,1110,3,15422
845,2019-11-08,1028,14213,1326,0,16567
845,2019-11-09,991,19123,1010,4,21128
845,2019-11-10,909,12289,2033,39,15270
845,2019-11-11,1417,11890,1829,0,15136
845,2019-11-12,1212,16692,2787,1,20692
845,2019-11-13,944,11485,1685,2,14116
845,2019-11-14,1018,7914,1536,4,10472
845,2019-11-15,1797,3533,1871,1,7202
845,2019-11-16,1044,2768,2338,0,6150
845,2019-11-17,1827,3928,3492,2,9249
845,2019-11-18,1874,3282,2775,1,7932
845,2019-11-19,1507,4671,2474,3,8655
845,2019-11-20,1117,1547,1718,2,4384
845,2019-11-21,1109,5508,1626,1,8244
845,2019-11-22,1595,5137,1270,2,8004
845,2019-11-23,1512,5988,2423,1,9924
845,2019-11-24,988,9886,1575,2,12451
845,2019-11-25,957,7439,2630,1,11027
845,2019-11-26,1146,5523,1241,0,7910
845,2019-11-27,1785,7501,1861,1,11148
845,2019-11-28,1012,7681,677,1,9371
845,2019-11-29,354,390,1,0,745
845,2019-09-03,528,2,1443,2,1975
845,2019-09-04,1715,3089,2305,1,7110
845,2019-09-05,1881,4781,2221,0,8883
845,2019-09-06,1189,9245,1542,1,11977
845,2019-09-07,1348,10825,1558,0,13731
845,2019-09-08,1266,4900,1730,0,7896
845,2019-09-09,2366,9609,2490,1,14466
845,2019-09-10,1504,6364,2022,2,9892
845,2019-09-11,1405,5816,3205,2,10428
845,2019-09-12,1841,11609,2542,2,15994
845,2019-09-13,2058,6572,2388,0,11018
845,2019-09-14,1188,6326,2492,0,10006
845,2019-09-15,1056,5617,1944,2,8619
845,2019-09-16,1960,7450,2432,0,11842
845,2019-09-17,1081,9315,2147,3,12546
845,2019-09-18,1023,10648,1494,1,13166
845,2019-09-19,1147,15061,1700,0,17908
845,2019-09-20,1217,17847,2396,1,21461
845,2019-09-21,1136,5450,2051,0,8637
845,2019-09-22,1953,10740,1452,1,14146
845,2019-09-23,1844,7573,2524,1,11942
845,2019-09-24,1046,6934,1800,2,9782
845,2019-09-25,1619,6259,2169,3,10050
845,2019-09-26,1272,12604,2246,1,16123
845,2019-09-27,1065,12544,1465,2,15076
845,2019-09-28,1010,14152,1375,2,16539
845,2019-09-29,2242,15974,1584,1,19801
845,2019-09-30,1263,16535,1832,3,19633
845,2019-10-01,1242,15637,2084,0,18963
845,2019-10-02,2132,9084,2383,0,13599
845,2019-10-03,2145,12515,1745,1,16406
845,2019-10-04,1109,8951,1471,4,11535
845,2019-10-05,1612,13771,1428,1,16812
845,2019-10-06,1565,10051,1663,1,13280
845,2019-10-07,1009,4379,1753,0,7141
845,2019-10-08,946,10989,1817,0,13752
845,2019-10-09,982,13788,1440,3,16213
845,2019-10-10,1177,8907,1352,3,11439
845,2019-10-11,1207,18266,1557,0,21030
845,2019-10-12,1101,7928,1948,1,10978
845,2019-10-13,1222,15125,1947,2,18296
845,2019-10-14,2870,6461,1478,0,10809
845,2019-10-15,1907,12808,1651,2,16368
845,2019-10-16,990,22781,1192,0,24963
845,2019-10-17,910,7464,1983,0,10357
845,2019-10-18,1258,19171,1668,2,22099
845,2019-10-19,1143,10180,2436,0,13759
845,2019-10-20,1611,652,1617,2,3882
845,2019-10-21,1436,17192,1509,2,20139
845,2019-10-22,2363,8223,1967,1,12554
845,2019-10-23,1577,14390,1792,0,17759
845,2019-10-24,1270,24849,1191,1,27311
845,2019-10-25,1068,13755,1165,2,15990
845,2019-10-26,1115,12145,2430,0,15690
845,2019-10-27,1801,15076,1667,1,18545
845,2019-10-28,1027,13200,2272,0,16499
845,2019-10-29,942,14552,1343,0,16837
845,2019-10-30,919,14872,1077,5,16873
845,2019-10-31,1511,11437,1627,1,14576
845,2019-11-01,1081,25291,1343,0,27715
845,2019-11-02,1962,16812,1800,0,20574
845,2019-11-03,979,36029,1437,0,38445
845,2019-11-04,991,13041,1777,2,15811
845,2019-11-05,1923,1512,1843,0,5278
845,2019-11-06,1052,6986,1787,1,9826
845,2019-11-07,1492,12817,1110,3,15422
845,2019-11-08,1028,14213,1326,0,16567
845,2019-11-09,991,19123,1010,4,21128
845,2019-11-10,909,12289,2033,39,15270
845,2019-11-11,1417,11890,1829,0,15136
845,2019-11-12,1212,16692,2787,1,20692
845,2019-11-13,944,11485,1685,2,14116
845,2019-11-14,1018,7914,1536,4,10472
845,2019-11-15,1797,3533,1871,1,7202
845,2019-11-16,1044,2768,2338,0,6150
845,2019-11-17,1827,3928,3492,2,9249
845,2019-11-18,1874,3282,2775,1,7932
845,2019-11-19,1507,4671,2474,3,8655
845,2019-11-20,1117,1547,1718,2,4384
845,2019-11-21,1109,5508,1626,1,8244
845,2019-11-22,1595,5137,1270,2,8004
845,2019-11-23,1512,5988,2423,1,9924
845,2019-11-24,988,9886,1575,2,12451
845,2019-11-25,957,7439,2630,1,11027
845,2019-11-26,1146,5523,1241,0,7910
845,2019-11-27,1785,7501,1861,1,11148
845,2019-11-28,1012,7681,677,1,9371
846,2019-08-30,74,0,0,0,74
846,2019-08-31,207,6,4,0,217
846,2019-09-01,412,17,0,0,429
846,2019-09-02,132,0,5,0,137
846,2019-09-03,411,50,1798,1,2260
846,2019-09-04,602,587,2974,0,4163
846,2019-09-05,530,10418,2398,1,13347
846,2019-09-06,640,9809,1932,1,12382
846,2019-09-07,609,6579,1140,0,8328
846,2019-09-08,588,5216,1441,0,7245
846,2019-09-09,585,4928,2271,2,7786
846,2019-09-10,486,10081,1809,0,12376
846,2019-09-11,1084,5463,2869,2,9418
846,2019-09-12,328,7637,1889,1,9855
846,2019-09-13,778,6494,2116,1,9389
846,2019-09-14,587,6050,2109,0,8746
846,2019-09-15,3000,4751,1918,36,9705
846,2019-09-16,1231,8099,2005,35,11370
846,2019-09-17,418,13613,1352,1,15384
846,2019-09-18,1677,12346,1007,1,15031
846,2019-09-19,684,10133,1530,2,12349
846,2019-09-20,590,12313,1076,0,13979
846,2019-09-21,434,4684,2070,0,7188
846,2019-09-22,421,7562,1247,0,9230
846,2019-09-23,522,7720,1800,3,10045
846,2019-09-24,624,8563,1900,234,11321
846,2019-09-25,537,6555,1215,0,8307
846,2019-09-26,222,11732,1636,3,13593
846,2019-09-27,285,9148,1901,2,11336
846,2019-09-28,1063,14239,1720,0,17022
846,2019-09-29,222,15827,1501,1,17551
846,2019-09-30,206,15360,1948,0,17514
846,2019-10-01,1047,15672,1573,2,18294
846,2019-10-02,1198,11172,1714,1,14085
846,2019-10-03,749,12652,1549,1,14951
846,2019-10-04,742,16682,1332,1,18757
846,2019-10-05,266,14911,1228,2,16407
846,2019-10-06,529,10162,1987,1,12679
846,2019-10-07,250,5312,2271,0,7833
846,2019-10-08,211,11466,1321,2,13000
846,2019-10-09,309,13659,2031,0,15999
846,2019-10-10,957,9097,1882,3,11939
846,2019-10-11,1574,12069,1895,2,15540
846,2019-10-12,1601,3267,1834,0,6702
846,2019-10-13,362,7144,1948,2,9456
846,2019-10-14,378,4654,1616,1,6649
846,2019-10-15,1287,7211,1464,0,9962
846,2019-10-16,384,12316,1534,3,14237
846,2019-10-17,477,4382,1839,0,6698
846,2019-10-18,652,7578,1635,1,9866
846,2019-10-19,2294,4233,1265,2,7794
846,2019-10-20,467,709,2160,1,3337
846,2019-10-21,1274,17557,1758,2,20591
846,2019-10-22,413,8598,1061,3,10075
846,2019-10-23,708,7052,1159,2,8921
846,2019-10-24,1004,12717,2031,2,15754
846,2019-10-25,877,9857,2495,1,13230
846,2019-10-26,377,11849,2673,0,14899
846,2019-10-27,660,14459,2454,1,17574
846,2019-10-28,453,13207,2445,0,16105
846,2019-10-29,499,16230,1709,0,18438
846,2019-10-30,1556,14837,1384,1,17778
846,2019-10-31,570,11581,1718,2,13871
846,2019-11-01,406,14311,617,1,15335
846,2019-11-02,453,14208,2210,0,16871
846,2019-11-03,424,36328,1558,0,38310
846,2019-11-04,380,12056,1704,2,14142
846,2019-11-05,1318,1395,1943,0,4656
846,2019-11-06,461,7061,2049,2,9573
846,2019-11-07,547,12463,1801,3,14814
846,2019-11-08,754,13968,1441,0,16163
846,2019-11-09,491,14554,1311,0,16356
846,2019-11-10,443,22880,800,0,24123
846,2019-11-11,421,14587,1899,0,16907
846,2019-11-12,391,16169,2365,0,18925
846,2019-11-13,434,12356,1805,0,14595
846,2019-11-14,453,11702,1569,0,13724
846,2019-11-15,425,4929,2558,0,7912
846,2019-11-16,529,2566,2597,0,5692
846,2019-11-17,597,3560,2877,0,7034
846,2019-11-18,412,2743,3009,0,6164
846,2019-11-19,499,5152,2317,0,7968
846,2019-11-20,478,1537,1903,0,3918
846,2019-11-21,425,5561,1904,0,7890
846,2019-11-22,562,1916,1806,0,4284
846,2019-11-23,849,5826,1652,0,8327
846,2019-11-24,563,6241,1630,0,8434
846,2019-11-25,398,6705,1540,0,8643
846,2019-11-26,500,5670,1144,0,7314
846,2019-11-27,1393,6638,1983,0,10014
846,2019-11-28,327,7926,549,0,8802
846,2019-08-31,207,6,4,0,217
846,2019-09-01,412,17,0,0,429
846,2019-09-02,132,0,5,0,137
846,2019-09-03,411,50,1798,1,2260
846,2019-09-04,602,587,2974,0,4163
846,2019-09-05,530,10418,2398,1,13347
846,2019-09-06,640,9809,1932,1,12382
846,2019-09-07,609,6579,1140,0,8328
846,2019-09-08,588,5216,1441,0,7245
846,2019-09-09,585,4928,2271,2,7786
846,2019-09-10,486,10081,1809,0,12376
846,2019-09-11,1084,5463,2869,2,9418
846,2019-09-12,328,7637,1889,1,9855
846,2019-09-13,778,6494,2116,1,9389
846,2019-09-14,587,6050,2109,0,8746
846,2019-09-15,3000,4751,1918,36,9705
846,2019-09-16,1231,8099,2005,35,11370
846,2019-09-17,418,13613,1352,1,15384
846,2019-09-18,1677,12346,1007,1,15031
846,2019-09-19,684,10133,1530,2,12349
846,2019-09-20,590,12313,1076,0,13979
846,2019-09-21,434,4684,2070,0,7188
846,2019-09-22,421,7562,1247,0,9230
846,2019-09-23,522,7720,1800,3,10045
846,2019-09-24,624,8563,1900,234,11321
846,2019-09-25,537,6555,1215,0,8307
846,2019-09-26,222,11732,1636,3,13593
846,2019-09-27,285,9148,1901,2,11336
846,2019-09-28,1063,14239,1720,0,17022
846,2019-09-29,222,15827,1501,1,17551
846,2019-09-30,206,15360,1948,0,17514
846,2019-10-01,1047,15672,1573,2,18294
846,2019-10-02,1198,11172,1714,1,14085
846,2019-10-03,749,12652,1549,1,14951
846,2019-10-04,742,16682,1332,1,18757
846,2019-10-05,266,14911,1228,2,16407
846,2019-10-06,529,10162,1987,1,12679
846,2019-10-07,250,5312,2271,0,7833
846,2019-10-08,211,11466,1321,2,13000
846,2019-10-09,309,13659,2031,0,15999
846,2019-10-10,957,9097,1882,3,11939
846,2019-10-11,1574,12069,1895,2,15540
846,2019-10-12,1601,3267,1834,0,6702
846,2019-10-13,362,7144,1948,2,9456
846,2019-10-14,378,4654,1616,1,6649
846,2019-10-15,1287,7211,1464,0,9962
846,2019-10-16,384,12316,1534,3,14237
846,2019-10-17,477,4382,1839,0,6698
846,2019-10-18,652,7578,1635,1,9866
846,2019-10-19,2294,4233,1265,2,7794
846,2019-10-20,467,709,2160,1,3337
846,2019-10-21,1274,17557,1758,2,20591
846,2019-10-22,413,8598,1061,3,10075
846,2019-10-23,708,7052,1159,2,8921
846,2019-10-24,1004,12717,2031,2,15754
846,2019-10-25,877,9857,2495,1,13230
846,2019-10-26,377,11849,2673,0,14899
846,2019-10-27,660,14459,2454,1,17574
846,2019-10-28,453,13207,2445,0,16105
846,2019-10-29,499,16230,1709,0,18438
846,2019-10-30,1556,14837,1384,1,17778
846,2019-10-31,570,11581,1718,2,13871
846,2019-11-01,406,14311,617,1,15335
846,2019-11-02,453,14208,2210,0,16871
846,2019-11-03,424,36328,1558,0,38310
846,2019-11-04,380,12056,1704,2,14142
846,2019-11-05,1318,1395,1943,0,4656
846,2019-11-06,461,7061,2049,2,9573
846,2019-11-07,547,12463,1801,3,14814
846,2019-11-08,754,13968,1441,0,16163
846,2019-11-09,491,14554,1311,0,16356
846,2019-11-10,443,22880,800,0,24123
846,2019-11-11,421,14587,1899,0,16907
846,2019-11-12,391,16169,2365,0,18925
846,2019-11-13,434,12356,1805,0,14595
846,2019-11-14,453,11702,1569,0,13724
846,2019-11-15,425,4929,2558,0,7912
846,2019-11-16,529,2566,2597,0,5692
846,2019-11-17,597,3560,2877,0,7034
846,2019-11-18,412,2743,3009,0,6164
846,2019-11-19,499,5152,2317,0,7968
846,2019-11-20,478,1537,1903,0,3918
846,2019-11-21,425,5561,1904,0,7890
846,2019-11-22,562,1916,1806,0,4284
846,2019-11-23,849,5826,1652,0,8327
846,2019-11-24,563,6241,1630,0,8434
846,2019-11-25,398,6705,1540,0,8643
846,2019-11-26,500,5670,1144,0,7314
846,2019-11-27,1393,6638,1983,0,10014
846,2019-11-28,327,7926,549,0,8802
846,2019-11-29,0,873,0,0,873
846,2019-08-31,207,6,4,0,217
846,2019-09-01,412,17,0,0,429
846,2019-09-02,132,0,5,0,137
846,2019-09-03,411,50,1798,1,2260
846,2019-09-04,602,587,2974,0,4163
846,2019-09-05,530,10418,2398,1,13347
846,2019-09-06,640,9809,1932,1,12382
846,2019-09-07,609,6579,1140,0,8328
846,2019-09-08,588,5216,1441,0,7245
846,2019-09-09,585,4928,2271,2,7786
846,2019-09-10,486,10081,1809,0,12376
846,2019-09-11,1084,5463,2869,2,9418
846,2019-09-12,328,7637,1889,1,9855
846,2019-09-13,778,6494,2116,1,9389
846,2019-09-14,587,6050,2109,0,8746
846,2019-09-15,3000,4751,1918,36,9705
846,2019-09-16,1231,8099,2005,35,11370
846,2019-09-17,418,13613,1352,1,15384
846,2019-09-18,1677,12346,1007,1,15031
846,2019-09-19,684,10133,1530,2,12349
846,2019-09-20,590,12313,1076,0,13979
846,2019-09-21,434,4684,2070,0,7188
846,2019-09-22,421,7562,1247,0,9230
846,2019-09-23,522,7720,1800,3,10045
846,2019-09-24,624,8563,1900,234,11321
846,2019-09-25,537,6555,1215,0,8307
846,2019-09-26,222,11732,1636,3,13593
846,2019-09-27,285,9148,1901,2,11336
846,2019-09-28,1063,14239,1720,0,17022
846,2019-09-29,222,15827,1501,1,17551
846,2019-09-30,206,15360,1948,0,17514
846,2019-10-01,1047,15672,1573,2,18294
846,2019-10-02,1198,11172,1714,1,14085
846,2019-10-03,749,12652,1549,1,14951
846,2019-10-04,742,16682,1332,1,18757
846,2019-10-05,266,14911,1228,2,16407
846,2019-10-06,529,10162,1987,1,12679
846,2019-10-07,250,5312,2271,0,7833
846,2019-10-08,211,11466,1321,2,13000
846,2019-10-09,309,13659,2031,0,15999
846,2019-10-10,957,9097,1882,3,11939
846,2019-10-11,1574,12069,1895,2,15540
846,2019-10-12,1601,3267,1834,0,6702
846,2019-10-13,362,7144,1948,2,9456
846,2019-10-14,378,4654,1616,1,6649
846,2019-10-15,1287,7211,1464,0,9962
846,2019-10-16,384,12316,1534,3,14237
846,2019-10-17,477,4382,1839,0,6698
846,2019-10-18,652,7578,1635,1,9866
846,2019-10-19,2294,4233,1265,2,7794
846,2019-10-20,467,709,2160,1,3337
846,2019-10-21,1274,17557,1758,2,20591
846,2019-10-22,413,8598,1061,3,10075
846,2019-10-23,708,7052,1159,2,8921
846,2019-10-24,1004,12717,2031,2,15754
846,2019-10-25,877,9857,2495,1,13230
846,2019-10-26,377,11849,2673,0,14899
846,2019-10-27,660,14459,2454,1,17574
846,2019-10-28,453,13207,2445,0,16105
846,2019-10-29,499,16230,1709,0,18438
846,2019-10-30,1556,14837,1384,1,17778
846,2019-10-31,570,11581,1718,2,13871
846,2019-11-01,406,14311,617,1,15335
846,2019-11-02,453,14208,2210,0,16871
846,2019-11-03,424,36328,1558,0,38310
846,2019-11-04,380,12056,1704,2,14142
846,2019-11-05,1318,1395,1943,0,4656
846,2019-11-06,461,7061,2049,2,9573
846,2019-11-07,547,12463,1801,3,14814
846,2019-11-08,754,13968,1441,0,16163
846,2019-11-09,491,14554,1311,0,16356
846,2019-11-10,443,22880,800,0,24123
846,2019-11-11,421,14587,1899,0,16907
846,2019-11-12,391,16169,2365,0,18925
846,2019-11-13,434,12356,1805,0,14595
846,2019-11-14,453,11702,1569,0,13724
846,2019-11-15,425,4929,2558,0,7912
846,2019-11-16,529,2566,2597,0,5692
846,2019-11-17,597,3560,2877,0,7034
846,2019-11-18,412,2743,3009,0,6164
846,2019-11-19,499,5152,2317,0,7968
846,2019-11-20,478,1537,1903,0,3918
846,2019-11-21,425,5561,1904,0,7890
846,2019-11-22,562,1916,1806,0,4284
846,2019-11-23,849,5826,1652,0,8327
846,2019-11-24,563,6241,1630,0,8434
846,2019-11-25,398,6705,1540,0,8643
846,2019-11-26,500,5670,1144,0,7314
846,2019-11-27,1393,6638,1983,0,10014
846,2019-11-28,327,7926,549,0,8802
846,2019-09-03,411,50,1798,1,2260
846,2019-09-04,602,587,2974,0,4163
846,2019-09-05,530,10418,2398,1,13347
846,2019-09-06,640,9809,1932,1,12382
846,2019-09-07,609,6579,1140,0,8328
846,2019-09-08,588,5216,1441,0,7245
846,2019-09-09,585,4928,2271,2,7786
846,2019-09-10,486,10081,1809,0,12376
846,2019-09-11,1084,5463,2869,2,9418
846,2019-09-12,328,7637,1889,1,9855
846,2019-09-13,778,6494,2116,1,9389
846,2019-09-14,587,6050,2109,0,8746
846,2019-09-15,3000,4751,1918,36,9705
846,2019-09-16,1231,8099,2005,35,11370
846,2019-09-17,418,13613,1352,1,15384
846,2019-09-18,1677,12346,1007,1,15031
846,2019-09-19,684,10133,1530,2,12349
846,2019-09-20,590,12313,1076,0,13979
846,2019-09-21,434,4684,2070,0,7188
846,2019-09-22,421,7562,1247,0,9230
846,2019-09-23,522,7720,1800,3,10045
846,2019-09-24,624,8563,1900,234,11321
846,2019-09-25,537,6555,1215,0,8307
846,2019-09-26,222,11732,1636,3,13593
846,2019-09-27,285,9148,1901,2,11336
846,2019-09-28,1063,14239,1720,0,17022
846,2019-09-29,222,15827,1501,1,17551
846,2019-09-30,206,15360,1948,0,17514
846,2019-10-01,1047,15672,1573,2,18294
846,2019-10-02,1198,11172,1714,1,14085
846,2019-10-03,749,12652,1549,1,14951
846,2019-10-04,742,16682,1332,1,18757
846,2019-10-05,266,14911,1228,2,16407
846,2019-10-06,529,10162,1987,1,12679
846,2019-10-07,250,5312,2271,0,7833
846,2019-10-08,211,11466,1321,2,13000
846,2019-10-09,309,13659,2031,0,15999
846,2019-10-10,957,9097,1882,3,11939
846,2019-10-11,1574,12069,1895,2,15540
846,2019-10-12,1601,3267,1834,0,6702
846,2019-10-13,362,7144,1948,2,9456
846,2019-10-14,378,4654,1616,1,6649
846,2019-10-15,1287,7211,1464,0,9962
846,2019-10-16,384,12316,1534,3,14237
846,2019-10-17,477,4382,1839,0,6698
846,2019-10-18,652,7578,1635,1,9866
846,2019-10-19,2294,4233,1265,2,7794
846,2019-10-20,467,709,2160,1,3337
846,2019-10-21,1274,17557,1758,2,20591
846,2019-10-22,413,8598,1061,3,10075
846,2019-10-23,708,7052,1159,2,8921
846,2019-10-24,1004,12717,2031,2,15754
846,2019-10-25,877,9857,2495,1,13230
846,2019-10-26,377,11849,2673,0,14899
846,2019-10-27,660,14459,2454,1,17574
846,2019-10-28,453,13207,2445,0,16105
846,2019-10-29,499,16230,1709,0,18438
846,2019-10-30,1556,14837,1384,1,17778
846,2019-10-31,570,11581,1718,2,13871
846,2019-11-01,406,14311,617,1,15335
846,2019-11-02,453,14208,2210,0,16871
846,2019-11-03,424,36328,1558,0,38310
846,2019-11-04,380,12056,1704,2,14142
846,2019-11-05,1318,1395,1943,0,4656
846,2019-11-06,461,7061,2049,2,9573
846,2019-11-07,547,12463,1801,3,14814
847,2019-08-31,8,8,1,0,17
847,2019-09-01,37,7,3,1,48
847,2019-09-02,0,0,0,0,0
847,2019-09-03,70,2,947,0,1019
847,2019-09-04,1098,867,2854,1,4820
847,2019-09-05,199,4911,1859,0,6969
847,2019-09-06,295,6270,2342,0,8907
847,2019-09-07,251,7030,1395,2,8678
847,2019-09-08,1206,7052,2509,0,10767
847,2019-09-09,123,5320,2106,1,7550
847,2019-09-10,96,7014,2627,1,9738
847,2019-09-11,206,5785,2773,3,8767
847,2019-09-12,110,8261,2352,2,10725
847,2019-09-13,119,8114,2564,2,10799
847,2019-09-14,201,5954,1766,0,7921
847,2019-09-15,147,4807,1946,3,6903
847,2019-09-16,210,7492,1913,1,9616
847,2019-09-17,130,8015,2075,0,10220
847,2019-09-18,119,12147,1541,0,13807
847,2019-09-19,1047,8893,1261,0,11201
847,2019-09-20,225,7580,1260,0,9065
847,2019-09-21,154,6020,1936,0,8110
847,2019-09-22,442,8523,1349,1,10315
847,2019-09-23,1511,8776,1710,1,11998
847,2019-09-24,133,7919,2213,2,10267
847,2019-09-25,727,18753,1531,3,21014
847,2019-09-26,132,7663,1449,0,9244
847,2019-09-27,792,7662,2611,2,11067
847,2019-09-28,2218,14879,2052,4,19153
847,2019-09-29,1096,19977,2499,2,23574
847,2019-09-30,94,35322,1390,0,36806
847,2019-10-01,122,34592,1931,0,36645
847,2019-10-02,183,31239,2371,1,33794
847,2019-10-03,170,13143,1679,1,14993
847,2019-10-04,191,10928,966,14,12099
847,2019-10-05,606,24255,1700,55,26616
847,2019-10-06,95,15234,2026,2,17357
847,2019-10-07,1312,4924,2072,1,8309
847,2019-10-08,328,10803,1706,3,12840
847,2019-10-09,137,14479,1487,1,16104
847,2019-10-10,1898,9165,1664,1,12728
847,2019-10-11,190,10990,1854,0,13034
847,2019-10-12,170,3121,2244,3,5538
847,2019-10-13,137,7773,1688,1,9599
847,2019-10-14,982,5350,2490,1,8823
847,2019-10-15,145,7071,2006,2,9224
847,2019-10-16,1373,17998,1303,2,20676
847,2019-10-17,131,7082,1825,1,9039
847,2019-10-18,108,7703,1245,4,9060
847,2019-10-19,1075,7297,2077,1,10450
847,2019-10-20,160,668,1999,0,2827
847,2019-10-21,134,9276,1382,0,10792
847,2019-10-22,129,4674,1508,608,6919
847,2019-10-23,108,6945,1324,4,8381
847,2019-10-24,143,25054,2066,2,27265
847,2019-10-25,243,14999,1368,1,16611
847,2019-10-26,125,16250,1624,0,17999
847,2019-10-27,117,27211,1594,1,28923
847,2019-10-28,97,24124,1349,0,25570
847,2019-10-29,209,17072,1631,0,18912
847,2019-10-30,714,23613,1801,2,26130
847,2019-10-31,1528,22470,1406,0,25404
847,2019-11-01,461,26812,1419,1,28693
847,2019-11-02,277,16492,710,4,17483
847,2019-11-03,416,21658,1481,1,23556
847,2019-11-04,252,6988,1842,2,9084
847,2019-11-05,168,1446,1859,0,3473
847,2019-11-06,1645,7377,1669,0,10691
847,2019-11-07,966,13452,1194,4,15616
847,2019-11-08,166,9029,1884,1,11080
847,2019-11-09,145,8075,1516,0,9736
847,2019-11-10,144,12252,2041,0,14437
847,2019-11-11,109,7932,3074,1,11116
847,2019-11-12,106,9430,3337,3,12876
847,2019-11-13,711,13623,1502,1,15837
847,2019-11-14,1717,7796,2306,2,11821
847,2019-11-15,490,3656,2014,0,6160
847,2019-11-16,1014,2788,2962,0,6764
847,2019-11-17,226,7372,3284,4,10886
847,2019-11-18,273,7737,2761,0,10771
847,2019-11-19,178,3306,2775,1,6260
847,2019-11-20,1068,1270,2249,1,4588
847,2019-11-21,163,3606,1697,1,5467
847,2019-11-22,991,5868,1680,6,8545
847,2019-11-23,132,9644,2833,7,12616
847,2019-11-24,631,6718,1214,14,8577
847,2019-11-25,207,10935,1674,0,12816
847,2019-11-26,82,7657,1594,0,9333
847,2019-11-27,117,10628,2228,0,12973
847,2019-11-28,114,12732,738,0,13584
847,2019-11-29,27,977,3,0,1007
847,2019-08-31,8,8,1,0,17
847,2019-09-01,37,7,3,1,48
847,2019-09-02,0,0,0,0,0
847,2019-09-03,70,2,947,0,1019
847,2019-09-04,1098,867,2854,1,4820
847,2019-09-05,199,4911,1859,0,6969
847,2019-09-06,295,6270,2342,0,8907
847,2019-09-07,251,7030,1395,2,8678
847,2019-09-08,1206,7052,2509,0,10767
847,2019-09-09,123,5320,2106,1,7550
847,2019-09-10,96,7014,2627,1,9738
847,2019-09-11,206,5785,2773,3,8767
847,2019-09-12,110,8261,2352,2,10725
847,2019-09-13,119,8114,2564,2,10799
847,2019-09-14,201,5954,1766,0,7921
847,2019-09-15,147,4807,1946,3,6903
847,2019-09-16,210,7492,1913,1,9616
847,2019-09-17,130,8015,2075,0,10220
847,2019-09-18,119,12147,1541,0,13807
847,2019-09-19,1047,8893,1261,0,11201
847,2019-09-20,225,7580,1260,0,9065
847,2019-09-21,154,6020,1936,0,8110
847,2019-09-22,442,8523,1349,1,10315
847,2019-09-23,1511,8776,1710,1,11998
847,2019-09-24,133,7919,2213,2,10267
847,2019-09-25,727,18753,1531,3,21014
847,2019-09-26,132,7663,1449,0,9244
847,2019-09-27,792,7662,2611,2,11067
847,2019-09-28,2218,14879,2052,4,19153
847,2019-09-29,1096,19977,2499,2,23574
847,2019-09-30,94,35322,1390,0,36806
847,2019-10-01,122,34592,1931,0,36645
847,2019-10-02,183,31239,2371,1,33794
847,2019-10-03,170,13143,1679,1,14993
847,2019-10-04,191,10928,966,14,12099
847,2019-10-05,606,24255,1700,55,26616
847,2019-10-06,95,15234,2026,2,17357
847,2019-10-07,1312,4924,2072,1,8309
847,2019-10-08,328,10803,1706,3,12840
847,2019-10-09,137,14479,1487,1,16104
847,2019-10-10,1898,9165,1664,1,12728
847,2019-10-11,190,10990,1854,0,13034
847,2019-10-12,170,3121,2244,3,5538
847,2019-10-13,137,7773,1688,1,9599
847,2019-10-14,982,5350,2490,1,8823
847,2019-10-15,145,7071,2006,2,9224
847,2019-10-16,1373,17998,1303,2,20676
847,2019-10-17,131,7082,1825,1,9039
847,2019-10-18,108,7703,1245,4,9060
847,2019-10-19,1075,7297,2077,1,10450
847,2019-10-20,160,668,1999,0,2827
847,2019-10-21,134,9276,1382,0,10792
847,2019-10-22,129,4674,1508,608,6919
847,2019-10-23,108,6945,1324,4,8381
847,2019-10-24,143,25054,2066,2,27265
847,2019-10-25,243,14999,1368,1,16611
847,2019-10-26,125,16250,1624,0,17999
847,2019-10-27,117,27211,1594,1,28923
847,2019-10-28,97,24124,1349,0,25570
847,2019-10-29,209,17072,1631,0,18912
847,2019-10-30,714,23613,1801,2,26130
847,2019-10-31,1528,22470,1406,0,25404
847,2019-11-01,461,26812,1419,1,28693
847,2019-11-02,277,16492,710,4,17483
847,2019-11-03,416,21658,1481,1,23556
847,2019-11-04,252,6988,1842,2,9084
847,2019-11-05,168,1446,1859,0,3473
847,2019-11-06,1645,7377,1669,0,10691
847,2019-11-07,966,13452,1194,4,15616
847,2019-11-08,166,9029,1884,1,11080
847,2019-11-09,145,8075,1516,0,9736
847,2019-11-10,144,12252,2041,0,14437
847,2019-11-11,109,7932,3074,1,11116
847,2019-11-12,106,9430,3337,3,12876
847,2019-11-13,711,13623,1502,1,15837
847,2019-11-14,1717,7796,2306,2,11821
847,2019-11-15,490,3656,2014,0,6160
847,2019-11-16,1014,2788,2962,0,6764
847,2019-11-17,226,7372,3284,4,10886
847,2019-11-18,273,7737,2761,0,10771
847,2019-11-19,178,3306,2775,1,6260
847,2019-11-20,1068,1270,2249,1,4588
847,2019-11-21,163,3606,1697,1,5467
847,2019-11-22,991,5868,1680,6,8545
847,2019-11-23,132,9644,2833,7,12616
847,2019-11-24,631,6718,1214,14,8577
847,2019-11-25,207,10935,1674,0,12816
847,2019-11-26,82,7657,1594,0,9333
847,2019-11-27,117,10628,2228,0,12973
847,2019-11-28,114,12732,738,0,13584
847,2019-11-29,27,977,3,0,1007
847,2019-08-31,8,8,1,0,17
847,2019-09-01,37,7,3,1,48
847,2019-09-02,0,0,0,0,0
847,2019-09-03,70,2,947,0,1019
847,2019-09-04,1098,867,2854,1,4820
847,2019-09-05,199,4911,1859,0,6969
847,2019-09-06,295,6270,2342,0,8907
847,2019-09-07,251,7030,1395,2,8678
847,2019-09-08,1206,7052,2509,0,10767
847,2019-09-09,123,5320,2106,1,7550
847,2019-09-10,96,7014,2627,1,9738
847,2019-09-11,206,5785,2773,3,8767
847,2019-09-12,110,8261,2352,2,10725
847,2019-09-13,119,8114,2564,2,10799
847,2019-09-14,201,5954,1766,0,7921
847,2019-09-15,147,4807,1946,3,6903
847,2019-09-16,210,7492,1913,1,9616
847,2019-09-17,130,8015,2075,0,10220
847,2019-09-18,119,12147,1541,0,13807
847,2019-09-19,1047,8893,1261,0,11201
847,2019-09-20,225,7580,1260,0,9065
847,2019-09-21,154,6020,1936,0,8110
847,2019-09-22,442,8523,1349,1,10315
847,2019-09-23,1511,8776,1710,1,11998
847,2019-09-24,133,7919,2213,2,10267
847,2019-09-25,727,18753,1531,3,21014
847,2019-09-26,132,7663,1449,0,9244
847,2019-09-27,792,7662,2611,2,11067
847,2019-09-28,2218,14879,2052,4,19153
847,2019-09-29,1096,19977,2499,2,23574
847,2019-09-30,94,35322,1390,0,36806
847,2019-10-01,122,34592,1931,0,36645
847,2019-10-02,183,31239,2371,1,33794
847,2019-10-03,170,13143,1679,1,14993
847,2019-10-04,191,10928,966,14,12099
847,2019-10-05,606,24255,1700,55,26616
847,2019-10-06,95,15234,2026,2,17357
847,2019-10-07,1312,4924,2072,1,8309
847,2019-10-08,328,10803,1706,3,12840
847,2019-10-09,137,14479,1487,1,16104
847,2019-10-10,1898,9165,1664,1,12728
847,2019-10-11,190,10990,1854,0,13034
847,2019-10-12,170,3121,2244,3,5538
847,2019-10-13,137,7773,1688,1,9599
847,2019-10-14,982,5350,2490,1,8823
847,2019-10-15,145,7071,2006,2,9224
847,2019-10-16,1373,17998,1303,2,20676
847,2019-10-17,131,7082,1825,1,9039
847,2019-10-18,108,7703,1245,4,9060
847,2019-10-19,1075,7297,2077,1,10450
847,2019-10-20,160,668,1999,0,2827
847,2019-10-21,134,9276,1382,0,10792
847,2019-10-22,129,4674,1508,608,6919
847,2019-10-23,108,6945,1324,4,8381
847,2019-10-24,143,25054,2066,2,27265
847,2019-10-25,243,14999,1368,1,16611
847,2019-10-26,125,16250,1624,0,17999
847,2019-10-27,117,27211,1594,1,28923
847,2019-10-28,97,24124,1349,0,25570
847,2019-10-29,209,17072,1631,0,18912
847,2019-10-30,714,23613,1801,2,26130
847,2019-10-31,1528,22470,1406,0,25404
847,2019-11-01,461,26812,1419,1,28693
847,2019-11-02,277,16492,710,4,17483
847,2019-11-03,416,21658,1481,1,23556
847,2019-11-04,252,6988,1842,2,9084
847,2019-11-05,168,1446,1859,0,3473
847,2019-11-06,1645,7377,1669,0,10691
847,2019-11-07,966,13452,1194,4,15616
847,2019-11-08,166,9029,1884,1,11080
847,2019-11-09,145,8075,1516,0,9736
847,2019-11-10,144,12252,2041,0,14437
847,2019-11-11,109,7932,3074,1,11116
847,2019-11-12,106,9430,3337,3,12876
847,2019-11-13,711,13623,1502,1,15837
847,2019-11-14,1717,7796,2306,2,11821
847,2019-11-15,490,3656,2014,0,6160
847,2019-11-16,1014,2788,2962,0,6764
847,2019-11-17,226,7372,3284,4,10886
847,2019-11-18,273,7737,2761,0,10771
847,2019-11-19,178,3306,2775,1,6260
847,2019-11-20,1068,1270,2249,1,4588
847,2019-11-21,163,3606,1697,1,5467
847,2019-11-22,991,5868,1680,6,8545
847,2019-11-23,132,9644,2833,7,12616
847,2019-11-24,631,6718,1214,14,8577
847,2019-11-25,207,10935,1674,0,12816
847,2019-11-26,82,7657,1594,0,9333
847,2019-11-27,117,10628,2228,0,12973
847,2019-11-28,114,12732,738,0,13584
847,2019-11-29,27,977,3,0,1007
847,2019-09-01,37,7,3,1,48
847,2019-09-02,0,0,0,0,0
847,2019-09-03,70,2,947,0,1019
847,2019-09-04,1098,867,2854,1,4820
847,2019-09-05,199,4911,1859,0,6969
847,2019-09-06,295,6270,2342,0,8907
847,2019-09-07,251,7030,1395,2,8678
847,2019-09-08,1206,7052,2509,0,10767
847,2019-09-09,123,5320,2106,1,7550
847,2019-09-10,96,7014,2627,1,9738
847,2019-09-11,206,5785,2773,3,8767
847,2019-09-12,110,8261,2352,2,10725
847,2019-09-13,119,8114,2564,2,10799
847,2019-09-14,201,5954,1766,0,7921
847,2019-09-15,147,4807,1946,3,6903
847,2019-09-16,210,7492,1913,1,9616
847,2019-09-17,130,8015,2075,0,10220
847,2019-09-18,119,12147,1541,0,13807
847,2019-09-19,1047,8893,1261,0,11201
847,2019-09-20,225,7580,1260,0,9065
847,2019-09-21,154,6020,1936,0,8110
847,2019-09-22,442,8523,1349,1,10315
847,2019-09-23,1511,8776,1710,1,11998
847,2019-09-24,133,7919,2213,2,10267
847,2019-09-25,727,18753,1531,3,21014
847,2019-09-26,132,7663,1449,0,9244
847,2019-09-27,792,7662,2611,2,11067
847,2019-09-28,2218,14879,2052,4,19153
847,2019-09-29,1096,19977,2499,2,23574
847,2019-09-30,94,35322,1390,0,36806
847,2019-10-01,122,34592,1931,0,36645
847,2019-10-02,183,31239,2371,1,33794
847,2019-10-03,170,13143,1679,1,14993
847,2019-10-04,191,10928,966,14,12099
847,2019-10-05,606,24255,1700,55,26616
847,2019-10-06,95,15234,2026,2,17357
847,2019-10-07,1312,4924,2072,1,8309
847,2019-10-08,328,10803,1706,3,12840
847,2019-10-09,137,14479,1487,1,16104
847,2019-10-10,1898,9165,1664,1,12728
847,2019-10-11,190,10990,1854,0,13034
847,2019-10-12,170,3121,2244,3,5538
847,2019-10-13,137,7773,1688,1,9599
847,2019-10-14,982,5350,2490,1,8823
847,2019-10-15,145,7071,2006,2,9224
847,2019-10-16,1373,17998,1303,2,20676
847,2019-10-17,131,7082,1825,1,9039
847,2019-10-18,108,7703,1245,4,9060
847,2019-10-19,1075,7297,2077,1,10450
847,2019-10-20,160,668,1999,0,2827
847,2019-10-21,134,9276,1382,0,10792
847,2019-10-22,129,4674,1508,608,6919
847,2019-10-23,108,6945,1324,4,8381
847,2019-10-24,143,25054,2066,2,27265
847,2019-10-25,243,14999,1368,1,16611
847,2019-10-26,125,16250,1624,0,17999
847,2019-10-27,117,27211,1594,1,28923
847,2019-10-28,97,24124,1349,0,25570
847,2019-10-29,209,17072,1631,0,18912
847,2019-10-30,714,23613,1801,2,26130
847,2019-10-31,1528,22470,1406,0,25404
847,2019-11-01,461,26812,1419,1,28693
847,2019-11-02,277,16492,710,4,17483
847,2019-11-03,416,21658,1481,1,23556
847,2019-11-04,252,6988,1842,2,9084
847,2019-11-05,168,1446,1859,0,3473
847,2019-11-06,1645,7377,1669,0,10691
847,2019-11-07,966,13452,1194,4,15616
847,2019-11-08,166,9029,1884,1,11080
847,2019-11-09,145,8075,1516,0,9736
847,2019-11-10,144,12252,2041,0,14437
847,2019-11-11,109,7932,3074,1,11116
847,2019-11-12,106,9430,3337,3,12876
847,2019-11-13,711,13623,1502,1,15837
847,2019-11-14,1717,7796,2306,2,11821
847,2019-11-15,490,3656,2014,0,6160
847,2019-11-16,1014,2788,2962,0,6764
847,2019-11-17,226,7372,3284,4,10886
847,2019-11-18,273,7737,2761,0,10771
847,2019-11-19,178,3306,2775,1,6260
847,2019-11-20,1068,1270,2249,1,4588
847,2019-11-21,163,3606,1697,1,5467
847,2019-11-22,991,5868,1680,6,8545
847,2019-11-23,132,9644,2833,7,12616
847,2019-11-24,631,6718,1214,14,8577
848,2019-08-31,745,6,0,0,751
848,2019-09-01,1375,3,0,0,1378
848,2019-09-02,0,0,0,0,0
848,2019-09-03,2588,0,636,1,3225
848,2019-09-04,16059,2857,2897,0,21813
848,2019-09-05,4543,10914,2026,0,17483
848,2019-09-06,11316,13797,2267,0,27380
848,2019-09-07,13230,5876,2007,0,21113
848,2019-09-08,11866,5548,2638,0,20052
848,2019-09-09,9751,5417,2199,1,17368
848,2019-09-10,11902,9691,2602,0,24195
848,2019-09-11,11997,7864,1725,1,21587
848,2019-09-12,11643,6618,2247,4,20512
848,2019-09-13,9974,6090,2107,1,18172
848,2019-09-14,10962,8764,2316,1,22043
848,2019-09-15,11360,17480,2250,3,31093
848,2019-09-16,9321,22955,2478,1,34755
848,2019-09-17,10166,6680,2809,0,19655
848,2019-09-18,9194,10405,1451,1,21051
848,2019-09-19,9712,2529,1769,1,14011
848,2019-09-20,8942,12977,2161,1,24081
848,2019-09-21,10397,7155,1904,1,19457
848,2019-09-22,9068,8815,1543,1,19427
848,2019-09-23,7146,9725,1512,0,18383
848,2019-09-24,7546,9658,1558,6,18768
848,2019-09-25,10573,10595,2321,2,23491
848,2019-09-26,9431,8393,1408,0,19232
848,2019-09-27,9249,7545,1338,3,18135
848,2019-09-28,9202,30868,1236,4,41310
848,2019-09-29,11253,27397,2184,3,40837
848,2019-09-30,9009,24216,1442,0,34667
848,2019-10-01,8441,24835,1570,0,34846
848,2019-10-02,8583,15728,1296,0,25607
848,2019-10-03,7117,20243,1457,0,28817
848,2019-10-04,13129,12285,1295,2,26711
848,2019-10-05,11015,19946,1726,1,32688
848,2019-10-06,10225,14907,1778,0,26910
848,2019-10-07,8430,3997,2057,0,14484
848,2019-10-08,8860,16102,1295,1,26258
848,2019-10-09,10133,23134,1409,2,34678
848,2019-10-10,12870,9539,1649,0,24058
848,2019-10-11,10952,13639,833,2,25426
848,2019-10-12,12442,4815,2096,0,19353
848,2019-10-13,12883,10833,1713,1,25430
848,2019-10-14,11687,6458,1988,1,20134
848,2019-10-15,10556,12733,1314,0,24603
848,2019-10-16,9387,23232,1205,1,33825
848,2019-10-17,13417,7038,2683,0,23138
848,2019-10-18,10369,13214,1399,0,24982
848,2019-10-19,12941,6887,1770,0,21598
848,2019-10-20,15383,805,2012,1,18201
848,2019-10-21,9823,8712,1541,2,20078
848,2019-10-22,11794,4341,1594,0,17729
848,2019-10-23,16992,12006,2361,1,31360
848,2019-10-24,12600,24122,1393,4,38119
848,2019-10-25,11743,17749,1265,1,30758
848,2019-10-26,13886,22888,2619,0,39393
848,2019-10-27,12756,28387,2349,0,43492
848,2019-10-28,12828,24166,2868,0,39862
848,2019-10-29,10841,26968,1655,3,39467
848,2019-10-30,11836,18766,1539,1,32142
848,2019-10-31,11844,19845,1390,1,33080
848,2019-11-01,10447,25354,1866,0,37667
848,2019-11-02,11689,15698,940,1,28328
848,2019-11-03,10119,35381,1083,17,46600
848,2019-11-04,12721,12008,1034,0,25763
848,2019-11-05,13658,964,2028,0,16650
848,2019-11-06,12960,12661,2130,2,27753
848,2019-11-07,10046,22600,1755,2,34403
848,2019-11-08,12590,15877,2037,0,30504
848,2019-11-09,13462,13869,3198,0,30529
848,2019-11-10,13067,22033,1126,0,36226
848,2019-11-11,11539,14488,977,1,27005
848,2019-11-12,11148,16692,1845,2,29687
848,2019-11-13,11382,11999,1649,2,25032
848,2019-11-14,11468,6990,1599,1,20058
848,2019-11-15,13875,1785,2036,0,17696
848,2019-11-16,17050,2552,2052,1,21655
848,2019-11-17,17035,1720,3069,1,21825
848,2019-11-18,12746,1148,2706,4,16604
848,2019-11-19,14701,4555,2083,0,21339
848,2019-11-20,15870,1011,2627,0,19508
848,2019-11-21,11462,4601,1937,0,18000
848,2019-11-22,9192,7938,1178,2,18310
848,2019-11-23,10403,5575,1691,0,17669
848,2019-11-24,10167,4766,1328,0,16261
848,2019-11-25,8386,4773,1634,0,14793
848,2019-11-26,7911,4205,1356,0,13472
848,2019-11-27,9495,4531,1592,0,15618
848,2019-11-28,8068,7452,478,0,15998
848,2019-11-29,102,316,2,0,420
848,2019-08-31,745,6,0,0,751
848,2019-09-01,1375,3,0,0,1378
848,2019-09-02,0,0,0,0,0
848,2019-09-03,2588,0,636,1,3225
848,2019-09-04,16059,2857,2897,0,21813
848,2019-09-05,4543,10914,2026,0,17483
848,2019-09-06,11316,13797,2267,0,27380
848,2019-09-07,13230,5876,2007,0,21113
848,2019-09-08,11866,5548,2638,0,20052
848,2019-09-09,9751,5417,2199,1,17368
848,2019-09-10,11902,9691,2602,0,24195
848,2019-09-11,11997,7864,1725,1,21587
848,2019-09-12,11643,6618,2247,4,20512
848,2019-09-13,9974,6090,2107,1,18172
848,2019-09-14,10962,8764,2316,1,22043
848,2019-09-15,11360,17480,2250,3,31093
848,2019-09-16,9321,22955,2478,1,34755
848,2019-09-17,10166,6680,2809,0,19655
848,2019-09-18,9194,10405,1451,1,21051
848,2019-09-19,9712,2529,1769,1,14011
848,2019-09-20,8942,12977,2161,1,24081
848,2019-09-21,10397,7155,1904,1,19457
848,2019-09-22,9068,8815,1543,1,19427
848,2019-09-23,7146,9725,1512,0,18383
848,2019-09-24,7546,9658,1558,6,18768
848,2019-09-25,10573,10595,2321,2,23491
848,2019-09-26,9431,8393,1408,0,19232
848,2019-09-27,9249,7545,1338,3,18135
848,2019-09-28,9202,30868,1236,4,41310
848,2019-09-29,11253,27397,2184,3,40837
848,2019-09-30,9009,24216,1442,0,34667
848,2019-10-01,8441,24835,1570,0,34846
848,2019-10-02,8583,15728,1296,0,25607
848,2019-10-03,7117,20243,1457,0,28817
848,2019-10-04,13129,12285,1295,2,26711
848,2019-10-05,11015,19946,1726,1,32688
848,2019-10-06,10225,14907,1778,0,26910
848,2019-10-07,8430,3997,2057,0,14484
848,2019-10-08,8860,16102,1295,1,26258
848,2019-10-09,10133,23134,1409,2,34678
848,2019-10-10,12870,9539,1649,0,24058
848,2019-10-11,10952,13639,833,2,25426
848,2019-10-12,12442,4815,2096,0,19353
848,2019-10-13,12883,10833,1713,1,25430
848,2019-10-14,11687,6458,1988,1,20134
848,2019-10-15,10556,12733,1314,0,24603
848,2019-10-16,9387,23232,1205,1,33825
848,2019-10-17,13417,7038,2683,0,23138
848,2019-10-18,10369,13214,1399,0,24982
848,2019-10-19,12941,6887,1770,0,21598
848,2019-10-20,15383,805,2012,1,18201
848,2019-10-21,9823,8712,1541,2,20078
848,2019-10-22,11794,4341,1594,0,17729
848,2019-10-23,16992,12006,2361,1,31360
848,2019-10-24,12600,24122,1393,4,38119
848,2019-10-25,11743,17749,1265,1,30758
848,2019-10-26,13886,22888,2619,0,39393
848,2019-10-27,12756,28387,2349,0,43492
848,2019-10-28,12828,24166,2868,0,39862
848,2019-10-29,10841,26968,1655,3,39467
848,2019-10-30,11836,18766,1539,1,32142
848,2019-10-31,11844,19845,1390,1,33080
848,2019-11-01,10447,25354,1866,0,37667
848,2019-11-02,11689,15698,940,1,28328
848,2019-11-03,10119,35381,1083,17,46600
848,2019-11-04,12721,12008,1034,0,25763
848,2019-11-05,13658,964,2028,0,16650
848,2019-11-06,12960,12661,2130,2,27753
848,2019-11-07,10046,22600,1755,2,34403
848,2019-11-08,12590,15877,2037,0,30504
848,2019-11-09,13462,13869,3198,0,30529
848,2019-11-10,13067,22033,1126,0,36226
848,2019-11-11,11539,14488,977,1,27005
848,2019-11-12,11148,16692,1845,2,29687
848,2019-11-13,11382,11999,1649,2,25032
848,2019-11-14,11468,6990,1599,1,20058
848,2019-11-15,13875,1785,2036,0,17696
848,2019-11-16,17050,2552,2052,1,21655
848,2019-11-17,17035,1720,3069,1,21825
848,2019-11-18,12746,1148,2706,4,16604
848,2019-11-19,14701,4555,2083,0,21339
848,2019-11-20,15870,1011,2627,0,19508
848,2019-11-21,11462,4601,1937,0,18000
848,2019-11-22,9192,7938,1178,2,18310
848,2019-11-23,10403,5575,1691,0,17669
848,2019-11-24,10167,4766,1328,0,16261
848,2019-11-25,8386,4773,1634,0,14793
848,2019-11-26,7911,4205,1356,0,13472
848,2019-11-27,9495,4531,1592,0,15618
848,2019-11-28,8068,7452,478,0,15998
848,2019-11-29,102,316,2,0,420
848,2019-09-03,2588,0,636,1,3225
848,2019-09-04,16059,2857,2897,0,21813
848,2019-09-05,4543,10914,2026,0,17483
848,2019-09-06,11316,13797,2267,0,27380
848,2019-09-07,13230,5876,2007,0,21113
848,2019-09-08,11866,5548,2638,0,20052
848,2019-09-09,9751,5417,2199,1,17368
848,2019-09-10,11902,9691,2602,0,24195
848,2019-09-11,11997,7864,1725,1,21587
848,2019-09-12,11643,6618,2247,4,20512
848,2019-09-13,9974,6090,2107,1,18172
848,2019-09-14,10962,8764,2316,1,22043
848,2019-09-15,11360,17480,2250,3,31093
848,2019-09-16,9321,22955,2478,1,34755
848,2019-09-17,10166,6680,2809,0,19655
848,2019-09-18,9194,10405,1451,1,21051
848,2019-09-19,9712,2529,1769,1,14011
848,2019-09-20,8942,12977,2161,1,24081
848,2019-09-21,10397,7155,1904,1,19457
848,2019-09-22,9068,8815,1543,1,19427
848,2019-09-23,7146,9725,1512,0,18383
848,2019-09-24,7546,9658,1558,6,18768
848,2019-09-25,10573,10595,2321,2,23491
848,2019-09-26,9431,8393,1408,0,19232
848,2019-09-27,9249,7545,1338,3,18135
848,2019-09-28,9202,30868,1236,4,41310
848,2019-09-29,11253,27397,2184,3,40837
848,2019-09-30,9009,24216,1442,0,34667
848,2019-10-01,8441,24835,1570,0,34846
848,2019-10-02,8583,15728,1296,0,25607
848,2019-10-03,7117,20243,1457,0,28817
848,2019-10-04,13129,12285,1295,2,26711
848,2019-10-05,11015,19946,1726,1,32688
848,2019-10-06,10225,14907,1778,0,26910
848,2019-10-07,8430,3997,2057,0,14484
848,2019-10-08,8860,16102,1295,1,26258
848,2019-10-09,10133,23134,1409,2,34678
848,2019-10-10,12870,9539,1649,0,24058
848,2019-10-11,10952,13639,833,2,25426
848,2019-10-12,12442,4815,2096,0,19353
848,2019-10-13,12883,10833,1713,1,25430
848,2019-10-14,11687,6458,1988,1,20134
848,2019-10-15,10556,12733,1314,0,24603
848,2019-10-16,9387,23232,1205,1,33825
848,2019-10-17,13417,7038,2683,0,23138
848,2019-10-18,10369,13214,1399,0,24982
848,2019-10-19,12941,6887,1770,0,21598
848,2019-10-20,15383,805,2012,1,18201
848,2019-10-21,9823,8712,1541,2,20078
848,2019-10-22,11794,4341,1594,0,17729
848,2019-10-23,16992,12006,2361,1,31360
848,2019-10-24,12600,24122,1393,4,38119
848,2019-10-25,11743,17749,1265,1,30758
848,2019-10-26,13886,22888,2619,0,39393
848,2019-10-27,12756,28387,2349,0,43492
848,2019-10-28,12828,24166,2868,0,39862
848,2019-10-29,10841,26968,1655,3,39467
848,2019-10-30,11836,18766,1539,1,32142
848,2019-10-31,11844,19845,1390,1,33080
848,2019-11-01,10447,25354,1866,0,37667
848,2019-11-02,11689,15698,940,1,28328
848,2019-11-03,10119,35381,1083,17,46600
848,2019-11-04,12721,12008,1034,0,25763
848,2019-11-05,13658,964,2028,0,16650
848,2019-11-06,12960,12661,2130,2,27753
848,2019-11-07,10046,22600,1755,2,34403
848,2019-11-08,12590,15877,2037,0,30504
848,2019-11-09,13462,13869,3198,0,30529
848,2019-11-10,13067,22033,1126,0,36226
848,2019-11-11,11539,14488,977,1,27005
848,2019-11-12,11148,16692,1845,2,29687
848,2019-11-13,11382,11999,1649,2,25032
848,2019-11-14,11468,6990,1599,1,20058
848,2019-11-15,13875,1785,2036,0,17696
848,2019-11-16,17050,2552,2052,1,21655
848,2019-11-17,17035,1720,3069,1,21825
848,2019-11-18,12746,1148,2706,4,16604
848,2019-11-19,14701,4555,2083,0,21339
848,2019-11-20,15870,1011,2627,0,19508
848,2019-11-21,11462,4601,1937,0,18000
848,2019-11-22,9192,7938,1178,2,18310
848,2019-11-23,10403,5575,1691,0,17669
848,2019-11-24,10167,4766,1328,0,16261
848,2019-11-25,8386,4773,1634,0,14793
848,2019-11-26,7911,4205,1356,0,13472
848,2019-11-27,9495,4531,1592,0,15618
848,2019-11-28,8068,7452,478,0,15998
848,2019-11-29,102,316,2,0,420
848,2019-09-03,2588,0,636,1,3225
848,2019-09-04,16059,2857,2897,0,21813
848,2019-09-05,4543,10914,2026,0,17483
848,2019-09-06,11316,13797,2267,0,27380
848,2019-09-07,13230,5876,2007,0,21113
848,2019-09-08,11866,5548,2638,0,20052
848,2019-09-09,9751,5417,2199,1,17368
848,2019-09-10,11902,9691,2602,0,24195
848,2019-09-11,11997,7864,1725,1,21587
848,2019-09-12,11643,6618,2247,4,20512
848,2019-09-13,9974,6090,2107,1,18172
848,2019-09-14,10962,8764,2316,1,22043
848,2019-09-15,11360,17480,2250,3,31093
848,2019-09-16,9321,22955,2478,1,34755
848,2019-09-17,10166,6680,2809,0,19655
848,2019-09-18,9194,10405,1451,1,21051
848,2019-09-19,9712,2529,1769,1,14011
848,2019-09-20,8942,12977,2161,1,24081
848,2019-09-21,10397,7155,1904,1,19457
848,2019-09-22,9068,8815,1543,1,19427
848,2019-09-23,7146,9725,1512,0,18383
848,2019-09-24,7546,9658,1558,6,18768
848,2019-09-25,10573,10595,2321,2,23491
848,2019-09-26,9431,8393,1408,0,19232
848,2019-09-27,9249,7545,1338,3,18135
848,2019-09-28,9202,30868,1236,4,41310
848,2019-09-29,11253,27397,2184,3,40837
848,2019-09-30,9009,24216,1442,0,34667
848,2019-10-01,8441,24835,1570,0,34846
848,2019-10-02,8583,15728,1296,0,25607
848,2019-10-03,7117,20243,1457,0,28817
848,2019-10-04,13129,12285,1295,2,26711
848,2019-10-05,11015,19946,1726,1,32688
848,2019-10-06,10225,14907,1778,0,26910
848,2019-10-07,8430,3997,2057,0,14484
848,2019-10-08,8860,16102,1295,1,26258
848,2019-10-09,10133,23134,1409,2,34678
848,2019-10-10,12870,9539,1649,0,24058
848,2019-10-11,10952,13639,833,2,25426
848,2019-10-12,12442,4815,2096,0,19353
848,2019-10-13,12883,10833,1713,1,25430
848,2019-10-14,11687,6458,1988,1,20134
848,2019-10-15,10556,12733,1314,0,24603
848,2019-10-16,9387,23232,1205,1,33825
848,2019-10-17,13417,7038,2683,0,23138
848,2019-10-18,10369,13214,1399,0,24982
848,2019-10-19,12941,6887,1770,0,21598
848,2019-10-20,15383,805,2012,1,18201
848,2019-10-21,9823,8712,1541,2,20078
848,2019-10-22,11794,4341,1594,0,17729
848,2019-10-23,16992,12006,2361,1,31360
848,2019-10-24,12600,24122,1393,4,38119
848,2019-10-25,11743,17749,1265,1,30758
848,2019-10-26,13886,22888,2619,0,39393
848,2019-10-27,12756,28387,2349,0,43492
848,2019-10-28,12828,24166,2868,0,39862
848,2019-10-29,10841,26968,1655,3,39467
848,2019-10-30,11836,18766,1539,1,32142
848,2019-10-31,11844,19845,1390,1,33080
848,2019-11-01,10447,25354,1866,0,37667
848,2019-11-02,11689,15698,940,1,28328
848,2019-11-03,10119,35381,1083,17,46600
848,2019-11-04,12721,12008,1034,0,25763
848,2019-11-05,13658,964,2028,0,16650
848,2019-11-06,12960,12661,2130,2,27753
848,2019-11-07,10046,22600,1755,2,34403
848,2019-11-08,12590,15877,2037,0,30504
848,2019-11-09,13462,13869,3198,0,30529
848,2019-11-10,13067,22033,1126,0,36226
848,2019-11-11,11539,14488,977,1,27005
848,2019-11-12,11148,16692,1845,2,29687
848,2019-11-13,11382,11999,1649,2,25032
848,2019-11-14,11468,6990,1599,1,20058
848,2019-11-15,13875,1785,2036,0,17696
848,2019-11-16,17050,2552,2052,1,21655
848,2019-11-17,17035,1720,3069,1,21825
848,2019-11-18,12746,1148,2706,4,16604
848,2019-11-19,14701,4555,2083,0,21339
848,2019-11-20,15870,1011,2627,0,19508
848,2019-11-21,11462,4601,1937,0,18000
848,2019-11-22,9192,7938,1178,2,18310
849,2019-08-31,22,5,1,0,28
849,2019-09-01,84,8,0,0,92
849,2019-09-02,2,0,0,0,2
849,2019-09-03,41,2,865,0,908
849,2019-09-04,458,3303,1987,0,5748
849,2019-09-05,354,7155,2211,5,9725
849,2019-09-06,425,33886,2352,1,36664
849,2019-09-07,314,10110,1939,1,12364
849,2019-09-08,432,5706,2124,0,8262
849,2019-09-09,1164,6221,2298,0,9683
849,2019-09-10,250,9156,1987,0,11393
849,2019-09-11,405,6866,2027,2,9300
849,2019-09-12,204,9513,862,0,10579
849,2019-09-13,1217,5229,2430,1,8877
849,2019-09-14,284,5744,1348,0,7376
849,2019-09-15,236,8476,2249,2,10963
849,2019-09-16,255,5882,1923,3,8063
849,2019-09-17,256,7192,1280,0,8728
849,2019-09-18,636,11613,1395,0,13644
849,2019-09-19,497,2652,1569,0,4718
849,2019-09-20,389,9872,1781,3,12045
849,2019-09-21,297,6287,2340,0,8924
849,2019-09-22,268,9971,1834,1,12074
849,2019-09-23,371,8161,1547,0,10079
849,2019-09-24,366,7342,1484,3,9195
849,2019-09-25,163,6503,1727,6,8399
849,2019-09-26,152,7827,2204,1,10184
849,2019-09-27,234,7550,1187,1,8972
849,2019-09-28,133,14839,1587,3,16562
849,2019-09-29,1861,16456,1777,2,20096
849,2019-09-30,118,16578,2256,4,18956
849,2019-10-01,129,15670,1032,0,16831
849,2019-10-02,271,11661,2037,0,13969
849,2019-10-03,192,12905,2010,0,15107
849,2019-10-04,232,11142,1519,1,12894
849,2019-10-05,186,15320,1557,2,17065
849,2019-10-06,384,10388,1665,2,12439
849,2019-10-07,195,4376,1700,0,6271
849,2019-10-08,253,11390,1844,1,13488
849,2019-10-09,136,15030,2049,2,17217
849,2019-10-10,296,9118,2231,2,11647
849,2019-10-11,961,11046,1043,0,13050
849,2019-10-12,1109,3407,1520,43,6079
849,2019-10-13,260,7299,2098,1,9658
849,2019-10-14,1112,4835,2315,1,8263
849,2019-10-15,314,7722,1541,2,9579
849,2019-10-16,1354,12939,1401,1,15695
849,2019-10-17,264,4766,2013,1,7044
849,2019-10-18,423,7819,1704,1,9947
849,2019-10-19,309,4329,2274,0,6912
849,2019-10-20,1183,687,1550,2,3422
849,2019-10-21,1547,17100,1458,0,20105
849,2019-10-22,233,8333,1683,2,10251
849,2019-10-23,1108,6948,1839,0,9895
849,2019-10-24,1366,19781,1884,1,23032
849,2019-10-25,1828,14114,1334,1,17277
849,2019-10-26,239,12742,1285,0,14266
849,2019-10-27,1151,27376,1161,2,29690
849,2019-10-28,225,25043,1796,1,27065
849,2019-10-29,410,28322,1658,2,30392
849,2019-10-30,579,27965,1238,3,29785
849,2019-10-31,315,13904,2489,2,16710
849,2019-11-01,1134,13773,1673,0,16580
849,2019-11-02,532,14330,2176,1,17039
849,2019-11-03,590,21812,1101,0,23503
849,2019-11-04,1153,9025,1735,3,11916
849,2019-11-05,371,1819,1916,0,4106
849,2019-11-06,240,17002,1478,1,18721
849,2019-11-07,387,15705,1619,2,17713
849,2019-11-08,391,9142,971,1,10505
849,2019-11-09,272,7573,1519,2,9366
849,2019-11-10,222,22872,1160,0,24254
849,2019-11-11,281,14543,1657,0,16481
849,2019-11-12,255,16992,2894,0,20141
849,2019-11-13,1216,13843,1122,0,16181
849,2019-11-14,335,11382,2086,0,13803
849,2019-11-15,1156,3248,2937,0,7341
849,2019-11-16,1210,982,2849,0,5041
849,2019-11-17,499,2336,3432,0,6267
849,2019-11-18,271,1131,3454,0,4856
849,2019-11-19,358,4830,2180,0,7368
849,2019-11-20,317,773,2051,0,3141
849,2019-11-21,283,3122,1998,0,5403
849,2019-11-22,316,5276,1769,0,7361
849,2019-11-23,254,5648,2254,0,8156
849,2019-11-24,355,5093,1844,0,7292
849,2019-11-25,274,5313,1574,0,7161
849,2019-11-26,432,4158,1505,0,6095
849,2019-11-27,990,5738,2229,0,8957
849,2019-11-28,272,8214,448,0,8934
849,2019-08-31,22,5,1,0,28
849,2019-09-01,84,8,0,0,92
849,2019-09-02,2,0,0,0,2
849,2019-09-03,41,2,865,0,908
849,2019-09-04,458,3303,1987,0,5748
849,2019-09-05,354,7155,2211,5,9725
849,2019-09-06,425,33886,2352,1,36664
849,2019-09-07,314,10110,1939,1,12364
849,2019-09-08,432,5706,2124,0,8262
849,2019-09-09,1164,6221,2298,0,9683
849,2019-09-10,250,9156,1987,0,11393
849,2019-09-11,405,6866,2027,2,9300
849,2019-09-12,204,9513,862,0,10579
849,2019-09-13,1217,5229,2430,1,8877
849,2019-09-14,284,5744,1348,0,7376
849,2019-09-15,236,8476,2249,2,10963
849,2019-09-16,255,5882,1923,3,8063
849,2019-09-17,256,7192,1280,0,8728
849,2019-09-18,636,11613,1395,0,13644
849,2019-09-19,497,2652,1569,0,4718
849,2019-09-20,389,9872,1781,3,12045
849,2019-09-21,297,6287,2340,0,8924
849,2019-09-22,268,9971,1834,1,12074
849,2019-09-23,371,8161,1547,0,10079
849,2019-09-24,366,7342,1484,3,9195
849,2019-09-25,163,6503,1727,6,8399
849,2019-09-26,152,7827,2204,1,10184
849,2019-09-27,234,7550,1187,1,8972
849,2019-09-28,133,14839,1587,3,16562
849,2019-09-29,1861,16456,1777,2,20096
849,2019-09-30,118,16578,2256,4,18956
849,2019-10-01,129,15670,1032,0,16831
849,2019-10-02,271,11661,2037,0,13969
849,2019-10-03,192,12905,2010,0,15107
849,2019-10-04,232,11142,1519,1,12894
849,2019-10-05,186,15320,1557,2,17065
849,2019-10-06,384,10388,1665,2,12439
849,2019-10-07,195,4376,1700,0,6271
849,2019-10-08,253,11390,1844,1,13488
849,2019-10-09,136,15030,2049,2,17217
849,2019-10-10,296,9118,2231,2,11647
849,2019-10-11,961,11046,1043,0,13050
849,2019-10-12,1109,3407,1520,43,6079
849,2019-10-13,260,7299,2098,1,9658
849,2019-10-14,1112,4835,2315,1,8263
849,2019-10-15,314,7722,1541,2,9579
849,2019-10-16,1354,12939,1401,1,15695
849,2019-10-17,264,4766,2013,1,7044
849,2019-10-18,423,7819,1704,1,9947
849,2019-10-19,309,4329,2274,0,6912
849,2019-10-20,1183,687,1550,2,3422
849,2019-10-21,1547,17100,1458,0,20105
849,2019-10-22,233,8333,1683,2,10251
849,2019-10-23,1108,6948,1839,0,9895
849,2019-10-24,1366,19781,1884,1,23032
849,2019-10-25,1828,14114,1334,1,17277
849,2019-10-26,239,12742,1285,0,14266
849,2019-10-27,1151,27376,1161,2,29690
849,2019-10-28,225,25043,1796,1,27065
849,2019-10-29,410,28322,1658,2,30392
849,2019-10-30,579,27965,1238,3,29785
849,2019-10-31,315,13904,2489,2,16710
849,2019-11-01,1134,13773,1673,0,16580
849,2019-11-02,532,14330,2176,1,17039
849,2019-11-03,590,21812,1101,0,23503
849,2019-11-04,1153,9025,1735,3,11916
849,2019-11-05,371,1819,1916,0,4106
849,2019-11-06,240,17002,1478,1,18721
849,2019-11-07,387,15705,1619,2,17713
849,2019-11-08,391,9142,971,1,10505
849,2019-11-09,272,7573,1519,2,9366
849,2019-11-10,222,22872,1160,0,24254
849,2019-11-11,281,14543,1657,0,16481
849,2019-11-12,255,16992,2894,0,20141
849,2019-11-13,1216,13843,1122,0,16181
849,2019-11-14,335,11382,2086,0,13803
849,2019-11-15,1156,3248,2937,0,7341
849,2019-11-16,1210,982,2849,0,5041
849,2019-11-17,499,2336,3432,0,6267
849,2019-11-18,271,1131,3454,0,4856
849,2019-11-19,358,4830,2180,0,7368
849,2019-11-20,317,773,2051,0,3141
849,2019-11-21,283,3122,1998,0,5403
849,2019-11-22,316,5276,1769,0,7361
849,2019-11-23,254,5648,2254,0,8156
849,2019-11-24,355,5093,1844,0,7292
849,2019-11-25,274,5313,1574,0,7161
849,2019-11-26,432,4158,1505,0,6095
849,2019-11-27,990,5738,2229,0,8957
849,2019-11-28,272,8214,448,0,8934
849,2019-11-29,0,802,0,0,802
849,2019-08-31,22,5,1,0,28
849,2019-09-01,84,8,0,0,92
849,2019-09-02,2,0,0,0,2
849,2019-09-03,41,2,865,0,908
849,2019-09-04,458,3303,1987,0,5748
849,2019-09-05,354,7155,2211,5,9725
849,2019-09-06,425,33886,2352,1,36664
849,2019-09-07,314,10110,1939,1,12364
849,2019-09-08,432,5706,2124,0,8262
849,2019-09-09,1164,6221,2298,0,9683
849,2019-09-10,250,9156,1987,0,11393
849,2019-09-11,405,6866,2027,2,9300
849,2019-09-12,204,9513,862,0,10579
849,2019-09-13,1217,5229,2430,1,8877
849,2019-09-14,284,5744,1348,0,7376
849,2019-09-15,236,8476,2249,2,10963
849,2019-09-16,255,5882,1923,3,8063
849,2019-09-17,256,7192,1280,0,8728
849,2019-09-18,636,11613,1395,0,13644
849,2019-09-19,497,2652,1569,0,4718
849,2019-09-20,389,9872,1781,3,12045
849,2019-09-21,297,6287,2340,0,8924
849,2019-09-22,268,9971,1834,1,12074
849,2019-09-23,371,8161,1547,0,10079
849,2019-09-24,366,7342,1484,3,9195
849,2019-09-25,163,6503,1727,6,8399
849,2019-09-26,152,7827,2204,1,10184
849,2019-09-27,234,7550,1187,1,8972
849,2019-09-28,133,14839,1587,3,16562
849,2019-09-29,1861,16456,1777,2,20096
849,2019-09-30,118,16578,2256,4,18956
849,2019-10-01,129,15670,1032,0,16831
849,2019-10-02,271,11661,2037,0,13969
849,2019-10-03,192,12905,2010,0,15107
849,2019-10-04,232,11142,1519,1,12894
849,2019-10-05,186,15320,1557,2,17065
849,2019-10-06,384,10388,1665,2,12439
849,2019-10-07,195,4376,1700,0,6271
849,2019-10-08,253,11390,1844,1,13488
849,2019-10-09,136,15030,2049,2,17217
849,2019-10-10,296,9118,2231,2,11647
849,2019-10-11,961,11046,1043,0,13050
849,2019-10-12,1109,3407,1520,43,6079
849,2019-10-13,260,7299,2098,1,9658
849,2019-10-14,1112,4835,2315,1,8263
849,2019-10-15,314,7722,1541,2,9579
849,2019-10-16,1354,12939,1401,1,15695
849,2019-10-17,264,4766,2013,1,7044
849,2019-10-18,423,7819,1704,1,9947
849,2019-10-19,309,4329,2274,0,6912
849,2019-10-20,1183,687,1550,2,3422
849,2019-10-21,1547,17100,1458,0,20105
849,2019-10-22,233,8333,1683,2,10251
849,2019-10-23,1108,6948,1839,0,9895
849,2019-10-24,1366,19781,1884,1,23032
849,2019-10-25,1828,14114,1334,1,17277
849,2019-10-26,239,12742,1285,0,14266
849,2019-10-27,1151,27376,1161,2,29690
849,2019-10-28,225,25043,1796,1,27065
849,2019-10-29,410,28322,1658,2,30392
849,2019-10-30,579,27965,1238,3,29785
849,2019-10-31,315,13904,2489,2,16710
849,2019-11-01,1134,13773,1673,0,16580
849,2019-11-02,532,14330,2176,1,17039
849,2019-11-03,590,21812,1101,0,23503
849,2019-11-04,1153,9025,1735,3,11916
849,2019-11-05,371,1819,1916,0,4106
849,2019-11-06,240,17002,1478,1,18721
849,2019-11-07,387,15705,1619,2,17713
849,2019-11-08,391,9142,971,1,10505
849,2019-11-09,272,7573,1519,2,9366
849,2019-11-10,222,22872,1160,0,24254
849,2019-11-11,281,14543,1657,0,16481
849,2019-11-12,255,16992,2894,0,20141
849,2019-11-13,1216,13843,1122,0,16181
849,2019-11-14,335,11382,2086,0,13803
849,2019-11-15,1156,3248,2937,0,7341
849,2019-11-16,1210,982,2849,0,5041
849,2019-11-17,499,2336,3432,0,6267
849,2019-11-18,271,1131,3454,0,4856
849,2019-11-19,358,4830,2180,0,7368
849,2019-11-20,317,773,2051,0,3141
849,2019-11-21,283,3122,1998,0,5403
849,2019-11-22,316,5276,1769,0,7361
849,2019-11-23,254,5648,2254,0,8156
849,2019-11-24,355,5093,1844,0,7292
849,2019-11-25,274,5313,1574,0,7161
849,2019-11-26,432,4158,1505,0,6095
849,2019-11-27,990,5738,2229,0,8957
849,2019-11-28,272,8214,448,0,8934
849,2019-09-05,354,7155,2211,5,9725
849,2019-09-06,425,33886,2352,1,36664
849,2019-09-07,314,10110,1939,1,12364
849,2019-09-08,432,5706,2124,0,8262
849,2019-09-09,1164,6221,2298,0,9683
849,2019-09-10,250,9156,1987,0,11393
849,2019-09-11,405,6866,2027,2,9300
849,2019-09-12,204,9513,862,0,10579
849,2019-09-13,1217,5229,2430,1,8877
849,2019-09-14,284,5744,1348,0,7376
849,2019-09-15,236,8476,2249,2,10963
849,2019-09-16,255,5882,1923,3,8063
849,2019-09-17,256,7192,1280,0,8728
849,2019-09-18,636,11613,1395,0,13644
849,2019-09-19,497,2652,1569,0,4718
849,2019-09-20,389,9872,1781,3,12045
849,2019-09-21,297,6287,2340,0,8924
849,2019-09-22,268,9971,1834,1,12074
849,2019-09-23,371,8161,1547,0,10079
849,2019-09-24,366,7342,1484,3,9195
849,2019-09-25,163,6503,1727,6,8399
849,2019-09-26,152,7827,2204,1,10184
849,2019-09-27,234,7550,1187,1,8972
849,2019-09-28,133,14839,1587,3,16562
849,2019-09-29,1861,16456,1777,2,20096
849,2019-09-30,118,16578,2256,4,18956
849,2019-10-01,129,15670,1032,0,16831
849,2019-10-02,271,11661,2037,0,13969
849,2019-10-03,192,12905,2010,0,15107
849,2019-10-04,232,11142,1519,1,12894
849,2019-10-05,186,15320,1557,2,17065
849,2019-10-06,384,10388,1665,2,12439
849,2019-10-07,195,4376,1700,0,6271
849,2019-10-08,253,11390,1844,1,13488
849,2019-10-09,136,15030,2049,2,17217
849,2019-10-10,296,9118,2231,2,11647
849,2019-10-11,961,11046,1043,0,13050
849,2019-10-12,1109,3407,1520,43,6079
849,2019-10-13,260,7299,2098,1,9658
849,2019-10-14,1112,4835,2315,1,8263
849,2019-10-15,314,7722,1541,2,9579
849,2019-10-16,1354,12939,1401,1,15695
849,2019-10-17,264,4766,2013,1,7044
849,2019-10-18,423,7819,1704,1,9947
849,2019-10-19,309,4329,2274,0,6912
849,2019-10-20,1183,687,1550,2,3422
849,2019-10-21,1547,17100,1458,0,20105
849,2019-10-22,233,8333,1683,2,10251
849,2019-10-23,1108,6948,1839,0,9895
849,2019-10-24,1366,19781,1884,1,23032
849,2019-10-25,1828,14114,1334,1,17277
849,2019-10-26,239,12742,1285,0,14266
849,2019-10-27,1151,27376,1161,2,29690
849,2019-10-28,225,25043,1796,1,27065
849,2019-10-29,410,28322,1658,2,30392
849,2019-10-30,579,27965,1238,3,29785
849,2019-10-31,315,13904,2489,2,16710
849,2019-11-01,1134,13773,1673,0,16580
849,2019-11-02,532,14330,2176,1,17039
849,2019-11-03,590,21812,1101,0,23503
849,2019-11-04,1153,9025,1735,3,11916
849,2019-11-05,371,1819,1916,0,4106
849,2019-11-06,240,17002,1478,1,18721
849,2019-11-07,387,15705,1619,2,17713
849,2019-11-08,391,9142,971,1,10505
849,2019-11-09,272,7573,1519,2,9366
850,2019-08-31,39,63,0,0,102
850,2019-09-01,47,42,0,1,90
850,2019-09-02,138,7,47,0,192
850,2019-09-03,369,8,1093,0,1470
850,2019-09-04,168,5131,1778,0,7077
850,2019-09-05,554,4802,1244,2,6602
850,2019-09-06,213,13023,2258,1,15495
850,2019-09-07,1186,12183,1027,0,14396
850,2019-09-08,286,4991,2193,0,7470
850,2019-09-09,1098,9390,2074,1,12563
850,2019-09-10,143,11526,1649,2,13320
850,2019-09-11,171,9289,2151,2,11613
850,2019-09-12,103,7030,2485,2,9620
850,2019-09-13,1779,6995,2172,3,10949
850,2019-09-14,76,10177,1700,1,11954
850,2019-09-15,95,7721,1892,2,9710
850,2019-09-16,973,7175,2504,6,10658
850,2019-09-17,994,9295,1915,8,12212
850,2019-09-18,124,11276,1149,9,12558
850,2019-09-19,1970,2883,1621,8,6482
850,2019-09-20,404,7145,1330,12,8891
850,2019-09-21,342,6061,2214,9,8626
850,2019-09-22,393,14284,1575,9,16261
850,2019-09-23,191,12413,1645,13,14262
850,2019-09-24,159,12804,2246,13,15222
850,2019-09-25,188,10717,1602,12,12519
850,2019-09-26,118,10676,1494,10,12298
850,2019-09-27,940,8509,1956,3,11408
850,2019-09-28,1705,24949,1598,3,28255
850,2019-09-29,113,18663,1862,2,20640
850,2019-09-30,85,26995,2595,2,29677
850,2019-10-01,2140,22350,2056,2,26548
850,2019-10-02,878,12125,2236,6,15245
850,2019-10-03,132,14606,1567,11,16316
850,2019-10-04,667,18324,896,11,19898
850,2019-10-05,160,18259,1580,10,20009
850,2019-10-06,952,11990,1471,11,14424
850,2019-10-07,243,7498,1577,13,9331
850,2019-10-08,1083,18250,1758,11,21102
850,2019-10-09,274,25413,1706,11,27404
850,2019-10-10,162,12359,1634,12,14167
850,2019-10-11,785,17850,1587,11,20233
850,2019-10-12,960,7065,2159,0,10184
850,2019-10-13,654,12064,2231,1,14950
850,2019-10-14,103,6297,2131,2,8533
850,2019-10-15,924,14371,1763,2,17060
850,2019-10-16,150,24301,1155,1,25607
850,2019-10-17,99,9356,2349,0,11804
850,2019-10-18,75,15253,1659,1,16988
850,2019-10-19,844,8852,2018,1,11715
850,2019-10-20,307,2844,1977,3,5131
850,2019-10-21,221,10671,1392,1,12285
850,2019-10-22,233,6673,1466,1,8373
850,2019-10-23,216,8525,1579,2,10322
850,2019-10-24,183,14489,2301,0,16973
850,2019-10-25,190,16082,1614,2,17888
850,2019-10-26,201,25046,1447,1,26695
850,2019-10-27,281,30912,1772,1,32966
850,2019-10-28,369,25790,1688,0,27847
850,2019-10-29,257,18958,1647,3,20865
850,2019-10-30,99,16375,1975,5,18454
850,2019-10-31,95,21595,1860,0,23550
850,2019-11-01,933,27635,1133,0,29701
850,2019-11-02,184,18071,1163,1,19419
850,2019-11-03,100,36772,1391,0,38263
850,2019-11-04,222,11623,1478,2,13325
850,2019-11-05,114,3467,2141,2,5724
850,2019-11-06,82,14310,1609,0,16001
850,2019-11-07,194,16608,1031,5,17838
850,2019-11-08,115,15842,880,0,16837
850,2019-11-09,282,16631,1557,1,18471
850,2019-11-10,1816,24191,2310,0,28317
850,2019-11-11,1028,16410,2952,1,20391
850,2019-11-12,852,18140,2043,1,21036
850,2019-11-13,148,12316,2199,1,14664
850,2019-11-14,1169,8446,1888,1,11504
850,2019-11-15,81,3853,2772,0,6706
850,2019-11-16,81,2697,2116,0,4894
850,2019-11-17,264,3758,2532,0,6554
850,2019-11-18,101,3494,3532,0,7127
850,2019-11-19,140,5326,3204,0,8670
850,2019-11-20,180,1404,1966,0,3550
850,2019-11-21,215,3935,2370,0,6520
850,2019-11-22,122,8341,1395,0,9858
850,2019-11-23,128,6783,1965,0,8876
850,2019-11-24,1232,8119,1580,0,10931
850,2019-11-25,87,6853,1472,0,8412
850,2019-11-26,74,7955,1496,0,9525
850,2019-11-27,91,6725,1023,0,7839
850,2019-11-28,1169,10404,360,0,11933
850,2019-11-29,18,0,0,0,18
850,2019-08-31,39,63,0,0,102
850,2019-09-01,47,42,0,1,90
850,2019-09-02,138,7,47,0,192
850,2019-09-03,369,8,1093,0,1470
850,2019-09-04,168,5131,1778,0,7077
850,2019-09-05,554,4802,1244,2,6602
850,2019-09-06,213,13023,2258,1,15495
850,2019-09-07,1186,12183,1027,0,14396
850,2019-09-08,286,4991,2193,0,7470
850,2019-09-09,1098,9390,2074,1,12563
850,2019-09-10,143,11526,1649,2,13320
850,2019-09-11,171,9289,2151,2,11613
850,2019-09-12,103,7030,2485,2,9620
850,2019-09-13,1779,6995,2172,3,10949
850,2019-09-14,76,10177,1700,1,11954
850,2019-09-15,95,7721,1892,2,9710
850,2019-09-16,973,7175,2504,6,10658
850,2019-09-17,994,9295,1915,8,12212
850,2019-09-18,124,11276,1149,9,12558
850,2019-09-19,1970,2883,1621,8,6482
850,2019-09-20,404,7145,1330,12,8891
850,2019-09-21,342,6061,2214,9,8626
850,2019-09-22,393,14284,1575,9,16261
850,2019-09-23,191,12413,1645,13,14262
850,2019-09-24,159,12804,2246,13,15222
850,2019-09-25,188,10717,1602,12,12519
850,2019-09-26,118,10676,1494,10,12298
850,2019-09-27,940,8509,1956,3,11408
850,2019-09-28,1705,24949,1598,3,28255
850,2019-09-29,113,18663,1862,2,20640
850,2019-09-30,85,26995,2595,2,29677
850,2019-10-01,2140,22350,2056,2,26548
850,2019-10-02,878,12125,2236,6,15245
850,2019-10-03,132,14606,1567,11,16316
850,2019-10-04,667,18324,896,11,19898
850,2019-10-05,160,18259,1580,10,20009
850,2019-10-06,952,11990,1471,11,14424
850,2019-10-07,243,7498,1577,13,9331
850,2019-10-08,1083,18250,1758,11,21102
850,2019-10-09,274,25413,1706,11,27404
850,2019-10-10,162,12359,1634,12,14167
850,2019-10-11,785,17850,1587,11,20233
850,2019-10-12,960,7065,2159,0,10184
850,2019-10-13,654,12064,2231,1,14950
850,2019-10-14,103,6297,2131,2,8533
850,2019-10-15,924,14371,1763,2,17060
850,2019-10-16,150,24301,1155,1,25607
850,2019-10-17,99,9356,2349,0,11804
850,2019-10-18,75,15253,1659,1,16988
850,2019-10-19,844,8852,2018,1,11715
850,2019-10-20,307,2844,1977,3,5131
850,2019-10-21,221,10671,1392,1,12285
850,2019-10-22,233,6673,1466,1,8373
850,2019-10-23,216,8525,1579,2,10322
850,2019-10-24,183,14489,2301,0,16973
850,2019-10-25,190,16082,1614,2,17888
850,2019-10-26,201,25046,1447,1,26695
850,2019-10-27,281,30912,1772,1,32966
850,2019-10-28,369,25790,1688,0,27847
850,2019-10-29,257,18958,1647,3,20865
850,2019-10-30,99,16375,1975,5,18454
850,2019-10-31,95,21595,1860,0,23550
850,2019-11-01,933,27635,1133,0,29701
850,2019-11-02,184,18071,1163,1,19419
850,2019-11-03,100,36772,1391,0,38263
850,2019-11-04,222,11623,1478,2,13325
850,2019-11-05,114,3467,2141,2,5724
850,2019-11-06,82,14310,1609,0,16001
850,2019-11-07,194,16608,1031,5,17838
850,2019-11-08,115,15842,880,0,16837
850,2019-11-09,282,16631,1557,1,18471
850,2019-11-10,1816,24191,2310,0,28317
850,2019-11-11,1028,16410,2952,1,20391
850,2019-11-12,852,18140,2043,1,21036
850,2019-11-13,148,12316,2199,1,14664
850,2019-11-14,1169,8446,1888,1,11504
850,2019-11-15,81,3853,2772,0,6706
850,2019-11-16,81,2697,2116,0,4894
850,2019-11-17,264,3758,2532,0,6554
850,2019-11-18,101,3494,3532,0,7127
850,2019-11-19,140,5326,3204,0,8670
850,2019-11-20,180,1404,1966,0,3550
850,2019-11-21,215,3935,2370,0,6520
850,2019-11-22,122,8341,1395,0,9858
850,2019-11-23,128,6783,1965,0,8876
850,2019-11-24,1232,8119,1580,0,10931
850,2019-11-25,87,6853,1472,0,8412
850,2019-11-26,74,7955,1496,0,9525
850,2019-11-27,91,6725,1023,0,7839
850,2019-11-28,1169,10404,360,0,11933
850,2019-09-02,138,7,47,0,192
850,2019-09-03,369,8,1093,0,1470
850,2019-09-04,168,5131,1778,0,7077
850,2019-09-05,554,4802,1244,2,6602
850,2019-09-06,213,13023,2258,1,15495
850,2019-09-07,1186,12183,1027,0,14396
850,2019-09-08,286,4991,2193,0,7470
850,2019-09-09,1098,9390,2074,1,12563
850,2019-09-10,143,11526,1649,2,13320
850,2019-09-11,171,9289,2151,2,11613
850,2019-09-12,103,7030,2485,2,9620
850,2019-09-13,1779,6995,2172,3,10949
850,2019-09-14,76,10177,1700,1,11954
850,2019-09-15,95,7721,1892,2,9710
850,2019-09-16,973,7175,2504,6,10658
850,2019-09-17,994,9295,1915,8,12212
850,2019-09-18,124,11276,1149,9,12558
850,2019-09-19,1970,2883,1621,8,6482
850,2019-09-20,404,7145,1330,12,8891
850,2019-09-21,342,6061,2214,9,8626
850,2019-09-22,393,14284,1575,9,16261
850,2019-09-23,191,12413,1645,13,14262
850,2019-09-24,159,12804,2246,13,15222
850,2019-09-25,188,10717,1602,12,12519
850,2019-09-26,118,10676,1494,10,12298
850,2019-09-27,940,8509,1956,3,11408
850,2019-09-28,1705,24949,1598,3,28255
850,2019-09-29,113,18663,1862,2,20640
850,2019-09-30,85,26995,2595,2,29677
850,2019-10-01,2140,22350,2056,2,26548
850,2019-10-02,878,12125,2236,6,15245
850,2019-10-03,132,14606,1567,11,16316
850,2019-10-04,667,18324,896,11,19898
850,2019-10-05,160,18259,1580,10,20009
850,2019-10-06,952,11990,1471,11,14424
850,2019-10-07,243,7498,1577,13,9331
850,2019-10-08,1083,18250,1758,11,21102
850,2019-10-09,274,25413,1706,11,27404
850,2019-10-10,162,12359,1634,12,14167
850,2019-10-11,785,17850,1587,11,20233
850,2019-10-12,960,7065,2159,0,10184
850,2019-10-13,654,12064,2231,1,14950
850,2019-10-14,103,6297,2131,2,8533
850,2019-10-15,924,14371,1763,2,17060
850,2019-10-16,150,24301,1155,1,25607
850,2019-10-17,99,9356,2349,0,11804
850,2019-10-18,75,15253,1659,1,16988
850,2019-10-19,844,8852,2018,1,11715
850,2019-10-20,307,2844,1977,3,5131
850,2019-10-21,221,10671,1392,1,12285
850,2019-10-22,233,6673,1466,1,8373
850,2019-10-23,216,8525,1579,2,10322
850,2019-10-24,183,14489,2301,0,16973
850,2019-10-25,190,16082,1614,2,17888
850,2019-10-26,201,25046,1447,1,26695
850,2019-10-27,281,30912,1772,1,32966
850,2019-10-28,369,25790,1688,0,27847
850,2019-10-29,257,18958,1647,3,20865
850,2019-10-30,99,16375,1975,5,18454
850,2019-10-31,95,21595,1860,0,23550
850,2019-11-01,933,27635,1133,0,29701
850,2019-11-02,184,18071,1163,1,19419
850,2019-11-03,100,36772,1391,0,38263
850,2019-11-04,222,11623,1478,2,13325
850,2019-11-05,114,3467,2141,2,5724
850,2019-11-06,82,14310,1609,0,16001
850,2019-11-07,194,16608,1031,5,17838
850,2019-11-08,115,15842,880,0,16837
850,2019-11-09,282,16631,1557,1,18471
850,2019-11-10,1816,24191,2310,0,28317
850,2019-11-11,1028,16410,2952,1,20391
850,2019-11-12,852,18140,2043,1,21036
850,2019-11-13,148,12316,2199,1,14664
850,2019-11-14,1169,8446,1888,1,11504
850,2019-11-15,81,3853,2772,0,6706
850,2019-11-16,81,2697,2116,0,4894
850,2019-11-17,264,3758,2532,0,6554
850,2019-11-18,101,3494,3532,0,7127
850,2019-11-19,140,5326,3204,0,8670
850,2019-11-20,180,1404,1966,0,3550
850,2019-11-21,215,3935,2370,0,6520
850,2019-11-22,122,8341,1395,0,9858
850,2019-11-23,128,6783,1965,0,8876
850,2019-11-24,1232,8119,1580,0,10931
850,2019-11-25,87,6853,1472,0,8412
850,2019-11-26,74,7955,1496,0,9525
850,2019-11-27,91,6725,1023,0,7839
850,2019-11-28,1169,10404,360,0,11933
850,2019-09-01,47,42,0,1,90
850,2019-09-02,138,7,47,0,192
850,2019-09-03,369,8,1093,0,1470
850,2019-09-04,168,5131,1778,0,7077
850,2019-09-05,554,4802,1244,2,6602
850,2019-09-06,213,13023,2258,1,15495
850,2019-09-07,1186,12183,1027,0,14396
850,2019-09-08,286,4991,2193,0,7470
850,2019-09-09,1098,9390,2074,1,12563
850,2019-09-10,143,11526,1649,2,13320
850,2019-09-11,171,9289,2151,2,11613
850,2019-09-12,103,7030,2485,2,9620
850,2019-09-13,1779,6995,2172,3,10949
850,2019-09-14,76,10177,1700,1,11954
850,2019-09-15,95,7721,1892,2,9710
850,2019-09-16,973,7175,2504,6,10658
850,2019-09-17,994,9295,1915,8,12212
850,2019-09-18,124,11276,1149,9,12558
850,2019-09-19,1970,2883,1621,8,6482
850,2019-09-20,404,7145,1330,12,8891
850,2019-09-21,342,6061,2214,9,8626
850,2019-09-22,393,14284,1575,9,16261
850,2019-09-23,191,12413,1645,13,14262
850,2019-09-24,159,12804,2246,13,15222
850,2019-09-25,188,10717,1602,12,12519
850,2019-09-26,118,10676,1494,10,12298
850,2019-09-27,940,8509,1956,3,11408
850,2019-09-28,1705,24949,1598,3,28255
850,2019-09-29,113,18663,1862,2,20640
850,2019-09-30,85,26995,2595,2,29677
850,2019-10-01,2140,22350,2056,2,26548
850,2019-10-02,878,12125,2236,6,15245
850,2019-10-03,132,14606,1567,11,16316
850,2019-10-04,667,18324,896,11,19898
850,2019-10-05,160,18259,1580,10,20009
850,2019-10-06,952,11990,1471,11,14424
850,2019-10-07,243,7498,1577,13,9331
850,2019-10-08,1083,18250,1758,11,21102
850,2019-10-09,274,25413,1706,11,27404
850,2019-10-10,162,12359,1634,12,14167
850,2019-10-11,785,17850,1587,11,20233
850,2019-10-12,960,7065,2159,0,10184
850,2019-10-13,654,12064,2231,1,14950
850,2019-10-14,103,6297,2131,2,8533
850,2019-10-15,924,14371,1763,2,17060
850,2019-10-16,150,24301,1155,1,25607
850,2019-10-17,99,9356,2349,0,11804
850,2019-10-18,75,15253,1659,1,16988
850,2019-10-19,844,8852,2018,1,11715
850,2019-10-20,307,2844,1977,3,5131
850,2019-10-21,221,10671,1392,1,12285
850,2019-10-22,233,6673,1466,1,8373
850,2019-10-23,216,8525,1579,2,10322
850,2019-10-24,183,14489,2301,0,16973
850,2019-10-25,190,16082,1614,2,17888
850,2019-10-26,201,25046,1447,1,26695
850,2019-10-27,281,30912,1772,1,32966
850,2019-10-28,369,25790,1688,0,27847
850,2019-10-29,257,18958,1647,3,20865
850,2019-10-30,99,16375,1975,5,18454
850,2019-10-31,95,21595,1860,0,23550
850,2019-11-01,933,27635,1133,0,29701
850,2019-11-02,184,18071,1163,1,19419
850,2019-11-03,100,36772,1391,0,38263
850,2019-11-04,222,11623,1478,2,13325
850,2019-11-05,114,3467,2141,2,5724
850,2019-11-06,82,14310,1609,0,16001
850,2019-11-07,194,16608,1031,5,17838
850,2019-11-08,115,15842,880,0,16837
850,2019-11-09,282,16631,1557,1,18471
850,2019-11-10,1816,24191,2310,0,28317
850,2019-11-11,1028,16410,2952,1,20391
850,2019-11-12,852,18140,2043,1,21036
850,2019-11-13,148,12316,2199,1,14664
850,2019-11-14,1169,8446,1888,1,11504
851,2019-08-31,9,14,1,0,24
851,2019-09-01,0,30,0,0,30
851,2019-09-02,0,0,0,0,0
851,2019-09-03,96,2,849,0,947
851,2019-09-04,1820,883,2251,1,4955
851,2019-09-05,137,8716,1959,1,10813
851,2019-09-06,946,17188,1186,2,19322
851,2019-09-07,75,10880,2934,1,13890
851,2019-09-08,322,7363,2064,0,9749
851,2019-09-09,297,5362,1671,2,7332
851,2019-09-10,899,12472,1544,0,14915
851,2019-09-11,604,9140,2045,3,11792
851,2019-09-12,915,7242,2266,4,10427
851,2019-09-13,1030,6051,1252,2,8335
851,2019-09-14,67,6385,1882,0,8334
851,2019-09-15,64,9267,1980,2,11313
851,2019-09-16,1755,8965,2588,0,13308
851,2019-09-17,58,10693,1568,1,12320
851,2019-09-18,64,12566,1807,1,14438
851,2019-09-19,259,2926,1749,1,4935
851,2019-09-20,1132,6781,2175,3,10091
851,2019-09-21,67,7220,2030,0,9317
851,2019-09-22,916,13476,1490,0,15882
851,2019-09-23,372,13105,1957,0,15434
851,2019-09-24,109,13154,1689,4,14956
851,2019-09-25,63,13097,1157,5,14322
851,2019-09-26,94,13857,2993,0,16944
851,2019-09-27,938,9684,1998,1,12621
851,2019-09-28,63,16110,1086,2,17261
851,2019-09-29,931,16934,1432,1,19298
851,2019-09-30,936,26749,2609,2,30296
851,2019-10-01,83,22326,1315,0,23724
851,2019-10-02,136,13152,2215,0,15503
851,2019-10-03,96,14241,1358,0,15695
851,2019-10-04,913,18455,2367,0,21735
851,2019-10-05,250,24960,1288,1,26499
851,2019-10-06,488,17346,2660,1,20495
851,2019-10-07,287,8102,2334,0,10723
851,2019-10-08,176,18782,1622,1,20581
851,2019-10-09,91,27251,1600,2,28944
851,2019-10-10,990,18468,1751,3,21212
851,2019-10-11,68,18197,2231,1,20497
851,2019-10-12,1308,9115,1830,0,12253
851,2019-10-13,59,8778,1712,2,10551
851,2019-10-14,76,11394,1273,2,12745
851,2019-10-15,151,22487,2033,3,24674
851,2019-10-16,623,23946,1605,1,26175
851,2019-10-17,932,8817,2020,0,11769
851,2019-10-18,200,9148,1726,0,11074
851,2019-10-19,61,5944,1933,0,7938
851,2019-10-20,70,2683,2179,2,4934
851,2019-10-21,91,18956,926,1,19974
851,2019-10-22,80,10641,1247,2,11970
851,2019-10-23,60,14392,1716,0,16168
851,2019-10-24,79,19610,1097,2,20788
851,2019-10-25,97,15969,2401,3,18470
851,2019-10-26,115,25092,1782,0,26989
851,2019-10-27,927,19064,1352,1,21344
851,2019-10-28,944,23984,854,1,25783
851,2019-10-29,164,17999,2104,0,20267
851,2019-10-30,60,17162,1598,3,18823
851,2019-10-31,56,21278,954,2,22290
851,2019-11-01,338,28158,1402,1,29899
851,2019-11-02,60,17856,1397,0,19313
851,2019-11-03,65,36880,1378,0,38323
851,2019-11-04,111,12385,2380,2,14878
851,2019-11-05,214,3780,1820,0,5814
851,2019-11-06,669,8891,1199,2,10761
851,2019-11-07,167,14151,890,2,15210
851,2019-11-08,88,9920,1133,0,11141
851,2019-11-09,200,9216,1144,3,10563
851,2019-11-10,625,14135,2252,0,17012
851,2019-11-11,95,10235,1130,2,11462
851,2019-11-12,464,11383,3418,1,15266
851,2019-11-13,64,19569,2163,1,21797
851,2019-11-14,86,10618,1545,2,12251
851,2019-11-15,88,3943,1398,1,5430
851,2019-11-16,966,3606,2270,0,6842
851,2019-11-17,170,4180,3661,0,8011
851,2019-11-18,86,3335,2437,1,5859
851,2019-11-19,1972,3396,2430,3,7801
851,2019-11-20,83,1324,2828,0,4235
851,2019-11-21,502,3632,1863,0,5997
851,2019-11-22,79,5628,1591,2,7300
851,2019-11-23,1440,6478,2029,0,9947
851,2019-11-24,276,7005,1633,0,8914
851,2019-11-25,606,10588,1719,0,12913
851,2019-11-26,91,9096,1454,0,10641
851,2019-11-27,50,6603,1954,0,8607
851,2019-11-28,56,12269,348,0,12673
851,2019-11-29,113,167,4,0,284
851,2019-08-31,9,14,1,0,24
851,2019-09-01,0,30,0,0,30
851,2019-09-02,0,0,0,0,0
851,2019-09-03,96,2,849,0,947
851,2019-09-04,1820,883,2251,1,4955
851,2019-09-05,137,8716,1959,1,10813
851,2019-09-06,946,17188,1186,2,19322
851,2019-09-07,75,10880,2934,1,13890
851,2019-09-08,322,7363,2064,0,9749
851,2019-09-09,297,5362,1671,2,7332
851,2019-09-10,899,12472,1544,0,14915
851,2019-09-11,604,9140,2045,3,11792
851,2019-09-12,915,7242,2266,4,10427
851,2019-09-13,1030,6051,1252,2,8335
851,2019-09-14,67,6385,1882,0,8334
851,2019-09-15,64,9267,1980,2,11313
851,2019-09-16,1755,8965,2588,0,13308
851,2019-09-17,58,10693,1568,1,12320
851,2019-09-18,64,12566,1807,1,14438
851,2019-09-19,259,2926,1749,1,4935
851,2019-09-20,1132,6781,2175,3,10091
851,2019-09-21,67,7220,2030,0,9317
851,2019-09-22,916,13476,1490,0,15882
851,2019-09-23,372,13105,1957,0,15434
851,2019-09-24,109,13154,1689,4,14956
851,2019-09-25,63,13097,1157,5,14322
851,2019-09-26,94,13857,2993,0,16944
851,2019-09-27,938,9684,1998,1,12621
851,2019-09-28,63,16110,1086,2,17261
851,2019-09-29,931,16934,1432,1,19298
851,2019-09-30,936,26749,2609,2,30296
851,2019-10-01,83,22326,1315,0,23724
851,2019-10-02,136,13152,2215,0,15503
851,2019-10-03,96,14241,1358,0,15695
851,2019-10-04,913,18455,2367,0,21735
851,2019-10-05,250,24960,1288,1,26499
851,2019-10-06,488,17346,2660,1,20495
851,2019-10-07,287,8102,2334,0,10723
851,2019-10-08,176,18782,1622,1,20581
851,2019-10-09,91,27251,1600,2,28944
851,2019-10-10,990,18468,1751,3,21212
851,2019-10-11,68,18197,2231,1,20497
851,2019-10-12,1308,9115,1830,0,12253
851,2019-10-13,59,8778,1712,2,10551
851,2019-10-14,76,11394,1273,2,12745
851,2019-10-15,151,22487,2033,3,24674
851,2019-10-16,623,23946,1605,1,26175
851,2019-10-17,932,8817,2020,0,11769
851,2019-10-18,200,9148,1726,0,11074
851,2019-10-19,61,5944,1933,0,7938
851,2019-10-20,70,2683,2179,2,4934
851,2019-10-21,91,18956,926,1,19974
851,2019-10-22,80,10641,1247,2,11970
851,2019-10-23,60,14392,1716,0,16168
851,2019-10-24,79,19610,1097,2,20788
851,2019-10-25,97,15969,2401,3,18470
851,2019-10-26,115,25092,1782,0,26989
851,2019-10-27,927,19064,1352,1,21344
851,2019-10-28,944,23984,854,1,25783
851,2019-10-29,164,17999,2104,0,20267
851,2019-10-30,60,17162,1598,3,18823
851,2019-10-31,56,21278,954,2,22290
851,2019-11-01,338,28158,1402,1,29899
851,2019-11-02,60,17856,1397,0,19313
851,2019-11-03,65,36880,1378,0,38323
851,2019-11-04,111,12385,2380,2,14878
851,2019-11-05,214,3780,1820,0,5814
851,2019-11-06,669,8891,1199,2,10761
851,2019-11-07,167,14151,890,2,15210
851,2019-11-08,88,9920,1133,0,11141
851,2019-11-09,200,9216,1144,3,10563
851,2019-11-10,625,14135,2252,0,17012
851,2019-11-11,95,10235,1130,2,11462
851,2019-11-12,464,11383,3418,1,15266
851,2019-11-13,64,19569,2163,1,21797
851,2019-11-14,86,10618,1545,2,12251
851,2019-11-15,88,3943,1398,1,5430
851,2019-11-16,966,3606,2270,0,6842
851,2019-11-17,170,4180,3661,0,8011
851,2019-11-18,86,3335,2437,1,5859
851,2019-11-19,1972,3396,2430,3,7801
851,2019-11-20,83,1324,2828,0,4235
851,2019-11-21,502,3632,1863,0,5997
851,2019-11-22,79,5628,1591,2,7300
851,2019-11-23,1440,6478,2029,0,9947
851,2019-11-24,276,7005,1633,0,8914
851,2019-11-25,606,10588,1719,0,12913
851,2019-11-26,91,9096,1454,0,10641
851,2019-11-27,50,6603,1954,0,8607
851,2019-11-28,56,12269,348,0,12673
851,2019-11-29,113,167,4,0,284
851,2019-08-31,9,14,1,0,24
851,2019-09-01,0,30,0,0,30
851,2019-09-02,0,0,0,0,0
851,2019-09-03,96,2,849,0,947
851,2019-09-04,1820,883,2251,1,4955
851,2019-09-05,137,8716,1959,1,10813
851,2019-09-06,946,17188,1186,2,19322
851,2019-09-07,75,10880,2934,1,13890
851,2019-09-08,322,7363,2064,0,9749
851,2019-09-09,297,5362,1671,2,7332
851,2019-09-10,899,12472,1544,0,14915
851,2019-09-11,604,9140,2045,3,11792
851,2019-09-12,915,7242,2266,4,10427
851,2019-09-13,1030,6051,1252,2,8335
851,2019-09-14,67,6385,1882,0,8334
851,2019-09-15,64,9267,1980,2,11313
851,2019-09-16,1755,8965,2588,0,13308
851,2019-09-17,58,10693,1568,1,12320
851,2019-09-18,64,12566,1807,1,14438
851,2019-09-19,259,2926,1749,1,4935
851,2019-09-20,1132,6781,2175,3,10091
851,2019-09-21,67,7220,2030,0,9317
851,2019-09-22,916,13476,1490,0,15882
851,2019-09-23,372,13105,1957,0,15434
851,2019-09-24,109,13154,1689,4,14956
851,2019-09-25,63,13097,1157,5,14322
851,2019-09-26,94,13857,2993,0,16944
851,2019-09-27,938,9684,1998,1,12621
851,2019-09-28,63,16110,1086,2,17261
851,2019-09-29,931,16934,1432,1,19298
851,2019-09-30,936,26749,2609,2,30296
851,2019-10-01,83,22326,1315,0,23724
851,2019-10-02,136,13152,2215,0,15503
851,2019-10-03,96,14241,1358,0,15695
851,2019-10-04,913,18455,2367,0,21735
851,2019-10-05,250,24960,1288,1,26499
851,2019-10-06,488,17346,2660,1,20495
851,2019-10-07,287,8102,2334,0,10723
851,2019-10-08,176,18782,1622,1,20581
851,2019-10-09,91,27251,1600,2,28944
851,2019-10-10,990,18468,1751,3,21212
851,2019-10-11,68,18197,2231,1,20497
851,2019-10-12,1308,9115,1830,0,12253
851,2019-10-13,59,8778,1712,2,10551
851,2019-10-14,76,11394,1273,2,12745
851,2019-10-15,151,22487,2033,3,24674
851,2019-10-16,623,23946,1605,1,26175
851,2019-10-17,932,8817,2020,0,11769
851,2019-10-18,200,9148,1726,0,11074
851,2019-10-19,61,5944,1933,0,7938
851,2019-10-20,70,2683,2179,2,4934
851,2019-10-21,91,18956,926,1,19974
851,2019-10-22,80,10641,1247,2,11970
851,2019-10-23,60,14392,1716,0,16168
851,2019-10-24,79,19610,1097,2,20788
851,2019-10-25,97,15969,2401,3,18470
851,2019-10-26,115,25092,1782,0,26989
851,2019-10-27,927,19064,1352,1,21344
851,2019-10-28,944,23984,854,1,25783
851,2019-10-29,164,17999,2104,0,20267
851,2019-10-30,60,17162,1598,3,18823
851,2019-10-31,56,21278,954,2,22290
851,2019-11-01,338,28158,1402,1,29899
851,2019-11-02,60,17856,1397,0,19313
851,2019-11-03,65,36880,1378,0,38323
851,2019-11-04,111,12385,2380,2,14878
851,2019-11-05,214,3780,1820,0,5814
851,2019-11-06,669,8891,1199,2,10761
851,2019-11-07,167,14151,890,2,15210
851,2019-11-08,88,9920,1133,0,11141
851,2019-11-09,200,9216,1144,3,10563
851,2019-11-10,625,14135,2252,0,17012
851,2019-11-11,95,10235,1130,2,11462
851,2019-11-12,464,11383,3418,1,15266
851,2019-11-13,64,19569,2163,1,21797
851,2019-11-14,86,10618,1545,2,12251
851,2019-11-15,88,3943,1398,1,5430
851,2019-11-16,966,3606,2270,0,6842
851,2019-11-17,170,4180,3661,0,8011
851,2019-11-18,86,3335,2437,1,5859
851,2019-11-19,1972,3396,2430,3,7801
851,2019-11-20,83,1324,2828,0,4235
851,2019-11-21,502,3632,1863,0,5997
851,2019-11-22,79,5628,1591,2,7300
851,2019-11-23,1440,6478,2029,0,9947
851,2019-11-24,276,7005,1633,0,8914
851,2019-11-25,606,10588,1719,0,12913
851,2019-11-26,91,9096,1454,0,10641
851,2019-11-27,50,6603,1954,0,8607
851,2019-11-28,56,12269,348,0,12673
851,2019-11-29,113,167,4,0,284
851,2019-09-04,1820,883,2251,1,4955
851,2019-09-05,137,8716,1959,1,10813
851,2019-09-06,946,17188,1186,2,19322
851,2019-09-07,75,10880,2934,1,13890
851,2019-09-08,322,7363,2064,0,9749
851,2019-09-09,297,5362,1671,2,7332
851,2019-09-10,899,12472,1544,0,14915
851,2019-09-11,604,9140,2045,3,11792
851,2019-09-12,915,7242,2266,4,10427
851,2019-09-13,1030,6051,1252,2,8335
851,2019-09-14,67,6385,1882,0,8334
851,2019-09-15,64,9267,1980,2,11313
851,2019-09-16,1755,8965,2588,0,13308
851,2019-09-17,58,10693,1568,1,12320
851,2019-09-18,64,12566,1807,1,14438
851,2019-09-19,259,2926,1749,1,4935
851,2019-09-20,1132,6781,2175,3,10091
851,2019-09-21,67,7220,2030,0,9317
851,2019-09-22,916,13476,1490,0,15882
851,2019-09-23,372,13105,1957,0,15434
851,2019-09-24,109,13154,1689,4,14956
851,2019-09-25,63,13097,1157,5,14322
851,2019-09-26,94,13857,2993,0,16944
851,2019-09-27,938,9684,1998,1,12621
851,2019-09-28,63,16110,1086,2,17261
851,2019-09-29,931,16934,1432,1,19298
851,2019-09-30,936,26749,2609,2,30296
851,2019-10-01,83,22326,1315,0,23724
851,2019-10-02,136,13152,2215,0,15503
851,2019-10-03,96,14241,1358,0,15695
851,2019-10-04,913,18455,2367,0,21735
851,2019-10-05,250,24960,1288,1,26499
851,2019-10-06,488,17346,2660,1,20495
851,2019-10-07,287,8102,2334,0,10723
851,2019-10-08,176,18782,1622,1,20581
851,2019-10-09,91,27251,1600,2,28944
851,2019-10-10,990,18468,1751,3,21212
851,2019-10-11,68,18197,2231,1,20497
851,2019-10-12,1308,9115,1830,0,12253
851,2019-10-13,59,8778,1712,2,10551
851,2019-10-14,76,11394,1273,2,12745
851,2019-10-15,151,22487,2033,3,24674
851,2019-10-16,623,23946,1605,1,26175
851,2019-10-17,932,8817,2020,0,11769
851,2019-10-18,200,9148,1726,0,11074
851,2019-10-19,61,5944,1933,0,7938
851,2019-10-20,70,2683,2179,2,4934
851,2019-10-21,91,18956,926,1,19974
851,2019-10-22,80,10641,1247,2,11970
851,2019-10-23,60,14392,1716,0,16168
851,2019-10-24,79,19610,1097,2,20788
851,2019-10-25,97,15969,2401,3,18470
851,2019-10-26,115,25092,1782,0,26989
851,2019-10-27,927,19064,1352,1,21344
851,2019-10-28,944,23984,854,1,25783
851,2019-10-29,164,17999,2104,0,20267
851,2019-10-30,60,17162,1598,3,18823
851,2019-10-31,56,21278,954,2,22290
851,2019-11-01,338,28158,1402,1,29899
851,2019-11-02,60,17856,1397,0,19313
851,2019-11-03,65,36880,1378,0,38323
851,2019-11-04,111,12385,2380,2,14878
851,2019-11-05,214,3780,1820,0,5814
851,2019-11-06,669,8891,1199,2,10761
851,2019-11-07,167,14151,890,2,15210
851,2019-11-08,88,9920,1133,0,11141
851,2019-11-09,200,9216,1144,3,10563
851,2019-11-10,625,14135,2252,0,17012
851,2019-11-11,95,10235,1130,2,11462
851,2019-11-12,464,11383,3418,1,15266
851,2019-11-13,64,19569,2163,1,21797
851,2019-11-14,86,10618,1545,2,12251
851,2019-11-15,88,3943,1398,1,5430
851,2019-11-16,966,3606,2270,0,6842
851,2019-11-17,170,4180,3661,0,8011
851,2019-11-18,86,3335,2437,1,5859
851,2019-11-19,1972,3396,2430,3,7801
851,2019-11-20,83,1324,2828,0,4235
851,2019-11-21,502,3632,1863,0,5997
851,2019-11-22,79,5628,1591,2,7300
852,2019-08-31,10,9,0,0,19
852,2019-09-01,0,26,0,0,26
852,2019-09-02,0,0,0,0,0
852,2019-09-03,179,0,758,1,938
852,2019-09-04,1016,1277,1382,1,3676
852,2019-09-05,290,5433,2286,1,8010
852,2019-09-06,428,13680,1906,0,16014
852,2019-09-07,456,10854,1671,1,12982
852,2019-09-08,592,4571,2305,0,7468
852,2019-09-09,1596,8620,900,1,11117
852,2019-09-10,200,10680,1898,1,12779
852,2019-09-11,1174,8334,2740,1,12249
852,2019-09-12,333,6187,1633,2,8155
852,2019-09-13,489,6921,1361,0,8771
852,2019-09-14,1137,6582,1804,2,9525
852,2019-09-15,277,9074,1831,3,11185
852,2019-09-16,370,8265,2930,0,11565
852,2019-09-17,335,7047,1780,2,9164
852,2019-09-18,978,28515,1044,0,30537
852,2019-09-19,555,8175,1817,1,10548
852,2019-09-20,391,7246,1441,0,9078
852,2019-09-21,327,7741,2201,0,10269
852,2019-09-22,1054,9010,1111,0,11175
852,2019-09-23,1222,11015,1893,5,14135
852,2019-09-24,438,8929,1922,1,11290
852,2019-09-25,1117,11112,1999,3,14231
852,2019-09-26,184,9055,1759,1,10999
852,2019-09-27,209,8586,1477,3,10275
852,2019-09-28,140,15971,1599,3,17713
852,2019-09-29,170,17499,1480,1,19150
852,2019-09-30,160,18248,1584,0,19992
852,2019-10-01,1035,17136,1613,0,19784
852,2019-10-02,163,12991,1263,0,14417
852,2019-10-03,162,14448,1894,0,16504
852,2019-10-04,282,12818,1254,0,14354
852,2019-10-05,332,14193,1997,1,16523
852,2019-10-06,547,11741,2232,1,14521
852,2019-10-07,1093,7356,1848,0,10297
852,2019-10-08,1239,13026,2263,6,16534
852,2019-10-09,255,15474,2023,1,17753
852,2019-10-10,2135,11293,1697,0,15125
852,2019-10-11,470,12404,1208,1,14083
852,2019-10-12,303,7763,2190,1,10257
852,2019-10-13,281,8743,1855,3,10882
852,2019-10-14,2186,6736,1341,1,10264
852,2019-10-15,312,8998,1443,1,10754
852,2019-10-16,668,19017,731,1,20417
852,2019-10-17,261,9074,1549,3,10887
852,2019-10-18,405,9051,1215,2,10673
852,2019-10-19,1232,5942,1789,0,8963
852,2019-10-20,1273,2907,1884,0,6064
852,2019-10-21,398,10620,2002,3,13023
852,2019-10-22,301,6690,1710,3,8704
852,2019-10-23,1189,15867,1475,4,18535
852,2019-10-24,377,25625,1867,1,27870
852,2019-10-25,365,19761,1565,1,21692
852,2019-10-26,248,16835,2554,0,19637
852,2019-10-27,347,27341,2459,0,30147
852,2019-10-28,888,25009,1992,0,27889
852,2019-10-29,399,18076,954,0,19429
852,2019-10-30,541,15666,1196,0,17403
852,2019-10-31,2032,20822,1631,0,24485
852,2019-11-01,356,27280,1257,0,28893
852,2019-11-02,734,26554,1189,2,28479
852,2019-11-03,252,53328,1320,0,54900
852,2019-11-04,299,14093,2000,1,16393
852,2019-11-05,322,3162,2889,0,6373
852,2019-11-06,754,14054,1834,1,16643
852,2019-11-07,606,16563,1421,5,18595
852,2019-11-08,361,9819,1084,63,11327
852,2019-11-09,625,8976,1347,1,10949
852,2019-11-10,1279,25218,1406,0,27903
852,2019-11-11,455,16849,1791,2,19097
852,2019-11-12,287,18628,2878,0,21793
852,2019-11-13,1246,13836,1997,0,17079
852,2019-11-14,358,13456,2275,0,16089
852,2019-11-15,315,5357,2147,0,7819
852,2019-11-16,310,2650,2317,0,5277
852,2019-11-17,565,4130,3603,0,8298
852,2019-11-18,360,2613,3139,0,6112
852,2019-11-19,1268,3115,2200,0,6583
852,2019-11-20,312,1580,2138,0,4030
852,2019-11-21,352,5404,2538,0,8294
852,2019-11-22,326,5805,2306,0,8437
852,2019-11-23,328,6328,2139,0,8795
852,2019-11-24,1380,7174,1949,1,10504
852,2019-11-25,277,6643,1165,0,8085
852,2019-11-26,306,5721,1521,0,7548
852,2019-11-27,1320,6674,1620,2,9616
852,2019-11-28,145,8537,728,1,9411
852,2019-11-29,92,576,60,0,728
852,2019-08-31,10,9,0,0,19
852,2019-09-01,0,26,0,0,26
852,2019-09-02,0,0,0,0,0
852,2019-09-03,179,0,758,1,938
852,2019-09-04,1016,1277,1382,1,3676
852,2019-09-05,290,5433,2286,1,8010
852,2019-09-06,428,13680,1906,0,16014
852,2019-09-07,456,10854,1671,1,12982
852,2019-09-08,592,4571,2305,0,7468
852,2019-09-09,1596,8620,900,1,11117
852,2019-09-10,200,10680,1898,1,12779
852,2019-09-11,1174,8334,2740,1,12249
852,2019-09-12,333,6187,1633,2,8155
852,2019-09-13,489,6921,1361,0,8771
852,2019-09-14,1137,6582,1804,2,9525
852,2019-09-15,277,9074,1831,3,11185
852,2019-09-16,370,8265,2930,0,11565
852,2019-09-17,335,7047,1780,2,9164
852,2019-09-18,978,28515,1044,0,30537
852,2019-09-19,555,8175,1817,1,10548
852,2019-09-20,391,7246,1441,0,9078
852,2019-09-21,327,7741,2201,0,10269
852,2019-09-22,1054,9010,1111,0,11175
852,2019-09-23,1222,11015,1893,5,14135
852,2019-09-24,438,8929,1922,1,11290
852,2019-09-25,1117,11112,1999,3,14231
852,2019-09-26,184,9055,1759,1,10999
852,2019-09-27,209,8586,1477,3,10275
852,2019-09-28,140,15971,1599,3,17713
852,2019-09-29,170,17499,1480,1,19150
852,2019-09-30,160,18248,1584,0,19992
852,2019-10-01,1035,17136,1613,0,19784
852,2019-10-02,163,12991,1263,0,14417
852,2019-10-03,162,14448,1894,0,16504
852,2019-10-04,282,12818,1254,0,14354
852,2019-10-05,332,14193,1997,1,16523
852,2019-10-06,547,11741,2232,1,14521
852,2019-10-07,1093,7356,1848,0,10297
852,2019-10-08,1239,13026,2263,6,16534
852,2019-10-09,255,15474,2023,1,17753
852,2019-10-10,2135,11293,1697,0,15125
852,2019-10-11,470,12404,1208,1,14083
852,2019-10-12,303,7763,2190,1,10257
852,2019-10-13,281,8743,1855,3,10882
852,2019-10-14,2186,6736,1341,1,10264
852,2019-10-15,312,8998,1443,1,10754
852,2019-10-16,668,19017,731,1,20417
852,2019-10-17,261,9074,1549,3,10887
852,2019-10-18,405,9051,1215,2,10673
852,2019-10-19,1232,5942,1789,0,8963
852,2019-10-20,1273,2907,1884,0,6064
852,2019-10-21,398,10620,2002,3,13023
852,2019-10-22,301,6690,1710,3,8704
852,2019-10-23,1189,15867,1475,4,18535
852,2019-10-24,377,25625,1867,1,27870
852,2019-10-25,365,19761,1565,1,21692
852,2019-10-26,248,16835,2554,0,19637
852,2019-10-27,347,27341,2459,0,30147
852,2019-10-28,888,25009,1992,0,27889
852,2019-10-29,399,18076,954,0,19429
852,2019-10-30,541,15666,1196,0,17403
852,2019-10-31,2032,20822,1631,0,24485
852,2019-11-01,356,27280,1257,0,28893
852,2019-11-02,734,26554,1189,2,28479
852,2019-11-03,252,53328,1320,0,54900
852,2019-11-04,299,14093,2000,1,16393
852,2019-11-05,322,3162,2889,0,6373
852,2019-11-06,754,14054,1834,1,16643
852,2019-11-07,606,16563,1421,5,18595
852,2019-11-08,361,9819,1084,63,11327
852,2019-11-09,625,8976,1347,1,10949
852,2019-11-10,1279,25218,1406,0,27903
852,2019-11-11,455,16849,1791,2,19097
852,2019-11-12,287,18628,2878,0,21793
852,2019-11-13,1246,13836,1997,0,17079
852,2019-11-14,358,13456,2275,0,16089
852,2019-11-15,315,5357,2147,0,7819
852,2019-11-16,310,2650,2317,0,5277
852,2019-11-17,565,4130,3603,0,8298
852,2019-11-18,360,2613,3139,0,6112
852,2019-11-19,1268,3115,2200,0,6583
852,2019-11-20,312,1580,2138,0,4030
852,2019-11-21,352,5404,2538,0,8294
852,2019-11-22,326,5805,2306,0,8437
852,2019-11-23,328,6328,2139,0,8795
852,2019-11-24,1380,7174,1949,1,10504
852,2019-11-25,277,6643,1165,0,8085
852,2019-11-26,306,5721,1521,0,7548
852,2019-11-27,1320,6674,1620,2,9616
852,2019-11-28,145,8537,728,1,9411
852,2019-11-29,92,576,60,0,728
852,2019-09-03,179,0,758,1,938
852,2019-09-04,1016,1277,1382,1,3676
852,2019-09-05,290,5433,2286,1,8010
852,2019-09-06,428,13680,1906,0,16014
852,2019-09-07,456,10854,1671,1,12982
852,2019-09-08,592,4571,2305,0,7468
852,2019-09-09,1596,8620,900,1,11117
852,2019-09-10,200,10680,1898,1,12779
852,2019-09-11,1174,8334,2740,1,12249
852,2019-09-12,333,6187,1633,2,8155
852,2019-09-13,489,6921,1361,0,8771
852,2019-09-14,1137,6582,1804,2,9525
852,2019-09-15,277,9074,1831,3,11185
852,2019-09-16,370,8265,2930,0,11565
852,2019-09-17,335,7047,1780,2,9164
852,2019-09-18,978,28515,1044,0,30537
852,2019-09-19,555,8175,1817,1,10548
852,2019-09-20,391,7246,1441,0,9078
852,2019-09-21,327,7741,2201,0,10269
852,2019-09-22,1054,9010,1111,0,11175
852,2019-09-23,1222,11015,1893,5,14135
852,2019-09-24,438,8929,1922,1,11290
852,2019-09-25,1117,11112,1999,3,14231
852,2019-09-26,184,9055,1759,1,10999
852,2019-09-27,209,8586,1477,3,10275
852,2019-09-28,140,15971,1599,3,17713
852,2019-09-29,170,17499,1480,1,19150
852,2019-09-30,160,18248,1584,0,19992
852,2019-10-01,1035,17136,1613,0,19784
852,2019-10-02,163,12991,1263,0,14417
852,2019-10-03,162,14448,1894,0,16504
852,2019-10-04,282,12818,1254,0,14354
852,2019-10-05,332,14193,1997,1,16523
852,2019-10-06,547,11741,2232,1,14521
852,2019-10-07,1093,7356,1848,0,10297
852,2019-10-08,1239,13026,2263,6,16534
852,2019-10-09,255,15474,2023,1,17753
852,2019-10-10,2135,11293,1697,0,15125
852,2019-10-11,470,12404,1208,1,14083
852,2019-10-12,303,7763,2190,1,10257
852,2019-10-13,281,8743,1855,3,10882
852,2019-10-14,2186,6736,1341,1,10264
852,2019-10-15,312,8998,1443,1,10754
852,2019-10-16,668,19017,731,1,20417
852,2019-10-17,261,9074,1549,3,10887
852,2019-10-18,405,9051,1215,2,10673
852,2019-10-19,1232,5942,1789,0,8963
852,2019-10-20,1273,2907,1884,0,6064
852,2019-10-21,398,10620,2002,3,13023
852,2019-10-22,301,6690,1710,3,8704
852,2019-10-23,1189,15867,1475,4,18535
852,2019-10-24,377,25625,1867,1,27870
852,2019-10-25,365,19761,1565,1,21692
852,2019-10-26,248,16835,2554,0,19637
852,2019-10-27,347,27341,2459,0,30147
852,2019-10-28,888,25009,1992,0,27889
852,2019-10-29,399,18076,954,0,19429
852,2019-10-30,541,15666,1196,0,17403
852,2019-10-31,2032,20822,1631,0,24485
852,2019-11-01,356,27280,1257,0,28893
852,2019-11-02,734,26554,1189,2,28479
852,2019-11-03,252,53328,1320,0,54900
852,2019-11-04,299,14093,2000,1,16393
852,2019-11-05,322,3162,2889,0,6373
852,2019-11-06,754,14054,1834,1,16643
852,2019-11-07,606,16563,1421,5,18595
852,2019-11-08,361,9819,1084,63,11327
852,2019-11-09,625,8976,1347,1,10949
852,2019-11-10,1279,25218,1406,0,27903
852,2019-11-11,455,16849,1791,2,19097
852,2019-11-12,287,18628,2878,0,21793
852,2019-11-13,1246,13836,1997,0,17079
852,2019-11-14,358,13456,2275,0,16089
852,2019-11-15,315,5357,2147,0,7819
852,2019-11-16,310,2650,2317,0,5277
852,2019-11-17,565,4130,3603,0,8298
852,2019-11-18,360,2613,3139,0,6112
852,2019-11-19,1268,3115,2200,0,6583
852,2019-11-20,312,1580,2138,0,4030
852,2019-11-21,352,5404,2538,0,8294
852,2019-11-22,326,5805,2306,0,8437
852,2019-11-23,328,6328,2139,0,8795
852,2019-11-24,1380,7174,1949,1,10504
852,2019-11-25,277,6643,1165,0,8085
852,2019-11-26,306,5721,1521,0,7548
852,2019-11-27,1320,6674,1620,2,9616
852,2019-11-28,145,8537,728,1,9411
852,2019-11-29,92,576,60,0,728
852,2019-09-03,179,0,758,1,938
852,2019-09-04,1016,1277,1382,1,3676
852,2019-09-05,290,5433,2286,1,8010
852,2019-09-06,428,13680,1906,0,16014
852,2019-09-07,456,10854,1671,1,12982
852,2019-09-08,592,4571,2305,0,7468
852,2019-09-09,1596,8620,900,1,11117
852,2019-09-10,200,10680,1898,1,12779
852,2019-09-11,1174,8334,2740,1,12249
852,2019-09-12,333,6187,1633,2,8155
852,2019-09-13,489,6921,1361,0,8771
852,2019-09-14,1137,6582,1804,2,9525
852,2019-09-15,277,9074,1831,3,11185
852,2019-09-16,370,8265,2930,0,11565
852,2019-09-17,335,7047,1780,2,9164
852,2019-09-18,978,28515,1044,0,30537
852,2019-09-19,555,8175,1817,1,10548
852,2019-09-20,391,7246,1441,0,9078
852,2019-09-21,327,7741,2201,0,10269
852,2019-09-22,1054,9010,1111,0,11175
852,2019-09-23,1222,11015,1893,5,14135
852,2019-09-24,438,8929,1922,1,11290
852,2019-09-25,1117,11112,1999,3,14231
852,2019-09-26,184,9055,1759,1,10999
852,2019-09-27,209,8586,1477,3,10275
852,2019-09-28,140,15971,1599,3,17713
852,2019-09-29,170,17499,1480,1,19150
852,2019-09-30,160,18248,1584,0,19992
852,2019-10-01,1035,17136,1613,0,19784
852,2019-10-02,163,12991,1263,0,14417
852,2019-10-03,162,14448,1894,0,16504
852,2019-10-04,282,12818,1254,0,14354
852,2019-10-05,332,14193,1997,1,16523
852,2019-10-06,547,11741,2232,1,14521
852,2019-10-07,1093,7356,1848,0,10297
852,2019-10-08,1239,13026,2263,6,16534
852,2019-10-09,255,15474,2023,1,17753
852,2019-10-10,2135,11293,1697,0,15125
852,2019-10-11,470,12404,1208,1,14083
852,2019-10-12,303,7763,2190,1,10257
852,2019-10-13,281,8743,1855,3,10882
852,2019-10-14,2186,6736,1341,1,10264
852,2019-10-15,312,8998,1443,1,10754
852,2019-10-16,668,19017,731,1,20417
852,2019-10-17,261,9074,1549,3,10887
852,2019-10-18,405,9051,1215,2,10673
852,2019-10-19,1232,5942,1789,0,8963
852,2019-10-20,1273,2907,1884,0,6064
852,2019-10-21,398,10620,2002,3,13023
852,2019-10-22,301,6690,1710,3,8704
852,2019-10-23,1189,15867,1475,4,18535
852,2019-10-24,377,25625,1867,1,27870
852,2019-10-25,365,19761,1565,1,21692
852,2019-10-26,248,16835,2554,0,19637
852,2019-10-27,347,27341,2459,0,30147
852,2019-10-28,888,25009,1992,0,27889
852,2019-10-29,399,18076,954,0,19429
852,2019-10-30,541,15666,1196,0,17403
852,2019-10-31,2032,20822,1631,0,24485
852,2019-11-01,356,27280,1257,0,28893
852,2019-11-02,734,26554,1189,2,28479
852,2019-11-03,252,53328,1320,0,54900
852,2019-11-04,299,14093,2000,1,16393
852,2019-11-05,322,3162,2889,0,6373
852,2019-11-06,754,14054,1834,1,16643
852,2019-11-07,606,16563,1421,5,18595
852,2019-11-08,361,9819,1084,63,11327
852,2019-11-09,625,8976,1347,1,10949
852,2019-11-10,1279,25218,1406,0,27903
852,2019-11-11,455,16849,1791,2,19097
852,2019-11-12,287,18628,2878,0,21793
852,2019-11-13,1246,13836,1997,0,17079
852,2019-11-14,358,13456,2275,0,16089
852,2019-11-15,315,5357,2147,0,7819
852,2019-11-16,310,2650,2317,0,5277
852,2019-11-17,565,4130,3603,0,8298
852,2019-11-18,360,2613,3139,0,6112
852,2019-11-19,1268,3115,2200,0,6583
852,2019-11-20,312,1580,2138,0,4030
852,2019-11-21,352,5404,2538,0,8294
852,2019-11-22,326,5805,2306,0,8437
852,2019-11-23,328,6328,2139,0,8795
852,2019-11-24,1380,7174,1949,1,10504
852,2019-11-25,277,6643,1165,0,8085
852,2019-11-26,306,5721,1521,0,7548
852,2019-11-27,1320,6674,1620,2,9616
852,2019-11-28,145,8537,728,1,9411
853,2019-08-31,14,4,2,0,20
853,2019-09-01,0,0,0,0,0
853,2019-09-02,0,0,0,0,0
853,2019-09-03,0,0,1605,0,1605
853,2019-09-04,0,3872,1858,1,5731
853,2019-09-05,0,4843,1659,0,6502
853,2019-09-06,351,12535,1896,0,14782
853,2019-09-07,255,8088,2407,1,10751
853,2019-09-08,1737,5349,1883,0,8969
853,2019-09-09,2193,6737,2198,1,11129
853,2019-09-10,118,7140,2545,3,9806
853,2019-09-11,272,6640,2161,1,9074
853,2019-09-12,400,7296,3135,0,10831
853,2019-09-13,1821,5517,2298,1,9637
853,2019-09-14,957,5393,1441,0,7791
853,2019-09-15,158,9284,1825,2,11269
853,2019-09-16,108,7111,1823,1,9043
853,2019-09-17,103,7865,1980,0,9948
853,2019-09-18,105,10880,1309,1,12295
853,2019-09-19,1197,2388,2340,0,5925
853,2019-09-20,207,7183,1532,1,8923
853,2019-09-21,99,6895,2602,1,9597
853,2019-09-22,938,9235,2037,0,12210
853,2019-09-23,228,8935,2010,1,11174
853,2019-09-24,1087,8753,1624,1,11465
853,2019-09-25,129,8107,1728,2,9966
853,2019-09-26,1321,9556,1106,0,11983
853,2019-09-27,109,8600,1660,3,10372
853,2019-09-28,120,15477,1554,0,17151
853,2019-09-29,78,16454,2083,1,18616
853,2019-09-30,113,27112,1840,4,29069
853,2019-10-01,960,22662,1228,0,24850
853,2019-10-02,1003,13538,2167,0,16708
853,2019-10-03,621,14460,1627,0,16708
853,2019-10-04,103,12396,1833,1,14333
853,2019-10-05,99,14521,2576,2,17198
853,2019-10-06,1851,11864,1020,1,14736
853,2019-10-07,1178,6733,1319,1,9231
853,2019-10-08,655,19015,1694,1,21365
853,2019-10-09,131,17172,1553,1,18857
853,2019-10-10,143,11318,2094,2,13557
853,2019-10-11,125,12702,1317,1,14145
853,2019-10-12,1721,7850,1454,0,11025
853,2019-10-13,299,9152,1852,1,11304
853,2019-10-14,153,8481,1222,1,9857
853,2019-10-15,1054,9339,1874,3,12270
853,2019-10-16,727,18524,1350,0,20601
853,2019-10-17,1072,8361,971,0,10404
853,2019-10-18,276,8913,1954,0,11143
853,2019-10-19,1158,5643,1941,1,8743
853,2019-10-20,113,3048,1993,2,5156
853,2019-10-21,122,10889,1579,0,12590
853,2019-10-22,1142,6885,2132,3,10162
853,2019-10-23,956,14503,1871,1,17331
853,2019-10-24,137,26160,1432,1,27730
853,2019-10-25,273,19907,1940,5,22125
853,2019-10-26,961,16987,1883,0,19831
853,2019-10-27,133,28014,2110,0,30257
853,2019-10-28,927,16263,2309,0,19499
853,2019-10-29,223,16010,1554,0,17787
853,2019-10-30,129,15814,1815,4,17762
853,2019-10-31,1885,21456,1397,0,24738
853,2019-11-01,89,27926,1813,0,29828
853,2019-11-02,115,26693,1947,0,28755
853,2019-11-03,655,25304,1723,0,27682
853,2019-11-04,300,11763,1288,1,13352
853,2019-11-05,554,3875,2420,0,6849
853,2019-11-06,192,8384,1567,0,10143
853,2019-11-07,205,23258,1148,2,24613
853,2019-11-08,176,18289,1867,0,20332
853,2019-11-09,141,15875,1813,2,17831
853,2019-11-10,117,15417,1183,0,16717
853,2019-11-11,206,13748,1063,4,15021
853,2019-11-12,874,13375,2849,1,17099
853,2019-11-13,228,21166,1454,1,22849
853,2019-11-14,186,14371,2781,4,17342
853,2019-11-15,241,4982,1804,1,7028
853,2019-11-16,203,3403,2419,0,6025
853,2019-11-17,247,3750,3550,0,7547
853,2019-11-18,128,3448,3000,0,6576
853,2019-11-19,196,3175,2204,2,5577
853,2019-11-20,177,1356,1536,1,3070
853,2019-11-21,119,5268,1960,0,7347
853,2019-11-22,128,5332,1848,1,7309
853,2019-11-23,1015,5787,1619,1,8422
853,2019-11-24,254,6659,2425,2,9340
853,2019-11-25,122,10424,1895,0,12441
853,2019-11-26,143,5893,1448,0,7484
853,2019-11-27,1054,6239,1490,1,8784
853,2019-11-28,86,8157,632,0,8875
853,2019-11-29,54,457,1,0,512
853,2019-08-31,14,4,2,0,20
853,2019-09-01,0,0,0,0,0
853,2019-09-02,0,0,0,0,0
853,2019-09-03,0,0,1605,0,1605
853,2019-09-04,0,3872,1858,1,5731
853,2019-09-05,0,4843,1659,0,6502
853,2019-09-06,351,12535,1896,0,14782
853,2019-09-07,255,8088,2407,1,10751
853,2019-09-08,1737,5349,1883,0,8969
853,2019-09-09,2193,6737,2198,1,11129
853,2019-09-10,118,7140,2545,3,9806
853,2019-09-11,272,6640,2161,1,9074
853,2019-09-12,400,7296,3135,0,10831
853,2019-09-13,1821,5517,2298,1,9637
853,2019-09-14,957,5393,1441,0,7791
853,2019-09-15,158,9284,1825,2,11269
853,2019-09-16,108,7111,1823,1,9043
853,2019-09-17,103,7865,1980,0,9948
853,2019-09-18,105,10880,1309,1,12295
853,2019-09-19,1197,2388,2340,0,5925
853,2019-09-20,207,7183,1532,1,8923
853,2019-09-21,99,6895,2602,1,9597
853,2019-09-22,938,9235,2037,0,12210
853,2019-09-23,228,8935,2010,1,11174
853,2019-09-24,1087,8753,1624,1,11465
853,2019-09-25,129,8107,1728,2,9966
853,2019-09-26,1321,9556,1106,0,11983
853,2019-09-27,109,8600,1660,3,10372
853,2019-09-28,120,15477,1554,0,17151
853,2019-09-29,78,16454,2083,1,18616
853,2019-09-30,113,27112,1840,4,29069
853,2019-10-01,960,22662,1228,0,24850
853,2019-10-02,1003,13538,2167,0,16708
853,2019-10-03,621,14460,1627,0,16708
853,2019-10-04,103,12396,1833,1,14333
853,2019-10-05,99,14521,2576,2,17198
853,2019-10-06,1851,11864,1020,1,14736
853,2019-10-07,1178,6733,1319,1,9231
853,2019-10-08,655,19015,1694,1,21365
853,2019-10-09,131,17172,1553,1,18857
853,2019-10-10,143,11318,2094,2,13557
853,2019-10-11,125,12702,1317,1,14145
853,2019-10-12,1721,7850,1454,0,11025
853,2019-10-13,299,9152,1852,1,11304
853,2019-10-14,153,8481,1222,1,9857
853,2019-10-15,1054,9339,1874,3,12270
853,2019-10-16,727,18524,1350,0,20601
853,2019-10-17,1072,8361,971,0,10404
853,2019-10-18,276,8913,1954,0,11143
853,2019-10-19,1158,5643,1941,1,8743
853,2019-10-20,113,3048,1993,2,5156
853,2019-10-21,122,10889,1579,0,12590
853,2019-10-22,1142,6885,2132,3,10162
853,2019-10-23,956,14503,1871,1,17331
853,2019-10-24,137,26160,1432,1,27730
853,2019-10-25,273,19907,1940,5,22125
853,2019-10-26,961,16987,1883,0,19831
853,2019-10-27,133,28014,2110,0,30257
853,2019-10-28,927,16263,2309,0,19499
853,2019-10-29,223,16010,1554,0,17787
853,2019-10-30,129,15814,1815,4,17762
853,2019-10-31,1885,21456,1397,0,24738
853,2019-11-01,89,27926,1813,0,29828
853,2019-11-02,115,26693,1947,0,28755
853,2019-11-03,655,25304,1723,0,27682
853,2019-11-04,300,11763,1288,1,13352
853,2019-11-05,554,3875,2420,0,6849
853,2019-11-06,192,8384,1567,0,10143
853,2019-11-07,205,23258,1148,2,24613
853,2019-11-08,176,18289,1867,0,20332
853,2019-11-09,141,15875,1813,2,17831
853,2019-11-10,117,15417,1183,0,16717
853,2019-11-11,206,13748,1063,4,15021
853,2019-11-12,874,13375,2849,1,17099
853,2019-11-13,228,21166,1454,1,22849
853,2019-11-14,186,14371,2781,4,17342
853,2019-11-15,241,4982,1804,1,7028
853,2019-11-16,203,3403,2419,0,6025
853,2019-11-17,247,3750,3550,0,7547
853,2019-11-18,128,3448,3000,0,6576
853,2019-11-19,196,3175,2204,2,5577
853,2019-11-20,177,1356,1536,1,3070
853,2019-11-21,119,5268,1960,0,7347
853,2019-11-22,128,5332,1848,1,7309
853,2019-11-23,1015,5787,1619,1,8422
853,2019-11-24,254,6659,2425,2,9340
853,2019-11-25,122,10424,1895,0,12441
853,2019-11-26,143,5893,1448,0,7484
853,2019-11-27,1054,6239,1490,1,8784
853,2019-11-28,86,8157,632,0,8875
853,2019-11-29,54,457,1,0,512
853,2019-08-31,14,4,2,0,20
853,2019-09-01,0,0,0,0,0
853,2019-09-02,0,0,0,0,0
853,2019-09-03,0,0,1605,0,1605
853,2019-09-04,0,3872,1858,1,5731
853,2019-09-05,0,4843,1659,0,6502
853,2019-09-06,351,12535,1896,0,14782
853,2019-09-07,255,8088,2407,1,10751
853,2019-09-08,1737,5349,1883,0,8969
853,2019-09-09,2193,6737,2198,1,11129
853,2019-09-10,118,7140,2545,3,9806
853,2019-09-11,272,6640,2161,1,9074
853,2019-09-12,400,7296,3135,0,10831
853,2019-09-13,1821,5517,2298,1,9637
853,2019-09-14,957,5393,1441,0,7791
853,2019-09-15,158,9284,1825,2,11269
853,2019-09-16,108,7111,1823,1,9043
853,2019-09-17,103,7865,1980,0,9948
853,2019-09-18,105,10880,1309,1,12295
853,2019-09-19,1197,2388,2340,0,5925
853,2019-09-20,207,7183,1532,1,8923
853,2019-09-21,99,6895,2602,1,9597
853,2019-09-22,938,9235,2037,0,12210
853,2019-09-23,228,8935,2010,1,11174
853,2019-09-24,1087,8753,1624,1,11465
853,2019-09-25,129,8107,1728,2,9966
853,2019-09-26,1321,9556,1106,0,11983
853,2019-09-27,109,8600,1660,3,10372
853,2019-09-28,120,15477,1554,0,17151
853,2019-09-29,78,16454,2083,1,18616
853,2019-09-30,113,27112,1840,4,29069
853,2019-10-01,960,22662,1228,0,24850
853,2019-10-02,1003,13538,2167,0,16708
853,2019-10-03,621,14460,1627,0,16708
853,2019-10-04,103,12396,1833,1,14333
853,2019-10-05,99,14521,2576,2,17198
853,2019-10-06,1851,11864,1020,1,14736
853,2019-10-07,1178,6733,1319,1,9231
853,2019-10-08,655,19015,1694,1,21365
853,2019-10-09,131,17172,1553,1,18857
853,2019-10-10,143,11318,2094,2,13557
853,2019-10-11,125,12702,1317,1,14145
853,2019-10-12,1721,7850,1454,0,11025
853,2019-10-13,299,9152,1852,1,11304
853,2019-10-14,153,8481,1222,1,9857
853,2019-10-15,1054,9339,1874,3,12270
853,2019-10-16,727,18524,1350,0,20601
853,2019-10-17,1072,8361,971,0,10404
853,2019-10-18,276,8913,1954,0,11143
853,2019-10-19,1158,5643,1941,1,8743
853,2019-10-20,113,3048,1993,2,5156
853,2019-10-21,122,10889,1579,0,12590
853,2019-10-22,1142,6885,2132,3,10162
853,2019-10-23,956,14503,1871,1,17331
853,2019-10-24,137,26160,1432,1,27730
853,2019-10-25,273,19907,1940,5,22125
853,2019-10-26,961,16987,1883,0,19831
853,2019-10-27,133,28014,2110,0,30257
853,2019-10-28,927,16263,2309,0,19499
853,2019-10-29,223,16010,1554,0,17787
853,2019-10-30,129,15814,1815,4,17762
853,2019-10-31,1885,21456,1397,0,24738
853,2019-11-01,89,27926,1813,0,29828
853,2019-11-02,115,26693,1947,0,28755
853,2019-11-03,655,25304,1723,0,27682
853,2019-11-04,300,11763,1288,1,13352
853,2019-11-05,554,3875,2420,0,6849
853,2019-11-06,192,8384,1567,0,10143
853,2019-11-07,205,23258,1148,2,24613
853,2019-11-08,176,18289,1867,0,20332
853,2019-11-09,141,15875,1813,2,17831
853,2019-11-10,117,15417,1183,0,16717
853,2019-11-11,206,13748,1063,4,15021
853,2019-11-12,874,13375,2849,1,17099
853,2019-11-13,228,21166,1454,1,22849
853,2019-11-14,186,14371,2781,4,17342
853,2019-11-15,241,4982,1804,1,7028
853,2019-11-16,203,3403,2419,0,6025
853,2019-11-17,247,3750,3550,0,7547
853,2019-11-18,128,3448,3000,0,6576
853,2019-11-19,196,3175,2204,2,5577
853,2019-11-20,177,1356,1536,1,3070
853,2019-11-21,119,5268,1960,0,7347
853,2019-11-22,128,5332,1848,1,7309
853,2019-11-23,1015,5787,1619,1,8422
853,2019-11-24,254,6659,2425,2,9340
853,2019-11-25,122,10424,1895,0,12441
853,2019-11-26,143,5893,1448,0,7484
853,2019-11-27,1054,6239,1490,1,8784
853,2019-11-28,86,8157,632,0,8875
853,2019-11-29,54,457,1,0,512
853,2019-09-04,0,3872,1858,1,5731
853,2019-09-05,0,4843,1659,0,6502
853,2019-09-06,351,12535,1896,0,14782
853,2019-09-07,255,8088,2407,1,10751
853,2019-09-08,1737,5349,1883,0,8969
853,2019-09-09,2193,6737,2198,1,11129
853,2019-09-10,118,7140,2545,3,9806
853,2019-09-11,272,6640,2161,1,9074
853,2019-09-12,400,7296,3135,0,10831
853,2019-09-13,1821,5517,2298,1,9637
853,2019-09-14,957,5393,1441,0,7791
853,2019-09-15,158,9284,1825,2,11269
853,2019-09-16,108,7111,1823,1,9043
853,2019-09-17,103,7865,1980,0,9948
853,2019-09-18,105,10880,1309,1,12295
853,2019-09-19,1197,2388,2340,0,5925
853,2019-09-20,207,7183,1532,1,8923
853,2019-09-21,99,6895,2602,1,9597
853,2019-09-22,938,9235,2037,0,12210
853,2019-09-23,228,8935,2010,1,11174
853,2019-09-24,1087,8753,1624,1,11465
853,2019-09-25,129,8107,1728,2,9966
853,2019-09-26,1321,9556,1106,0,11983
853,2019-09-27,109,8600,1660,3,10372
853,2019-09-28,120,15477,1554,0,17151
853,2019-09-29,78,16454,2083,1,18616
853,2019-09-30,113,27112,1840,4,29069
853,2019-10-01,960,22662,1228,0,24850
853,2019-10-02,1003,13538,2167,0,16708
853,2019-10-03,621,14460,1627,0,16708
853,2019-10-04,103,12396,1833,1,14333
853,2019-10-05,99,14521,2576,2,17198
853,2019-10-06,1851,11864,1020,1,14736
853,2019-10-07,1178,6733,1319,1,9231
853,2019-10-08,655,19015,1694,1,21365
853,2019-10-09,131,17172,1553,1,18857
853,2019-10-10,143,11318,2094,2,13557
853,2019-10-11,125,12702,1317,1,14145
853,2019-10-12,1721,7850,1454,0,11025
853,2019-10-13,299,9152,1852,1,11304
853,2019-10-14,153,8481,1222,1,9857
853,2019-10-15,1054,9339,1874,3,12270
853,2019-10-16,727,18524,1350,0,20601
853,2019-10-17,1072,8361,971,0,10404
853,2019-10-18,276,8913,1954,0,11143
853,2019-10-19,1158,5643,1941,1,8743
853,2019-10-20,113,3048,1993,2,5156
853,2019-10-21,122,10889,1579,0,12590
853,2019-10-22,1142,6885,2132,3,10162
853,2019-10-23,956,14503,1871,1,17331
853,2019-10-24,137,26160,1432,1,27730
853,2019-10-25,273,19907,1940,5,22125
853,2019-10-26,961,16987,1883,0,19831
853,2019-10-27,133,28014,2110,0,30257
853,2019-10-28,927,16263,2309,0,19499
853,2019-10-29,223,16010,1554,0,17787
853,2019-10-30,129,15814,1815,4,17762
853,2019-10-31,1885,21456,1397,0,24738
853,2019-11-01,89,27926,1813,0,29828
853,2019-11-02,115,26693,1947,0,28755
853,2019-11-03,655,25304,1723,0,27682
853,2019-11-04,300,11763,1288,1,13352
853,2019-11-05,554,3875,2420,0,6849
853,2019-11-06,192,8384,1567,0,10143
853,2019-11-07,205,23258,1148,2,24613
853,2019-11-08,176,18289,1867,0,20332
853,2019-11-09,141,15875,1813,2,17831
853,2019-11-10,117,15417,1183,0,16717
853,2019-11-11,206,13748,1063,4,15021
853,2019-11-12,874,13375,2849,1,17099
853,2019-11-13,228,21166,1454,1,22849
853,2019-11-14,186,14371,2781,4,17342
853,2019-11-15,241,4982,1804,1,7028
853,2019-11-16,203,3403,2419,0,6025
853,2019-11-17,247,3750,3550,0,7547
853,2019-11-18,128,3448,3000,0,6576
853,2019-11-19,196,3175,2204,2,5577
853,2019-11-20,177,1356,1536,1,3070
853,2019-11-21,119,5268,1960,0,7347
853,2019-11-22,128,5332,1848,1,7309
853,2019-11-23,1015,5787,1619,1,8422
853,2019-11-24,254,6659,2425,2,9340
853,2019-11-25,122,10424,1895,0,12441
853,2019-11-26,143,5893,1448,0,7484
853,2019-11-27,1054,6239,1490,1,8784
854,2019-08-31,30,16,2,0,48
854,2019-09-01,16,5,0,0,21
854,2019-09-02,0,0,0,0,0
854,2019-09-03,994,25,962,0,1981
854,2019-09-04,385,3947,1952,3,6287
854,2019-09-05,305,8594,2030,1,10930
854,2019-09-06,357,12822,1921,0,15100
854,2019-09-07,410,13874,1345,2,15631
854,2019-09-08,483,5050,1223,0,6756
854,2019-09-09,274,10060,1989,0,12323
854,2019-09-10,173,7032,1397,1,8603
854,2019-09-11,942,6350,2199,2,9493
854,2019-09-12,270,6047,1832,1,8150
854,2019-09-13,106,6137,2197,0,8440
854,2019-09-14,153,5563,2352,0,8068
854,2019-09-15,211,8368,1573,2,10154
854,2019-09-16,184,5775,2528,1,8488
854,2019-09-17,151,11099,1982,0,13232
854,2019-09-18,213,10837,1243,1,12294
854,2019-09-19,258,2708,1714,0,4680
854,2019-09-20,217,7073,1410,1,8701
854,2019-09-21,139,7207,1878,0,9224
854,2019-09-22,778,8808,2288,2,11876
854,2019-09-23,142,8617,1932,1,10692
854,2019-09-24,137,9077,2541,3,11758
854,2019-09-25,231,28872,1492,2,30597
854,2019-09-26,791,17112,2073,1,19977
854,2019-09-27,114,8837,1949,2,10902
854,2019-09-28,238,15161,1492,3,16894
854,2019-09-29,813,19499,1257,1,21570
854,2019-09-30,113,17499,2161,1,19774
854,2019-10-01,96,16677,2048,2,18823
854,2019-10-02,148,13079,1399,0,14626
854,2019-10-03,104,14729,1731,2,16566
854,2019-10-04,653,12245,761,1,13660
854,2019-10-05,159,22955,1610,1,24725
854,2019-10-06,989,39493,1105,0,41587
854,2019-10-07,440,12433,1536,1,14410
854,2019-10-08,1005,13103,2690,4,16802
854,2019-10-09,983,14787,2445,397,18612
854,2019-10-10,129,11191,2039,0,13359
854,2019-10-11,172,13406,1326,1,14905
854,2019-10-12,695,7930,1722,0,10347
854,2019-10-13,2179,9084,1703,4,12970
854,2019-10-14,103,8661,2110,2,10876
854,2019-10-15,169,8225,2100,0,10494
854,2019-10-16,107,18883,2453,2,21445
854,2019-10-17,194,8487,1581,2,10264
854,2019-10-18,1062,9271,1875,1,12209
854,2019-10-19,1008,5630,1980,0,8618
854,2019-10-20,1818,3150,1749,1,6718
854,2019-10-21,779,19279,1842,0,21900
854,2019-10-22,109,10397,1637,3,12146
854,2019-10-23,725,14783,1666,5,17179
854,2019-10-24,220,25389,1575,3,27187
854,2019-10-25,291,15228,1732,2,17253
854,2019-10-26,131,34166,1393,1,35691
854,2019-10-27,254,43647,1185,1,45087
854,2019-10-28,108,26173,1967,1,28249
854,2019-10-29,195,29387,1509,0,31091
854,2019-10-30,576,21202,865,1,22644
854,2019-10-31,440,20816,1125,0,22381
854,2019-11-01,821,28220,1427,0,30468
854,2019-11-02,147,26385,1576,4,28112
854,2019-11-03,1346,53079,1032,0,55457
854,2019-11-04,158,15020,2099,2,17279
854,2019-11-05,1193,4406,1770,0,7369
854,2019-11-06,1130,14647,1090,0,16867
854,2019-11-07,894,17085,1237,3,19219
854,2019-11-08,1064,10275,1551,2,12892
854,2019-11-09,161,9389,1556,0,11106
854,2019-11-10,1745,14247,1891,0,17883
854,2019-11-11,199,9581,1897,2,11679
854,2019-11-12,554,10742,2987,2,14285
854,2019-11-13,215,11482,2272,3,13972
854,2019-11-14,205,12738,1097,1,14041
854,2019-11-15,407,5384,2378,1,8170
854,2019-11-16,140,2700,2086,0,4926
854,2019-11-17,1080,3772,3199,4,8055
854,2019-11-18,127,2564,3232,0,5923
854,2019-11-19,174,3377,2477,1,6029
854,2019-11-20,247,1511,1921,0,3679
854,2019-11-21,100,5454,2023,2,7579
854,2019-11-22,831,5731,1344,3,7909
854,2019-11-23,140,6070,2701,2,8913
854,2019-11-24,224,9441,1839,1,11505
854,2019-11-25,160,11419,2144,1,13724
854,2019-11-26,97,8695,1384,1,10177
854,2019-11-27,82,6274,1581,4,7941
854,2019-11-28,112,8030,561,0,8703
854,2019-11-29,17,895,23,0,935
854,2019-08-31,30,16,2,0,48
854,2019-09-01,16,5,0,0,21
854,2019-09-02,0,0,0,0,0
854,2019-09-03,994,25,962,0,1981
854,2019-09-04,385,3947,1952,3,6287
854,2019-09-05,305,8594,2030,1,10930
854,2019-09-06,357,12822,1921,0,15100
854,2019-09-07,410,13874,1345,2,15631
854,2019-09-08,483,5050,1223,0,6756
854,2019-09-09,274,10060,1989,0,12323
854,2019-09-10,173,7032,1397,1,8603
854,2019-09-11,942,6350,2199,2,9493
854,2019-09-12,270,6047,1832,1,8150
854,2019-09-13,106,6137,2197,0,8440
854,2019-09-14,153,5563,2352,0,8068
854,2019-09-15,211,8368,1573,2,10154
854,2019-09-16,184,5775,2528,1,8488
854,2019-09-17,151,11099,1982,0,13232
854,2019-09-18,213,10837,1243,1,12294
854,2019-09-19,258,2708,1714,0,4680
854,2019-09-20,217,7073,1410,1,8701
854,2019-09-21,139,7207,1878,0,9224
854,2019-09-22,778,8808,2288,2,11876
854,2019-09-23,142,8617,1932,1,10692
854,2019-09-24,137,9077,2541,3,11758
854,2019-09-25,231,28872,1492,2,30597
854,2019-09-26,791,17112,2073,1,19977
854,2019-09-27,114,8837,1949,2,10902
854,2019-09-28,238,15161,1492,3,16894
854,2019-09-29,813,19499,1257,1,21570
854,2019-09-30,113,17499,2161,1,19774
854,2019-10-01,96,16677,2048,2,18823
854,2019-10-02,148,13079,1399,0,14626
854,2019-10-03,104,14729,1731,2,16566
854,2019-10-04,653,12245,761,1,13660
854,2019-10-05,159,22955,1610,1,24725
854,2019-10-06,989,39493,1105,0,41587
854,2019-10-07,440,12433,1536,1,14410
854,2019-10-08,1005,13103,2690,4,16802
854,2019-10-09,983,14787,2445,397,18612
854,2019-10-10,129,11191,2039,0,13359
854,2019-10-11,172,13406,1326,1,14905
854,2019-10-12,695,7930,1722,0,10347
854,2019-10-13,2179,9084,1703,4,12970
854,2019-10-14,103,8661,2110,2,10876
854,2019-10-15,169,8225,2100,0,10494
854,2019-10-16,107,18883,2453,2,21445
854,2019-10-17,194,8487,1581,2,10264
854,2019-10-18,1062,9271,1875,1,12209
854,2019-10-19,1008,5630,1980,0,8618
854,2019-10-20,1818,3150,1749,1,6718
854,2019-10-21,779,19279,1842,0,21900
854,2019-10-22,109,10397,1637,3,12146
854,2019-10-23,725,14783,1666,5,17179
854,2019-10-24,220,25389,1575,3,27187
854,2019-10-25,291,15228,1732,2,17253
854,2019-10-26,131,34166,1393,1,35691
854,2019-10-27,254,43647,1185,1,45087
854,2019-10-28,108,26173,1967,1,28249
854,2019-10-29,195,29387,1509,0,31091
854,2019-10-30,576,21202,865,1,22644
854,2019-10-31,440,20816,1125,0,22381
854,2019-11-01,821,28220,1427,0,30468
854,2019-11-02,147,26385,1576,4,28112
854,2019-11-03,1346,53079,1032,0,55457
854,2019-11-04,158,15020,2099,2,17279
854,2019-11-05,1193,4406,1770,0,7369
854,2019-11-06,1130,14647,1090,0,16867
854,2019-11-07,894,17085,1237,3,19219
854,2019-11-08,1064,10275,1551,2,12892
854,2019-11-09,161,9389,1556,0,11106
854,2019-11-10,1745,14247,1891,0,17883
854,2019-11-11,199,9581,1897,2,11679
854,2019-11-12,554,10742,2987,2,14285
854,2019-11-13,215,11482,2272,3,13972
854,2019-11-14,205,12738,1097,1,14041
854,2019-11-15,407,5384,2378,1,8170
854,2019-11-16,140,2700,2086,0,4926
854,2019-11-17,1080,3772,3199,4,8055
854,2019-11-18,127,2564,3232,0,5923
854,2019-11-19,174,3377,2477,1,6029
854,2019-11-20,247,1511,1921,0,3679
854,2019-11-21,100,5454,2023,2,7579
854,2019-11-22,831,5731,1344,3,7909
854,2019-11-23,140,6070,2701,2,8913
854,2019-11-24,224,9441,1839,1,11505
854,2019-11-25,160,11419,2144,1,13724
854,2019-11-26,97,8695,1384,1,10177
854,2019-11-27,82,6274,1581,4,7941
854,2019-11-28,112,8030,561,0,8703
854,2019-11-29,17,895,23,0,935
854,2019-08-31,30,16,2,0,48
854,2019-09-01,16,5,0,0,21
854,2019-09-02,0,0,0,0,0
854,2019-09-03,994,25,962,0,1981
854,2019-09-04,385,3947,1952,3,6287
854,2019-09-05,305,8594,2030,1,10930
854,2019-09-06,357,12822,1921,0,15100
854,2019-09-07,410,13874,1345,2,15631
854,2019-09-08,483,5050,1223,0,6756
854,2019-09-09,274,10060,1989,0,12323
854,2019-09-10,173,7032,1397,1,8603
854,2019-09-11,942,6350,2199,2,9493
854,2019-09-12,270,6047,1832,1,8150
854,2019-09-13,106,6137,2197,0,8440
854,2019-09-14,153,5563,2352,0,8068
854,2019-09-15,211,8368,1573,2,10154
854,2019-09-16,184,5775,2528,1,8488
854,2019-09-17,151,11099,1982,0,13232
854,2019-09-18,213,10837,1243,1,12294
854,2019-09-19,258,2708,1714,0,4680
854,2019-09-20,217,7073,1410,1,8701
854,2019-09-21,139,7207,1878,0,9224
854,2019-09-22,778,8808,2288,2,11876
854,2019-09-23,142,8617,1932,1,10692
854,2019-09-24,137,9077,2541,3,11758
854,2019-09-25,231,28872,1492,2,30597
854,2019-09-26,791,17112,2073,1,19977
854,2019-09-27,114,8837,1949,2,10902
854,2019-09-28,238,15161,1492,3,16894
854,2019-09-29,813,19499,1257,1,21570
854,2019-09-30,113,17499,2161,1,19774
854,2019-10-01,96,16677,2048,2,18823
854,2019-10-02,148,13079,1399,0,14626
854,2019-10-03,104,14729,1731,2,16566
854,2019-10-04,653,12245,761,1,13660
854,2019-10-05,159,22955,1610,1,24725
854,2019-10-06,989,39493,1105,0,41587
854,2019-10-07,440,12433,1536,1,14410
854,2019-10-08,1005,13103,2690,4,16802
854,2019-10-09,983,14787,2445,397,18612
854,2019-10-10,129,11191,2039,0,13359
854,2019-10-11,172,13406,1326,1,14905
854,2019-10-12,695,7930,1722,0,10347
854,2019-10-13,2179,9084,1703,4,12970
854,2019-10-14,103,8661,2110,2,10876
854,2019-10-15,169,8225,2100,0,10494
854,2019-10-16,107,18883,2453,2,21445
854,2019-10-17,194,8487,1581,2,10264
854,2019-10-18,1062,9271,1875,1,12209
854,2019-10-19,1008,5630,1980,0,8618
854,2019-10-20,1818,3150,1749,1,6718
854,2019-10-21,779,19279,1842,0,21900
854,2019-10-22,109,10397,1637,3,12146
854,2019-10-23,725,14783,1666,5,17179
854,2019-10-24,220,25389,1575,3,27187
854,2019-10-25,291,15228,1732,2,17253
854,2019-10-26,131,34166,1393,1,35691
854,2019-10-27,254,43647,1185,1,45087
854,2019-10-28,108,26173,1967,1,28249
854,2019-10-29,195,29387,1509,0,31091
854,2019-10-30,576,21202,865,1,22644
854,2019-10-31,440,20816,1125,0,22381
854,2019-11-01,821,28220,1427,0,30468
854,2019-11-02,147,26385,1576,4,28112
854,2019-11-03,1346,53079,1032,0,55457
854,2019-11-04,158,15020,2099,2,17279
854,2019-11-05,1193,4406,1770,0,7369
854,2019-11-06,1130,14647,1090,0,16867
854,2019-11-07,894,17085,1237,3,19219
854,2019-11-08,1064,10275,1551,2,12892
854,2019-11-09,161,9389,1556,0,11106
854,2019-11-10,1745,14247,1891,0,17883
854,2019-11-11,199,9581,1897,2,11679
854,2019-11-12,554,10742,2987,2,14285
854,2019-11-13,215,11482,2272,3,13972
854,2019-11-14,205,12738,1097,1,14041
854,2019-11-15,407,5384,2378,1,8170
854,2019-11-16,140,2700,2086,0,4926
854,2019-11-17,1080,3772,3199,4,8055
854,2019-11-18,127,2564,3232,0,5923
854,2019-11-19,174,3377,2477,1,6029
854,2019-11-20,247,1511,1921,0,3679
854,2019-11-21,100,5454,2023,2,7579
854,2019-11-22,831,5731,1344,3,7909
854,2019-11-23,140,6070,2701,2,8913
854,2019-11-24,224,9441,1839,1,11505
854,2019-11-25,160,11419,2144,1,13724
854,2019-11-26,97,8695,1384,1,10177
854,2019-11-27,82,6274,1581,4,7941
854,2019-11-28,112,8030,561,0,8703
854,2019-11-29,17,895,23,0,935
854,2019-09-04,385,3947,1952,3,6287
854,2019-09-05,305,8594,2030,1,10930
854,2019-09-06,357,12822,1921,0,15100
854,2019-09-07,410,13874,1345,2,15631
854,2019-09-08,483,5050,1223,0,6756
854,2019-09-09,274,10060,1989,0,12323
854,2019-09-10,173,7032,1397,1,8603
854,2019-09-11,942,6350,2199,2,9493
854,2019-09-12,270,6047,1832,1,8150
854,2019-09-13,106,6137,2197,0,8440
854,2019-09-14,153,5563,2352,0,8068
854,2019-09-15,211,8368,1573,2,10154
854,2019-09-16,184,5775,2528,1,8488
854,2019-09-17,151,11099,1982,0,13232
854,2019-09-18,213,10837,1243,1,12294
854,2019-09-19,258,2708,1714,0,4680
854,2019-09-20,217,7073,1410,1,8701
854,2019-09-21,139,7207,1878,0,9224
854,2019-09-22,778,8808,2288,2,11876
854,2019-09-23,142,8617,1932,1,10692
854,2019-09-24,137,9077,2541,3,11758
854,2019-09-25,231,28872,1492,2,30597
854,2019-09-26,791,17112,2073,1,19977
854,2019-09-27,114,8837,1949,2,10902
854,2019-09-28,238,15161,1492,3,16894
854,2019-09-29,813,19499,1257,1,21570
854,2019-09-30,113,17499,2161,1,19774
854,2019-10-01,96,16677,2048,2,18823
854,2019-10-02,148,13079,1399,0,14626
854,2019-10-03,104,14729,1731,2,16566
854,2019-10-04,653,12245,761,1,13660
854,2019-10-05,159,22955,1610,1,24725
854,2019-10-06,989,39493,1105,0,41587
854,2019-10-07,440,12433,1536,1,14410
854,2019-10-08,1005,13103,2690,4,16802
854,2019-10-09,983,14787,2445,397,18612
854,2019-10-10,129,11191,2039,0,13359
854,2019-10-11,172,13406,1326,1,14905
854,2019-10-12,695,7930,1722,0,10347
854,2019-10-13,2179,9084,1703,4,12970
854,2019-10-14,103,8661,2110,2,10876
854,2019-10-15,169,8225,2100,0,10494
854,2019-10-16,107,18883,2453,2,21445
854,2019-10-17,194,8487,1581,2,10264
854,2019-10-18,1062,9271,1875,1,12209
854,2019-10-19,1008,5630,1980,0,8618
854,2019-10-20,1818,3150,1749,1,6718
854,2019-10-21,779,19279,1842,0,21900
854,2019-10-22,109,10397,1637,3,12146
854,2019-10-23,725,14783,1666,5,17179
854,2019-10-24,220,25389,1575,3,27187
854,2019-10-25,291,15228,1732,2,17253
854,2019-10-26,131,34166,1393,1,35691
854,2019-10-27,254,43647,1185,1,45087
854,2019-10-28,108,26173,1967,1,28249
854,2019-10-29,195,29387,1509,0,31091
854,2019-10-30,576,21202,865,1,22644
854,2019-10-31,440,20816,1125,0,22381
854,2019-11-01,821,28220,1427,0,30468
854,2019-11-02,147,26385,1576,4,28112
854,2019-11-03,1346,53079,1032,0,55457
854,2019-11-04,158,15020,2099,2,17279
854,2019-11-05,1193,4406,1770,0,7369
854,2019-11-06,1130,14647,1090,0,16867
854,2019-11-07,894,17085,1237,3,19219
854,2019-11-08,1064,10275,1551,2,12892
854,2019-11-09,161,9389,1556,0,11106
854,2019-11-10,1745,14247,1891,0,17883
854,2019-11-11,199,9581,1897,2,11679
854,2019-11-12,554,10742,2987,2,14285
854,2019-11-13,215,11482,2272,3,13972
854,2019-11-14,205,12738,1097,1,14041
854,2019-11-15,407,5384,2378,1,8170
854,2019-11-16,140,2700,2086,0,4926
854,2019-11-17,1080,3772,3199,4,8055
854,2019-11-18,127,2564,3232,0,5923
854,2019-11-19,174,3377,2477,1,6029
854,2019-11-20,247,1511,1921,0,3679
854,2019-11-21,100,5454,2023,2,7579
854,2019-11-22,831,5731,1344,3,7909
854,2019-11-23,140,6070,2701,2,8913
854,2019-11-24,224,9441,1839,1,11505
854,2019-11-25,160,11419,2144,1,13724
854,2019-11-26,97,8695,1384,1,10177
854,2019-11-27,82,6274,1581,4,7941
856,2019-09-04,27,8,1218,0,1253
856,2019-09-05,1337,4612,2912,2,8863
856,2019-09-06,667,13536,2193,0,16396
856,2019-09-07,1649,11359,2055,0,15063
856,2019-09-08,821,8591,1310,0,10722
856,2019-09-09,1703,6340,2208,0,10251
856,2019-09-10,1469,7721,2216,0,11406
856,2019-09-11,1201,6528,3131,2,10862
856,2019-09-12,1732,6445,1326,1356,10859
856,2019-09-13,1671,6223,2069,1,9964
856,2019-09-14,524,6268,858,0,7650
856,2019-09-15,487,9221,817,2,10527
856,2019-09-16,655,5282,2217,0,8154
856,2019-09-17,1583,9655,2538,1,13777
856,2019-09-18,2600,11427,1197,0,15224
856,2019-09-19,933,2758,3017,0,6708
856,2019-09-20,811,6736,1953,1,9501
856,2019-09-21,331,7274,1562,1,9168
856,2019-09-22,1279,9201,1789,0,12269
856,2019-09-23,2277,9010,1445,0,12732
856,2019-09-24,1919,8871,2066,4,12860
856,2019-09-25,1091,10074,1398,0,12563
856,2019-09-26,271,10116,1084,3,11474
856,2019-09-27,487,8203,1904,1,10595
856,2019-09-28,289,15352,1472,0,17113
856,2019-09-29,176,16919,1900,2,18997
856,2019-09-30,2631,17595,1954,2,22182
856,2019-10-01,179,16681,2103,1,18964
856,2019-10-02,1041,13116,2019,0,16176
856,2019-10-03,1346,14448,1203,1,16998
856,2019-10-04,143,12207,1337,2,13689
856,2019-10-05,1833,21567,1642,1,25043
856,2019-10-06,140,16669,1365,3,18177
856,2019-10-07,418,6583,2513,0,9514
856,2019-10-08,173,12900,1517,0,14590
856,2019-10-09,177,23210,1813,1,25201
856,2019-10-10,401,11974,1503,2,13880
856,2019-10-11,671,11540,2195,2,14408
856,2019-10-12,252,7768,740,2,8762
856,2019-10-13,1933,8986,1746,0,12665
856,2019-10-14,307,6485,2054,2,8848
856,2019-10-15,249,8620,1494,1,10364
856,2019-10-16,274,18828,1594,3,20699
856,2019-10-17,535,8757,1979,0,11271
856,2019-10-18,342,8797,1577,6273,16989
856,2019-10-19,3355,5567,1420,0,10342
856,2019-10-20,292,3216,1486,1,4995
856,2019-10-21,276,10356,1242,5,11879
856,2019-10-22,265,6565,1936,0,8766
856,2019-10-23,1156,14245,2167,1,17569
856,2019-10-24,315,25282,1425,1,27023
856,2019-10-25,365,15412,1498,2,17277
856,2019-10-26,1201,14063,1522,0,16786
856,2019-10-27,281,16156,1465,0,17902
856,2019-10-28,1198,14285,1305,0,16788
856,2019-10-29,397,15995,1401,1,17794
856,2019-10-30,683,16241,1365,1,18290
856,2019-10-31,1237,12448,1118,3,14806
856,2019-11-01,266,15340,940,0,16546
856,2019-11-02,412,14535,999,1,15947
856,2019-11-03,278,22809,1007,0,24094
856,2019-11-04,394,8087,1558,0,10039
856,2019-11-05,1520,3301,2249,0,7070
856,2019-11-06,415,14515,1279,2,16211
856,2019-11-07,369,16777,961,4,18111
856,2019-11-08,310,10022,1016,2,11350
856,2019-11-09,324,9040,1636,0,11000
856,2019-11-10,272,15593,1024,2,16891
856,2019-11-11,361,11130,1337,2,12830
856,2019-11-12,277,11263,2798,0,14338
856,2019-11-13,358,21391,1364,3,23116
856,2019-11-14,1179,14655,1510,3,17347
856,2019-11-15,1229,4692,1834,1,7756
856,2019-11-16,291,2886,2280,1,5458
856,2019-11-17,324,3791,3981,1,8097
856,2019-11-18,289,3290,3718,0,7297
856,2019-11-19,348,3152,3011,0,6511
856,2019-11-20,335,1805,2093,4,4237
856,2019-11-21,335,3502,1747,0,5584
856,2019-11-22,355,5871,1831,2,8059
856,2019-11-23,858,6248,2498,0,9604
856,2019-11-24,409,5343,1464,2,7218
856,2019-11-25,259,6566,2430,3,9258
856,2019-11-26,276,4513,1146,1,5936
856,2019-11-27,407,6204,1643,0,8254
856,2019-11-28,1056,12058,704,0,13818
856,2019-11-29,74,158,2,0,234
856,2019-09-04,27,8,1218,0,1253
856,2019-09-05,1337,4612,2912,2,8863
856,2019-09-06,667,13536,2193,0,16396
856,2019-09-07,1649,11359,2055,0,15063
856,2019-09-08,821,8591,1310,0,10722
856,2019-09-09,1703,6340,2208,0,10251
856,2019-09-10,1469,7721,2216,0,11406
856,2019-09-11,1201,6528,3131,2,10862
856,2019-09-12,1732,6445,1326,1356,10859
856,2019-09-13,1671,6223,2069,1,9964
856,2019-09-14,524,6268,858,0,7650
856,2019-09-15,487,9221,817,2,10527
856,2019-09-16,655,5282,2217,0,8154
856,2019-09-17,1583,9655,2538,1,13777
856,2019-09-18,2600,11427,1197,0,15224
856,2019-09-19,933,2758,3017,0,6708
856,2019-09-20,811,6736,1953,1,9501
856,2019-09-21,331,7274,1562,1,9168
856,2019-09-22,1279,9201,1789,0,12269
856,2019-09-23,2277,9010,1445,0,12732
856,2019-09-24,1919,8871,2066,4,12860
856,2019-09-25,1091,10074,1398,0,12563
856,2019-09-26,271,10116,1084,3,11474
856,2019-09-27,487,8203,1904,1,10595
856,2019-09-28,289,15352,1472,0,17113
856,2019-09-29,176,16919,1900,2,18997
856,2019-09-30,2631,17595,1954,2,22182
856,2019-10-01,179,16681,2103,1,18964
856,2019-10-02,1041,13116,2019,0,16176
856,2019-10-03,1346,14448,1203,1,16998
856,2019-10-04,143,12207,1337,2,13689
856,2019-10-05,1833,21567,1642,1,25043
856,2019-10-06,140,16669,1365,3,18177
856,2019-10-07,418,6583,2513,0,9514
856,2019-10-08,173,12900,1517,0,14590
856,2019-10-09,177,23210,1813,1,25201
856,2019-10-10,401,11974,1503,2,13880
856,2019-10-11,671,11540,2195,2,14408
856,2019-10-12,252,7768,740,2,8762
856,2019-10-13,1933,8986,1746,0,12665
856,2019-10-14,307,6485,2054,2,8848
856,2019-10-15,249,8620,1494,1,10364
856,2019-10-16,274,18828,1594,3,20699
856,2019-10-17,535,8757,1979,0,11271
856,2019-10-18,342,8797,1577,6273,16989
856,2019-10-19,3355,5567,1420,0,10342
856,2019-10-20,292,3216,1486,1,4995
856,2019-10-21,276,10356,1242,5,11879
856,2019-10-22,265,6565,1936,0,8766
856,2019-10-23,1156,14245,2167,1,17569
856,2019-10-24,315,25282,1425,1,27023
856,2019-10-25,365,15412,1498,2,17277
856,2019-10-26,1201,14063,1522,0,16786
856,2019-10-27,281,16156,1465,0,17902
856,2019-10-28,1198,14285,1305,0,16788
856,2019-10-29,397,15995,1401,1,17794
856,2019-10-30,683,16241,1365,1,18290
856,2019-10-31,1237,12448,1118,3,14806
856,2019-11-01,266,15340,940,0,16546
856,2019-11-02,412,14535,999,1,15947
856,2019-11-03,278,22809,1007,0,24094
856,2019-11-04,394,8087,1558,0,10039
856,2019-11-05,1520,3301,2249,0,7070
856,2019-11-06,415,14515,1279,2,16211
856,2019-11-07,369,16777,961,4,18111
856,2019-11-08,310,10022,1016,2,11350
856,2019-11-09,324,9040,1636,0,11000
856,2019-11-10,272,15593,1024,2,16891
856,2019-11-11,361,11130,1337,2,12830
856,2019-11-12,277,11263,2798,0,14338
856,2019-11-13,358,21391,1364,3,23116
856,2019-11-14,1179,14655,1510,3,17347
856,2019-11-15,1229,4692,1834,1,7756
856,2019-11-16,291,2886,2280,1,5458
856,2019-11-17,324,3791,3981,1,8097
856,2019-11-18,289,3290,3718,0,7297
856,2019-11-19,348,3152,3011,0,6511
856,2019-11-20,335,1805,2093,4,4237
856,2019-11-21,335,3502,1747,0,5584
856,2019-11-22,355,5871,1831,2,8059
856,2019-11-23,858,6248,2498,0,9604
856,2019-11-24,409,5343,1464,2,7218
856,2019-11-25,259,6566,2430,3,9258
856,2019-11-26,276,4513,1146,1,5936
856,2019-11-27,407,6204,1643,0,8254
856,2019-11-28,1056,12058,704,0,13818
856,2019-11-29,74,158,2,0,234
856,2019-09-04,27,8,1218,0,1253
856,2019-09-05,1337,4612,2912,2,8863
856,2019-09-06,667,13536,2193,0,16396
856,2019-09-07,1649,11359,2055,0,15063
856,2019-09-08,821,8591,1310,0,10722
856,2019-09-09,1703,6340,2208,0,10251
856,2019-09-10,1469,7721,2216,0,11406
856,2019-09-11,1201,6528,3131,2,10862
856,2019-09-12,1732,6445,1326,1356,10859
856,2019-09-13,1671,6223,2069,1,9964
856,2019-09-14,524,6268,858,0,7650
856,2019-09-15,487,9221,817,2,10527
856,2019-09-16,655,5282,2217,0,8154
856,2019-09-17,1583,9655,2538,1,13777
856,2019-09-18,2600,11427,1197,0,15224
856,2019-09-19,933,2758,3017,0,6708
856,2019-09-20,811,6736,1953,1,9501
856,2019-09-21,331,7274,1562,1,9168
856,2019-09-22,1279,9201,1789,0,12269
856,2019-09-23,2277,9010,1445,0,12732
856,2019-09-24,1919,8871,2066,4,12860
856,2019-09-25,1091,10074,1398,0,12563
856,2019-09-26,271,10116,1084,3,11474
856,2019-09-27,487,8203,1904,1,10595
856,2019-09-28,289,15352,1472,0,17113
856,2019-09-29,176,16919,1900,2,18997
856,2019-09-30,2631,17595,1954,2,22182
856,2019-10-01,179,16681,2103,1,18964
856,2019-10-02,1041,13116,2019,0,16176
856,2019-10-03,1346,14448,1203,1,16998
856,2019-10-04,143,12207,1337,2,13689
856,2019-10-05,1833,21567,1642,1,25043
856,2019-10-06,140,16669,1365,3,18177
856,2019-10-07,418,6583,2513,0,9514
856,2019-10-08,173,12900,1517,0,14590
856,2019-10-09,177,23210,1813,1,25201
856,2019-10-10,401,11974,1503,2,13880
856,2019-10-11,671,11540,2195,2,14408
856,2019-10-12,252,7768,740,2,8762
856,2019-10-13,1933,8986,1746,0,12665
856,2019-10-14,307,6485,2054,2,8848
856,2019-10-15,249,8620,1494,1,10364
856,2019-10-16,274,18828,1594,3,20699
856,2019-10-17,535,8757,1979,0,11271
856,2019-10-18,342,8797,1577,6273,16989
856,2019-10-19,3355,5567,1420,0,10342
856,2019-10-20,292,3216,1486,1,4995
856,2019-10-21,276,10356,1242,5,11879
856,2019-10-22,265,6565,1936,0,8766
856,2019-10-23,1156,14245,2167,1,17569
856,2019-10-24,315,25282,1425,1,27023
856,2019-10-25,365,15412,1498,2,17277
856,2019-10-26,1201,14063,1522,0,16786
856,2019-10-27,281,16156,1465,0,17902
856,2019-10-28,1198,14285,1305,0,16788
856,2019-10-29,397,15995,1401,1,17794
856,2019-10-30,683,16241,1365,1,18290
856,2019-10-31,1237,12448,1118,3,14806
856,2019-11-01,266,15340,940,0,16546
856,2019-11-02,412,14535,999,1,15947
856,2019-11-03,278,22809,1007,0,24094
856,2019-11-04,394,8087,1558,0,10039
856,2019-11-05,1520,3301,2249,0,7070
856,2019-11-06,415,14515,1279,2,16211
856,2019-11-07,369,16777,961,4,18111
856,2019-11-08,310,10022,1016,2,11350
856,2019-11-09,324,9040,1636,0,11000
856,2019-11-10,272,15593,1024,2,16891
856,2019-11-11,361,11130,1337,2,12830
856,2019-11-12,277,11263,2798,0,14338
856,2019-11-13,358,21391,1364,3,23116
856,2019-11-14,1179,14655,1510,3,17347
856,2019-11-15,1229,4692,1834,1,7756
856,2019-11-16,291,2886,2280,1,5458
856,2019-11-17,324,3791,3981,1,8097
856,2019-11-18,289,3290,3718,0,7297
856,2019-11-19,348,3152,3011,0,6511
856,2019-11-20,335,1805,2093,4,4237
856,2019-11-21,335,3502,1747,0,5584
856,2019-11-22,355,5871,1831,2,8059
856,2019-11-23,858,6248,2498,0,9604
856,2019-11-24,409,5343,1464,2,7218
856,2019-11-25,259,6566,2430,3,9258
856,2019-11-26,276,4513,1146,1,5936
856,2019-11-27,407,6204,1643,0,8254
856,2019-11-28,1056,12058,704,0,13818
856,2019-11-29,74,158,2,0,234
856,2019-09-05,1337,4612,2912,2,8863
856,2019-09-06,667,13536,2193,0,16396
856,2019-09-07,1649,11359,2055,0,15063
856,2019-09-08,821,8591,1310,0,10722
856,2019-09-09,1703,6340,2208,0,10251
856,2019-09-10,1469,7721,2216,0,11406
856,2019-09-11,1201,6528,3131,2,10862
856,2019-09-12,1732,6445,1326,1356,10859
856,2019-09-13,1671,6223,2069,1,9964
856,2019-09-14,524,6268,858,0,7650
856,2019-09-15,487,9221,817,2,10527
856,2019-09-16,655,5282,2217,0,8154
856,2019-09-17,1583,9655,2538,1,13777
856,2019-09-18,2600,11427,1197,0,15224
856,2019-09-19,933,2758,3017,0,6708
856,2019-09-20,811,6736,1953,1,9501
856,2019-09-21,331,7274,1562,1,9168
856,2019-09-22,1279,9201,1789,0,12269
856,2019-09-23,2277,9010,1445,0,12732
856,2019-09-24,1919,8871,2066,4,12860
856,2019-09-25,1091,10074,1398,0,12563
856,2019-09-26,271,10116,1084,3,11474
856,2019-09-27,487,8203,1904,1,10595
856,2019-09-28,289,15352,1472,0,17113
856,2019-09-29,176,16919,1900,2,18997
856,2019-09-30,2631,17595,1954,2,22182
856,2019-10-01,179,16681,2103,1,18964
856,2019-10-02,1041,13116,2019,0,16176
856,2019-10-03,1346,14448,1203,1,16998
856,2019-10-04,143,12207,1337,2,13689
856,2019-10-05,1833,21567,1642,1,25043
856,2019-10-06,140,16669,1365,3,18177
856,2019-10-07,418,6583,2513,0,9514
856,2019-10-08,173,12900,1517,0,14590
856,2019-10-09,177,23210,1813,1,25201
856,2019-10-10,401,11974,1503,2,13880
856,2019-10-11,671,11540,2195,2,14408
856,2019-10-12,252,7768,740,2,8762
856,2019-10-13,1933,8986,1746,0,12665
856,2019-10-14,307,6485,2054,2,8848
856,2019-10-15,249,8620,1494,1,10364
856,2019-10-16,274,18828,1594,3,20699
856,2019-10-17,535,8757,1979,0,11271
856,2019-10-18,342,8797,1577,6273,16989
856,2019-10-19,3355,5567,1420,0,10342
856,2019-10-20,292,3216,1486,1,4995
856,2019-10-21,276,10356,1242,5,11879
856,2019-10-22,265,6565,1936,0,8766
856,2019-10-23,1156,14245,2167,1,17569
856,2019-10-24,315,25282,1425,1,27023
856,2019-10-25,365,15412,1498,2,17277
856,2019-10-26,1201,14063,1522,0,16786
856,2019-10-27,281,16156,1465,0,17902
856,2019-10-28,1198,14285,1305,0,16788
856,2019-10-29,397,15995,1401,1,17794
856,2019-10-30,683,16241,1365,1,18290
856,2019-10-31,1237,12448,1118,3,14806
856,2019-11-01,266,15340,940,0,16546
856,2019-11-02,412,14535,999,1,15947
856,2019-11-03,278,22809,1007,0,24094
856,2019-11-04,394,8087,1558,0,10039
856,2019-11-05,1520,3301,2249,0,7070
856,2019-11-06,415,14515,1279,2,16211
856,2019-11-07,369,16777,961,4,18111
856,2019-11-08,310,10022,1016,2,11350
856,2019-11-09,324,9040,1636,0,11000
856,2019-11-10,272,15593,1024,2,16891
856,2019-11-11,361,11130,1337,2,12830
856,2019-11-12,277,11263,2798,0,14338
856,2019-11-13,358,21391,1364,3,23116
856,2019-11-14,1179,14655,1510,3,17347
856,2019-11-15,1229,4692,1834,1,7756
856,2019-11-16,291,2886,2280,1,5458
856,2019-11-17,324,3791,3981,1,8097
856,2019-11-18,289,3290,3718,0,7297
856,2019-11-19,348,3152,3011,0,6511
856,2019-11-20,335,1805,2093,4,4237
856,2019-11-21,335,3502,1747,0,5584
856,2019-11-22,355,5871,1831,2,8059
856,2019-11-23,858,6248,2498,0,9604
856,2019-11-24,409,5343,1464,2,7218
856,2019-11-25,259,6566,2430,3,9258
856,2019-11-26,276,4513,1146,1,5936
857,2019-09-04,64,6,1194,161,1425
857,2019-09-05,467,11689,1827,1,13984
857,2019-09-06,722,13211,1116,0,15049
857,2019-09-07,709,11005,2347,0,14061
857,2019-09-08,664,4949,2112,0,7725
857,2019-09-09,545,5485,1976,2,8008
857,2019-09-10,381,8706,2198,0,11285
857,2019-09-11,472,7216,3093,4,10785
857,2019-09-12,557,6778,2082,0,9417
857,2019-09-13,1799,5005,1980,0,8784
857,2019-09-14,515,5556,1307,0,7378
857,2019-09-15,445,9173,2290,1,11909
857,2019-09-16,468,5748,1468,1,7685
857,2019-09-17,447,13177,1609,0,15233
857,2019-09-18,700,11382,2030,0,14112
857,2019-09-19,765,8002,1353,0,10120
857,2019-09-20,634,11308,1582,1,13525
857,2019-09-21,415,7192,1795,0,9402
857,2019-09-22,487,14598,2357,0,17442
857,2019-09-23,2158,11037,2652,1,15848
857,2019-09-24,1484,9118,1503,3,12108
857,2019-09-25,340,11557,1979,4,13880
857,2019-09-26,1105,11089,1576,0,13770
857,2019-09-27,404,9045,1646,2,11097
857,2019-09-28,260,14038,1917,2,16217
857,2019-09-29,269,17512,2025,2,19808
857,2019-09-30,442,17728,2024,2,20196
857,2019-10-01,410,17412,1821,1,19644
857,2019-10-02,852,13155,1913,0,15920
857,2019-10-03,398,14344,1739,3,16484
857,2019-10-04,401,12465,1397,1,14264
857,2019-10-05,595,21189,1954,1,23739
857,2019-10-06,2454,16992,1711,0,21157
857,2019-10-07,1565,8006,2206,0,11777
857,2019-10-08,762,18594,2754,2,22112
857,2019-10-09,509,17144,1270,0,18923
857,2019-10-10,2390,16826,1886,4,21106
857,2019-10-11,648,17372,1659,1,19680
857,2019-10-12,389,9301,2303,0,11993
857,2019-10-13,449,8975,2709,1,12134
857,2019-10-14,417,6320,1398,2,8137
857,2019-10-15,866,14443,2098,3,17410
857,2019-10-16,419,23832,1655,0,25906
857,2019-10-17,1012,9063,1740,0,11815
857,2019-10-18,483,15060,2676,0,18219
857,2019-10-19,452,9059,2185,0,11696
857,2019-10-20,1443,2867,2042,1,6353
857,2019-10-21,408,10826,1029,1,12264
857,2019-10-22,445,7333,1463,1,9242
857,2019-10-23,402,8731,2174,0,11307
857,2019-10-24,492,14206,1037,0,15735
857,2019-10-25,472,12084,1106,3,13665
857,2019-10-26,419,13867,1665,0,15951
857,2019-10-27,501,16481,1379,0,18361
857,2019-10-28,451,14356,1515,0,16322
857,2019-10-29,1162,27058,1037,3,29260
857,2019-10-30,520,20978,1850,2,23350
857,2019-10-31,423,13248,1213,0,14884
857,2019-11-01,455,25692,1492,2,27641
857,2019-11-02,382,17231,942,0,18555
857,2019-11-03,445,36906,874,0,38225
857,2019-11-04,521,11409,1572,3,13505
857,2019-11-05,444,3436,1956,0,5836
857,2019-11-06,456,8642,937,0,10035
857,2019-11-07,548,22915,861,3,24327
857,2019-11-08,493,12429,1395,1,14318
857,2019-11-09,513,9364,1367,3,11247
857,2019-11-10,440,14852,1752,0,17044
857,2019-11-11,1469,10009,2160,0,13638
857,2019-11-12,614,11022,2487,1,14124
857,2019-11-13,513,14432,1449,1,16395
857,2019-11-14,505,8364,1600,3,10472
857,2019-11-15,401,3987,1785,0,6173
857,2019-11-16,1171,2653,2482,0,6306
857,2019-11-17,1533,3667,3089,0,8289
857,2019-11-18,845,3299,3226,1,7371
857,2019-11-19,1496,3199,2568,4,7267
857,2019-11-20,639,1300,2308,0,4247
857,2019-11-21,805,3463,1235,2,5505
857,2019-11-22,896,5341,1252,2,7491
857,2019-11-23,471,5921,2932,1,9325
857,2019-11-24,1420,6435,1576,1,9432
857,2019-11-25,2020,6927,1606,0,10553
857,2019-11-26,481,8211,1463,0,10155
857,2019-11-27,1352,6457,1028,0,8837
857,2019-11-28,395,11781,713,0,12889
857,2019-11-29,382,741,2,0,1125
857,2019-09-04,64,6,1194,161,1425
857,2019-09-05,467,11689,1827,1,13984
857,2019-09-06,722,13211,1116,0,15049
857,2019-09-07,709,11005,2347,0,14061
857,2019-09-08,664,4949,2112,0,7725
857,2019-09-09,545,5485,1976,2,8008
857,2019-09-10,381,8706,2198,0,11285
857,2019-09-11,472,7216,3093,4,10785
857,2019-09-12,557,6778,2082,0,9417
857,2019-09-13,1799,5005,1980,0,8784
857,2019-09-14,515,5556,1307,0,7378
857,2019-09-15,445,9173,2290,1,11909
857,2019-09-16,468,5748,1468,1,7685
857,2019-09-17,447,13177,1609,0,15233
857,2019-09-18,700,11382,2030,0,14112
857,2019-09-19,765,8002,1353,0,10120
857,2019-09-20,634,11308,1582,1,13525
857,2019-09-21,415,7192,1795,0,9402
857,2019-09-22,487,14598,2357,0,17442
857,2019-09-23,2158,11037,2652,1,15848
857,2019-09-24,1484,9118,1503,3,12108
857,2019-09-25,340,11557,1979,4,13880
857,2019-09-26,1105,11089,1576,0,13770
857,2019-09-27,404,9045,1646,2,11097
857,2019-09-28,260,14038,1917,2,16217
857,2019-09-29,269,17512,2025,2,19808
857,2019-09-30,442,17728,2024,2,20196
857,2019-10-01,410,17412,1821,1,19644
857,2019-10-02,852,13155,1913,0,15920
857,2019-10-03,398,14344,1739,3,16484
857,2019-10-04,401,12465,1397,1,14264
857,2019-10-05,595,21189,1954,1,23739
857,2019-10-06,2454,16992,1711,0,21157
857,2019-10-07,1565,8006,2206,0,11777
857,2019-10-08,762,18594,2754,2,22112
857,2019-10-09,509,17144,1270,0,18923
857,2019-10-10,2390,16826,1886,4,21106
857,2019-10-11,648,17372,1659,1,19680
857,2019-10-12,389,9301,2303,0,11993
857,2019-10-13,449,8975,2709,1,12134
857,2019-10-14,417,6320,1398,2,8137
857,2019-10-15,866,14443,2098,3,17410
857,2019-10-16,419,23832,1655,0,25906
857,2019-10-17,1012,9063,1740,0,11815
857,2019-10-18,483,15060,2676,0,18219
857,2019-10-19,452,9059,2185,0,11696
857,2019-10-20,1443,2867,2042,1,6353
857,2019-10-21,408,10826,1029,1,12264
857,2019-10-22,445,7333,1463,1,9242
857,2019-10-23,402,8731,2174,0,11307
857,2019-10-24,492,14206,1037,0,15735
857,2019-10-25,472,12084,1106,3,13665
857,2019-10-26,419,13867,1665,0,15951
857,2019-10-27,501,16481,1379,0,18361
857,2019-10-28,451,14356,1515,0,16322
857,2019-10-29,1162,27058,1037,3,29260
857,2019-10-30,520,20978,1850,2,23350
857,2019-10-31,423,13248,1213,0,14884
857,2019-11-01,455,25692,1492,2,27641
857,2019-11-02,382,17231,942,0,18555
857,2019-11-03,445,36906,874,0,38225
857,2019-11-04,521,11409,1572,3,13505
857,2019-11-05,444,3436,1956,0,5836
857,2019-11-06,456,8642,937,0,10035
857,2019-11-07,548,22915,861,3,24327
857,2019-11-08,493,12429,1395,1,14318
857,2019-11-09,513,9364,1367,3,11247
857,2019-11-10,440,14852,1752,0,17044
857,2019-11-11,1469,10009,2160,0,13638
857,2019-11-12,614,11022,2487,1,14124
857,2019-11-13,513,14432,1449,1,16395
857,2019-11-14,505,8364,1600,3,10472
857,2019-11-15,401,3987,1785,0,6173
857,2019-11-16,1171,2653,2482,0,6306
857,2019-11-17,1533,3667,3089,0,8289
857,2019-11-18,845,3299,3226,1,7371
857,2019-11-19,1496,3199,2568,4,7267
857,2019-11-20,639,1300,2308,0,4247
857,2019-11-21,805,3463,1235,2,5505
857,2019-11-22,896,5341,1252,2,7491
857,2019-11-23,471,5921,2932,1,9325
857,2019-11-24,1420,6435,1576,1,9432
857,2019-11-25,2020,6927,1606,0,10553
857,2019-11-26,481,8211,1463,0,10155
857,2019-11-27,1352,6457,1028,0,8837
857,2019-11-28,395,11781,713,0,12889
857,2019-11-29,382,741,2,0,1125
857,2019-09-04,64,6,1194,161,1425
857,2019-09-05,467,11689,1827,1,13984
857,2019-09-06,722,13211,1116,0,15049
857,2019-09-07,709,11005,2347,0,14061
857,2019-09-08,664,4949,2112,0,7725
857,2019-09-09,545,5485,1976,2,8008
857,2019-09-10,381,8706,2198,0,11285
857,2019-09-11,472,7216,3093,4,10785
857,2019-09-12,557,6778,2082,0,9417
857,2019-09-13,1799,5005,1980,0,8784
857,2019-09-14,515,5556,1307,0,7378
857,2019-09-15,445,9173,2290,1,11909
857,2019-09-16,468,5748,1468,1,7685
857,2019-09-17,447,13177,1609,0,15233
857,2019-09-18,700,11382,2030,0,14112
857,2019-09-19,765,8002,1353,0,10120
857,2019-09-20,634,11308,1582,1,13525
857,2019-09-21,415,7192,1795,0,9402
857,2019-09-22,487,14598,2357,0,17442
857,2019-09-23,2158,11037,2652,1,15848
857,2019-09-24,1484,9118,1503,3,12108
857,2019-09-25,340,11557,1979,4,13880
857,2019-09-26,1105,11089,1576,0,13770
857,2019-09-27,404,9045,1646,2,11097
857,2019-09-28,260,14038,1917,2,16217
857,2019-09-29,269,17512,2025,2,19808
857,2019-09-30,442,17728,2024,2,20196
857,2019-10-01,410,17412,1821,1,19644
857,2019-10-02,852,13155,1913,0,15920
857,2019-10-03,398,14344,1739,3,16484
857,2019-10-04,401,12465,1397,1,14264
857,2019-10-05,595,21189,1954,1,23739
857,2019-10-06,2454,16992,1711,0,21157
857,2019-10-07,1565,8006,2206,0,11777
857,2019-10-08,762,18594,2754,2,22112
857,2019-10-09,509,17144,1270,0,18923
857,2019-10-10,2390,16826,1886,4,21106
857,2019-10-11,648,17372,1659,1,19680
857,2019-10-12,389,9301,2303,0,11993
857,2019-10-13,449,8975,2709,1,12134
857,2019-10-14,417,6320,1398,2,8137
857,2019-10-15,866,14443,2098,3,17410
857,2019-10-16,419,23832,1655,0,25906
857,2019-10-17,1012,9063,1740,0,11815
857,2019-10-18,483,15060,2676,0,18219
857,2019-10-19,452,9059,2185,0,11696
857,2019-10-20,1443,2867,2042,1,6353
857,2019-10-21,408,10826,1029,1,12264
857,2019-10-22,445,7333,1463,1,9242
857,2019-10-23,402,8731,2174,0,11307
857,2019-10-24,492,14206,1037,0,15735
857,2019-10-25,472,12084,1106,3,13665
857,2019-10-26,419,13867,1665,0,15951
857,2019-10-27,501,16481,1379,0,18361
857,2019-10-28,451,14356,1515,0,16322
857,2019-10-29,1162,27058,1037,3,29260
857,2019-10-30,520,20978,1850,2,23350
857,2019-10-31,423,13248,1213,0,14884
857,2019-11-01,455,25692,1492,2,27641
857,2019-11-02,382,17231,942,0,18555
857,2019-11-03,445,36906,874,0,38225
857,2019-11-04,521,11409,1572,3,13505
857,2019-11-05,444,3436,1956,0,5836
857,2019-11-06,456,8642,937,0,10035
857,2019-11-07,548,22915,861,3,24327
857,2019-11-08,493,12429,1395,1,14318
857,2019-11-09,513,9364,1367,3,11247
857,2019-11-10,440,14852,1752,0,17044
857,2019-11-11,1469,10009,2160,0,13638
857,2019-11-12,614,11022,2487,1,14124
857,2019-11-13,513,14432,1449,1,16395
857,2019-11-14,505,8364,1600,3,10472
857,2019-11-15,401,3987,1785,0,6173
857,2019-11-16,1171,2653,2482,0,6306
857,2019-11-17,1533,3667,3089,0,8289
857,2019-11-18,845,3299,3226,1,7371
857,2019-11-19,1496,3199,2568,4,7267
857,2019-11-20,639,1300,2308,0,4247
857,2019-11-21,805,3463,1235,2,5505
857,2019-11-22,896,5341,1252,2,7491
857,2019-11-23,471,5921,2932,1,9325
857,2019-11-24,1420,6435,1576,1,9432
857,2019-11-25,2020,6927,1606,0,10553
857,2019-11-26,481,8211,1463,0,10155
857,2019-11-27,1352,6457,1028,0,8837
857,2019-11-28,395,11781,713,0,12889
857,2019-11-29,382,741,2,0,1125
857,2019-09-04,64,6,1194,161,1425
857,2019-09-05,467,11689,1827,1,13984
857,2019-09-06,722,13211,1116,0,15049
857,2019-09-07,709,11005,2347,0,14061
857,2019-09-08,664,4949,2112,0,7725
857,2019-09-09,545,5485,1976,2,8008
857,2019-09-10,381,8706,2198,0,11285
857,2019-09-11,472,7216,3093,4,10785
857,2019-09-12,557,6778,2082,0,9417
857,2019-09-13,1799,5005,1980,0,8784
857,2019-09-14,515,5556,1307,0,7378
857,2019-09-15,445,9173,2290,1,11909
857,2019-09-16,468,5748,1468,1,7685
857,2019-09-17,447,13177,1609,0,15233
857,2019-09-18,700,11382,2030,0,14112
857,2019-09-19,765,8002,1353,0,10120
857,2019-09-20,634,11308,1582,1,13525
857,2019-09-21,415,7192,1795,0,9402
857,2019-09-22,487,14598,2357,0,17442
857,2019-09-23,2158,11037,2652,1,15848
857,2019-09-24,1484,9118,1503,3,12108
857,2019-09-25,340,11557,1979,4,13880
857,2019-09-26,1105,11089,1576,0,13770
857,2019-09-27,404,9045,1646,2,11097
857,2019-09-28,260,14038,1917,2,16217
857,2019-09-29,269,17512,2025,2,19808
857,2019-09-30,442,17728,2024,2,20196
857,2019-10-01,410,17412,1821,1,19644
857,2019-10-02,852,13155,1913,0,15920
857,2019-10-03,398,14344,1739,3,16484
857,2019-10-04,401,12465,1397,1,14264
857,2019-10-05,595,21189,1954,1,23739
857,2019-10-06,2454,16992,1711,0,21157
857,2019-10-07,1565,8006,2206,0,11777
857,2019-10-08,762,18594,2754,2,22112
857,2019-10-09,509,17144,1270,0,18923
857,2019-10-10,2390,16826,1886,4,21106
857,2019-10-11,648,17372,1659,1,19680
857,2019-10-12,389,9301,2303,0,11993
857,2019-10-13,449,8975,2709,1,12134
857,2019-10-14,417,6320,1398,2,8137
857,2019-10-15,866,14443,2098,3,17410
857,2019-10-16,419,23832,1655,0,25906
857,2019-10-17,1012,9063,1740,0,11815
857,2019-10-18,483,15060,2676,0,18219
857,2019-10-19,452,9059,2185,0,11696
857,2019-10-20,1443,2867,2042,1,6353
857,2019-10-21,408,10826,1029,1,12264
857,2019-10-22,445,7333,1463,1,9242
857,2019-10-23,402,8731,2174,0,11307
857,2019-10-24,492,14206,1037,0,15735
857,2019-10-25,472,12084,1106,3,13665
857,2019-10-26,419,13867,1665,0,15951
857,2019-10-27,501,16481,1379,0,18361
857,2019-10-28,451,14356,1515,0,16322
857,2019-10-29,1162,27058,1037,3,29260
857,2019-10-30,520,20978,1850,2,23350
857,2019-10-31,423,13248,1213,0,14884
857,2019-11-01,455,25692,1492,2,27641
857,2019-11-02,382,17231,942,0,18555
857,2019-11-03,445,36906,874,0,38225
857,2019-11-04,521,11409,1572,3,13505
857,2019-11-05,444,3436,1956,0,5836
857,2019-11-06,456,8642,937,0,10035
857,2019-11-07,548,22915,861,3,24327
857,2019-11-08,493,12429,1395,1,14318
857,2019-11-09,513,9364,1367,3,11247
857,2019-11-10,440,14852,1752,0,17044
857,2019-11-11,1469,10009,2160,0,13638
857,2019-11-12,614,11022,2487,1,14124
857,2019-11-13,513,14432,1449,1,16395
857,2019-11-14,505,8364,1600,3,10472
857,2019-11-15,401,3987,1785,0,6173
857,2019-11-16,1171,2653,2482,0,6306
857,2019-11-17,1533,3667,3089,0,8289
857,2019-11-18,845,3299,3226,1,7371
857,2019-11-19,1496,3199,2568,4,7267
857,2019-11-20,639,1300,2308,0,4247
857,2019-11-21,805,3463,1235,2,5505
857,2019-11-22,896,5341,1252,2,7491
857,2019-11-23,471,5921,2932,1,9325
857,2019-11-24,1420,6435,1576,1,9432
858,2019-09-04,75,12,599,0,686
858,2019-09-05,808,3867,1730,1,6406
858,2019-09-06,1115,13950,2263,1,17329
858,2019-09-07,1521,6386,1153,0,9060
858,2019-09-08,1224,7024,2290,1,10539
858,2019-09-09,1956,6264,2296,1,10517
858,2019-09-10,2823,6845,2545,0,12213
858,2019-09-11,1935,6586,1347,2,9870
858,2019-09-12,1214,6473,2423,1,10111
858,2019-09-13,1627,5524,1776,0,8927
858,2019-09-14,1194,12623,1866,1,15684
858,2019-09-15,1462,7900,2158,2,11522
858,2019-09-16,2281,9366,2331,0,13978
858,2019-09-17,3011,11011,2163,0,16185
858,2019-09-18,3516,18373,1093,1,22983
858,2019-09-19,4006,2744,1650,0,8400
858,2019-09-20,2987,13705,1990,2,18684
858,2019-09-21,2589,9755,1891,0,14235
858,2019-09-22,3010,12764,2410,0,18184
858,2019-09-23,3281,11531,1656,1,16469
858,2019-09-24,3595,7919,2474,4,13992
858,2019-09-25,4027,9019,1692,0,14738
858,2019-09-26,3492,11855,1328,3,16678
858,2019-09-27,2351,8127,2247,1,12726
858,2019-09-28,2891,24732,2136,4,29763
858,2019-09-29,2349,27478,1137,0,30964
858,2019-09-30,2566,18934,1466,0,22966
858,2019-10-01,2341,16246,1433,2,20022
858,2019-10-02,3675,12702,1701,0,18078
858,2019-10-03,2982,22306,1502,1,26791
858,2019-10-04,2144,20203,1498,0,23845
858,2019-10-05,3077,23198,1104,1,27380
858,2019-10-06,11963,16867,1682,4,30516
858,2019-10-07,19239,6474,2090,2,27805
858,2019-10-08,1897,18362,1425,2,21686
858,2019-10-09,2680,24362,1656,0,28698
858,2019-10-10,2034,17972,2298,2,22306
858,2019-10-11,2320,16800,1594,3,20717
858,2019-10-12,1608,9325,2166,1,13100
858,2019-10-13,1809,8618,2241,0,12668
858,2019-10-14,1802,17755,1943,1,21501
858,2019-10-15,2599,15382,1928,1,19910
858,2019-10-16,1521,23227,1996,3,26747
858,2019-10-17,1706,8316,1462,0,11484
858,2019-10-18,1354,8897,2043,0,12294
858,2019-10-19,1405,5457,2300,1,9163
858,2019-10-20,1760,3098,2241,0,7099
858,2019-10-21,1704,18500,1233,3,21440
858,2019-10-22,1731,10415,945,1,13092
858,2019-10-23,2098,14453,1531,1,18083
858,2019-10-24,2320,18393,1721,1,22435
858,2019-10-25,1984,15672,1457,1,19114
858,2019-10-26,3739,25034,1448,2,30223
858,2019-10-27,4556,29854,835,1,35246
858,2019-10-28,6618,15773,1319,0,23710
858,2019-10-29,3024,15700,1836,0,20560
858,2019-10-30,3884,15382,1854,2,21122
858,2019-10-31,14135,20278,1697,2,36112
858,2019-11-01,7207,26837,1529,0,35573
858,2019-11-02,3040,17277,1267,0,21584
858,2019-11-03,4515,22015,719,2,27251
858,2019-11-04,4808,8309,1942,2,15061
858,2019-11-05,4696,3085,1310,1,9092
858,2019-11-06,6877,14362,2005,1,23245
858,2019-11-07,4265,25067,1057,3,30392
858,2019-11-08,5237,17335,1347,0,23919
858,2019-11-09,4388,15584,1355,1,21328
858,2019-11-10,8994,15199,2104,3,26300
858,2019-11-11,4040,9708,2102,2,15852
858,2019-11-12,3564,10794,2934,0,17292
858,2019-11-13,3364,12092,1238,4,16698
858,2019-11-14,4852,10387,1842,834,17915
858,2019-11-15,3873,3731,1947,0,9551
858,2019-11-16,5563,2555,2343,2,10463
858,2019-11-17,8326,3119,2633,0,14078
858,2019-11-18,3113,2608,3000,1,8722
858,2019-11-19,2376,3103,2922,0,8401
858,2019-11-20,2979,1423,1707,3,6112
858,2019-11-21,3834,5087,1785,2,10708
858,2019-11-22,1608,8576,1139,2,11325
858,2019-11-23,2758,6866,2321,3,11948
858,2019-11-24,2257,6298,1764,2,10321
858,2019-11-25,1865,6681,2072,0,10618
858,2019-11-26,1821,8477,1017,1,11316
858,2019-11-27,1566,6221,1664,1,9452
858,2019-11-28,1543,7265,669,0,9477
858,2019-11-29,227,364,1,0,592
858,2019-09-04,75,12,599,0,686
858,2019-09-05,808,3867,1730,1,6406
858,2019-09-06,1115,13950,2263,1,17329
858,2019-09-07,1521,6386,1153,0,9060
858,2019-09-08,1224,7024,2290,1,10539
858,2019-09-09,1956,6264,2296,1,10517
858,2019-09-10,2823,6845,2545,0,12213
858,2019-09-11,1935,6586,1347,2,9870
858,2019-09-12,1214,6473,2423,1,10111
858,2019-09-13,1627,5524,1776,0,8927
858,2019-09-14,1194,12623,1866,1,15684
858,2019-09-15,1462,7900,2158,2,11522
858,2019-09-16,2281,9366,2331,0,13978
858,2019-09-17,3011,11011,2163,0,16185
858,2019-09-18,3516,18373,1093,1,22983
858,2019-09-19,4006,2744,1650,0,8400
858,2019-09-20,2987,13705,1990,2,18684
858,2019-09-21,2589,9755,1891,0,14235
858,2019-09-22,3010,12764,2410,0,18184
858,2019-09-23,3281,11531,1656,1,16469
858,2019-09-24,3595,7919,2474,4,13992
858,2019-09-25,4027,9019,1692,0,14738
858,2019-09-26,3492,11855,1328,3,16678
858,2019-09-27,2351,8127,2247,1,12726
858,2019-09-28,2891,24732,2136,4,29763
858,2019-09-29,2349,27478,1137,0,30964
858,2019-09-30,2566,18934,1466,0,22966
858,2019-10-01,2341,16246,1433,2,20022
858,2019-10-02,3675,12702,1701,0,18078
858,2019-10-03,2982,22306,1502,1,26791
858,2019-10-04,2144,20203,1498,0,23845
858,2019-10-05,3077,23198,1104,1,27380
858,2019-10-06,11963,16867,1682,4,30516
858,2019-10-07,19239,6474,2090,2,27805
858,2019-10-08,1897,18362,1425,2,21686
858,2019-10-09,2680,24362,1656,0,28698
858,2019-10-10,2034,17972,2298,2,22306
858,2019-10-11,2320,16800,1594,3,20717
858,2019-10-12,1608,9325,2166,1,13100
858,2019-10-13,1809,8618,2241,0,12668
858,2019-10-14,1802,17755,1943,1,21501
858,2019-10-15,2599,15382,1928,1,19910
858,2019-10-16,1521,23227,1996,3,26747
858,2019-10-17,1706,8316,1462,0,11484
858,2019-10-18,1354,8897,2043,0,12294
858,2019-10-19,1405,5457,2300,1,9163
858,2019-10-20,1760,3098,2241,0,7099
858,2019-10-21,1704,18500,1233,3,21440
858,2019-10-22,1731,10415,945,1,13092
858,2019-10-23,2098,14453,1531,1,18083
858,2019-10-24,2320,18393,1721,1,22435
858,2019-10-25,1984,15672,1457,1,19114
858,2019-10-26,3739,25034,1448,2,30223
858,2019-10-27,4556,29854,835,1,35246
858,2019-10-28,6618,15773,1319,0,23710
858,2019-10-29,3024,15700,1836,0,20560
858,2019-10-30,3884,15382,1854,2,21122
858,2019-10-31,14135,20278,1697,2,36112
858,2019-11-01,7207,26837,1529,0,35573
858,2019-11-02,3040,17277,1267,0,21584
858,2019-11-03,4515,22015,719,2,27251
858,2019-11-04,4808,8309,1942,2,15061
858,2019-11-05,4696,3085,1310,1,9092
858,2019-11-06,6877,14362,2005,1,23245
858,2019-11-07,4265,25067,1057,3,30392
858,2019-11-08,5237,17335,1347,0,23919
858,2019-11-09,4388,15584,1355,1,21328
858,2019-11-10,8994,15199,2104,3,26300
858,2019-11-11,4040,9708,2102,2,15852
858,2019-11-12,3564,10794,2934,0,17292
858,2019-11-13,3364,12092,1238,4,16698
858,2019-11-14,4852,10387,1842,834,17915
858,2019-11-15,3873,3731,1947,0,9551
858,2019-11-16,5563,2555,2343,2,10463
858,2019-11-17,8326,3119,2633,0,14078
858,2019-11-18,3113,2608,3000,1,8722
858,2019-11-19,2376,3103,2922,0,8401
858,2019-11-20,2979,1423,1707,3,6112
858,2019-11-21,3834,5087,1785,2,10708
858,2019-11-22,1608,8576,1139,2,11325
858,2019-11-23,2758,6866,2321,3,11948
858,2019-11-24,2257,6298,1764,2,10321
858,2019-11-25,1865,6681,2072,0,10618
858,2019-11-26,1821,8477,1017,1,11316
858,2019-11-27,1566,6221,1664,1,9452
858,2019-11-28,1543,7265,669,0,9477
858,2019-11-29,227,364,1,0,592
858,2019-09-04,75,12,599,0,686
858,2019-09-05,808,3867,1730,1,6406
858,2019-09-06,1115,13950,2263,1,17329
858,2019-09-07,1521,6386,1153,0,9060
858,2019-09-08,1224,7024,2290,1,10539
858,2019-09-09,1956,6264,2296,1,10517
858,2019-09-10,2823,6845,2545,0,12213
858,2019-09-11,1935,6586,1347,2,9870
858,2019-09-12,1214,6473,2423,1,10111
858,2019-09-13,1627,5524,1776,0,8927
858,2019-09-14,1194,12623,1866,1,15684
858,2019-09-15,1462,7900,2158,2,11522
858,2019-09-16,2281,9366,2331,0,13978
858,2019-09-17,3011,11011,2163,0,16185
858,2019-09-18,3516,18373,1093,1,22983
858,2019-09-19,4006,2744,1650,0,8400
858,2019-09-20,2987,13705,1990,2,18684
858,2019-09-21,2589,9755,1891,0,14235
858,2019-09-22,3010,12764,2410,0,18184
858,2019-09-23,3281,11531,1656,1,16469
858,2019-09-24,3595,7919,2474,4,13992
858,2019-09-25,4027,9019,1692,0,14738
858,2019-09-26,3492,11855,1328,3,16678
858,2019-09-27,2351,8127,2247,1,12726
858,2019-09-28,2891,24732,2136,4,29763
858,2019-09-29,2349,27478,1137,0,30964
858,2019-09-30,2566,18934,1466,0,22966
858,2019-10-01,2341,16246,1433,2,20022
858,2019-10-02,3675,12702,1701,0,18078
858,2019-10-03,2982,22306,1502,1,26791
858,2019-10-04,2144,20203,1498,0,23845
858,2019-10-05,3077,23198,1104,1,27380
858,2019-10-06,11963,16867,1682,4,30516
858,2019-10-07,19239,6474,2090,2,27805
858,2019-10-08,1897,18362,1425,2,21686
858,2019-10-09,2680,24362,1656,0,28698
858,2019-10-10,2034,17972,2298,2,22306
858,2019-10-11,2320,16800,1594,3,20717
858,2019-10-12,1608,9325,2166,1,13100
858,2019-10-13,1809,8618,2241,0,12668
858,2019-10-14,1802,17755,1943,1,21501
858,2019-10-15,2599,15382,1928,1,19910
858,2019-10-16,1521,23227,1996,3,26747
858,2019-10-17,1706,8316,1462,0,11484
858,2019-10-18,1354,8897,2043,0,12294
858,2019-10-19,1405,5457,2300,1,9163
858,2019-10-20,1760,3098,2241,0,7099
858,2019-10-21,1704,18500,1233,3,21440
858,2019-10-22,1731,10415,945,1,13092
858,2019-10-23,2098,14453,1531,1,18083
858,2019-10-24,2320,18393,1721,1,22435
858,2019-10-25,1984,15672,1457,1,19114
858,2019-10-26,3739,25034,1448,2,30223
858,2019-10-27,4556,29854,835,1,35246
858,2019-10-28,6618,15773,1319,0,23710
858,2019-10-29,3024,15700,1836,0,20560
858,2019-10-30,3884,15382,1854,2,21122
858,2019-10-31,14135,20278,1697,2,36112
858,2019-11-01,7207,26837,1529,0,35573
858,2019-11-02,3040,17277,1267,0,21584
858,2019-11-03,4515,22015,719,2,27251
858,2019-11-04,4808,8309,1942,2,15061
858,2019-11-05,4696,3085,1310,1,9092
858,2019-11-06,6877,14362,2005,1,23245
858,2019-11-07,4265,25067,1057,3,30392
858,2019-11-08,5237,17335,1347,0,23919
858,2019-11-09,4388,15584,1355,1,21328
858,2019-11-10,8994,15199,2104,3,26300
858,2019-11-11,4040,9708,2102,2,15852
858,2019-11-12,3564,10794,2934,0,17292
858,2019-11-13,3364,12092,1238,4,16698
858,2019-11-14,4852,10387,1842,834,17915
858,2019-11-15,3873,3731,1947,0,9551
858,2019-11-16,5563,2555,2343,2,10463
858,2019-11-17,8326,3119,2633,0,14078
858,2019-11-18,3113,2608,3000,1,8722
858,2019-11-19,2376,3103,2922,0,8401
858,2019-11-20,2979,1423,1707,3,6112
858,2019-11-21,3834,5087,1785,2,10708
858,2019-11-22,1608,8576,1139,2,11325
858,2019-11-23,2758,6866,2321,3,11948
858,2019-11-24,2257,6298,1764,2,10321
858,2019-11-25,1865,6681,2072,0,10618
858,2019-11-26,1821,8477,1017,1,11316
858,2019-11-27,1566,6221,1664,1,9452
858,2019-11-28,1543,7265,669,0,9477
858,2019-11-29,227,364,1,0,592
858,2019-09-05,808,3867,1730,1,6406
858,2019-09-06,1115,13950,2263,1,17329
858,2019-09-07,1521,6386,1153,0,9060
858,2019-09-08,1224,7024,2290,1,10539
858,2019-09-09,1956,6264,2296,1,10517
858,2019-09-10,2823,6845,2545,0,12213
858,2019-09-11,1935,6586,1347,2,9870
858,2019-09-12,1214,6473,2423,1,10111
858,2019-09-13,1627,5524,1776,0,8927
858,2019-09-14,1194,12623,1866,1,15684
858,2019-09-15,1462,7900,2158,2,11522
858,2019-09-16,2281,9366,2331,0,13978
858,2019-09-17,3011,11011,2163,0,16185
858,2019-09-18,3516,18373,1093,1,22983
858,2019-09-19,4006,2744,1650,0,8400
858,2019-09-20,2987,13705,1990,2,18684
858,2019-09-21,2589,9755,1891,0,14235
858,2019-09-22,3010,12764,2410,0,18184
858,2019-09-23,3281,11531,1656,1,16469
858,2019-09-24,3595,7919,2474,4,13992
858,2019-09-25,4027,9019,1692,0,14738
858,2019-09-26,3492,11855,1328,3,16678
858,2019-09-27,2351,8127,2247,1,12726
858,2019-09-28,2891,24732,2136,4,29763
858,2019-09-29,2349,27478,1137,0,30964
858,2019-09-30,2566,18934,1466,0,22966
858,2019-10-01,2341,16246,1433,2,20022
858,2019-10-02,3675,12702,1701,0,18078
858,2019-10-03,2982,22306,1502,1,26791
858,2019-10-04,2144,20203,1498,0,23845
858,2019-10-05,3077,23198,1104,1,27380
858,2019-10-06,11963,16867,1682,4,30516
858,2019-10-07,19239,6474,2090,2,27805
858,2019-10-08,1897,18362,1425,2,21686
858,2019-10-09,2680,24362,1656,0,28698
858,2019-10-10,2034,17972,2298,2,22306
858,2019-10-11,2320,16800,1594,3,20717
858,2019-10-12,1608,9325,2166,1,13100
858,2019-10-13,1809,8618,2241,0,12668
858,2019-10-14,1802,17755,1943,1,21501
858,2019-10-15,2599,15382,1928,1,19910
858,2019-10-16,1521,23227,1996,3,26747
858,2019-10-17,1706,8316,1462,0,11484
858,2019-10-18,1354,8897,2043,0,12294
858,2019-10-19,1405,5457,2300,1,9163
858,2019-10-20,1760,3098,2241,0,7099
858,2019-10-21,1704,18500,1233,3,21440
858,2019-10-22,1731,10415,945,1,13092
858,2019-10-23,2098,14453,1531,1,18083
858,2019-10-24,2320,18393,1721,1,22435
858,2019-10-25,1984,15672,1457,1,19114
858,2019-10-26,3739,25034,1448,2,30223
858,2019-10-27,4556,29854,835,1,35246
858,2019-10-28,6618,15773,1319,0,23710
858,2019-10-29,3024,15700,1836,0,20560
858,2019-10-30,3884,15382,1854,2,21122
858,2019-10-31,14135,20278,1697,2,36112
858,2019-11-01,7207,26837,1529,0,35573
858,2019-11-02,3040,17277,1267,0,21584
858,2019-11-03,4515,22015,719,2,27251
858,2019-11-04,4808,8309,1942,2,15061
858,2019-11-05,4696,3085,1310,1,9092
858,2019-11-06,6877,14362,2005,1,23245
858,2019-11-07,4265,25067,1057,3,30392
858,2019-11-08,5237,17335,1347,0,23919
858,2019-11-09,4388,15584,1355,1,21328
858,2019-11-10,8994,15199,2104,3,26300
858,2019-11-11,4040,9708,2102,2,15852
858,2019-11-12,3564,10794,2934,0,17292
858,2019-11-13,3364,12092,1238,4,16698
858,2019-11-14,4852,10387,1842,834,17915
858,2019-11-15,3873,3731,1947,0,9551
858,2019-11-16,5563,2555,2343,2,10463
858,2019-11-17,8326,3119,2633,0,14078
858,2019-11-18,3113,2608,3000,1,8722
858,2019-11-19,2376,3103,2922,0,8401
858,2019-11-20,2979,1423,1707,3,6112
858,2019-11-21,3834,5087,1785,2,10708
858,2019-11-22,1608,8576,1139,2,11325
858,2019-11-23,2758,6866,2321,3,11948
858,2019-11-24,2257,6298,1764,2,10321
858,2019-11-25,1865,6681,2072,0,10618
858,2019-11-26,1821,8477,1017,1,11316
858,2019-11-27,1566,6221,1664,1,9452
859,2019-09-04,19,2,881,0,902
859,2019-09-05,213,5558,2165,0,7936
859,2019-09-06,334,10750,1140,0,12224
859,2019-09-07,163,6518,2151,0,8832
859,2019-09-08,290,4662,2438,1,7391
859,2019-09-09,952,5834,2471,0,9257
859,2019-09-10,169,8536,1343,0,10048
859,2019-09-11,222,7740,1977,1,9940
859,2019-09-12,209,6793,2243,2,9247
859,2019-09-13,99,4843,2505,2,7449
859,2019-09-14,114,5052,1988,0,7154
859,2019-09-15,145,9238,2470,2,11855
859,2019-09-16,159,15077,1816,1,17053
859,2019-09-17,967,12090,1551,0,14608
859,2019-09-18,106,11112,1449,2,12669
859,2019-09-19,278,3577,1350,0,5205
859,2019-09-20,332,10636,1856,1,12825
859,2019-09-21,141,6479,1798,0,8418
859,2019-09-22,673,13435,2134,1,16243
859,2019-09-23,1042,10889,1502,1,13434
859,2019-09-24,260,8884,2142,6,11292
859,2019-09-25,147,9433,2267,1,11848
859,2019-09-26,168,11528,1004,3,12703
859,2019-09-27,133,8231,1403,1,9768
859,2019-09-28,110,15482,1387,3,16982
859,2019-09-29,232,16758,1758,0,18748
859,2019-09-30,1433,25366,965,0,27764
859,2019-10-01,509,22888,2097,2,25496
859,2019-10-02,1059,16905,1620,0,19584
859,2019-10-03,159,14619,1067,0,15845
859,2019-10-04,248,12545,1244,38,14075
859,2019-10-05,116,21434,1185,0,22735
859,2019-10-06,142,17586,2452,3,20183
859,2019-10-07,1983,6983,1567,1,10534
859,2019-10-08,278,18838,1917,3,21036
859,2019-10-09,1147,17674,1256,1,20078
859,2019-10-10,693,10992,2189,1,13875
859,2019-10-11,156,16602,1430,2,18190
859,2019-10-12,191,9769,1347,12,11319
859,2019-10-13,1042,12327,1642,0,15011
859,2019-10-14,169,6306,1709,1,8185
859,2019-10-15,1077,8617,2054,1,11749
859,2019-10-16,250,24705,912,3,25870
859,2019-10-17,171,11932,1575,0,13678
859,2019-10-18,1077,15176,1299,0,17552
859,2019-10-19,168,8942,1973,0,11083
859,2019-10-20,2132,3022,1839,2,6995
859,2019-10-21,614,10795,2114,5,13528
859,2019-10-22,229,6817,2361,0,9407
859,2019-10-23,1698,14614,1453,2,17767
859,2019-10-24,293,25684,1451,0,27428
859,2019-10-25,301,14832,2567,2,17702
859,2019-10-26,326,13426,2386,1,16139
859,2019-10-27,282,27388,1860,0,29530
859,2019-10-28,243,15924,2596,1,18764
859,2019-10-29,1713,26995,1667,1,30376
859,2019-10-30,273,29282,925,0,30480
859,2019-10-31,259,14851,1454,4,16568
859,2019-11-01,254,15247,1083,1,16585
859,2019-11-02,959,14271,1596,0,16826
859,2019-11-03,288,38056,1177,0,39521
859,2019-11-04,1222,13970,1955,0,17147
859,2019-11-05,288,3428,2530,0,6246
859,2019-11-06,684,13951,1747,0,16382
859,2019-11-07,455,16354,1790,4,18603
859,2019-11-08,291,9622,1943,0,11856
859,2019-11-09,399,8842,2146,0,11387
859,2019-11-10,1178,15058,1397,2,17635
859,2019-11-11,389,10263,1779,2,12433
859,2019-11-12,287,10885,2366,0,13538
859,2019-11-13,282,14366,1570,3,16221
859,2019-11-14,288,12954,1828,0,15070
859,2019-11-15,1210,5433,2106,0,8749
859,2019-11-16,363,2564,2619,0,5546
859,2019-11-17,334,3496,3172,0,7002
859,2019-11-18,273,2519,3486,0,6278
859,2019-11-19,819,3064,2240,0,6123
859,2019-11-20,396,1337,2475,0,4208
859,2019-11-21,285,3342,1919,0,5546
859,2019-11-22,251,9031,1311,0,10593
859,2019-11-23,526,6853,3034,0,10413
859,2019-11-24,402,5771,1967,0,8140
859,2019-11-25,877,6545,1623,0,9045
859,2019-11-26,295,5418,793,0,6506
859,2019-11-27,351,6272,1213,0,7836
859,2019-11-28,260,7971,462,0,8693
859,2019-11-29,156,163,110,0,429
859,2019-09-04,19,2,881,0,902
859,2019-09-05,213,5558,2165,0,7936
859,2019-09-06,334,10750,1140,0,12224
859,2019-09-07,163,6518,2151,0,8832
859,2019-09-08,290,4662,2438,1,7391
859,2019-09-09,952,5834,2471,0,9257
859,2019-09-10,169,8536,1343,0,10048
859,2019-09-11,222,7740,1977,1,9940
859,2019-09-12,209,6793,2243,2,9247
859,2019-09-13,99,4843,2505,2,7449
859,2019-09-14,114,5052,1988,0,7154
859,2019-09-15,145,9238,2470,2,11855
859,2019-09-16,159,15077,1816,1,17053
859,2019-09-17,967,12090,1551,0,14608
859,2019-09-18,106,11112,1449,2,12669
859,2019-09-19,278,3577,1350,0,5205
859,2019-09-20,332,10636,1856,1,12825
859,2019-09-21,141,6479,1798,0,8418
859,2019-09-22,673,13435,2134,1,16243
859,2019-09-23,1042,10889,1502,1,13434
859,2019-09-24,260,8884,2142,6,11292
859,2019-09-25,147,9433,2267,1,11848
859,2019-09-26,168,11528,1004,3,12703
859,2019-09-27,133,8231,1403,1,9768
859,2019-09-28,110,15482,1387,3,16982
859,2019-09-29,232,16758,1758,0,18748
859,2019-09-30,1433,25366,965,0,27764
859,2019-10-01,509,22888,2097,2,25496
859,2019-10-02,1059,16905,1620,0,19584
859,2019-10-03,159,14619,1067,0,15845
859,2019-10-04,248,12545,1244,38,14075
859,2019-10-05,116,21434,1185,0,22735
859,2019-10-06,142,17586,2452,3,20183
859,2019-10-07,1983,6983,1567,1,10534
859,2019-10-08,278,18838,1917,3,21036
859,2019-10-09,1147,17674,1256,1,20078
859,2019-10-10,693,10992,2189,1,13875
859,2019-10-11,156,16602,1430,2,18190
859,2019-10-12,191,9769,1347,12,11319
859,2019-10-13,1042,12327,1642,0,15011
859,2019-10-14,169,6306,1709,1,8185
859,2019-10-15,1077,8617,2054,1,11749
859,2019-10-16,250,24705,912,3,25870
859,2019-10-17,171,11932,1575,0,13678
859,2019-10-18,1077,15176,1299,0,17552
859,2019-10-19,168,8942,1973,0,11083
859,2019-10-20,2132,3022,1839,2,6995
859,2019-10-21,614,10795,2114,5,13528
859,2019-10-22,229,6817,2361,0,9407
859,2019-10-23,1698,14614,1453,2,17767
859,2019-10-24,293,25684,1451,0,27428
859,2019-10-25,301,14832,2567,2,17702
859,2019-10-26,326,13426,2386,1,16139
859,2019-10-27,282,27388,1860,0,29530
859,2019-10-28,243,15924,2596,1,18764
859,2019-10-29,1713,26995,1667,1,30376
859,2019-10-30,273,29282,925,0,30480
859,2019-10-31,259,14851,1454,4,16568
859,2019-11-01,254,15247,1083,1,16585
859,2019-11-02,959,14271,1596,0,16826
859,2019-11-03,288,38056,1177,0,39521
859,2019-11-04,1222,13970,1955,0,17147
859,2019-11-05,288,3428,2530,0,6246
859,2019-11-06,684,13951,1747,0,16382
859,2019-11-07,455,16354,1790,4,18603
859,2019-11-08,291,9622,1943,0,11856
859,2019-11-09,399,8842,2146,0,11387
859,2019-11-10,1178,15058,1397,2,17635
859,2019-11-11,389,10263,1779,2,12433
859,2019-11-12,287,10885,2366,0,13538
859,2019-11-13,282,14366,1570,3,16221
859,2019-11-14,288,12954,1828,0,15070
859,2019-11-15,1210,5433,2106,0,8749
859,2019-11-16,363,2564,2619,0,5546
859,2019-11-17,334,3496,3172,0,7002
859,2019-11-18,273,2519,3486,0,6278
859,2019-11-19,819,3064,2240,0,6123
859,2019-11-20,396,1337,2475,0,4208
859,2019-11-21,285,3342,1919,0,5546
859,2019-11-22,251,9031,1311,0,10593
859,2019-11-23,526,6853,3034,0,10413
859,2019-11-24,402,5771,1967,0,8140
859,2019-11-25,877,6545,1623,0,9045
859,2019-11-26,295,5418,793,0,6506
859,2019-11-27,351,6272,1213,0,7836
859,2019-11-28,260,7971,462,0,8693
859,2019-11-29,156,163,110,0,429
859,2019-09-04,19,2,881,0,902
859,2019-09-05,213,5558,2165,0,7936
859,2019-09-06,334,10750,1140,0,12224
859,2019-09-07,163,6518,2151,0,8832
859,2019-09-08,290,4662,2438,1,7391
859,2019-09-09,952,5834,2471,0,9257
859,2019-09-10,169,8536,1343,0,10048
859,2019-09-11,222,7740,1977,1,9940
859,2019-09-12,209,6793,2243,2,9247
859,2019-09-13,99,4843,2505,2,7449
859,2019-09-14,114,5052,1988,0,7154
859,2019-09-15,145,9238,2470,2,11855
859,2019-09-16,159,15077,1816,1,17053
859,2019-09-17,967,12090,1551,0,14608
859,2019-09-18,106,11112,1449,2,12669
859,2019-09-19,278,3577,1350,0,5205
859,2019-09-20,332,10636,1856,1,12825
859,2019-09-21,141,6479,1798,0,8418
859,2019-09-22,673,13435,2134,1,16243
859,2019-09-23,1042,10889,1502,1,13434
859,2019-09-24,260,8884,2142,6,11292
859,2019-09-25,147,9433,2267,1,11848
859,2019-09-26,168,11528,1004,3,12703
859,2019-09-27,133,8231,1403,1,9768
859,2019-09-28,110,15482,1387,3,16982
859,2019-09-29,232,16758,1758,0,18748
859,2019-09-30,1433,25366,965,0,27764
859,2019-10-01,509,22888,2097,2,25496
859,2019-10-02,1059,16905,1620,0,19584
859,2019-10-03,159,14619,1067,0,15845
859,2019-10-04,248,12545,1244,38,14075
859,2019-10-05,116,21434,1185,0,22735
859,2019-10-06,142,17586,2452,3,20183
859,2019-10-07,1983,6983,1567,1,10534
859,2019-10-08,278,18838,1917,3,21036
859,2019-10-09,1147,17674,1256,1,20078
859,2019-10-10,693,10992,2189,1,13875
859,2019-10-11,156,16602,1430,2,18190
859,2019-10-12,191,9769,1347,12,11319
859,2019-10-13,1042,12327,1642,0,15011
859,2019-10-14,169,6306,1709,1,8185
859,2019-10-15,1077,8617,2054,1,11749
859,2019-10-16,250,24705,912,3,25870
859,2019-10-17,171,11932,1575,0,13678
859,2019-10-18,1077,15176,1299,0,17552
859,2019-10-19,168,8942,1973,0,11083
859,2019-10-20,2132,3022,1839,2,6995
859,2019-10-21,614,10795,2114,5,13528
859,2019-10-22,229,6817,2361,0,9407
859,2019-10-23,1698,14614,1453,2,17767
859,2019-10-24,293,25684,1451,0,27428
859,2019-10-25,301,14832,2567,2,17702
859,2019-10-26,326,13426,2386,1,16139
859,2019-10-27,282,27388,1860,0,29530
859,2019-10-28,243,15924,2596,1,18764
859,2019-10-29,1713,26995,1667,1,30376
859,2019-10-30,273,29282,925,0,30480
859,2019-10-31,259,14851,1454,4,16568
859,2019-11-01,254,15247,1083,1,16585
859,2019-11-02,959,14271,1596,0,16826
859,2019-11-03,288,38056,1177,0,39521
859,2019-11-04,1222,13970,1955,0,17147
859,2019-11-05,288,3428,2530,0,6246
859,2019-11-06,684,13951,1747,0,16382
859,2019-11-07,455,16354,1790,4,18603
859,2019-11-08,291,9622,1943,0,11856
859,2019-11-09,399,8842,2146,0,11387
859,2019-11-10,1178,15058,1397,2,17635
859,2019-11-11,389,10263,1779,2,12433
859,2019-11-12,287,10885,2366,0,13538
859,2019-11-13,282,14366,1570,3,16221
859,2019-11-14,288,12954,1828,0,15070
859,2019-11-15,1210,5433,2106,0,8749
859,2019-11-16,363,2564,2619,0,5546
859,2019-11-17,334,3496,3172,0,7002
859,2019-11-18,273,2519,3486,0,6278
859,2019-11-19,819,3064,2240,0,6123
859,2019-11-20,396,1337,2475,0,4208
859,2019-11-21,285,3342,1919,0,5546
859,2019-11-22,251,9031,1311,0,10593
859,2019-11-23,526,6853,3034,0,10413
859,2019-11-24,402,5771,1967,0,8140
859,2019-11-25,877,6545,1623,0,9045
859,2019-11-26,295,5418,793,0,6506
859,2019-11-27,351,6272,1213,0,7836
859,2019-11-28,260,7971,462,0,8693
859,2019-11-29,156,163,110,0,429
859,2019-09-08,290,4662,2438,1,7391
859,2019-09-09,952,5834,2471,0,9257
859,2019-09-10,169,8536,1343,0,10048
859,2019-09-11,222,7740,1977,1,9940
859,2019-09-12,209,6793,2243,2,9247
859,2019-09-13,99,4843,2505,2,7449
859,2019-09-14,114,5052,1988,0,7154
859,2019-09-15,145,9238,2470,2,11855
859,2019-09-16,159,15077,1816,1,17053
859,2019-09-17,967,12090,1551,0,14608
859,2019-09-18,106,11112,1449,2,12669
859,2019-09-19,278,3577,1350,0,5205
859,2019-09-20,332,10636,1856,1,12825
859,2019-09-21,141,6479,1798,0,8418
859,2019-09-22,673,13435,2134,1,16243
859,2019-09-23,1042,10889,1502,1,13434
859,2019-09-24,260,8884,2142,6,11292
859,2019-09-25,147,9433,2267,1,11848
859,2019-09-26,168,11528,1004,3,12703
859,2019-09-27,133,8231,1403,1,9768
859,2019-09-28,110,15482,1387,3,16982
859,2019-09-29,232,16758,1758,0,18748
859,2019-09-30,1433,25366,965,0,27764
859,2019-10-01,509,22888,2097,2,25496
859,2019-10-02,1059,16905,1620,0,19584
859,2019-10-03,159,14619,1067,0,15845
859,2019-10-04,248,12545,1244,38,14075
859,2019-10-05,116,21434,1185,0,22735
859,2019-10-06,142,17586,2452,3,20183
859,2019-10-07,1983,6983,1567,1,10534
859,2019-10-08,278,18838,1917,3,21036
859,2019-10-09,1147,17674,1256,1,20078
859,2019-10-10,693,10992,2189,1,13875
859,2019-10-11,156,16602,1430,2,18190
859,2019-10-12,191,9769,1347,12,11319
859,2019-10-13,1042,12327,1642,0,15011
859,2019-10-14,169,6306,1709,1,8185
859,2019-10-15,1077,8617,2054,1,11749
859,2019-10-16,250,24705,912,3,25870
859,2019-10-17,171,11932,1575,0,13678
859,2019-10-18,1077,15176,1299,0,17552
859,2019-10-19,168,8942,1973,0,11083
859,2019-10-20,2132,3022,1839,2,6995
859,2019-10-21,614,10795,2114,5,13528
859,2019-10-22,229,6817,2361,0,9407
859,2019-10-23,1698,14614,1453,2,17767
859,2019-10-24,293,25684,1451,0,27428
859,2019-10-25,301,14832,2567,2,17702
859,2019-10-26,326,13426,2386,1,16139
859,2019-10-27,282,27388,1860,0,29530
859,2019-10-28,243,15924,2596,1,18764
859,2019-10-29,1713,26995,1667,1,30376
859,2019-10-30,273,29282,925,0,30480
859,2019-10-31,259,14851,1454,4,16568
859,2019-11-01,254,15247,1083,1,16585
859,2019-11-02,959,14271,1596,0,16826
859,2019-11-03,288,38056,1177,0,39521
859,2019-11-04,1222,13970,1955,0,17147
859,2019-11-05,288,3428,2530,0,6246
859,2019-11-06,684,13951,1747,0,16382
859,2019-11-07,455,16354,1790,4,18603
859,2019-11-08,291,9622,1943,0,11856
859,2019-11-09,399,8842,2146,0,11387
859,2019-11-10,1178,15058,1397,2,17635
859,2019-11-11,389,10263,1779,2,12433
859,2019-11-12,287,10885,2366,0,13538
859,2019-11-13,282,14366,1570,3,16221
860,2019-09-04,772,12,1297,0,2081
860,2019-09-05,378,9421,1585,0,11384
860,2019-09-06,435,17508,2023,0,19966
860,2019-09-07,308,11255,2271,1,13835
860,2019-09-08,321,10893,1146,1,12361
860,2019-09-09,1047,5952,1569,0,8568
860,2019-09-10,262,7776,1791,2,9831
860,2019-09-11,1673,9205,1657,2,12537
860,2019-09-12,196,6179,1756,1,8132
860,2019-09-13,165,3965,2015,0,6145
860,2019-09-14,137,7042,1954,1,9134
860,2019-09-15,125,6975,2146,1,9247
860,2019-09-16,264,13336,2641,2,16243
860,2019-09-17,162,10875,1717,0,12754
860,2019-09-18,101,11409,1259,1,12770
860,2019-09-19,316,3442,2128,0,5886
860,2019-09-20,267,10594,1459,0,12320
860,2019-09-21,141,7024,1894,0,9059
860,2019-09-22,134,14983,1911,0,17028
860,2019-09-23,182,12779,1507,1,14469
860,2019-09-24,157,12324,2582,3,15066
860,2019-09-25,140,10417,2269,1,12827
860,2019-09-26,155,11256,2491,3,13905
860,2019-09-27,117,23475,1353,2,24947
860,2019-09-28,122,32165,1174,2,33463
860,2019-09-29,990,35647,2317,0,38954
860,2019-09-30,104,32910,2258,0,35272
860,2019-10-01,120,25094,1578,1,26793
860,2019-10-02,683,17573,1931,0,20187
860,2019-10-03,761,22376,1015,28,24180
860,2019-10-04,202,14392,1392,29,16015
860,2019-10-05,108,23568,1403,0,25079
860,2019-10-06,749,22253,1657,3,24662
860,2019-10-07,192,7182,1990,0,9364
860,2019-10-08,272,18325,1026,1,19624
860,2019-10-09,147,16127,1647,1,17922
860,2019-10-10,278,11034,1601,3,12916
860,2019-10-11,126,12418,1551,5,14100
860,2019-10-12,226,7926,1891,0,10043
860,2019-10-13,229,8692,1380,1,10302
860,2019-10-14,1178,28310,2031,1,31520
860,2019-10-15,440,17577,1892,1,19910
860,2019-10-16,99,18269,2096,2,20466
860,2019-10-17,989,8396,1950,0,11335
860,2019-10-18,119,9328,1955,1,11403
860,2019-10-19,978,5637,2096,1,8712
860,2019-10-20,944,2938,2161,0,6043
860,2019-10-21,215,10479,1391,5,12090
860,2019-10-22,128,6525,1596,3,8252
860,2019-10-23,967,14470,1607,1,17045
860,2019-10-24,117,25959,1880,1,27957
860,2019-10-25,108,19631,921,2,20662
860,2019-10-26,2179,25633,1549,0,29361
860,2019-10-27,883,30933,1829,0,33645
860,2019-10-28,86,25695,2404,0,28185
860,2019-10-29,181,29534,964,0,30679
860,2019-10-30,100,21277,1031,1,22409
860,2019-10-31,1025,20616,1480,4,23125
860,2019-11-01,179,27382,1752,0,29313
860,2019-11-02,120,16887,1792,44,18843
860,2019-11-03,852,37524,1113,0,39489
860,2019-11-04,1621,11372,1311,1,14305
860,2019-11-05,140,3930,2326,0,6396
860,2019-11-06,1479,8922,1089,1,11491
860,2019-11-07,195,13983,946,5,15129
860,2019-11-08,864,10641,1662,0,13167
860,2019-11-09,332,9392,2135,1,11860
860,2019-11-10,161,14419,1881,2,16463
860,2019-11-11,257,10038,1699,3,11997
860,2019-11-12,158,10924,2361,1,13444
860,2019-11-13,131,21379,1656,2,23168
860,2019-11-14,83,10642,2397,1,13123
860,2019-11-15,130,4048,1799,0,5977
860,2019-11-16,92,2633,2448,1,5174
860,2019-11-17,84,4108,3533,0,7725
860,2019-11-18,1420,3298,3077,1,7796
860,2019-11-19,166,4809,3204,1,8180
860,2019-11-20,1303,1509,2626,2,5440
860,2019-11-21,141,5497,1684,0,7322
860,2019-11-22,122,5810,1499,2,7433
860,2019-11-23,540,5968,2180,1,8689
860,2019-11-24,291,7977,2183,1,10452
860,2019-11-25,108,11295,1435,0,12838
860,2019-11-26,144,8190,1639,2,9975
860,2019-11-27,63,6306,1809,1,8179
860,2019-11-28,85,8381,512,0,8978
860,2019-11-29,30,802,0,0,832
860,2019-09-04,772,12,1297,0,2081
860,2019-09-05,378,9421,1585,0,11384
860,2019-09-06,435,17508,2023,0,19966
860,2019-09-07,308,11255,2271,1,13835
860,2019-09-08,321,10893,1146,1,12361
860,2019-09-09,1047,5952,1569,0,8568
860,2019-09-10,262,7776,1791,2,9831
860,2019-09-11,1673,9205,1657,2,12537
860,2019-09-12,196,6179,1756,1,8132
860,2019-09-13,165,3965,2015,0,6145
860,2019-09-14,137,7042,1954,1,9134
860,2019-09-15,125,6975,2146,1,9247
860,2019-09-16,264,13336,2641,2,16243
860,2019-09-17,162,10875,1717,0,12754
860,2019-09-18,101,11409,1259,1,12770
860,2019-09-19,316,3442,2128,0,5886
860,2019-09-20,267,10594,1459,0,12320
860,2019-09-21,141,7024,1894,0,9059
860,2019-09-22,134,14983,1911,0,17028
860,2019-09-23,182,12779,1507,1,14469
860,2019-09-24,157,12324,2582,3,15066
860,2019-09-25,140,10417,2269,1,12827
860,2019-09-26,155,11256,2491,3,13905
860,2019-09-27,117,23475,1353,2,24947
860,2019-09-28,122,32165,1174,2,33463
860,2019-09-29,990,35647,2317,0,38954
860,2019-09-30,104,32910,2258,0,35272
860,2019-10-01,120,25094,1578,1,26793
860,2019-10-02,683,17573,1931,0,20187
860,2019-10-03,761,22376,1015,28,24180
860,2019-10-04,202,14392,1392,29,16015
860,2019-10-05,108,23568,1403,0,25079
860,2019-10-06,749,22253,1657,3,24662
860,2019-10-07,192,7182,1990,0,9364
860,2019-10-08,272,18325,1026,1,19624
860,2019-10-09,147,16127,1647,1,17922
860,2019-10-10,278,11034,1601,3,12916
860,2019-10-11,126,12418,1551,5,14100
860,2019-10-12,226,7926,1891,0,10043
860,2019-10-13,229,8692,1380,1,10302
860,2019-10-14,1178,28310,2031,1,31520
860,2019-10-15,440,17577,1892,1,19910
860,2019-10-16,99,18269,2096,2,20466
860,2019-10-17,989,8396,1950,0,11335
860,2019-10-18,119,9328,1955,1,11403
860,2019-10-19,978,5637,2096,1,8712
860,2019-10-20,944,2938,2161,0,6043
860,2019-10-21,215,10479,1391,5,12090
860,2019-10-22,128,6525,1596,3,8252
860,2019-10-23,967,14470,1607,1,17045
860,2019-10-24,117,25959,1880,1,27957
860,2019-10-25,108,19631,921,2,20662
860,2019-10-26,2179,25633,1549,0,29361
860,2019-10-27,883,30933,1829,0,33645
860,2019-10-28,86,25695,2404,0,28185
860,2019-10-29,181,29534,964,0,30679
860,2019-10-30,100,21277,1031,1,22409
860,2019-10-31,1025,20616,1480,4,23125
860,2019-11-01,179,27382,1752,0,29313
860,2019-11-02,120,16887,1792,44,18843
860,2019-11-03,852,37524,1113,0,39489
860,2019-11-04,1621,11372,1311,1,14305
860,2019-11-05,140,3930,2326,0,6396
860,2019-11-06,1479,8922,1089,1,11491
860,2019-11-07,195,13983,946,5,15129
860,2019-11-08,864,10641,1662,0,13167
860,2019-11-09,332,9392,2135,1,11860
860,2019-11-10,161,14419,1881,2,16463
860,2019-11-11,257,10038,1699,3,11997
860,2019-11-12,158,10924,2361,1,13444
860,2019-11-13,131,21379,1656,2,23168
860,2019-11-14,83,10642,2397,1,13123
860,2019-11-15,130,4048,1799,0,5977
860,2019-11-16,92,2633,2448,1,5174
860,2019-11-17,84,4108,3533,0,7725
860,2019-11-18,1420,3298,3077,1,7796
860,2019-11-19,166,4809,3204,1,8180
860,2019-11-20,1303,1509,2626,2,5440
860,2019-11-21,141,5497,1684,0,7322
860,2019-11-22,122,5810,1499,2,7433
860,2019-11-23,540,5968,2180,1,8689
860,2019-11-24,291,7977,2183,1,10452
860,2019-11-25,108,11295,1435,0,12838
860,2019-11-26,144,8190,1639,2,9975
860,2019-11-27,63,6306,1809,1,8179
860,2019-11-28,85,8381,512,0,8978
860,2019-11-29,30,802,0,0,832
860,2019-09-04,772,12,1297,0,2081
860,2019-09-05,378,9421,1585,0,11384
860,2019-09-06,435,17508,2023,0,19966
860,2019-09-07,308,11255,2271,1,13835
860,2019-09-08,321,10893,1146,1,12361
860,2019-09-09,1047,5952,1569,0,8568
860,2019-09-10,262,7776,1791,2,9831
860,2019-09-11,1673,9205,1657,2,12537
860,2019-09-12,196,6179,1756,1,8132
860,2019-09-13,165,3965,2015,0,6145
860,2019-09-14,137,7042,1954,1,9134
860,2019-09-15,125,6975,2146,1,9247
860,2019-09-16,264,13336,2641,2,16243
860,2019-09-17,162,10875,1717,0,12754
860,2019-09-18,101,11409,1259,1,12770
860,2019-09-19,316,3442,2128,0,5886
860,2019-09-20,267,10594,1459,0,12320
860,2019-09-21,141,7024,1894,0,9059
860,2019-09-22,134,14983,1911,0,17028
860,2019-09-23,182,12779,1507,1,14469
860,2019-09-24,157,12324,2582,3,15066
860,2019-09-25,140,10417,2269,1,12827
860,2019-09-26,155,11256,2491,3,13905
860,2019-09-27,117,23475,1353,2,24947
860,2019-09-28,122,32165,1174,2,33463
860,2019-09-29,990,35647,2317,0,38954
860,2019-09-30,104,32910,2258,0,35272
860,2019-10-01,120,25094,1578,1,26793
860,2019-10-02,683,17573,1931,0,20187
860,2019-10-03,761,22376,1015,28,24180
860,2019-10-04,202,14392,1392,29,16015
860,2019-10-05,108,23568,1403,0,25079
860,2019-10-06,749,22253,1657,3,24662
860,2019-10-07,192,7182,1990,0,9364
860,2019-10-08,272,18325,1026,1,19624
860,2019-10-09,147,16127,1647,1,17922
860,2019-10-10,278,11034,1601,3,12916
860,2019-10-11,126,12418,1551,5,14100
860,2019-10-12,226,7926,1891,0,10043
860,2019-10-13,229,8692,1380,1,10302
860,2019-10-14,1178,28310,2031,1,31520
860,2019-10-15,440,17577,1892,1,19910
860,2019-10-16,99,18269,2096,2,20466
860,2019-10-17,989,8396,1950,0,11335
860,2019-10-18,119,9328,1955,1,11403
860,2019-10-19,978,5637,2096,1,8712
860,2019-10-20,944,2938,2161,0,6043
860,2019-10-21,215,10479,1391,5,12090
860,2019-10-22,128,6525,1596,3,8252
860,2019-10-23,967,14470,1607,1,17045
860,2019-10-24,117,25959,1880,1,27957
860,2019-10-25,108,19631,921,2,20662
860,2019-10-26,2179,25633,1549,0,29361
860,2019-10-27,883,30933,1829,0,33645
860,2019-10-28,86,25695,2404,0,28185
860,2019-10-29,181,29534,964,0,30679
860,2019-10-30,100,21277,1031,1,22409
860,2019-10-31,1025,20616,1480,4,23125
860,2019-11-01,179,27382,1752,0,29313
860,2019-11-02,120,16887,1792,44,18843
860,2019-11-03,852,37524,1113,0,39489
860,2019-11-04,1621,11372,1311,1,14305
860,2019-11-05,140,3930,2326,0,6396
860,2019-11-06,1479,8922,1089,1,11491
860,2019-11-07,195,13983,946,5,15129
860,2019-11-08,864,10641,1662,0,13167
860,2019-11-09,332,9392,2135,1,11860
860,2019-11-10,161,14419,1881,2,16463
860,2019-11-11,257,10038,1699,3,11997
860,2019-11-12,158,10924,2361,1,13444
860,2019-11-13,131,21379,1656,2,23168
860,2019-11-14,83,10642,2397,1,13123
860,2019-11-15,130,4048,1799,0,5977
860,2019-11-16,92,2633,2448,1,5174
860,2019-11-17,84,4108,3533,0,7725
860,2019-11-18,1420,3298,3077,1,7796
860,2019-11-19,166,4809,3204,1,8180
860,2019-11-20,1303,1509,2626,2,5440
860,2019-11-21,141,5497,1684,0,7322
860,2019-11-22,122,5810,1499,2,7433
860,2019-11-23,540,5968,2180,1,8689
860,2019-11-24,291,7977,2183,1,10452
860,2019-11-25,108,11295,1435,0,12838
860,2019-11-26,144,8190,1639,2,9975
860,2019-11-27,63,6306,1809,1,8179
860,2019-11-28,85,8381,512,0,8978
860,2019-09-07,308,11255,2271,1,13835
860,2019-09-08,321,10893,1146,1,12361
860,2019-09-09,1047,5952,1569,0,8568
860,2019-09-10,262,7776,1791,2,9831
860,2019-09-11,1673,9205,1657,2,12537
860,2019-09-12,196,6179,1756,1,8132
860,2019-09-13,165,3965,2015,0,6145
860,2019-09-14,137,7042,1954,1,9134
860,2019-09-15,125,6975,2146,1,9247
860,2019-09-16,264,13336,2641,2,16243
860,2019-09-17,162,10875,1717,0,12754
860,2019-09-18,101,11409,1259,1,12770
860,2019-09-19,316,3442,2128,0,5886
860,2019-09-20,267,10594,1459,0,12320
860,2019-09-21,141,7024,1894,0,9059
860,2019-09-22,134,14983,1911,0,17028
860,2019-09-23,182,12779,1507,1,14469
860,2019-09-24,157,12324,2582,3,15066
860,2019-09-25,140,10417,2269,1,12827
860,2019-09-26,155,11256,2491,3,13905
860,2019-09-27,117,23475,1353,2,24947
860,2019-09-28,122,32165,1174,2,33463
860,2019-09-29,990,35647,2317,0,38954
860,2019-09-30,104,32910,2258,0,35272
860,2019-10-01,120,25094,1578,1,26793
860,2019-10-02,683,17573,1931,0,20187
860,2019-10-03,761,22376,1015,28,24180
860,2019-10-04,202,14392,1392,29,16015
860,2019-10-05,108,23568,1403,0,25079
860,2019-10-06,749,22253,1657,3,24662
860,2019-10-07,192,7182,1990,0,9364
860,2019-10-08,272,18325,1026,1,19624
860,2019-10-09,147,16127,1647,1,17922
860,2019-10-10,278,11034,1601,3,12916
860,2019-10-11,126,12418,1551,5,14100
860,2019-10-12,226,7926,1891,0,10043
860,2019-10-13,229,8692,1380,1,10302
860,2019-10-14,1178,28310,2031,1,31520
860,2019-10-15,440,17577,1892,1,19910
860,2019-10-16,99,18269,2096,2,20466
860,2019-10-17,989,8396,1950,0,11335
860,2019-10-18,119,9328,1955,1,11403
860,2019-10-19,978,5637,2096,1,8712
860,2019-10-20,944,2938,2161,0,6043
860,2019-10-21,215,10479,1391,5,12090
860,2019-10-22,128,6525,1596,3,8252
860,2019-10-23,967,14470,1607,1,17045
860,2019-10-24,117,25959,1880,1,27957
860,2019-10-25,108,19631,921,2,20662
860,2019-10-26,2179,25633,1549,0,29361
860,2019-10-27,883,30933,1829,0,33645
860,2019-10-28,86,25695,2404,0,28185
860,2019-10-29,181,29534,964,0,30679
860,2019-10-30,100,21277,1031,1,22409
860,2019-10-31,1025,20616,1480,4,23125
860,2019-11-01,179,27382,1752,0,29313
860,2019-11-02,120,16887,1792,44,18843
860,2019-11-03,852,37524,1113,0,39489
860,2019-11-04,1621,11372,1311,1,14305
860,2019-11-05,140,3930,2326,0,6396
860,2019-11-06,1479,8922,1089,1,11491
860,2019-11-07,195,13983,946,5,15129
860,2019-11-08,864,10641,1662,0,13167
860,2019-11-09,332,9392,2135,1,11860
860,2019-11-10,161,14419,1881,2,16463
860,2019-11-11,257,10038,1699,3,11997
860,2019-11-12,158,10924,2361,1,13444
860,2019-11-13,131,21379,1656,2,23168
860,2019-11-14,83,10642,2397,1,13123
860,2019-11-15,130,4048,1799,0,5977
860,2019-11-16,92,2633,2448,1,5174
860,2019-11-17,84,4108,3533,0,7725
860,2019-11-18,1420,3298,3077,1,7796
860,2019-11-19,166,4809,3204,1,8180
860,2019-11-20,1303,1509,2626,2,5440
860,2019-11-21,141,5497,1684,0,7322
860,2019-11-22,122,5810,1499,2,7433
860,2019-11-23,540,5968,2180,1,8689
860,2019-11-24,291,7977,2183,1,10452
860,2019-11-25,108,11295,1435,0,12838
860,2019-11-26,144,8190,1639,2,9975
860,2019-11-27,63,6306,1809,1,8179
861,2019-09-04,66,0,739,0,805
861,2019-09-05,1163,0,2091,0,3254
861,2019-09-06,1759,0,2463,1,4223
861,2019-09-07,2856,0,1776,0,4632
861,2019-09-08,1421,0,2068,0,3489
861,2019-09-09,923,0,2305,2,3230
861,2019-09-10,1004,0,2368,1,3373
861,2019-09-11,2776,0,1718,1,4495
861,2019-09-12,2205,0,2345,1,4551
861,2019-09-13,1106,0,2708,1,3815
861,2019-09-14,1261,0,2872,0,4133
861,2019-09-15,1031,0,1750,1,2782
861,2019-09-16,2654,0,2203,2,4859
861,2019-09-17,1008,0,2134,0,3142
861,2019-09-18,1097,0,1438,0,2535
861,2019-09-19,1225,0,1204,2,2431
861,2019-09-20,1336,0,2162,0,3498
861,2019-09-21,1046,0,1747,1,2794
861,2019-09-22,1194,0,1600,0,2794
861,2019-09-23,1167,0,2341,0,3508
861,2019-09-24,1568,0,1801,5,3374
861,2019-09-25,1865,0,1739,7,3611
861,2019-09-26,2010,0,1773,2,3785
861,2019-09-27,2070,0,2078,2,4150
861,2019-09-28,1780,0,1697,3,3480
861,2019-09-29,1977,0,1332,4,3313
861,2019-09-30,1948,0,1920,1,3869
861,2019-10-01,1145,0,1881,1,3027
861,2019-10-02,1642,0,2250,0,3892
861,2019-10-03,849,0,1637,0,2486
861,2019-10-04,1545,0,2019,2,3566
861,2019-10-05,1451,0,1389,2,2842
861,2019-10-06,2127,0,1372,0,3499
861,2019-10-07,1932,0,1510,3,3445
861,2019-10-08,2821,0,1718,1,4540
861,2019-10-09,1730,0,1057,3,2790
861,2019-10-10,906,0,1756,0,2662
861,2019-10-11,1670,0,1653,0,3323
861,2019-10-12,1820,0,1343,0,3163
861,2019-10-13,851,0,1505,2,2358
861,2019-10-14,880,0,2800,6471,10151
861,2019-10-15,793,0,1912,2,2707
861,2019-10-16,1032,0,1718,0,2750
861,2019-10-17,1023,0,1661,1,2685
861,2019-10-18,921,0,2044,2,2967
861,2019-10-19,2224,0,3618,0,5842
861,2019-10-20,1858,0,3066,0,4924
861,2019-10-21,1752,0,1651,1,3404
861,2019-10-22,1518,0,2322,0,3840
861,2019-10-23,1437,0,1034,1,2472
861,2019-10-24,1855,0,1423,3,3281
861,2019-10-25,1437,0,1875,1,3313
861,2019-10-26,1906,0,2511,0,4417
861,2019-10-27,1679,0,741,0,2420
861,2019-10-28,1238,0,1148,0,2386
861,2019-10-29,1143,0,1320,4,2467
861,2019-10-30,1345,0,1041,0,2386
861,2019-10-31,839,0,1413,0,2252
861,2019-11-01,1080,0,1840,0,2920
861,2019-11-02,1420,0,1400,1,2821
861,2019-11-03,1377,0,918,1,2296
861,2019-11-04,1429,0,1089,0,2518
861,2019-11-05,1262,0,1757,0,3019
861,2019-11-06,1868,0,1167,0,3035
861,2019-11-07,1050,0,957,0,2007
861,2019-11-08,797,0,915,0,1712
861,2019-11-09,1867,0,1737,0,3604
861,2019-11-10,1115,0,2227,0,3342
861,2019-11-11,1235,0,2081,0,3316
861,2019-11-12,2548,0,2987,0,5535
861,2019-11-13,894,0,1746,0,2640
861,2019-11-14,1733,0,1648,0,3381
861,2019-11-15,983,0,2508,0,3491
861,2019-11-16,1444,0,1652,0,3096
861,2019-11-17,1956,0,2960,0,4916
861,2019-11-18,850,0,2533,0,3383
861,2019-11-19,1154,0,2478,0,3632
861,2019-11-20,1806,0,1731,0,3537
861,2019-11-21,1023,0,1529,0,2552
861,2019-11-22,789,0,1891,0,2680
861,2019-11-23,902,0,1826,0,2728
861,2019-11-24,1568,0,1543,0,3111
861,2019-11-25,1225,0,1112,0,2337
861,2019-11-26,2086,0,1240,0,3326
861,2019-11-27,1154,0,1217,0,2371
861,2019-11-28,1152,0,612,0,1764
861,2019-09-04,66,0,739,0,805
861,2019-09-05,1163,0,2091,0,3254
861,2019-09-06,1759,0,2463,1,4223
861,2019-09-07,2856,0,1776,0,4632
861,2019-09-08,1421,0,2068,0,3489
861,2019-09-09,923,0,2305,2,3230
861,2019-09-10,1004,0,2368,1,3373
861,2019-09-11,2776,0,1718,1,4495
861,2019-09-12,2205,0,2345,1,4551
861,2019-09-13,1106,0,2708,1,3815
861,2019-09-14,1261,0,2872,0,4133
861,2019-09-15,1031,0,1750,1,2782
861,2019-09-16,2654,0,2203,2,4859
861,2019-09-17,1008,0,2134,0,3142
861,2019-09-18,1097,0,1438,0,2535
861,2019-09-19,1225,0,1204,2,2431
861,2019-09-20,1336,0,2162,0,3498
861,2019-09-21,1046,0,1747,1,2794
861,2019-09-22,1194,0,1600,0,2794
861,2019-09-23,1167,0,2341,0,3508
861,2019-09-24,1568,0,1801,5,3374
861,2019-09-25,1865,0,1739,7,3611
861,2019-09-26,2010,0,1773,2,3785
861,2019-09-27,2070,0,2078,2,4150
861,2019-09-28,1780,0,1697,3,3480
861,2019-09-29,1977,0,1332,4,3313
861,2019-09-30,1948,0,1920,1,3869
861,2019-10-01,1145,0,1881,1,3027
861,2019-10-02,1642,0,2250,0,3892
861,2019-10-03,849,0,1637,0,2486
861,2019-10-04,1545,0,2019,2,3566
861,2019-10-05,1451,0,1389,2,2842
861,2019-10-06,2127,0,1372,0,3499
861,2019-10-07,1932,0,1510,3,3445
861,2019-10-08,2821,0,1718,1,4540
861,2019-10-09,1730,0,1057,3,2790
861,2019-10-10,906,0,1756,0,2662
861,2019-10-11,1670,0,1653,0,3323
861,2019-10-12,1820,0,1343,0,3163
861,2019-10-13,851,0,1505,2,2358
861,2019-10-14,880,0,2800,6471,10151
861,2019-10-15,793,0,1912,2,2707
861,2019-10-16,1032,0,1718,0,2750
861,2019-10-17,1023,0,1661,1,2685
861,2019-10-18,921,0,2044,2,2967
861,2019-10-19,2224,0,3618,0,5842
861,2019-10-20,1858,0,3066,0,4924
861,2019-10-21,1752,0,1651,1,3404
861,2019-10-22,1518,0,2322,0,3840
861,2019-10-23,1437,0,1034,1,2472
861,2019-10-24,1855,0,1423,3,3281
861,2019-10-25,1437,0,1875,1,3313
861,2019-10-26,1906,0,2511,0,4417
861,2019-10-27,1679,0,741,0,2420
861,2019-10-28,1238,0,1148,0,2386
861,2019-10-29,1143,0,1320,4,2467
861,2019-10-30,1345,0,1041,0,2386
861,2019-10-31,839,0,1413,0,2252
861,2019-11-01,1080,0,1840,0,2920
861,2019-11-02,1420,0,1400,1,2821
861,2019-11-03,1377,0,918,1,2296
861,2019-11-04,1429,0,1089,0,2518
861,2019-11-05,1262,0,1757,0,3019
861,2019-11-06,1868,0,1167,0,3035
861,2019-11-07,1050,0,957,0,2007
861,2019-11-08,797,0,915,0,1712
861,2019-11-09,1867,0,1737,0,3604
861,2019-11-10,1115,0,2227,0,3342
861,2019-11-11,1235,0,2081,0,3316
861,2019-11-12,2548,0,2987,0,5535
861,2019-11-13,894,0,1746,0,2640
861,2019-11-14,1733,0,1648,0,3381
861,2019-11-15,983,0,2508,0,3491
861,2019-11-16,1444,0,1652,0,3096
861,2019-11-17,1956,0,2960,0,4916
861,2019-11-18,850,0,2533,0,3383
861,2019-11-19,1154,0,2478,0,3632
861,2019-11-20,1806,0,1731,0,3537
861,2019-11-21,1023,0,1529,0,2552
861,2019-11-22,789,0,1891,0,2680
861,2019-11-23,902,0,1826,0,2728
861,2019-11-24,1568,0,1543,0,3111
861,2019-11-25,1225,0,1112,0,2337
861,2019-11-26,2086,0,1240,0,3326
861,2019-11-27,1154,0,1217,0,2371
861,2019-11-28,1152,0,612,0,1764
861,2019-09-06,1759,0,2463,1,4223
861,2019-09-07,2856,0,1776,0,4632
861,2019-09-08,1421,0,2068,0,3489
861,2019-09-09,923,0,2305,2,3230
861,2019-09-10,1004,0,2368,1,3373
861,2019-09-11,2776,0,1718,1,4495
861,2019-09-12,2205,0,2345,1,4551
861,2019-09-13,1106,0,2708,1,3815
861,2019-09-14,1261,0,2872,0,4133
861,2019-09-15,1031,0,1750,1,2782
861,2019-09-16,2654,0,2203,2,4859
861,2019-09-17,1008,0,2134,0,3142
861,2019-09-18,1097,0,1438,0,2535
861,2019-09-19,1225,0,1204,2,2431
861,2019-09-20,1336,0,2162,0,3498
861,2019-09-21,1046,0,1747,1,2794
861,2019-09-22,1194,0,1600,0,2794
861,2019-09-23,1167,0,2341,0,3508
861,2019-09-24,1568,0,1801,5,3374
861,2019-09-25,1865,0,1739,7,3611
861,2019-09-26,2010,0,1773,2,3785
861,2019-09-27,2070,0,2078,2,4150
861,2019-09-28,1780,0,1697,3,3480
861,2019-09-29,1977,0,1332,4,3313
861,2019-09-30,1948,0,1920,1,3869
861,2019-10-01,1145,0,1881,1,3027
861,2019-10-02,1642,0,2250,0,3892
861,2019-10-03,849,0,1637,0,2486
861,2019-10-04,1545,0,2019,2,3566
861,2019-10-05,1451,0,1389,2,2842
861,2019-10-06,2127,0,1372,0,3499
861,2019-10-07,1932,0,1510,3,3445
861,2019-10-08,2821,0,1718,1,4540
861,2019-10-09,1730,0,1057,3,2790
861,2019-10-10,906,0,1756,0,2662
861,2019-10-11,1670,0,1653,0,3323
861,2019-10-12,1820,0,1343,0,3163
861,2019-10-13,851,0,1505,2,2358
861,2019-10-14,880,0,2800,6471,10151
861,2019-10-15,793,0,1912,2,2707
861,2019-10-16,1032,0,1718,0,2750
861,2019-10-17,1023,0,1661,1,2685
861,2019-10-18,921,0,2044,2,2967
861,2019-10-19,2224,0,3618,0,5842
861,2019-10-20,1858,0,3066,0,4924
861,2019-10-21,1752,0,1651,1,3404
861,2019-10-22,1518,0,2322,0,3840
861,2019-10-23,1437,0,1034,1,2472
861,2019-10-24,1855,0,1423,3,3281
861,2019-10-25,1437,0,1875,1,3313
861,2019-10-26,1906,0,2511,0,4417
861,2019-10-27,1679,0,741,0,2420
861,2019-10-28,1238,0,1148,0,2386
861,2019-10-29,1143,0,1320,4,2467
861,2019-10-30,1345,0,1041,0,2386
861,2019-10-31,839,0,1413,0,2252
861,2019-11-01,1080,0,1840,0,2920
861,2019-11-02,1420,0,1400,1,2821
861,2019-11-03,1377,0,918,1,2296
862,2019-09-04,33,0,1026,1,1060
862,2019-09-05,394,0,1899,1,2294
862,2019-09-06,457,0,2165,1,2623
862,2019-09-07,620,0,1730,0,2350
862,2019-09-08,1118,0,2049,1,3168
862,2019-09-09,382,0,2267,1,2650
862,2019-09-10,244,0,1814,2,2060
862,2019-09-11,460,0,2269,1,2730
862,2019-09-12,1139,0,2075,2,3216
862,2019-09-13,565,0,1749,1,2315
862,2019-09-14,328,0,1672,1,2001
862,2019-09-15,1127,0,2409,1,3537
862,2019-09-16,305,0,2413,1,2719
862,2019-09-17,1913,0,2610,0,4523
862,2019-09-18,359,0,1629,0,1988
862,2019-09-19,737,0,1810,3,2550
862,2019-09-20,411,0,1298,0,1709
862,2019-09-21,889,0,1858,0,2747
862,2019-09-22,1383,0,2256,0,3639
862,2019-09-23,324,0,2355,1,2680
862,2019-09-24,403,0,1603,2,2008
862,2019-09-25,174,0,1702,2,1878
862,2019-09-26,1012,0,1137,4,2153
862,2019-09-27,136,0,2187,4,2327
862,2019-09-28,971,0,2049,2,3022
862,2019-09-29,151,0,2119,1,2271
862,2019-09-30,160,0,2157,0,2317
862,2019-10-01,1884,0,1487,1,3372
862,2019-10-02,259,0,1790,2,2051
862,2019-10-03,723,0,1750,1,2474
862,2019-10-04,140,0,1426,1,1567
862,2019-10-05,159,0,1206,1,1366
862,2019-10-06,139,0,1781,1,1921
862,2019-10-07,1027,0,1334,0,2361
862,2019-10-08,1055,0,2370,1,3426
862,2019-10-09,3180,0,1617,0,4797
862,2019-10-10,285,0,2166,1,2452
862,2019-10-11,921,0,1807,3,2731
862,2019-10-12,242,0,1562,1,1805
862,2019-10-13,1156,0,1324,0,2480
862,2019-10-14,1112,0,1568,1,2681
862,2019-10-15,1075,0,1342,1,2418
862,2019-10-16,269,0,1490,3,1762
862,2019-10-17,272,0,2374,0,2646
862,2019-10-18,323,0,1532,1,1856
862,2019-10-19,303,0,1549,0,1852
862,2019-10-20,302,0,1285,1,1588
862,2019-10-21,243,0,1442,2,1687
862,2019-10-22,1161,0,1516,1,2678
862,2019-10-23,235,0,1321,1,1557
862,2019-10-24,272,0,1630,0,1902
862,2019-10-25,295,0,1444,2,1741
862,2019-10-26,378,0,2740,0,3118
862,2019-10-27,274,0,2417,0,2691
862,2019-10-28,419,0,1389,0,1808
862,2019-10-29,1140,0,921,0,2061
862,2019-10-30,269,0,1564,1,1834
862,2019-10-31,434,0,1968,2,2404
862,2019-11-01,1018,0,1214,1,2233
862,2019-11-02,242,0,1386,1,1629
862,2019-11-03,296,0,1385,1,1682
862,2019-11-04,369,0,2215,2,2586
862,2019-11-05,1048,0,1951,2,3001
862,2019-11-06,569,0,1917,0,2486
862,2019-11-07,361,0,1502,3,1866
862,2019-11-08,275,0,1605,2,1882
862,2019-11-09,262,0,1732,0,1994
862,2019-11-10,728,0,1521,2,2251
862,2019-11-11,1013,0,1537,715,3265
862,2019-11-12,1020,0,2430,0,3450
862,2019-11-13,1368,0,2113,5,3486
862,2019-11-14,771,0,1464,337,2572
862,2019-11-15,678,0,2217,1,2896
862,2019-11-16,260,0,2504,1,2765
862,2019-11-17,1297,0,2560,0,3857
862,2019-11-18,1599,0,2709,0,4308
862,2019-11-19,350,0,2676,2,3028
862,2019-11-20,1086,0,1865,3,2954
862,2019-11-21,1196,0,1418,0,2614
862,2019-11-22,396,0,1454,0,1850
862,2019-11-23,294,0,2127,2,2423
862,2019-11-24,497,0,1212,2,1711
862,2019-11-25,1323,0,1083,0,2406
862,2019-11-26,260,0,865,1,1126
862,2019-11-27,1146,0,1891,0,3037
862,2019-11-28,317,0,474,0,791
862,2019-11-29,117,0,1,0,118
862,2019-09-04,33,0,1026,1,1060
862,2019-09-05,394,0,1899,1,2294
862,2019-09-06,457,0,2165,1,2623
862,2019-09-07,620,0,1730,0,2350
862,2019-09-08,1118,0,2049,1,3168
862,2019-09-09,382,0,2267,1,2650
862,2019-09-10,244,0,1814,2,2060
862,2019-09-11,460,0,2269,1,2730
862,2019-09-12,1139,0,2075,2,3216
862,2019-09-13,565,0,1749,1,2315
862,2019-09-14,328,0,1672,1,2001
862,2019-09-15,1127,0,2409,1,3537
862,2019-09-16,305,0,2413,1,2719
862,2019-09-17,1913,0,2610,0,4523
862,2019-09-18,359,0,1629,0,1988
862,2019-09-19,737,0,1810,3,2550
862,2019-09-20,411,0,1298,0,1709
862,2019-09-21,889,0,1858,0,2747
862,2019-09-22,1383,0,2256,0,3639
862,2019-09-23,324,0,2355,1,2680
862,2019-09-24,403,0,1603,2,2008
862,2019-09-25,174,0,1702,2,1878
862,2019-09-26,1012,0,1137,4,2153
862,2019-09-27,136,0,2187,4,2327
862,2019-09-28,971,0,2049,2,3022
862,2019-09-29,151,0,2119,1,2271
862,2019-09-30,160,0,2157,0,2317
862,2019-10-01,1884,0,1487,1,3372
862,2019-10-02,259,0,1790,2,2051
862,2019-10-03,723,0,1750,1,2474
862,2019-10-04,140,0,1426,1,1567
862,2019-10-05,159,0,1206,1,1366
862,2019-10-06,139,0,1781,1,1921
862,2019-10-07,1027,0,1334,0,2361
862,2019-10-08,1055,0,2370,1,3426
862,2019-10-09,3180,0,1617,0,4797
862,2019-10-10,285,0,2166,1,2452
862,2019-10-11,921,0,1807,3,2731
862,2019-10-12,242,0,1562,1,1805
862,2019-10-13,1156,0,1324,0,2480
862,2019-10-14,1112,0,1568,1,2681
862,2019-10-15,1075,0,1342,1,2418
862,2019-10-16,269,0,1490,3,1762
862,2019-10-17,272,0,2374,0,2646
862,2019-10-18,323,0,1532,1,1856
862,2019-10-19,303,0,1549,0,1852
862,2019-10-20,302,0,1285,1,1588
862,2019-10-21,243,0,1442,2,1687
862,2019-10-22,1161,0,1516,1,2678
862,2019-10-23,235,0,1321,1,1557
862,2019-10-24,272,0,1630,0,1902
862,2019-10-25,295,0,1444,2,1741
862,2019-10-26,378,0,2740,0,3118
862,2019-10-27,274,0,2417,0,2691
862,2019-10-28,419,0,1389,0,1808
862,2019-10-29,1140,0,921,0,2061
862,2019-10-30,269,0,1564,1,1834
862,2019-10-31,434,0,1968,2,2404
862,2019-11-01,1018,0,1214,1,2233
862,2019-11-02,242,0,1386,1,1629
862,2019-11-03,296,0,1385,1,1682
862,2019-11-04,369,0,2215,2,2586
862,2019-11-05,1048,0,1951,2,3001
862,2019-11-06,569,0,1917,0,2486
862,2019-11-07,361,0,1502,3,1866
862,2019-11-08,275,0,1605,2,1882
862,2019-11-09,262,0,1732,0,1994
862,2019-11-10,728,0,1521,2,2251
862,2019-11-11,1013,0,1537,715,3265
862,2019-11-12,1020,0,2430,0,3450
862,2019-11-13,1368,0,2113,5,3486
862,2019-11-14,771,0,1464,337,2572
862,2019-11-15,678,0,2217,1,2896
862,2019-11-16,260,0,2504,1,2765
862,2019-11-17,1297,0,2560,0,3857
862,2019-11-18,1599,0,2709,0,4308
862,2019-11-19,350,0,2676,2,3028
862,2019-11-20,1086,0,1865,3,2954
862,2019-11-21,1196,0,1418,0,2614
862,2019-11-22,396,0,1454,0,1850
862,2019-11-23,294,0,2127,2,2423
862,2019-11-24,497,0,1212,2,1711
862,2019-11-25,1323,0,1083,0,2406
862,2019-11-26,260,0,865,1,1126
862,2019-11-27,1146,0,1891,0,3037
862,2019-11-28,317,0,474,0,791
862,2019-11-29,117,0,1,0,118
862,2019-09-04,33,0,1026,1,1060
862,2019-09-05,394,0,1899,1,2294
862,2019-09-06,457,0,2165,1,2623
862,2019-09-07,620,0,1730,0,2350
862,2019-09-08,1118,0,2049,1,3168
862,2019-09-09,382,0,2267,1,2650
862,2019-09-10,244,0,1814,2,2060
862,2019-09-11,460,0,2269,1,2730
862,2019-09-12,1139,0,2075,2,3216
862,2019-09-13,565,0,1749,1,2315
862,2019-09-14,328,0,1672,1,2001
862,2019-09-15,1127,0,2409,1,3537
862,2019-09-16,305,0,2413,1,2719
862,2019-09-17,1913,0,2610,0,4523
862,2019-09-18,359,0,1629,0,1988
862,2019-09-19,737,0,1810,3,2550
862,2019-09-20,411,0,1298,0,1709
862,2019-09-21,889,0,1858,0,2747
862,2019-09-22,1383,0,2256,0,3639
862,2019-09-23,324,0,2355,1,2680
862,2019-09-24,403,0,1603,2,2008
862,2019-09-25,174,0,1702,2,1878
862,2019-09-26,1012,0,1137,4,2153
862,2019-09-27,136,0,2187,4,2327
862,2019-09-28,971,0,2049,2,3022
862,2019-09-29,151,0,2119,1,2271
862,2019-09-30,160,0,2157,0,2317
862,2019-10-01,1884,0,1487,1,3372
862,2019-10-02,259,0,1790,2,2051
862,2019-10-03,723,0,1750,1,2474
862,2019-10-04,140,0,1426,1,1567
862,2019-10-05,159,0,1206,1,1366
862,2019-10-06,139,0,1781,1,1921
862,2019-10-07,1027,0,1334,0,2361
862,2019-10-08,1055,0,2370,1,3426
862,2019-10-09,3180,0,1617,0,4797
862,2019-10-10,285,0,2166,1,2452
862,2019-10-11,921,0,1807,3,2731
862,2019-10-12,242,0,1562,1,1805
862,2019-10-13,1156,0,1324,0,2480
862,2019-10-14,1112,0,1568,1,2681
862,2019-10-15,1075,0,1342,1,2418
862,2019-10-16,269,0,1490,3,1762
862,2019-10-17,272,0,2374,0,2646
862,2019-10-18,323,0,1532,1,1856
862,2019-10-19,303,0,1549,0,1852
862,2019-10-20,302,0,1285,1,1588
862,2019-10-21,243,0,1442,2,1687
862,2019-10-22,1161,0,1516,1,2678
862,2019-10-23,235,0,1321,1,1557
862,2019-10-24,272,0,1630,0,1902
862,2019-10-25,295,0,1444,2,1741
862,2019-10-26,378,0,2740,0,3118
862,2019-10-27,274,0,2417,0,2691
862,2019-10-28,419,0,1389,0,1808
862,2019-10-29,1140,0,921,0,2061
862,2019-10-30,269,0,1564,1,1834
862,2019-10-31,434,0,1968,2,2404
862,2019-11-01,1018,0,1214,1,2233
862,2019-11-02,242,0,1386,1,1629
862,2019-11-03,296,0,1385,1,1682
862,2019-11-04,369,0,2215,2,2586
862,2019-11-05,1048,0,1951,2,3001
862,2019-11-06,569,0,1917,0,2486
862,2019-11-07,361,0,1502,3,1866
862,2019-11-08,275,0,1605,2,1882
862,2019-11-09,262,0,1732,0,1994
862,2019-11-10,728,0,1521,2,2251
862,2019-11-11,1013,0,1537,715,3265
862,2019-11-12,1020,0,2430,0,3450
862,2019-11-13,1368,0,2113,5,3486
862,2019-11-14,771,0,1464,337,2572
862,2019-11-15,678,0,2217,1,2896
862,2019-11-16,260,0,2504,1,2765
862,2019-11-17,1297,0,2560,0,3857
862,2019-11-18,1599,0,2709,0,4308
862,2019-11-19,350,0,2676,2,3028
862,2019-11-20,1086,0,1865,3,2954
862,2019-11-21,1196,0,1418,0,2614
862,2019-11-22,396,0,1454,0,1850
862,2019-11-23,294,0,2127,2,2423
862,2019-11-24,497,0,1212,2,1711
862,2019-11-25,1323,0,1083,0,2406
862,2019-11-26,260,0,865,1,1126
863,2019-09-04,20,0,933,1,954
863,2019-09-05,191,0,2899,1,3091
863,2019-09-06,1012,0,2035,1,3048
863,2019-09-07,269,0,2204,0,2473
863,2019-09-08,276,0,2925,1,3202
863,2019-09-09,250,0,1657,1,1908
863,2019-09-10,399,0,2849,1,3249
863,2019-09-11,348,0,2831,3,3182
863,2019-09-12,943,0,2795,2,3740
863,2019-09-13,139,0,1714,0,1853
863,2019-09-14,959,0,2722,53,3734
863,2019-09-15,86,0,1625,1,1712
863,2019-09-16,236,0,1893,0,2129
863,2019-09-17,952,0,2631,1,3584
863,2019-09-18,135,0,1256,0,1391
863,2019-09-19,270,0,1485,0,1755
863,2019-09-20,125,0,1982,0,2107
863,2019-09-21,134,0,2356,233,2723
863,2019-09-22,108,0,2064,1,2173
863,2019-09-23,190,0,1952,1,2143
863,2019-09-24,174,0,2021,3,2198
863,2019-09-25,185,0,1746,1,1932
863,2019-09-26,976,0,1965,1,2942
863,2019-09-27,86,0,1790,2,1878
863,2019-09-28,143,0,1665,1,1809
863,2019-09-29,90,0,1564,1,1655
863,2019-09-30,197,0,2412,0,2609
863,2019-10-01,113,0,1788,1,1902
863,2019-10-02,210,0,1666,0,1876
863,2019-10-03,163,0,1402,0,1565
863,2019-10-04,1067,0,2539,1,3607
863,2019-10-05,737,0,2461,2,3200
863,2019-10-06,108,0,1721,2,1831
863,2019-10-07,982,0,2035,2,3019
863,2019-10-08,976,0,1483,2,2461
863,2019-10-09,132,0,1314,0,1446
863,2019-10-10,160,0,1594,2,1756
863,2019-10-11,112,0,2459,2,2573
863,2019-10-12,118,0,1878,1,1997
863,2019-10-13,2766,0,1716,0,4482
863,2019-10-14,1002,0,1831,1,2834
863,2019-10-15,981,0,1804,2,2787
863,2019-10-16,147,0,1271,3,1421
863,2019-10-17,242,0,815,0,1057
863,2019-10-18,173,0,2182,0,2355
863,2019-10-19,159,0,1728,0,1887
863,2019-10-20,720,0,1937,1,2658
863,2019-10-21,972,0,1614,3,2589
863,2019-10-22,1916,0,1362,1,3279
863,2019-10-23,1721,0,774,0,2495
863,2019-10-24,484,0,1377,1,1862
863,2019-10-25,149,0,1448,1,1598
863,2019-10-26,108,0,1857,1,1966
863,2019-10-27,187,0,1204,0,1391
863,2019-10-28,165,0,1397,0,1562
863,2019-10-29,1061,0,1468,1,2530
863,2019-10-30,358,0,1498,1,1857
863,2019-10-31,1391,0,1521,2,2914
863,2019-11-01,599,0,1678,2,2279
863,2019-11-02,85,0,1618,1,1704
863,2019-11-03,88,0,1018,0,1106
863,2019-11-04,221,0,1765,0,1986
863,2019-11-05,145,0,1553,0,1698
863,2019-11-06,108,0,1229,748,2085
863,2019-11-07,200,0,1295,3,1498
863,2019-11-08,1014,0,965,2,1981
863,2019-11-09,135,0,1520,1,1656
863,2019-11-10,597,0,1703,2,2302
863,2019-11-11,601,0,2196,1,2798
863,2019-11-12,116,0,2510,0,2626
863,2019-11-13,230,0,1693,3,1926
863,2019-11-14,409,0,1970,1,2380
863,2019-11-15,94,0,1868,2,1964
863,2019-11-16,82,0,1891,812,2785
863,2019-11-17,185,0,2391,0,2576
863,2019-11-18,377,0,2614,0,2991
863,2019-11-19,1003,0,2460,1,3464
863,2019-11-20,2502,0,1858,2,4362
863,2019-11-21,178,0,2150,0,2328
863,2019-11-22,499,0,995,3,1497
863,2019-11-23,121,0,1847,0,1968
863,2019-11-24,212,0,2026,2,2240
863,2019-11-25,90,0,1517,2,1609
863,2019-11-26,308,0,1355,0,1663
863,2019-11-27,105,0,1578,2,1685
863,2019-11-28,620,0,858,0,1478
863,2019-11-29,72,0,2,0,74
863,2019-09-04,20,0,933,1,954
863,2019-09-05,191,0,2899,1,3091
863,2019-09-06,1012,0,2035,1,3048
863,2019-09-07,269,0,2204,0,2473
863,2019-09-08,276,0,2925,1,3202
863,2019-09-09,250,0,1657,1,1908
863,2019-09-10,399,0,2849,1,3249
863,2019-09-11,348,0,2831,3,3182
863,2019-09-12,943,0,2795,2,3740
863,2019-09-13,139,0,1714,0,1853
863,2019-09-14,959,0,2722,53,3734
863,2019-09-15,86,0,1625,1,1712
863,2019-09-16,236,0,1893,0,2129
863,2019-09-17,952,0,2631,1,3584
863,2019-09-18,135,0,1256,0,1391
863,2019-09-19,270,0,1485,0,1755
863,2019-09-20,125,0,1982,0,2107
863,2019-09-21,134,0,2356,233,2723
863,2019-09-22,108,0,2064,1,2173
863,2019-09-23,190,0,1952,1,2143
863,2019-09-24,174,0,2021,3,2198
863,2019-09-25,185,0,1746,1,1932
863,2019-09-26,976,0,1965,1,2942
863,2019-09-27,86,0,1790,2,1878
863,2019-09-28,143,0,1665,1,1809
863,2019-09-29,90,0,1564,1,1655
863,2019-09-30,197,0,2412,0,2609
863,2019-10-01,113,0,1788,1,1902
863,2019-10-02,210,0,1666,0,1876
863,2019-10-03,163,0,1402,0,1565
863,2019-10-04,1067,0,2539,1,3607
863,2019-10-05,737,0,2461,2,3200
863,2019-10-06,108,0,1721,2,1831
863,2019-10-07,982,0,2035,2,3019
863,2019-10-08,976,0,1483,2,2461
863,2019-10-09,132,0,1314,0,1446
863,2019-10-10,160,0,1594,2,1756
863,2019-10-11,112,0,2459,2,2573
863,2019-10-12,118,0,1878,1,1997
863,2019-10-13,2766,0,1716,0,4482
863,2019-10-14,1002,0,1831,1,2834
863,2019-10-15,981,0,1804,2,2787
863,2019-10-16,147,0,1271,3,1421
863,2019-10-17,242,0,815,0,1057
863,2019-10-18,173,0,2182,0,2355
863,2019-10-19,159,0,1728,0,1887
863,2019-10-20,720,0,1937,1,2658
863,2019-10-21,972,0,1614,3,2589
863,2019-10-22,1916,0,1362,1,3279
863,2019-10-23,1721,0,774,0,2495
863,2019-10-24,484,0,1377,1,1862
863,2019-10-25,149,0,1448,1,1598
863,2019-10-26,108,0,1857,1,1966
863,2019-10-27,187,0,1204,0,1391
863,2019-10-28,165,0,1397,0,1562
863,2019-10-29,1061,0,1468,1,2530
863,2019-10-30,358,0,1498,1,1857
863,2019-10-31,1391,0,1521,2,2914
863,2019-11-01,599,0,1678,2,2279
863,2019-11-02,85,0,1618,1,1704
863,2019-11-03,88,0,1018,0,1106
863,2019-11-04,221,0,1765,0,1986
863,2019-11-05,145,0,1553,0,1698
863,2019-11-06,108,0,1229,748,2085
863,2019-11-07,200,0,1295,3,1498
863,2019-11-08,1014,0,965,2,1981
863,2019-11-09,135,0,1520,1,1656
863,2019-11-10,597,0,1703,2,2302
863,2019-11-11,601,0,2196,1,2798
863,2019-11-12,116,0,2510,0,2626
863,2019-11-13,230,0,1693,3,1926
863,2019-11-14,409,0,1970,1,2380
863,2019-11-15,94,0,1868,2,1964
863,2019-11-16,82,0,1891,812,2785
863,2019-11-17,185,0,2391,0,2576
863,2019-11-18,377,0,2614,0,2991
863,2019-11-19,1003,0,2460,1,3464
863,2019-11-20,2502,0,1858,2,4362
863,2019-11-21,178,0,2150,0,2328
863,2019-11-22,499,0,995,3,1497
863,2019-11-23,121,0,1847,0,1968
863,2019-11-24,212,0,2026,2,2240
863,2019-11-25,90,0,1517,2,1609
863,2019-11-26,308,0,1355,0,1663
863,2019-11-27,105,0,1578,2,1685
863,2019-11-28,620,0,858,0,1478
863,2019-11-29,72,0,2,0,74
863,2019-09-04,20,0,933,1,954
863,2019-09-05,191,0,2899,1,3091
863,2019-09-06,1012,0,2035,1,3048
863,2019-09-07,269,0,2204,0,2473
863,2019-09-08,276,0,2925,1,3202
863,2019-09-09,250,0,1657,1,1908
863,2019-09-10,399,0,2849,1,3249
863,2019-09-11,348,0,2831,3,3182
863,2019-09-12,943,0,2795,2,3740
863,2019-09-13,139,0,1714,0,1853
863,2019-09-14,959,0,2722,53,3734
863,2019-09-15,86,0,1625,1,1712
863,2019-09-16,236,0,1893,0,2129
863,2019-09-17,952,0,2631,1,3584
863,2019-09-18,135,0,1256,0,1391
863,2019-09-19,270,0,1485,0,1755
863,2019-09-20,125,0,1982,0,2107
863,2019-09-21,134,0,2356,233,2723
863,2019-09-22,108,0,2064,1,2173
863,2019-09-23,190,0,1952,1,2143
863,2019-09-24,174,0,2021,3,2198
863,2019-09-25,185,0,1746,1,1932
863,2019-09-26,976,0,1965,1,2942
863,2019-09-27,86,0,1790,2,1878
863,2019-09-28,143,0,1665,1,1809
863,2019-09-29,90,0,1564,1,1655
863,2019-09-30,197,0,2412,0,2609
863,2019-10-01,113,0,1788,1,1902
863,2019-10-02,210,0,1666,0,1876
863,2019-10-03,163,0,1402,0,1565
863,2019-10-04,1067,0,2539,1,3607
863,2019-10-05,737,0,2461,2,3200
863,2019-10-06,108,0,1721,2,1831
863,2019-10-07,982,0,2035,2,3019
863,2019-10-08,976,0,1483,2,2461
863,2019-10-09,132,0,1314,0,1446
863,2019-10-10,160,0,1594,2,1756
863,2019-10-11,112,0,2459,2,2573
863,2019-10-12,118,0,1878,1,1997
863,2019-10-13,2766,0,1716,0,4482
863,2019-10-14,1002,0,1831,1,2834
863,2019-10-15,981,0,1804,2,2787
863,2019-10-16,147,0,1271,3,1421
863,2019-10-17,242,0,815,0,1057
863,2019-10-18,173,0,2182,0,2355
863,2019-10-19,159,0,1728,0,1887
863,2019-10-20,720,0,1937,1,2658
863,2019-10-21,972,0,1614,3,2589
863,2019-10-22,1916,0,1362,1,3279
863,2019-10-23,1721,0,774,0,2495
863,2019-10-24,484,0,1377,1,1862
863,2019-10-25,149,0,1448,1,1598
863,2019-10-26,108,0,1857,1,1966
863,2019-10-27,187,0,1204,0,1391
863,2019-10-28,165,0,1397,0,1562
863,2019-10-29,1061,0,1468,1,2530
863,2019-10-30,358,0,1498,1,1857
863,2019-10-31,1391,0,1521,2,2914
863,2019-11-01,599,0,1678,2,2279
863,2019-11-02,85,0,1618,1,1704
863,2019-11-03,88,0,1018,0,1106
863,2019-11-04,221,0,1765,0,1986
863,2019-11-05,145,0,1553,0,1698
863,2019-11-06,108,0,1229,748,2085
863,2019-11-07,200,0,1295,3,1498
863,2019-11-08,1014,0,965,2,1981
863,2019-11-09,135,0,1520,1,1656
863,2019-11-10,597,0,1703,2,2302
863,2019-11-11,601,0,2196,1,2798
863,2019-11-12,116,0,2510,0,2626
863,2019-11-13,230,0,1693,3,1926
863,2019-11-14,409,0,1970,1,2380
863,2019-11-15,94,0,1868,2,1964
863,2019-11-16,82,0,1891,812,2785
863,2019-11-17,185,0,2391,0,2576
863,2019-11-18,377,0,2614,0,2991
863,2019-11-19,1003,0,2460,1,3464
863,2019-11-20,2502,0,1858,2,4362
863,2019-11-21,178,0,2150,0,2328
863,2019-11-22,499,0,995,3,1497
863,2019-11-23,121,0,1847,0,1968
863,2019-11-24,212,0,2026,2,2240
863,2019-11-25,90,0,1517,2,1609
863,2019-11-26,308,0,1355,0,1663
863,2019-11-27,105,0,1578,2,1685
864,2019-09-04,20,0,833,0,853
864,2019-09-05,250,0,1879,0,2129
864,2019-09-06,152,0,1727,1,1880
864,2019-09-07,160,0,1395,0,1555
864,2019-09-08,1125,0,1935,1,3061
864,2019-09-09,469,0,1568,0,2037
864,2019-09-10,916,0,1293,0,2209
864,2019-09-11,131,0,2017,1,2149
864,2019-09-12,83,0,2204,2,2289
864,2019-09-13,926,0,1672,1,2599
864,2019-09-14,63,0,920,1,984
864,2019-09-15,892,0,1479,2,2373
864,2019-09-16,62,0,1821,2,1885
864,2019-09-17,70,0,1460,1,1531
864,2019-09-18,496,0,820,1,1317
864,2019-09-19,334,0,2076,1,2411
864,2019-09-20,174,0,1704,1,1879
864,2019-09-21,1033,0,1620,0,2653
864,2019-09-22,900,0,1967,1,2868
864,2019-09-23,114,0,1925,1,2040
864,2019-09-24,92,0,1881,1,1974
864,2019-09-25,78,0,1013,1,1092
864,2019-09-26,81,0,1129,3,1213
864,2019-09-27,55,0,1536,1,1592
864,2019-09-28,162,0,1699,3,1864
864,2019-09-29,65,0,1857,0,1922
864,2019-09-30,69,0,1944,0,2013
864,2019-10-01,83,0,1434,1,1518
864,2019-10-02,991,0,1296,1,2288
864,2019-10-03,89,0,982,0,1071
864,2019-10-04,231,0,1479,2,1712
864,2019-10-05,2193,0,1073,0,3266
864,2019-10-06,1565,0,1969,2,3536
864,2019-10-07,1084,0,2028,1,3113
864,2019-10-08,174,0,1572,2,1748
864,2019-10-09,748,0,1452,1,2201
864,2019-10-10,120,0,2106,2,2228
864,2019-10-11,953,0,1838,4,2795
864,2019-10-12,72,0,1755,1,1828
864,2019-10-13,1814,0,2004,2,3820
864,2019-10-14,2720,0,1958,0,4678
864,2019-10-15,988,0,1427,1,2416
864,2019-10-16,77,0,1692,2,1771
864,2019-10-17,48,0,1459,1,1508
864,2019-10-18,968,0,1634,0,2602
864,2019-10-19,1408,0,1680,0,3088
864,2019-10-20,1840,0,1957,0,3797
864,2019-10-21,823,0,1491,3,2317
864,2019-10-22,88,0,1612,2,1702
864,2019-10-23,42,0,2393,4,2439
864,2019-10-24,183,0,1323,1,1507
864,2019-10-25,69,0,2128,1,2198
864,2019-10-26,973,0,2843,0,3816
864,2019-10-27,71,0,1053,0,1124
864,2019-10-28,130,0,1466,0,1596
864,2019-10-29,118,0,2172,2,2292
864,2019-10-30,1307,0,1365,2,2674
864,2019-10-31,50,0,1342,3,1395
864,2019-11-01,136,0,1204,0,1340
864,2019-11-02,43,0,1236,0,1279
864,2019-11-03,160,0,1462,0,1622
864,2019-11-04,64,0,1643,1,1708
864,2019-11-05,214,0,2952,1,3167
864,2019-11-06,966,0,2034,1,3001
864,2019-11-07,798,0,1644,0,2442
864,2019-11-08,1026,0,969,0,1995
864,2019-11-09,40,0,1587,0,1627
864,2019-11-10,72,0,1225,1,1298
864,2019-11-11,397,0,1324,0,1721
864,2019-11-12,429,0,2038,0,2467
864,2019-11-13,72,0,1628,0,1700
864,2019-11-14,1234,0,1797,0,3031
864,2019-11-15,1081,0,1713,0,2794
864,2019-11-16,70,0,1761,0,1831
864,2019-11-17,183,0,2990,0,3173
864,2019-11-18,87,0,2495,0,2582
864,2019-11-19,86,0,2172,0,2258
864,2019-11-20,78,0,2126,0,2204
864,2019-11-21,74,0,2179,0,2253
864,2019-11-22,69,0,1674,0,1743
864,2019-11-23,553,0,2445,0,2998
864,2019-11-24,1063,0,1341,0,2404
864,2019-11-25,75,0,2039,0,2114
864,2019-11-26,1777,0,680,0,2457
864,2019-11-27,58,0,1702,0,1760
864,2019-11-28,51,0,892,0,943
864,2019-11-29,12,0,1,0,13
864,2019-09-04,20,0,833,0,853
864,2019-09-05,250,0,1879,0,2129
864,2019-09-06,152,0,1727,1,1880
864,2019-09-07,160,0,1395,0,1555
864,2019-09-08,1125,0,1935,1,3061
864,2019-09-09,469,0,1568,0,2037
864,2019-09-10,916,0,1293,0,2209
864,2019-09-11,131,0,2017,1,2149
864,2019-09-12,83,0,2204,2,2289
864,2019-09-13,926,0,1672,1,2599
864,2019-09-14,63,0,920,1,984
864,2019-09-15,892,0,1479,2,2373
864,2019-09-16,62,0,1821,2,1885
864,2019-09-17,70,0,1460,1,1531
864,2019-09-18,496,0,820,1,1317
864,2019-09-19,334,0,2076,1,2411
864,2019-09-20,174,0,1704,1,1879
864,2019-09-21,1033,0,1620,0,2653
864,2019-09-22,900,0,1967,1,2868
864,2019-09-23,114,0,1925,1,2040
864,2019-09-24,92,0,1881,1,1974
864,2019-09-25,78,0,1013,1,1092
864,2019-09-26,81,0,1129,3,1213
864,2019-09-27,55,0,1536,1,1592
864,2019-09-28,162,0,1699,3,1864
864,2019-09-29,65,0,1857,0,1922
864,2019-09-30,69,0,1944,0,2013
864,2019-10-01,83,0,1434,1,1518
864,2019-10-02,991,0,1296,1,2288
864,2019-10-03,89,0,982,0,1071
864,2019-10-04,231,0,1479,2,1712
864,2019-10-05,2193,0,1073,0,3266
864,2019-10-06,1565,0,1969,2,3536
864,2019-10-07,1084,0,2028,1,3113
864,2019-10-08,174,0,1572,2,1748
864,2019-10-09,748,0,1452,1,2201
864,2019-10-10,120,0,2106,2,2228
864,2019-10-11,953,0,1838,4,2795
864,2019-10-12,72,0,1755,1,1828
864,2019-10-13,1814,0,2004,2,3820
864,2019-10-14,2720,0,1958,0,4678
864,2019-10-15,988,0,1427,1,2416
864,2019-10-16,77,0,1692,2,1771
864,2019-10-17,48,0,1459,1,1508
864,2019-10-18,968,0,1634,0,2602
864,2019-10-19,1408,0,1680,0,3088
864,2019-10-20,1840,0,1957,0,3797
864,2019-10-21,823,0,1491,3,2317
864,2019-10-22,88,0,1612,2,1702
864,2019-10-23,42,0,2393,4,2439
864,2019-10-24,183,0,1323,1,1507
864,2019-10-25,69,0,2128,1,2198
864,2019-10-26,973,0,2843,0,3816
864,2019-10-27,71,0,1053,0,1124
864,2019-10-28,130,0,1466,0,1596
864,2019-10-29,118,0,2172,2,2292
864,2019-10-30,1307,0,1365,2,2674
864,2019-10-31,50,0,1342,3,1395
864,2019-11-01,136,0,1204,0,1340
864,2019-11-02,43,0,1236,0,1279
864,2019-11-03,160,0,1462,0,1622
864,2019-11-04,64,0,1643,1,1708
864,2019-11-05,214,0,2952,1,3167
864,2019-11-06,966,0,2034,1,3001
864,2019-11-07,798,0,1644,0,2442
864,2019-11-08,1026,0,969,0,1995
864,2019-11-09,40,0,1587,0,1627
864,2019-11-10,72,0,1225,1,1298
864,2019-11-11,397,0,1324,0,1721
864,2019-11-12,429,0,2038,0,2467
864,2019-11-13,72,0,1628,0,1700
864,2019-11-14,1234,0,1797,0,3031
864,2019-11-15,1081,0,1713,0,2794
864,2019-11-16,70,0,1761,0,1831
864,2019-11-17,183,0,2990,0,3173
864,2019-11-18,87,0,2495,0,2582
864,2019-11-19,86,0,2172,0,2258
864,2019-11-20,78,0,2126,0,2204
864,2019-11-21,74,0,2179,0,2253
864,2019-11-22,69,0,1674,0,1743
864,2019-11-23,553,0,2445,0,2998
864,2019-11-24,1063,0,1341,0,2404
864,2019-11-25,75,0,2039,0,2114
864,2019-11-26,1777,0,680,0,2457
864,2019-11-27,58,0,1702,0,1760
864,2019-11-28,51,0,892,0,943
864,2019-11-29,12,0,1,0,13
864,2019-09-06,152,0,1727,1,1880
864,2019-09-07,160,0,1395,0,1555
864,2019-09-08,1125,0,1935,1,3061
864,2019-09-09,469,0,1568,0,2037
864,2019-09-10,916,0,1293,0,2209
864,2019-09-11,131,0,2017,1,2149
864,2019-09-12,83,0,2204,2,2289
864,2019-09-13,926,0,1672,1,2599
864,2019-09-14,63,0,920,1,984
864,2019-09-15,892,0,1479,2,2373
864,2019-09-16,62,0,1821,2,1885
864,2019-09-17,70,0,1460,1,1531
864,2019-09-18,496,0,820,1,1317
864,2019-09-19,334,0,2076,1,2411
864,2019-09-20,174,0,1704,1,1879
864,2019-09-21,1033,0,1620,0,2653
864,2019-09-22,900,0,1967,1,2868
864,2019-09-23,114,0,1925,1,2040
864,2019-09-24,92,0,1881,1,1974
864,2019-09-25,78,0,1013,1,1092
864,2019-09-26,81,0,1129,3,1213
864,2019-09-27,55,0,1536,1,1592
864,2019-09-28,162,0,1699,3,1864
864,2019-09-29,65,0,1857,0,1922
864,2019-09-30,69,0,1944,0,2013
864,2019-10-01,83,0,1434,1,1518
864,2019-10-02,991,0,1296,1,2288
864,2019-10-03,89,0,982,0,1071
864,2019-10-04,231,0,1479,2,1712
864,2019-10-05,2193,0,1073,0,3266
864,2019-10-06,1565,0,1969,2,3536
864,2019-10-07,1084,0,2028,1,3113
864,2019-10-08,174,0,1572,2,1748
864,2019-10-09,748,0,1452,1,2201
864,2019-10-10,120,0,2106,2,2228
864,2019-10-11,953,0,1838,4,2795
864,2019-10-12,72,0,1755,1,1828
864,2019-10-13,1814,0,2004,2,3820
864,2019-10-14,2720,0,1958,0,4678
864,2019-10-15,988,0,1427,1,2416
864,2019-10-16,77,0,1692,2,1771
864,2019-10-17,48,0,1459,1,1508
864,2019-10-18,968,0,1634,0,2602
864,2019-10-19,1408,0,1680,0,3088
864,2019-10-20,1840,0,1957,0,3797
864,2019-10-21,823,0,1491,3,2317
864,2019-10-22,88,0,1612,2,1702
864,2019-10-23,42,0,2393,4,2439
864,2019-10-24,183,0,1323,1,1507
864,2019-10-25,69,0,2128,1,2198
864,2019-10-26,973,0,2843,0,3816
864,2019-10-27,71,0,1053,0,1124
864,2019-10-28,130,0,1466,0,1596
864,2019-10-29,118,0,2172,2,2292
864,2019-10-30,1307,0,1365,2,2674
864,2019-10-31,50,0,1342,3,1395
864,2019-11-01,136,0,1204,0,1340
864,2019-11-02,43,0,1236,0,1279
864,2019-11-03,160,0,1462,0,1622
864,2019-11-04,64,0,1643,1,1708
864,2019-11-05,214,0,2952,1,3167
864,2019-11-06,966,0,2034,1,3001
864,2019-11-07,798,0,1644,0,2442
864,2019-11-08,1026,0,969,0,1995
864,2019-11-09,40,0,1587,0,1627
864,2019-11-10,72,0,1225,1,1298
865,2019-09-04,44,0,1196,0,1240
865,2019-09-05,2924,0,2039,1,4964
865,2019-09-06,1293,0,1642,0,2935
865,2019-09-07,2172,0,2400,0,4572
865,2019-09-08,1378,0,1814,0,3192
865,2019-09-09,507,0,2408,0,2915
865,2019-09-10,294,0,2212,0,2506
865,2019-09-11,1074,0,2445,2,3521
865,2019-09-12,245,0,1711,1,1957
865,2019-09-13,511,0,2432,0,2943
865,2019-09-14,1992,0,2011,0,4003
865,2019-09-15,279,0,1925,3,2207
865,2019-09-16,284,0,2695,1,2980
865,2019-09-17,1187,0,1683,1,2871
865,2019-09-18,361,0,788,0,1149
865,2019-09-19,474,0,1643,0,2117
865,2019-09-20,350,0,1555,2,1907
865,2019-09-21,287,0,1514,2,1803
865,2019-09-22,282,0,1843,1,2126
865,2019-09-23,417,0,1665,2,2084
865,2019-09-24,384,0,1849,2,2235
865,2019-09-25,158,0,1262,0,1420
865,2019-09-26,156,0,1990,6,2152
865,2019-09-27,112,0,1995,2,2109
865,2019-09-28,149,0,1107,2,1258
865,2019-09-29,147,0,1298,1,1446
865,2019-09-30,168,0,1791,1,1960
865,2019-10-01,985,0,1777,2,2764
865,2019-10-02,2321,0,1860,1,4182
865,2019-10-03,222,0,1933,1,2156
865,2019-10-04,438,0,2397,2,2837
865,2019-10-05,374,0,1903,0,2277
865,2019-10-06,871,0,2626,3,3500
865,2019-10-07,1058,0,1786,0,2844
865,2019-10-08,673,0,2347,0,3020
865,2019-10-09,151,0,2332,1,2484
865,2019-10-10,599,0,2902,2,3503
865,2019-10-11,1049,0,2154,3,3206
865,2019-10-12,233,0,2802,12,3047
865,2019-10-13,236,0,2980,1,3217
865,2019-10-14,497,0,3566,1,4064
865,2019-10-15,388,0,2249,1,2638
865,2019-10-16,650,0,3109,2,3761
865,2019-10-17,272,0,2847,0,3119
865,2019-10-18,273,0,2532,0,2805
865,2019-10-19,1190,0,3236,0,4426
865,2019-10-20,1179,0,3097,0,4276
865,2019-10-21,1138,0,2128,4,3270
865,2019-10-22,260,0,1395,3,1658
865,2019-10-23,1143,0,1593,2,2738
865,2019-10-24,381,0,1107,1,1489
865,2019-10-25,262,0,2275,1,2538
865,2019-10-26,1525,0,2284,0,3809
865,2019-10-27,1224,0,2352,0,3576
865,2019-10-28,273,0,2296,0,2569
865,2019-10-29,341,0,2374,3,2718
865,2019-10-30,2018,0,1570,3,3591
865,2019-10-31,266,0,997,2,1265
865,2019-11-01,252,0,1314,1,1567
865,2019-11-02,679,0,1872,0,2551
865,2019-11-03,224,0,1156,0,1380
865,2019-11-04,252,0,2349,0,2601
865,2019-11-05,280,0,1782,0,2062
865,2019-11-06,259,0,2148,1,2408
865,2019-11-07,339,0,2019,2,2360
865,2019-11-08,272,0,1941,0,2213
865,2019-11-09,261,0,1882,0,2143
865,2019-11-10,233,0,1240,2,1475
865,2019-11-11,1927,0,1864,2,3793
865,2019-11-12,247,0,2191,0,2438
865,2019-11-13,263,0,1828,2,2093
865,2019-11-14,247,0,1736,0,1983
865,2019-11-15,227,0,2029,0,2256
865,2019-11-16,277,0,2159,0,2436
865,2019-11-17,257,0,2799,0,3056
865,2019-11-18,266,0,3157,0,3423
865,2019-11-19,635,0,2044,0,2679
865,2019-11-20,1212,0,1977,0,3189
865,2019-11-21,455,0,1560,0,2015
865,2019-11-22,254,0,1069,0,1323
865,2019-11-23,253,0,1869,0,2122
865,2019-11-24,344,0,2112,0,2456
865,2019-11-25,265,0,1866,0,2131
865,2019-11-26,273,0,1647,0,1920
865,2019-11-27,317,0,1260,0,1577
865,2019-11-28,295,0,584,0,879
865,2019-11-29,50,0,3,0,53
865,2019-09-04,44,0,1196,0,1240
865,2019-09-05,2924,0,2039,1,4964
865,2019-09-06,1293,0,1642,0,2935
865,2019-09-07,2172,0,2400,0,4572
865,2019-09-08,1378,0,1814,0,3192
865,2019-09-09,507,0,2408,0,2915
865,2019-09-10,294,0,2212,0,2506
865,2019-09-11,1074,0,2445,2,3521
865,2019-09-12,245,0,1711,1,1957
865,2019-09-13,511,0,2432,0,2943
865,2019-09-14,1992,0,2011,0,4003
865,2019-09-15,279,0,1925,3,2207
865,2019-09-16,284,0,2695,1,2980
865,2019-09-17,1187,0,1683,1,2871
865,2019-09-18,361,0,788,0,1149
865,2019-09-19,474,0,1643,0,2117
865,2019-09-20,350,0,1555,2,1907
865,2019-09-21,287,0,1514,2,1803
865,2019-09-22,282,0,1843,1,2126
865,2019-09-23,417,0,1665,2,2084
865,2019-09-24,384,0,1849,2,2235
865,2019-09-25,158,0,1262,0,1420
865,2019-09-26,156,0,1990,6,2152
865,2019-09-27,112,0,1995,2,2109
865,2019-09-28,149,0,1107,2,1258
865,2019-09-29,147,0,1298,1,1446
865,2019-09-30,168,0,1791,1,1960
865,2019-10-01,985,0,1777,2,2764
865,2019-10-02,2321,0,1860,1,4182
865,2019-10-03,222,0,1933,1,2156
865,2019-10-04,438,0,2397,2,2837
865,2019-10-05,374,0,1903,0,2277
865,2019-10-06,871,0,2626,3,3500
865,2019-10-07,1058,0,1786,0,2844
865,2019-10-08,673,0,2347,0,3020
865,2019-10-09,151,0,2332,1,2484
865,2019-10-10,599,0,2902,2,3503
865,2019-10-11,1049,0,2154,3,3206
865,2019-10-12,233,0,2802,12,3047
865,2019-10-13,236,0,2980,1,3217
865,2019-10-14,497,0,3566,1,4064
865,2019-10-15,388,0,2249,1,2638
865,2019-10-16,650,0,3109,2,3761
865,2019-10-17,272,0,2847,0,3119
865,2019-10-18,273,0,2532,0,2805
865,2019-10-19,1190,0,3236,0,4426
865,2019-10-20,1179,0,3097,0,4276
865,2019-10-21,1138,0,2128,4,3270
865,2019-10-22,260,0,1395,3,1658
865,2019-10-23,1143,0,1593,2,2738
865,2019-10-24,381,0,1107,1,1489
865,2019-10-25,262,0,2275,1,2538
865,2019-10-26,1525,0,2284,0,3809
865,2019-10-27,1224,0,2352,0,3576
865,2019-10-28,273,0,2296,0,2569
865,2019-10-29,341,0,2374,3,2718
865,2019-10-30,2018,0,1570,3,3591
865,2019-10-31,266,0,997,2,1265
865,2019-11-01,252,0,1314,1,1567
865,2019-11-02,679,0,1872,0,2551
865,2019-11-03,224,0,1156,0,1380
865,2019-11-04,252,0,2349,0,2601
865,2019-11-05,280,0,1782,0,2062
865,2019-11-06,259,0,2148,1,2408
865,2019-11-07,339,0,2019,2,2360
865,2019-11-08,272,0,1941,0,2213
865,2019-11-09,261,0,1882,0,2143
865,2019-11-10,233,0,1240,2,1475
865,2019-11-11,1927,0,1864,2,3793
865,2019-11-12,247,0,2191,0,2438
865,2019-11-13,263,0,1828,2,2093
865,2019-11-14,247,0,1736,0,1983
865,2019-11-15,227,0,2029,0,2256
865,2019-11-16,277,0,2159,0,2436
865,2019-11-17,257,0,2799,0,3056
865,2019-11-18,266,0,3157,0,3423
865,2019-11-19,635,0,2044,0,2679
865,2019-11-20,1212,0,1977,0,3189
865,2019-11-21,455,0,1560,0,2015
865,2019-11-22,254,0,1069,0,1323
865,2019-11-23,253,0,1869,0,2122
865,2019-11-24,344,0,2112,0,2456
865,2019-11-25,265,0,1866,0,2131
865,2019-11-26,273,0,1647,0,1920
865,2019-11-27,317,0,1260,0,1577
865,2019-11-28,295,0,584,0,879
865,2019-11-29,50,0,3,0,53
865,2019-09-05,2924,0,2039,1,4964
865,2019-09-06,1293,0,1642,0,2935
865,2019-09-07,2172,0,2400,0,4572
865,2019-09-08,1378,0,1814,0,3192
865,2019-09-09,507,0,2408,0,2915
865,2019-09-10,294,0,2212,0,2506
865,2019-09-11,1074,0,2445,2,3521
865,2019-09-12,245,0,1711,1,1957
865,2019-09-13,511,0,2432,0,2943
865,2019-09-14,1992,0,2011,0,4003
865,2019-09-15,279,0,1925,3,2207
865,2019-09-16,284,0,2695,1,2980
865,2019-09-17,1187,0,1683,1,2871
865,2019-09-18,361,0,788,0,1149
865,2019-09-19,474,0,1643,0,2117
865,2019-09-20,350,0,1555,2,1907
865,2019-09-21,287,0,1514,2,1803
865,2019-09-22,282,0,1843,1,2126
865,2019-09-23,417,0,1665,2,2084
865,2019-09-24,384,0,1849,2,2235
865,2019-09-25,158,0,1262,0,1420
865,2019-09-26,156,0,1990,6,2152
865,2019-09-27,112,0,1995,2,2109
865,2019-09-28,149,0,1107,2,1258
865,2019-09-29,147,0,1298,1,1446
865,2019-09-30,168,0,1791,1,1960
865,2019-10-01,985,0,1777,2,2764
865,2019-10-02,2321,0,1860,1,4182
865,2019-10-03,222,0,1933,1,2156
865,2019-10-04,438,0,2397,2,2837
865,2019-10-05,374,0,1903,0,2277
865,2019-10-06,871,0,2626,3,3500
865,2019-10-07,1058,0,1786,0,2844
865,2019-10-08,673,0,2347,0,3020
865,2019-10-09,151,0,2332,1,2484
865,2019-10-10,599,0,2902,2,3503
865,2019-10-11,1049,0,2154,3,3206
865,2019-10-12,233,0,2802,12,3047
865,2019-10-13,236,0,2980,1,3217
865,2019-10-14,497,0,3566,1,4064
865,2019-10-15,388,0,2249,1,2638
865,2019-10-16,650,0,3109,2,3761
865,2019-10-17,272,0,2847,0,3119
865,2019-10-18,273,0,2532,0,2805
865,2019-10-19,1190,0,3236,0,4426
865,2019-10-20,1179,0,3097,0,4276
865,2019-10-21,1138,0,2128,4,3270
865,2019-10-22,260,0,1395,3,1658
865,2019-10-23,1143,0,1593,2,2738
865,2019-10-24,381,0,1107,1,1489
865,2019-10-25,262,0,2275,1,2538
865,2019-10-26,1525,0,2284,0,3809
865,2019-10-27,1224,0,2352,0,3576
865,2019-10-28,273,0,2296,0,2569
865,2019-10-29,341,0,2374,3,2718
865,2019-10-30,2018,0,1570,3,3591
865,2019-10-31,266,0,997,2,1265
865,2019-11-01,252,0,1314,1,1567
865,2019-11-02,679,0,1872,0,2551
865,2019-11-03,224,0,1156,0,1380
865,2019-11-04,252,0,2349,0,2601
865,2019-11-05,280,0,1782,0,2062
865,2019-11-06,259,0,2148,1,2408
865,2019-11-07,339,0,2019,2,2360
865,2019-11-08,272,0,1941,0,2213
865,2019-11-09,261,0,1882,0,2143
865,2019-11-10,233,0,1240,2,1475
865,2019-11-11,1927,0,1864,2,3793
865,2019-11-12,247,0,2191,0,2438
865,2019-11-13,263,0,1828,2,2093
866,2019-09-04,24,0,680,1,705
866,2019-09-05,164,0,2083,0,2247
866,2019-09-06,989,0,2343,1,3333
866,2019-09-07,171,0,1575,0,1746
866,2019-09-08,260,0,1962,2,2224
866,2019-09-09,217,0,1546,1,1764
866,2019-09-10,81,0,1869,1,1951
866,2019-09-11,114,0,2265,2,2381
866,2019-09-12,68,0,1664,0,1732
866,2019-09-13,102,0,1586,0,1688
866,2019-09-14,897,0,2276,0,3173
866,2019-09-15,56,0,2538,1,2595
866,2019-09-16,87,0,1560,1,1648
866,2019-09-17,884,0,2339,0,3223
866,2019-09-18,66,0,1350,1,1417
866,2019-09-19,318,0,1443,3,1764
866,2019-09-20,1018,0,2946,0,3964
866,2019-09-21,100,0,1912,0,2012
866,2019-09-22,57,0,2227,0,2284
866,2019-09-23,246,0,2460,1,2707
866,2019-09-24,103,0,2388,3,2494
866,2019-09-25,89,0,1821,5,1915
866,2019-09-26,74,0,1290,0,1364
866,2019-09-27,58,0,1948,1,2007
866,2019-09-28,106,0,1525,4,1635
866,2019-09-29,186,0,2292,1,2479
866,2019-09-30,77,0,1594,3,1674
866,2019-10-01,414,0,1577,1,1992
866,2019-10-02,963,0,1518,0,2481
866,2019-10-03,608,0,880,0,1488
866,2019-10-04,437,0,1033,0,1470
866,2019-10-05,162,0,965,1,1128
866,2019-10-06,1879,0,1775,2,3656
866,2019-10-07,1033,0,1803,0,2836
866,2019-10-08,1118,0,1536,2,2656
866,2019-10-09,80,0,2200,1,2281
866,2019-10-10,96,0,1368,3,1467
866,2019-10-11,72,0,1868,0,1940
866,2019-10-12,69,0,1878,1,1948
866,2019-10-13,935,0,1711,0,2646
866,2019-10-14,64,0,1764,1,1829
866,2019-10-15,630,0,1451,2,2083
866,2019-10-16,60,0,913,1,974
866,2019-10-17,339,0,1138,0,1477
866,2019-10-18,502,0,1553,2,2057
866,2019-10-19,75,0,1492,0,1567
866,2019-10-20,51,0,1283,2,1336
866,2019-10-21,667,0,945,1,1613
866,2019-10-22,950,0,1267,2,2219
866,2019-10-23,915,0,1448,0,2363
866,2019-10-24,1781,0,1306,3,3090
866,2019-10-25,582,0,1883,2,2467
866,2019-10-26,954,0,2510,0,3464
866,2019-10-27,518,0,2384,1,2903
866,2019-10-28,49,0,2458,0,2507
866,2019-10-29,132,0,1545,0,1677
866,2019-10-30,73,0,896,4,973
866,2019-10-31,52,0,1182,1,1235
866,2019-11-01,35,0,1429,0,1464
866,2019-11-02,49,0,1290,0,1339
866,2019-11-03,991,0,1349,0,2340
866,2019-11-04,199,0,1295,3,1497
866,2019-11-05,1056,0,2461,0,3517
866,2019-11-06,253,0,2067,1,2321
866,2019-11-07,703,0,1646,0,2349
866,2019-11-08,82,0,1351,0,1433
866,2019-11-09,76,0,1189,0,1265
866,2019-11-10,73,0,1566,0,1639
866,2019-11-11,98,0,1512,0,1610
866,2019-11-12,80,0,2533,0,2613
866,2019-11-13,79,0,2195,0,2274
866,2019-11-14,738,0,2043,0,2781
866,2019-11-15,1531,0,2180,0,3711
866,2019-11-16,77,0,2743,0,2820
866,2019-11-17,267,0,3243,0,3510
866,2019-11-18,996,0,2377,0,3373
866,2019-11-19,113,0,1902,0,2015
866,2019-11-20,111,0,1242,0,1353
866,2019-11-21,972,0,1504,0,2476
866,2019-11-22,73,0,1720,0,1793
866,2019-11-23,93,0,1682,0,1775
866,2019-11-24,115,0,2119,0,2234
866,2019-11-25,1938,0,1875,0,3813
866,2019-11-26,80,0,1000,0,1080
866,2019-11-27,75,0,1539,0,1614
866,2019-11-28,63,0,1059,0,1122
866,2019-11-29,15,0,1,0,16
866,2019-09-04,24,0,680,1,705
866,2019-09-05,164,0,2083,0,2247
866,2019-09-06,989,0,2343,1,3333
866,2019-09-07,171,0,1575,0,1746
866,2019-09-08,260,0,1962,2,2224
866,2019-09-09,217,0,1546,1,1764
866,2019-09-10,81,0,1869,1,1951
866,2019-09-11,114,0,2265,2,2381
866,2019-09-12,68,0,1664,0,1732
866,2019-09-13,102,0,1586,0,1688
866,2019-09-14,897,0,2276,0,3173
866,2019-09-15,56,0,2538,1,2595
866,2019-09-16,87,0,1560,1,1648
866,2019-09-17,884,0,2339,0,3223
866,2019-09-18,66,0,1350,1,1417
866,2019-09-19,318,0,1443,3,1764
866,2019-09-20,1018,0,2946,0,3964
866,2019-09-21,100,0,1912,0,2012
866,2019-09-22,57,0,2227,0,2284
866,2019-09-23,246,0,2460,1,2707
866,2019-09-24,103,0,2388,3,2494
866,2019-09-25,89,0,1821,5,1915
866,2019-09-26,74,0,1290,0,1364
866,2019-09-27,58,0,1948,1,2007
866,2019-09-28,106,0,1525,4,1635
866,2019-09-29,186,0,2292,1,2479
866,2019-09-30,77,0,1594,3,1674
866,2019-10-01,414,0,1577,1,1992
866,2019-10-02,963,0,1518,0,2481
866,2019-10-03,608,0,880,0,1488
866,2019-10-04,437,0,1033,0,1470
866,2019-10-05,162,0,965,1,1128
866,2019-10-06,1879,0,1775,2,3656
866,2019-10-07,1033,0,1803,0,2836
866,2019-10-08,1118,0,1536,2,2656
866,2019-10-09,80,0,2200,1,2281
866,2019-10-10,96,0,1368,3,1467
866,2019-10-11,72,0,1868,0,1940
866,2019-10-12,69,0,1878,1,1948
866,2019-10-13,935,0,1711,0,2646
866,2019-10-14,64,0,1764,1,1829
866,2019-10-15,630,0,1451,2,2083
866,2019-10-16,60,0,913,1,974
866,2019-10-17,339,0,1138,0,1477
866,2019-10-18,502,0,1553,2,2057
866,2019-10-19,75,0,1492,0,1567
866,2019-10-20,51,0,1283,2,1336
866,2019-10-21,667,0,945,1,1613
866,2019-10-22,950,0,1267,2,2219
866,2019-10-23,915,0,1448,0,2363
866,2019-10-24,1781,0,1306,3,3090
866,2019-10-25,582,0,1883,2,2467
866,2019-10-26,954,0,2510,0,3464
866,2019-10-27,518,0,2384,1,2903
866,2019-10-28,49,0,2458,0,2507
866,2019-10-29,132,0,1545,0,1677
866,2019-10-30,73,0,896,4,973
866,2019-10-31,52,0,1182,1,1235
866,2019-11-01,35,0,1429,0,1464
866,2019-11-02,49,0,1290,0,1339
866,2019-11-03,991,0,1349,0,2340
866,2019-11-04,199,0,1295,3,1497
866,2019-11-05,1056,0,2461,0,3517
866,2019-11-06,253,0,2067,1,2321
866,2019-11-07,703,0,1646,0,2349
866,2019-11-08,82,0,1351,0,1433
866,2019-11-09,76,0,1189,0,1265
866,2019-11-10,73,0,1566,0,1639
866,2019-11-11,98,0,1512,0,1610
866,2019-11-12,80,0,2533,0,2613
866,2019-11-13,79,0,2195,0,2274
866,2019-11-14,738,0,2043,0,2781
866,2019-11-15,1531,0,2180,0,3711
866,2019-11-16,77,0,2743,0,2820
866,2019-11-17,267,0,3243,0,3510
866,2019-11-18,996,0,2377,0,3373
866,2019-11-19,113,0,1902,0,2015
866,2019-11-20,111,0,1242,0,1353
866,2019-11-21,972,0,1504,0,2476
866,2019-11-22,73,0,1720,0,1793
866,2019-11-23,93,0,1682,0,1775
866,2019-11-24,115,0,2119,0,2234
866,2019-11-25,1938,0,1875,0,3813
866,2019-11-26,80,0,1000,0,1080
866,2019-11-27,75,0,1539,0,1614
866,2019-11-28,63,0,1059,0,1122
866,2019-11-29,15,0,1,0,16
866,2019-09-04,24,0,680,1,705
866,2019-09-05,164,0,2083,0,2247
866,2019-09-06,989,0,2343,1,3333
866,2019-09-07,171,0,1575,0,1746
866,2019-09-08,260,0,1962,2,2224
866,2019-09-09,217,0,1546,1,1764
866,2019-09-10,81,0,1869,1,1951
866,2019-09-11,114,0,2265,2,2381
866,2019-09-12,68,0,1664,0,1732
866,2019-09-13,102,0,1586,0,1688
866,2019-09-14,897,0,2276,0,3173
866,2019-09-15,56,0,2538,1,2595
866,2019-09-16,87,0,1560,1,1648
866,2019-09-17,884,0,2339,0,3223
866,2019-09-18,66,0,1350,1,1417
866,2019-09-19,318,0,1443,3,1764
866,2019-09-20,1018,0,2946,0,3964
866,2019-09-21,100,0,1912,0,2012
866,2019-09-22,57,0,2227,0,2284
866,2019-09-23,246,0,2460,1,2707
866,2019-09-24,103,0,2388,3,2494
866,2019-09-25,89,0,1821,5,1915
866,2019-09-26,74,0,1290,0,1364
866,2019-09-27,58,0,1948,1,2007
866,2019-09-28,106,0,1525,4,1635
866,2019-09-29,186,0,2292,1,2479
866,2019-09-30,77,0,1594,3,1674
866,2019-10-01,414,0,1577,1,1992
866,2019-10-02,963,0,1518,0,2481
866,2019-10-03,608,0,880,0,1488
866,2019-10-04,437,0,1033,0,1470
866,2019-10-05,162,0,965,1,1128
866,2019-10-06,1879,0,1775,2,3656
866,2019-10-07,1033,0,1803,0,2836
866,2019-10-08,1118,0,1536,2,2656
866,2019-10-09,80,0,2200,1,2281
866,2019-10-10,96,0,1368,3,1467
866,2019-10-11,72,0,1868,0,1940
866,2019-10-12,69,0,1878,1,1948
866,2019-10-13,935,0,1711,0,2646
866,2019-10-14,64,0,1764,1,1829
866,2019-10-15,630,0,1451,2,2083
866,2019-10-16,60,0,913,1,974
866,2019-10-17,339,0,1138,0,1477
866,2019-10-18,502,0,1553,2,2057
866,2019-10-19,75,0,1492,0,1567
866,2019-10-20,51,0,1283,2,1336
866,2019-10-21,667,0,945,1,1613
866,2019-10-22,950,0,1267,2,2219
866,2019-10-23,915,0,1448,0,2363
866,2019-10-24,1781,0,1306,3,3090
866,2019-10-25,582,0,1883,2,2467
866,2019-10-26,954,0,2510,0,3464
866,2019-10-27,518,0,2384,1,2903
866,2019-10-28,49,0,2458,0,2507
866,2019-10-29,132,0,1545,0,1677
866,2019-10-30,73,0,896,4,973
866,2019-10-31,52,0,1182,1,1235
866,2019-11-01,35,0,1429,0,1464
866,2019-11-02,49,0,1290,0,1339
866,2019-11-03,991,0,1349,0,2340
866,2019-11-04,199,0,1295,3,1497
866,2019-11-05,1056,0,2461,0,3517
866,2019-11-06,253,0,2067,1,2321
867,2019-09-04,27,0,769,0,796
867,2019-09-05,783,0,2158,2,2943
867,2019-09-06,405,0,2339,1,2745
867,2019-09-07,520,0,1628,0,2148
867,2019-09-08,592,0,1476,0,2068
867,2019-09-09,451,0,1466,0,1917
867,2019-09-10,312,0,1926,1,2239
867,2019-09-11,969,0,2612,2,3583
867,2019-09-12,969,0,1528,3,2500
867,2019-09-13,532,0,1885,0,2417
867,2019-09-14,609,0,2198,1,2808
867,2019-09-15,531,0,2345,2,2878
867,2019-09-16,303,0,2458,0,2761
867,2019-09-17,1012,0,1534,0,2546
867,2019-09-18,282,0,1946,0,2228
867,2019-09-19,1359,0,1891,0,3250
867,2019-09-20,1207,0,1502,1,2710
867,2019-09-21,336,0,1821,0,2157
867,2019-09-22,1141,0,1674,1,2816
867,2019-09-23,830,0,1892,0,2722
867,2019-09-24,1151,0,1081,3,2235
867,2019-09-25,203,0,1631,0,1834
867,2019-09-26,518,0,982,5,1505
867,2019-09-27,597,0,1925,2,2524
867,2019-09-28,2596,0,1193,3,3792
867,2019-09-29,549,0,1613,0,2162
867,2019-09-30,229,0,1992,0,2221
867,2019-10-01,208,0,2198,1,2407
867,2019-10-02,216,0,760,0,976
867,2019-10-03,213,0,1503,0,1716
867,2019-10-04,247,0,798,1,1046
867,2019-10-05,2565,0,1092,2,3659
867,2019-10-06,1058,0,1516,2,2576
867,2019-10-07,579,0,2330,4,2913
867,2019-10-08,275,0,1616,0,1891
867,2019-10-09,1260,0,1959,1,3220
867,2019-10-10,752,0,2291,1,3044
867,2019-10-11,246,0,1288,666,2200
867,2019-10-12,266,0,2194,1,2461
867,2019-10-13,332,0,1289,1,1622
867,2019-10-14,262,0,2041,0,2303
867,2019-10-15,392,0,1942,0,2334
867,2019-10-16,729,0,1158,4,1891
867,2019-10-17,466,0,2034,0,2500
867,2019-10-18,336,0,1338,0,1674
867,2019-10-19,260,0,1598,0,1858
867,2019-10-20,1176,0,1173,14,2363
867,2019-10-21,321,0,2041,4,2366
867,2019-10-22,2283,0,1993,1,4277
867,2019-10-23,703,0,1775,0,2478
867,2019-10-24,291,0,1339,1,1631
867,2019-10-25,542,0,1268,2,1812
867,2019-10-26,300,0,1354,0,1654
867,2019-10-27,364,0,666,0,1030
867,2019-10-28,1138,0,1049,0,2187
867,2019-10-29,258,0,1163,1,1422
867,2019-10-30,933,0,1450,3,2386
867,2019-10-31,453,0,1606,2,2061
867,2019-11-01,245,0,907,0,1152
867,2019-11-02,338,0,1412,0,1750
867,2019-11-03,2476,0,1701,0,4177
867,2019-11-04,403,0,1958,0,2361
867,2019-11-05,1065,0,1172,1,2238
867,2019-11-06,259,0,1248,0,1507
867,2019-11-07,430,0,1197,3,1630
867,2019-11-08,373,0,1040,0,1413
867,2019-11-09,474,0,2128,0,2602
867,2019-11-10,1403,0,1375,0,2778
867,2019-11-11,397,0,1086,0,1483
867,2019-11-12,406,0,2339,0,2745
867,2019-11-13,392,0,1464,0,1856
867,2019-11-14,522,0,1678,0,2200
867,2019-11-15,605,0,2611,0,3216
867,2019-11-16,497,0,1838,0,2335
867,2019-11-17,419,0,2406,0,2825
867,2019-11-18,1510,0,3094,0,4604
867,2019-11-19,1305,0,1816,0,3121
867,2019-11-20,249,0,1730,0,1979
867,2019-11-21,315,0,1409,0,1724
867,2019-11-22,313,0,1396,0,1709
867,2019-11-23,391,0,1594,0,1985
867,2019-11-24,368,0,1524,0,1892
867,2019-11-25,174,0,1797,0,1971
867,2019-11-26,1489,0,1357,0,2846
867,2019-11-27,437,0,975,0,1412
867,2019-11-28,184,0,885,0,1069
867,2019-11-29,105,0,1,0,106
867,2019-09-04,27,0,769,0,796
867,2019-09-05,783,0,2158,2,2943
867,2019-09-06,405,0,2339,1,2745
867,2019-09-07,520,0,1628,0,2148
867,2019-09-08,592,0,1476,0,2068
867,2019-09-09,451,0,1466,0,1917
867,2019-09-10,312,0,1926,1,2239
867,2019-09-11,969,0,2612,2,3583
867,2019-09-12,969,0,1528,3,2500
867,2019-09-13,532,0,1885,0,2417
867,2019-09-14,609,0,2198,1,2808
867,2019-09-15,531,0,2345,2,2878
867,2019-09-16,303,0,2458,0,2761
867,2019-09-17,1012,0,1534,0,2546
867,2019-09-18,282,0,1946,0,2228
867,2019-09-19,1359,0,1891,0,3250
867,2019-09-20,1207,0,1502,1,2710
867,2019-09-21,336,0,1821,0,2157
867,2019-09-22,1141,0,1674,1,2816
867,2019-09-23,830,0,1892,0,2722
867,2019-09-24,1151,0,1081,3,2235
867,2019-09-25,203,0,1631,0,1834
867,2019-09-26,518,0,982,5,1505
867,2019-09-27,597,0,1925,2,2524
867,2019-09-28,2596,0,1193,3,3792
867,2019-09-29,549,0,1613,0,2162
867,2019-09-30,229,0,1992,0,2221
867,2019-10-01,208,0,2198,1,2407
867,2019-10-02,216,0,760,0,976
867,2019-10-03,213,0,1503,0,1716
867,2019-10-04,247,0,798,1,1046
867,2019-10-05,2565,0,1092,2,3659
867,2019-10-06,1058,0,1516,2,2576
867,2019-10-07,579,0,2330,4,2913
867,2019-10-08,275,0,1616,0,1891
867,2019-10-09,1260,0,1959,1,3220
867,2019-10-10,752,0,2291,1,3044
867,2019-10-11,246,0,1288,666,2200
867,2019-10-12,266,0,2194,1,2461
867,2019-10-13,332,0,1289,1,1622
867,2019-10-14,262,0,2041,0,2303
867,2019-10-15,392,0,1942,0,2334
867,2019-10-16,729,0,1158,4,1891
867,2019-10-17,466,0,2034,0,2500
867,2019-10-18,336,0,1338,0,1674
867,2019-10-19,260,0,1598,0,1858
867,2019-10-20,1176,0,1173,14,2363
867,2019-10-21,321,0,2041,4,2366
867,2019-10-22,2283,0,1993,1,4277
867,2019-10-23,703,0,1775,0,2478
867,2019-10-24,291,0,1339,1,1631
867,2019-10-25,542,0,1268,2,1812
867,2019-10-26,300,0,1354,0,1654
867,2019-10-27,364,0,666,0,1030
867,2019-10-28,1138,0,1049,0,2187
867,2019-10-29,258,0,1163,1,1422
867,2019-10-30,933,0,1450,3,2386
867,2019-10-31,453,0,1606,2,2061
867,2019-11-01,245,0,907,0,1152
867,2019-11-02,338,0,1412,0,1750
867,2019-11-03,2476,0,1701,0,4177
867,2019-11-04,403,0,1958,0,2361
867,2019-11-05,1065,0,1172,1,2238
867,2019-11-06,259,0,1248,0,1507
867,2019-11-07,430,0,1197,3,1630
867,2019-11-08,373,0,1040,0,1413
867,2019-11-09,474,0,2128,0,2602
867,2019-11-10,1403,0,1375,0,2778
867,2019-11-11,397,0,1086,0,1483
867,2019-11-12,406,0,2339,0,2745
867,2019-11-13,392,0,1464,0,1856
867,2019-11-14,522,0,1678,0,2200
867,2019-11-15,605,0,2611,0,3216
867,2019-11-16,497,0,1838,0,2335
867,2019-11-17,419,0,2406,0,2825
867,2019-11-18,1510,0,3094,0,4604
867,2019-11-19,1305,0,1816,0,3121
867,2019-11-20,249,0,1730,0,1979
867,2019-11-21,315,0,1409,0,1724
867,2019-11-22,313,0,1396,0,1709
867,2019-11-23,391,0,1594,0,1985
867,2019-11-24,368,0,1524,0,1892
867,2019-11-25,174,0,1797,0,1971
867,2019-11-26,1489,0,1357,0,2846
867,2019-11-27,437,0,975,0,1412
867,2019-11-28,184,0,885,0,1069
867,2019-11-29,105,0,1,0,106
867,2019-09-05,783,0,2158,2,2943
867,2019-09-06,405,0,2339,1,2745
867,2019-09-07,520,0,1628,0,2148
867,2019-09-08,592,0,1476,0,2068
867,2019-09-09,451,0,1466,0,1917
867,2019-09-10,312,0,1926,1,2239
867,2019-09-11,969,0,2612,2,3583
867,2019-09-12,969,0,1528,3,2500
867,2019-09-13,532,0,1885,0,2417
867,2019-09-14,609,0,2198,1,2808
867,2019-09-15,531,0,2345,2,2878
867,2019-09-16,303,0,2458,0,2761
867,2019-09-17,1012,0,1534,0,2546
867,2019-09-18,282,0,1946,0,2228
867,2019-09-19,1359,0,1891,0,3250
867,2019-09-20,1207,0,1502,1,2710
867,2019-09-21,336,0,1821,0,2157
867,2019-09-22,1141,0,1674,1,2816
867,2019-09-23,830,0,1892,0,2722
867,2019-09-24,1151,0,1081,3,2235
867,2019-09-25,203,0,1631,0,1834
867,2019-09-26,518,0,982,5,1505
867,2019-09-27,597,0,1925,2,2524
867,2019-09-28,2596,0,1193,3,3792
867,2019-09-29,549,0,1613,0,2162
867,2019-09-30,229,0,1992,0,2221
867,2019-10-01,208,0,2198,1,2407
867,2019-10-02,216,0,760,0,976
867,2019-10-03,213,0,1503,0,1716
867,2019-10-04,247,0,798,1,1046
867,2019-10-05,2565,0,1092,2,3659
867,2019-10-06,1058,0,1516,2,2576
867,2019-10-07,579,0,2330,4,2913
867,2019-10-08,275,0,1616,0,1891
867,2019-10-09,1260,0,1959,1,3220
867,2019-10-10,752,0,2291,1,3044
867,2019-10-11,246,0,1288,666,2200
867,2019-10-12,266,0,2194,1,2461
867,2019-10-13,332,0,1289,1,1622
867,2019-10-14,262,0,2041,0,2303
867,2019-10-15,392,0,1942,0,2334
867,2019-10-16,729,0,1158,4,1891
867,2019-10-17,466,0,2034,0,2500
867,2019-10-18,336,0,1338,0,1674
867,2019-10-19,260,0,1598,0,1858
867,2019-10-20,1176,0,1173,14,2363
867,2019-10-21,321,0,2041,4,2366
867,2019-10-22,2283,0,1993,1,4277
867,2019-10-23,703,0,1775,0,2478
867,2019-10-24,291,0,1339,1,1631
867,2019-10-25,542,0,1268,2,1812
867,2019-10-26,300,0,1354,0,1654
867,2019-10-27,364,0,666,0,1030
867,2019-10-28,1138,0,1049,0,2187
867,2019-10-29,258,0,1163,1,1422
867,2019-10-30,933,0,1450,3,2386
867,2019-10-31,453,0,1606,2,2061
867,2019-11-01,245,0,907,0,1152
867,2019-11-02,338,0,1412,0,1750
867,2019-11-03,2476,0,1701,0,4177
867,2019-11-04,403,0,1958,0,2361
867,2019-11-05,1065,0,1172,1,2238
867,2019-11-06,259,0,1248,0,1507
867,2019-11-07,430,0,1197,3,1630
868,2019-09-04,70,0,1606,0,1676
868,2019-09-05,588,0,2288,0,2876
868,2019-09-06,818,0,1948,1,2767
868,2019-09-07,784,0,2437,0,3221
868,2019-09-08,1708,0,2206,2,3916
868,2019-09-09,1189,0,1444,2,2635
868,2019-09-10,720,0,2068,1,2789
868,2019-09-11,598,0,1455,3,2056
868,2019-09-12,340,0,2250,2,2592
868,2019-09-13,773,0,1906,0,2679
868,2019-09-14,2105,0,1501,2,3608
868,2019-09-15,861,0,2986,1,3848
868,2019-09-16,2517,0,1891,1,4409
868,2019-09-17,1722,0,2662,1,4385
868,2019-09-18,1041,0,1643,0,2684
868,2019-09-19,1094,0,1532,1,2627
868,2019-09-20,758,0,1868,0,2626
868,2019-09-21,1591,0,1766,0,3357
868,2019-09-22,692,0,2028,0,2720
868,2019-09-23,733,0,2541,2,3276
868,2019-09-24,806,0,2264,2,3072
868,2019-09-25,1307,0,1894,1,3202
868,2019-09-26,400,0,2009,1,2410
868,2019-09-27,456,0,932,3,1391
868,2019-09-28,398,0,1667,1,2066
868,2019-09-29,1320,0,1395,0,2715
868,2019-09-30,349,0,1922,0,2271
868,2019-10-01,394,0,1433,0,1827
868,2019-10-02,301,0,1648,0,1949
868,2019-10-03,488,0,1635,0,2123
868,2019-10-04,264,0,1035,1,1300
868,2019-10-05,453,0,1832,1,2286
868,2019-10-06,419,0,1836,2,2257
868,2019-10-07,290,0,1494,3,1787
868,2019-10-08,237,0,2574,1,2812
868,2019-10-09,394,0,1644,1,2039
868,2019-10-10,1239,0,3406,0,4645
868,2019-10-11,609,0,2077,2,2688
868,2019-10-12,582,0,2280,2,2864
868,2019-10-13,1423,0,1859,1,3283
868,2019-10-14,1563,0,2886,1,4450
868,2019-10-15,565,0,1773,0,2338
868,2019-10-16,492,0,1181,1,1674
868,2019-10-17,471,0,1926,2,2399
868,2019-10-18,658,0,1988,0,2646
868,2019-10-19,1533,0,1927,1,3461
868,2019-10-20,613,0,1608,0,2221
868,2019-10-21,1050,0,1310,2,2362
868,2019-10-22,1769,0,1610,1,3380
868,2019-10-23,1425,0,1553,0,2978
868,2019-10-24,556,0,2157,1,2714
868,2019-10-25,565,0,1665,1,2231
868,2019-10-26,456,0,2800,2,3258
868,2019-10-27,581,0,1652,2,2235
868,2019-10-28,524,0,1305,1,1830
868,2019-10-29,582,0,1169,0,1751
868,2019-10-30,594,0,1415,0,2009
868,2019-10-31,445,0,1452,1,1898
868,2019-11-01,620,0,1652,2,2274
868,2019-11-02,555,0,968,1,1524
868,2019-11-03,494,0,1944,0,2438
868,2019-11-04,1027,0,1208,0,2235
868,2019-11-05,1005,0,2223,1,3229
868,2019-11-06,652,0,2832,0,3484
868,2019-11-07,1699,0,2116,3,3818
868,2019-11-08,651,0,1789,0,2440
868,2019-11-09,598,0,1271,0,1869
868,2019-11-10,911,0,1547,0,2458
868,2019-11-11,551,0,1438,5,1994
868,2019-11-12,767,0,2288,1,3056
868,2019-11-13,570,0,1363,1,1934
868,2019-11-14,693,0,1496,2,2191
868,2019-11-15,559,0,1603,2,2164
868,2019-11-16,1519,0,2300,3,3822
868,2019-11-17,2520,0,2295,0,4815
868,2019-11-18,543,0,2983,0,3526
868,2019-11-19,1517,0,2809,0,4326
868,2019-11-20,583,0,2456,1,3040
868,2019-11-21,643,0,1394,2,2039
868,2019-11-22,636,0,1345,3,1984
868,2019-11-23,664,0,1857,0,2521
868,2019-11-24,614,0,1730,0,2344
868,2019-11-25,492,0,1824,0,2316
868,2019-11-26,490,0,862,3,1355
868,2019-11-27,517,0,1434,0,1951
868,2019-11-28,1984,0,376,0,2360
868,2019-11-29,135,0,3,0,138
868,2019-09-04,70,0,1606,0,1676
868,2019-09-05,588,0,2288,0,2876
868,2019-09-06,818,0,1948,1,2767
868,2019-09-07,784,0,2437,0,3221
868,2019-09-08,1708,0,2206,2,3916
868,2019-09-09,1189,0,1444,2,2635
868,2019-09-10,720,0,2068,1,2789
868,2019-09-11,598,0,1455,3,2056
868,2019-09-12,340,0,2250,2,2592
868,2019-09-13,773,0,1906,0,2679
868,2019-09-14,2105,0,1501,2,3608
868,2019-09-15,861,0,2986,1,3848
868,2019-09-16,2517,0,1891,1,4409
868,2019-09-17,1722,0,2662,1,4385
868,2019-09-18,1041,0,1643,0,2684
868,2019-09-19,1094,0,1532,1,2627
868,2019-09-20,758,0,1868,0,2626
868,2019-09-21,1591,0,1766,0,3357
868,2019-09-22,692,0,2028,0,2720
868,2019-09-23,733,0,2541,2,3276
868,2019-09-24,806,0,2264,2,3072
868,2019-09-25,1307,0,1894,1,3202
868,2019-09-26,400,0,2009,1,2410
868,2019-09-27,456,0,932,3,1391
868,2019-09-28,398,0,1667,1,2066
868,2019-09-29,1320,0,1395,0,2715
868,2019-09-30,349,0,1922,0,2271
868,2019-10-01,394,0,1433,0,1827
868,2019-10-02,301,0,1648,0,1949
868,2019-10-03,488,0,1635,0,2123
868,2019-10-04,264,0,1035,1,1300
868,2019-10-05,453,0,1832,1,2286
868,2019-10-06,419,0,1836,2,2257
868,2019-10-07,290,0,1494,3,1787
868,2019-10-08,237,0,2574,1,2812
868,2019-10-09,394,0,1644,1,2039
868,2019-10-10,1239,0,3406,0,4645
868,2019-10-11,609,0,2077,2,2688
868,2019-10-12,582,0,2280,2,2864
868,2019-10-13,1423,0,1859,1,3283
868,2019-10-14,1563,0,2886,1,4450
868,2019-10-15,565,0,1773,0,2338
868,2019-10-16,492,0,1181,1,1674
868,2019-10-17,471,0,1926,2,2399
868,2019-10-18,658,0,1988,0,2646
868,2019-10-19,1533,0,1927,1,3461
868,2019-10-20,613,0,1608,0,2221
868,2019-10-21,1050,0,1310,2,2362
868,2019-10-22,1769,0,1610,1,3380
868,2019-10-23,1425,0,1553,0,2978
868,2019-10-24,556,0,2157,1,2714
868,2019-10-25,565,0,1665,1,2231
868,2019-10-26,456,0,2800,2,3258
868,2019-10-27,581,0,1652,2,2235
868,2019-10-28,524,0,1305,1,1830
868,2019-10-29,582,0,1169,0,1751
868,2019-10-30,594,0,1415,0,2009
868,2019-10-31,445,0,1452,1,1898
868,2019-11-01,620,0,1652,2,2274
868,2019-11-02,555,0,968,1,1524
868,2019-11-03,494,0,1944,0,2438
868,2019-11-04,1027,0,1208,0,2235
868,2019-11-05,1005,0,2223,1,3229
868,2019-11-06,652,0,2832,0,3484
868,2019-11-07,1699,0,2116,3,3818
868,2019-11-08,651,0,1789,0,2440
868,2019-11-09,598,0,1271,0,1869
868,2019-11-10,911,0,1547,0,2458
868,2019-11-11,551,0,1438,5,1994
868,2019-11-12,767,0,2288,1,3056
868,2019-11-13,570,0,1363,1,1934
868,2019-11-14,693,0,1496,2,2191
868,2019-11-15,559,0,1603,2,2164
868,2019-11-16,1519,0,2300,3,3822
868,2019-11-17,2520,0,2295,0,4815
868,2019-11-18,543,0,2983,0,3526
868,2019-11-19,1517,0,2809,0,4326
868,2019-11-20,583,0,2456,1,3040
868,2019-11-21,643,0,1394,2,2039
868,2019-11-22,636,0,1345,3,1984
868,2019-11-23,664,0,1857,0,2521
868,2019-11-24,614,0,1730,0,2344
868,2019-11-25,492,0,1824,0,2316
868,2019-11-26,490,0,862,3,1355
868,2019-11-27,517,0,1434,0,1951
868,2019-11-28,1984,0,376,0,2360
868,2019-11-29,135,0,3,0,138
868,2019-09-06,818,0,1948,1,2767
868,2019-09-07,784,0,2437,0,3221
868,2019-09-08,1708,0,2206,2,3916
868,2019-09-09,1189,0,1444,2,2635
868,2019-09-10,720,0,2068,1,2789
868,2019-09-11,598,0,1455,3,2056
868,2019-09-12,340,0,2250,2,2592
868,2019-09-13,773,0,1906,0,2679
868,2019-09-14,2105,0,1501,2,3608
868,2019-09-15,861,0,2986,1,3848
868,2019-09-16,2517,0,1891,1,4409
868,2019-09-17,1722,0,2662,1,4385
868,2019-09-18,1041,0,1643,0,2684
868,2019-09-19,1094,0,1532,1,2627
868,2019-09-20,758,0,1868,0,2626
868,2019-09-21,1591,0,1766,0,3357
868,2019-09-22,692,0,2028,0,2720
868,2019-09-23,733,0,2541,2,3276
868,2019-09-24,806,0,2264,2,3072
868,2019-09-25,1307,0,1894,1,3202
868,2019-09-26,400,0,2009,1,2410
868,2019-09-27,456,0,932,3,1391
868,2019-09-28,398,0,1667,1,2066
868,2019-09-29,1320,0,1395,0,2715
868,2019-09-30,349,0,1922,0,2271
868,2019-10-01,394,0,1433,0,1827
868,2019-10-02,301,0,1648,0,1949
868,2019-10-03,488,0,1635,0,2123
868,2019-10-04,264,0,1035,1,1300
868,2019-10-05,453,0,1832,1,2286
868,2019-10-06,419,0,1836,2,2257
868,2019-10-07,290,0,1494,3,1787
868,2019-10-08,237,0,2574,1,2812
868,2019-10-09,394,0,1644,1,2039
868,2019-10-10,1239,0,3406,0,4645
868,2019-10-11,609,0,2077,2,2688
868,2019-10-12,582,0,2280,2,2864
868,2019-10-13,1423,0,1859,1,3283
868,2019-10-14,1563,0,2886,1,4450
868,2019-10-15,565,0,1773,0,2338
868,2019-10-16,492,0,1181,1,1674
868,2019-10-17,471,0,1926,2,2399
868,2019-10-18,658,0,1988,0,2646
868,2019-10-19,1533,0,1927,1,3461
868,2019-10-20,613,0,1608,0,2221
868,2019-10-21,1050,0,1310,2,2362
868,2019-10-22,1769,0,1610,1,3380
868,2019-10-23,1425,0,1553,0,2978
868,2019-10-24,556,0,2157,1,2714
868,2019-10-25,565,0,1665,1,2231
868,2019-10-26,456,0,2800,2,3258
868,2019-10-27,581,0,1652,2,2235
868,2019-10-28,524,0,1305,1,1830
868,2019-10-29,582,0,1169,0,1751
868,2019-10-30,594,0,1415,0,2009
868,2019-10-31,445,0,1452,1,1898
868,2019-11-01,620,0,1652,2,2274
868,2019-11-02,555,0,968,1,1524
868,2019-11-03,494,0,1944,0,2438
868,2019-11-04,1027,0,1208,0,2235
868,2019-11-05,1005,0,2223,1,3229
868,2019-11-06,652,0,2832,0,3484
868,2019-11-07,1699,0,2116,3,3818
868,2019-11-08,651,0,1789,0,2440
868,2019-11-09,598,0,1271,0,1869
868,2019-11-10,911,0,1547,0,2458
868,2019-11-11,551,0,1438,5,1994
868,2019-11-12,767,0,2288,1,3056
868,2019-11-13,570,0,1363,1,1934
868,2019-11-14,693,0,1496,2,2191
868,2019-11-15,559,0,1603,2,2164
868,2019-11-16,1519,0,2300,3,3822
868,2019-11-17,2520,0,2295,0,4815
868,2019-11-18,543,0,2983,0,3526
868,2019-11-19,1517,0,2809,0,4326
868,2019-11-20,583,0,2456,1,3040
868,2019-11-21,643,0,1394,2,2039
868,2019-11-22,636,0,1345,3,1984
868,2019-11-23,664,0,1857,0,2521
868,2019-11-24,614,0,1730,0,2344
868,2019-11-25,492,0,1824,0,2316
868,2019-11-26,490,0,862,3,1355
869,2019-09-04,1798,0,1120,2,2920
869,2019-09-05,437,0,1620,0,2057
869,2019-09-06,523,0,1827,0,2350
869,2019-09-07,1469,0,2125,0,3594
869,2019-09-08,431,0,2274,1,2706
869,2019-09-09,221,0,2560,2,2783
869,2019-09-10,576,0,1552,2,2130
869,2019-09-11,751,0,1892,2,2645
869,2019-09-12,274,0,1663,4,1941
869,2019-09-13,1309,0,1782,2,3093
869,2019-09-14,163,0,1856,0,2019
869,2019-09-15,828,0,2340,1,3169
869,2019-09-16,1252,0,2609,5,3866
869,2019-09-17,179,0,1348,7,1534
869,2019-09-18,212,0,1316,9,1537
869,2019-09-19,1461,0,1623,11,3095
869,2019-09-20,345,0,1980,8,2333
869,2019-09-21,263,0,2150,9,2422
869,2019-09-22,212,0,1364,9,1585
869,2019-09-23,546,0,1650,11,2207
869,2019-09-24,1897,0,2085,16,3998
869,2019-09-25,250,0,1320,11,1581
869,2019-09-26,325,0,888,10,1223
869,2019-09-27,303,0,2039,2,2344
869,2019-09-28,1085,0,1030,100,2215
869,2019-09-29,389,0,1208,4,1601
869,2019-09-30,267,0,2103,1,2371
869,2019-10-01,227,0,1261,3,1491
869,2019-10-02,405,0,1955,7,2367
869,2019-10-03,245,0,2316,10,2571
869,2019-10-04,257,0,582,13,852
869,2019-10-05,396,0,1527,11,1934
869,2019-10-06,409,0,1998,11,2418
869,2019-10-07,587,0,2106,10,2703
869,2019-10-08,358,0,1764,11,2133
869,2019-10-09,1894,0,1295,11,3200
869,2019-10-10,309,0,1744,10,2063
869,2019-10-11,654,0,1841,10,2505
869,2019-10-12,258,0,2158,0,2416
869,2019-10-13,1143,0,1357,0,2500
869,2019-10-14,368,0,1994,2,2364
869,2019-10-15,285,0,1994,0,2279
869,2019-10-16,1314,0,2212,1,3527
869,2019-10-17,348,0,1788,1,2137
869,2019-10-18,267,0,1801,0,2068
869,2019-10-19,229,0,1547,1,1777
869,2019-10-20,1288,0,1510,0,2798
869,2019-10-21,206,0,1422,3,1631
869,2019-10-22,510,0,1452,0,1962
869,2019-10-23,215,0,1772,0,1987
869,2019-10-24,305,0,1675,3,1983
869,2019-10-25,952,0,1594,0,2546
869,2019-10-26,449,0,2245,0,2694
869,2019-10-27,749,0,2379,1,3129
869,2019-10-28,276,0,2448,1,2725
869,2019-10-29,536,0,1774,4,2314
869,2019-10-30,275,0,1678,0,1953
869,2019-10-31,1222,0,2245,679,4146
869,2019-11-01,302,0,1305,0,1607
869,2019-11-02,180,0,2355,0,2535
869,2019-11-03,892,0,1118,3,2013
869,2019-11-04,429,0,1425,0,1854
869,2019-11-05,276,0,2444,0,2720
869,2019-11-06,299,0,1028,0,1327
869,2019-11-07,496,0,1077,3,1576
869,2019-11-08,282,0,1386,2,1670
869,2019-11-09,331,0,1611,0,1942
869,2019-11-10,213,0,1139,0,1352
869,2019-11-11,1129,0,1276,0,2405
869,2019-11-12,308,0,2120,1,2429
869,2019-11-13,316,0,1856,5,2177
869,2019-11-14,826,0,2738,2,3566
869,2019-11-15,297,0,2340,297,2934
869,2019-11-16,172,0,1156,1,1329
869,2019-11-17,953,0,2470,0,3423
869,2019-11-18,313,0,2146,4,2463
869,2019-11-19,713,0,2345,1,3059
869,2019-11-20,432,0,2456,0,2888
869,2019-11-21,205,0,2030,0,2235
869,2019-11-22,296,0,1483,680,2459
869,2019-11-23,396,0,2092,3,2491
869,2019-11-24,306,0,1783,2,2091
869,2019-11-25,1083,0,1885,0,2968
869,2019-11-26,481,0,893,67,1441
869,2019-11-27,174,0,1737,0,1911
869,2019-11-28,253,0,548,1,802
869,2019-11-29,16,0,2,0,18
869,2019-09-04,1798,0,1120,2,2920
869,2019-09-05,437,0,1620,0,2057
869,2019-09-06,523,0,1827,0,2350
869,2019-09-07,1469,0,2125,0,3594
869,2019-09-08,431,0,2274,1,2706
869,2019-09-09,221,0,2560,2,2783
869,2019-09-10,576,0,1552,2,2130
869,2019-09-11,751,0,1892,2,2645
869,2019-09-12,274,0,1663,4,1941
869,2019-09-13,1309,0,1782,2,3093
869,2019-09-14,163,0,1856,0,2019
869,2019-09-15,828,0,2340,1,3169
869,2019-09-16,1252,0,2609,5,3866
869,2019-09-17,179,0,1348,7,1534
869,2019-09-18,212,0,1316,9,1537
869,2019-09-19,1461,0,1623,11,3095
869,2019-09-20,345,0,1980,8,2333
869,2019-09-21,263,0,2150,9,2422
869,2019-09-22,212,0,1364,9,1585
869,2019-09-23,546,0,1650,11,2207
869,2019-09-24,1897,0,2085,16,3998
869,2019-09-25,250,0,1320,11,1581
869,2019-09-26,325,0,888,10,1223
869,2019-09-27,303,0,2039,2,2344
869,2019-09-28,1085,0,1030,100,2215
869,2019-09-29,389,0,1208,4,1601
869,2019-09-30,267,0,2103,1,2371
869,2019-10-01,227,0,1261,3,1491
869,2019-10-02,405,0,1955,7,2367
869,2019-10-03,245,0,2316,10,2571
869,2019-10-04,257,0,582,13,852
869,2019-10-05,396,0,1527,11,1934
869,2019-10-06,409,0,1998,11,2418
869,2019-10-07,587,0,2106,10,2703
869,2019-10-08,358,0,1764,11,2133
869,2019-10-09,1894,0,1295,11,3200
869,2019-10-10,309,0,1744,10,2063
869,2019-10-11,654,0,1841,10,2505
869,2019-10-12,258,0,2158,0,2416
869,2019-10-13,1143,0,1357,0,2500
869,2019-10-14,368,0,1994,2,2364
869,2019-10-15,285,0,1994,0,2279
869,2019-10-16,1314,0,2212,1,3527
869,2019-10-17,348,0,1788,1,2137
869,2019-10-18,267,0,1801,0,2068
869,2019-10-19,229,0,1547,1,1777
869,2019-10-20,1288,0,1510,0,2798
869,2019-10-21,206,0,1422,3,1631
869,2019-10-22,510,0,1452,0,1962
869,2019-10-23,215,0,1772,0,1987
869,2019-10-24,305,0,1675,3,1983
869,2019-10-25,952,0,1594,0,2546
869,2019-10-26,449,0,2245,0,2694
869,2019-10-27,749,0,2379,1,3129
869,2019-10-28,276,0,2448,1,2725
869,2019-10-29,536,0,1774,4,2314
869,2019-10-30,275,0,1678,0,1953
869,2019-10-31,1222,0,2245,679,4146
869,2019-11-01,302,0,1305,0,1607
869,2019-11-02,180,0,2355,0,2535
869,2019-11-03,892,0,1118,3,2013
869,2019-11-04,429,0,1425,0,1854
869,2019-11-05,276,0,2444,0,2720
869,2019-11-06,299,0,1028,0,1327
869,2019-11-07,496,0,1077,3,1576
869,2019-11-08,282,0,1386,2,1670
869,2019-11-09,331,0,1611,0,1942
869,2019-11-10,213,0,1139,0,1352
869,2019-11-11,1129,0,1276,0,2405
869,2019-11-12,308,0,2120,1,2429
869,2019-11-13,316,0,1856,5,2177
869,2019-11-14,826,0,2738,2,3566
869,2019-11-15,297,0,2340,297,2934
869,2019-11-16,172,0,1156,1,1329
869,2019-11-17,953,0,2470,0,3423
869,2019-11-18,313,0,2146,4,2463
869,2019-11-19,713,0,2345,1,3059
869,2019-11-20,432,0,2456,0,2888
869,2019-11-21,205,0,2030,0,2235
869,2019-11-22,296,0,1483,680,2459
869,2019-11-23,396,0,2092,3,2491
869,2019-11-24,306,0,1783,2,2091
869,2019-11-25,1083,0,1885,0,2968
869,2019-11-26,481,0,893,67,1441
869,2019-11-27,174,0,1737,0,1911
869,2019-11-28,253,0,548,1,802
869,2019-11-29,16,0,2,0,18
869,2019-09-04,1798,0,1120,2,2920
869,2019-09-05,437,0,1620,0,2057
869,2019-09-06,523,0,1827,0,2350
869,2019-09-07,1469,0,2125,0,3594
869,2019-09-08,431,0,2274,1,2706
869,2019-09-09,221,0,2560,2,2783
869,2019-09-10,576,0,1552,2,2130
869,2019-09-11,751,0,1892,2,2645
869,2019-09-12,274,0,1663,4,1941
869,2019-09-13,1309,0,1782,2,3093
869,2019-09-14,163,0,1856,0,2019
869,2019-09-15,828,0,2340,1,3169
869,2019-09-16,1252,0,2609,5,3866
869,2019-09-17,179,0,1348,7,1534
869,2019-09-18,212,0,1316,9,1537
869,2019-09-19,1461,0,1623,11,3095
869,2019-09-20,345,0,1980,8,2333
869,2019-09-21,263,0,2150,9,2422
869,2019-09-22,212,0,1364,9,1585
869,2019-09-23,546,0,1650,11,2207
869,2019-09-24,1897,0,2085,16,3998
869,2019-09-25,250,0,1320,11,1581
869,2019-09-26,325,0,888,10,1223
869,2019-09-27,303,0,2039,2,2344
869,2019-09-28,1085,0,1030,100,2215
869,2019-09-29,389,0,1208,4,1601
869,2019-09-30,267,0,2103,1,2371
869,2019-10-01,227,0,1261,3,1491
869,2019-10-02,405,0,1955,7,2367
869,2019-10-03,245,0,2316,10,2571
869,2019-10-04,257,0,582,13,852
869,2019-10-05,396,0,1527,11,1934
869,2019-10-06,409,0,1998,11,2418
869,2019-10-07,587,0,2106,10,2703
869,2019-10-08,358,0,1764,11,2133
869,2019-10-09,1894,0,1295,11,3200
869,2019-10-10,309,0,1744,10,2063
869,2019-10-11,654,0,1841,10,2505
869,2019-10-12,258,0,2158,0,2416
869,2019-10-13,1143,0,1357,0,2500
869,2019-10-14,368,0,1994,2,2364
869,2019-10-15,285,0,1994,0,2279
869,2019-10-16,1314,0,2212,1,3527
869,2019-10-17,348,0,1788,1,2137
869,2019-10-18,267,0,1801,0,2068
869,2019-10-19,229,0,1547,1,1777
869,2019-10-20,1288,0,1510,0,2798
869,2019-10-21,206,0,1422,3,1631
869,2019-10-22,510,0,1452,0,1962
869,2019-10-23,215,0,1772,0,1987
869,2019-10-24,305,0,1675,3,1983
869,2019-10-25,952,0,1594,0,2546
869,2019-10-26,449,0,2245,0,2694
869,2019-10-27,749,0,2379,1,3129
869,2019-10-28,276,0,2448,1,2725
869,2019-10-29,536,0,1774,4,2314
869,2019-10-30,275,0,1678,0,1953
869,2019-10-31,1222,0,2245,679,4146
869,2019-11-01,302,0,1305,0,1607
869,2019-11-02,180,0,2355,0,2535
869,2019-11-03,892,0,1118,3,2013
869,2019-11-04,429,0,1425,0,1854
869,2019-11-05,276,0,2444,0,2720
869,2019-11-06,299,0,1028,0,1327
869,2019-11-07,496,0,1077,3,1576
869,2019-11-08,282,0,1386,2,1670
869,2019-11-09,331,0,1611,0,1942
869,2019-11-10,213,0,1139,0,1352
869,2019-11-11,1129,0,1276,0,2405
869,2019-11-12,308,0,2120,1,2429
869,2019-11-13,316,0,1856,5,2177
869,2019-11-14,826,0,2738,2,3566
869,2019-11-15,297,0,2340,297,2934
869,2019-11-16,172,0,1156,1,1329
869,2019-11-17,953,0,2470,0,3423
869,2019-11-18,313,0,2146,4,2463
869,2019-11-19,713,0,2345,1,3059
869,2019-11-20,432,0,2456,0,2888
869,2019-11-21,205,0,2030,0,2235
869,2019-11-22,296,0,1483,680,2459
869,2019-11-23,396,0,2092,3,2491
869,2019-11-24,306,0,1783,2,2091
869,2019-11-25,1083,0,1885,0,2968
869,2019-11-26,481,0,893,67,1441
869,2019-11-27,174,0,1737,0,1911
869,2019-11-28,253,0,548,1,802
870,2019-09-04,18,0,1056,0,1074
870,2019-09-05,116,0,1787,0,1903
870,2019-09-06,170,0,2314,1,2485
870,2019-09-07,318,0,2460,0,2778
870,2019-09-08,237,0,2106,0,2343
870,2019-09-09,245,0,1494,0,1739
870,2019-09-10,113,0,1833,0,1946
870,2019-09-11,164,0,2588,2,2754
870,2019-09-12,967,0,2201,2,3170
870,2019-09-13,126,0,2602,0,2728
870,2019-09-14,1764,0,1983,1,3748
870,2019-09-15,57,0,2877,3,2937
870,2019-09-16,97,0,2248,0,2345
870,2019-09-17,66,0,2376,1,2443
870,2019-09-18,103,0,1371,1,1475
870,2019-09-19,186,0,1364,2,1552
870,2019-09-20,229,0,2049,0,2278
870,2019-09-21,109,0,1885,2,1996
870,2019-09-22,100,0,1992,2,2094
870,2019-09-23,160,0,1771,2,1933
870,2019-09-24,127,0,2921,2,3050
870,2019-09-25,99,0,1574,0,1673
870,2019-09-26,89,0,1564,3,1656
870,2019-09-27,101,0,3038,1,3140
870,2019-09-28,100,0,2332,2,2434
870,2019-09-29,919,0,818,1,1738
870,2019-09-30,88,0,1943,0,2031
870,2019-10-01,107,0,1346,1,1454
870,2019-10-02,152,0,1951,0,2103
870,2019-10-03,185,0,1469,1,1655
870,2019-10-04,79,0,1799,326,2204
870,2019-10-05,1099,0,1305,0,2404
870,2019-10-06,100,0,1521,5,1626
870,2019-10-07,933,0,1445,0,2378
870,2019-10-08,82,0,1371,0,1453
870,2019-10-09,109,0,2030,0,2139
870,2019-10-10,100,0,1474,2,1576
870,2019-10-11,746,0,1597,3,2346
870,2019-10-12,365,0,1516,1,1882
870,2019-10-13,967,0,2504,3,3474
870,2019-10-14,1843,0,2402,0,4245
870,2019-10-15,200,0,1732,0,1932
870,2019-10-16,483,0,1083,2,1568
870,2019-10-17,159,0,1966,1,2126
870,2019-10-18,159,0,1586,0,1745
870,2019-10-19,70,0,2184,1,2255
870,2019-10-20,954,0,1665,1,2620
870,2019-10-21,982,0,1314,4,2300
870,2019-10-22,532,0,1720,0,2252
870,2019-10-23,301,0,1926,2,2229
870,2019-10-24,76,0,1163,0,1239
870,2019-10-25,729,0,1658,1,2388
870,2019-10-26,100,0,1163,1,1264
870,2019-10-27,325,0,2148,1,2474
870,2019-10-28,463,0,1464,1,1928
870,2019-10-29,135,0,1051,0,1186
870,2019-10-30,507,0,1124,2,1633
870,2019-10-31,73,0,1999,2,2074
870,2019-11-01,37,0,1707,1,1745
870,2019-11-02,88,0,921,0,1009
870,2019-11-03,505,0,744,0,1249
870,2019-11-04,967,0,1773,1,2741
870,2019-11-05,129,0,1357,2,1488
870,2019-11-06,120,0,1220,1,1341
870,2019-11-07,170,0,1076,3,1249
870,2019-11-08,733,0,636,0,1369
870,2019-11-09,988,0,1840,0,2828
870,2019-11-10,493,0,1715,2,2210
870,2019-11-11,97,0,2596,3,2696
870,2019-11-12,475,0,2421,0,2896
870,2019-11-13,110,0,1399,3,1512
870,2019-11-14,86,0,1216,3,1305
870,2019-11-15,234,0,1427,0,1661
870,2019-11-16,459,0,2180,0,2639
870,2019-11-17,982,0,2014,1,2997
870,2019-11-18,101,0,2962,1,3064
870,2019-11-19,128,0,2677,0,2805
870,2019-11-20,1015,0,1895,3,2913
870,2019-11-21,173,0,2417,2,2592
870,2019-11-22,107,0,1469,2,1578
870,2019-11-23,77,0,2475,1,2553
870,2019-11-24,198,0,1465,9,1672
870,2019-11-25,1368,0,1955,0,3323
870,2019-11-26,353,0,852,0,1205
870,2019-11-27,518,0,1344,0,1862
870,2019-11-28,477,0,665,0,1142
870,2019-11-29,21,0,0,0,21
870,2019-09-04,18,0,1056,0,1074
870,2019-09-05,116,0,1787,0,1903
870,2019-09-06,170,0,2314,1,2485
870,2019-09-07,318,0,2460,0,2778
870,2019-09-08,237,0,2106,0,2343
870,2019-09-09,245,0,1494,0,1739
870,2019-09-10,113,0,1833,0,1946
870,2019-09-11,164,0,2588,2,2754
870,2019-09-12,967,0,2201,2,3170
870,2019-09-13,126,0,2602,0,2728
870,2019-09-14,1764,0,1983,1,3748
870,2019-09-15,57,0,2877,3,2937
870,2019-09-16,97,0,2248,0,2345
870,2019-09-17,66,0,2376,1,2443
870,2019-09-18,103,0,1371,1,1475
870,2019-09-19,186,0,1364,2,1552
870,2019-09-20,229,0,2049,0,2278
870,2019-09-21,109,0,1885,2,1996
870,2019-09-22,100,0,1992,2,2094
870,2019-09-23,160,0,1771,2,1933
870,2019-09-24,127,0,2921,2,3050
870,2019-09-25,99,0,1574,0,1673
870,2019-09-26,89,0,1564,3,1656
870,2019-09-27,101,0,3038,1,3140
870,2019-09-28,100,0,2332,2,2434
870,2019-09-29,919,0,818,1,1738
870,2019-09-30,88,0,1943,0,2031
870,2019-10-01,107,0,1346,1,1454
870,2019-10-02,152,0,1951,0,2103
870,2019-10-03,185,0,1469,1,1655
870,2019-10-04,79,0,1799,326,2204
870,2019-10-05,1099,0,1305,0,2404
870,2019-10-06,100,0,1521,5,1626
870,2019-10-07,933,0,1445,0,2378
870,2019-10-08,82,0,1371,0,1453
870,2019-10-09,109,0,2030,0,2139
870,2019-10-10,100,0,1474,2,1576
870,2019-10-11,746,0,1597,3,2346
870,2019-10-12,365,0,1516,1,1882
870,2019-10-13,967,0,2504,3,3474
870,2019-10-14,1843,0,2402,0,4245
870,2019-10-15,200,0,1732,0,1932
870,2019-10-16,483,0,1083,2,1568
870,2019-10-17,159,0,1966,1,2126
870,2019-10-18,159,0,1586,0,1745
870,2019-10-19,70,0,2184,1,2255
870,2019-10-20,954,0,1665,1,2620
870,2019-10-21,982,0,1314,4,2300
870,2019-10-22,532,0,1720,0,2252
870,2019-10-23,301,0,1926,2,2229
870,2019-10-24,76,0,1163,0,1239
870,2019-10-25,729,0,1658,1,2388
870,2019-10-26,100,0,1163,1,1264
870,2019-10-27,325,0,2148,1,2474
870,2019-10-28,463,0,1464,1,1928
870,2019-10-29,135,0,1051,0,1186
870,2019-10-30,507,0,1124,2,1633
870,2019-10-31,73,0,1999,2,2074
870,2019-11-01,37,0,1707,1,1745
870,2019-11-02,88,0,921,0,1009
870,2019-11-03,505,0,744,0,1249
870,2019-11-04,967,0,1773,1,2741
870,2019-11-05,129,0,1357,2,1488
870,2019-11-06,120,0,1220,1,1341
870,2019-11-07,170,0,1076,3,1249
870,2019-11-08,733,0,636,0,1369
870,2019-11-09,988,0,1840,0,2828
870,2019-11-10,493,0,1715,2,2210
870,2019-11-11,97,0,2596,3,2696
870,2019-11-12,475,0,2421,0,2896
870,2019-11-13,110,0,1399,3,1512
870,2019-11-14,86,0,1216,3,1305
870,2019-11-15,234,0,1427,0,1661
870,2019-11-16,459,0,2180,0,2639
870,2019-11-17,982,0,2014,1,2997
870,2019-11-18,101,0,2962,1,3064
870,2019-11-19,128,0,2677,0,2805
870,2019-11-20,1015,0,1895,3,2913
870,2019-11-21,173,0,2417,2,2592
870,2019-11-22,107,0,1469,2,1578
870,2019-11-23,77,0,2475,1,2553
870,2019-11-24,198,0,1465,9,1672
870,2019-11-25,1368,0,1955,0,3323
870,2019-11-26,353,0,852,0,1205
870,2019-11-27,518,0,1344,0,1862
870,2019-11-28,477,0,665,0,1142
870,2019-09-06,170,0,2314,1,2485
870,2019-09-07,318,0,2460,0,2778
870,2019-09-08,237,0,2106,0,2343
870,2019-09-09,245,0,1494,0,1739
870,2019-09-10,113,0,1833,0,1946
870,2019-09-11,164,0,2588,2,2754
870,2019-09-12,967,0,2201,2,3170
870,2019-09-13,126,0,2602,0,2728
870,2019-09-14,1764,0,1983,1,3748
870,2019-09-15,57,0,2877,3,2937
870,2019-09-16,97,0,2248,0,2345
870,2019-09-17,66,0,2376,1,2443
870,2019-09-18,103,0,1371,1,1475
870,2019-09-19,186,0,1364,2,1552
870,2019-09-20,229,0,2049,0,2278
870,2019-09-21,109,0,1885,2,1996
870,2019-09-22,100,0,1992,2,2094
870,2019-09-23,160,0,1771,2,1933
870,2019-09-24,127,0,2921,2,3050
870,2019-09-25,99,0,1574,0,1673
870,2019-09-26,89,0,1564,3,1656
870,2019-09-27,101,0,3038,1,3140
870,2019-09-28,100,0,2332,2,2434
870,2019-09-29,919,0,818,1,1738
870,2019-09-30,88,0,1943,0,2031
870,2019-10-01,107,0,1346,1,1454
870,2019-10-02,152,0,1951,0,2103
870,2019-10-03,185,0,1469,1,1655
870,2019-10-04,79,0,1799,326,2204
870,2019-10-05,1099,0,1305,0,2404
870,2019-10-06,100,0,1521,5,1626
870,2019-10-07,933,0,1445,0,2378
870,2019-10-08,82,0,1371,0,1453
870,2019-10-09,109,0,2030,0,2139
870,2019-10-10,100,0,1474,2,1576
870,2019-10-11,746,0,1597,3,2346
870,2019-10-12,365,0,1516,1,1882
870,2019-10-13,967,0,2504,3,3474
870,2019-10-14,1843,0,2402,0,4245
870,2019-10-15,200,0,1732,0,1932
870,2019-10-16,483,0,1083,2,1568
870,2019-10-17,159,0,1966,1,2126
870,2019-10-18,159,0,1586,0,1745
870,2019-10-19,70,0,2184,1,2255
870,2019-10-20,954,0,1665,1,2620
870,2019-10-21,982,0,1314,4,2300
870,2019-10-22,532,0,1720,0,2252
870,2019-10-23,301,0,1926,2,2229
870,2019-10-24,76,0,1163,0,1239
870,2019-10-25,729,0,1658,1,2388
870,2019-10-26,100,0,1163,1,1264
870,2019-10-27,325,0,2148,1,2474
870,2019-10-28,463,0,1464,1,1928
870,2019-10-29,135,0,1051,0,1186
870,2019-10-30,507,0,1124,2,1633
870,2019-10-31,73,0,1999,2,2074
870,2019-11-01,37,0,1707,1,1745
870,2019-11-02,88,0,921,0,1009
870,2019-11-03,505,0,744,0,1249
870,2019-11-04,967,0,1773,1,2741
870,2019-11-05,129,0,1357,2,1488
870,2019-11-06,120,0,1220,1,1341
870,2019-11-07,170,0,1076,3,1249
870,2019-11-08,733,0,636,0,1369
870,2019-11-09,988,0,1840,0,2828
870,2019-11-10,493,0,1715,2,2210
870,2019-11-11,97,0,2596,3,2696
870,2019-11-12,475,0,2421,0,2896
870,2019-11-13,110,0,1399,3,1512
870,2019-11-14,86,0,1216,3,1305
870,2019-11-15,234,0,1427,0,1661
870,2019-11-16,459,0,2180,0,2639
870,2019-11-17,982,0,2014,1,2997
870,2019-11-18,101,0,2962,1,3064
870,2019-11-19,128,0,2677,0,2805
870,2019-11-20,1015,0,1895,3,2913
870,2019-11-21,173,0,2417,2,2592
870,2019-11-22,107,0,1469,2,1578
870,2019-11-23,77,0,2475,1,2553
870,2019-11-24,198,0,1465,9,1672
871,2019-09-04,21,0,1465,0,1486
871,2019-09-05,234,0,1884,2,2120
871,2019-09-06,221,0,1329,2,1552
871,2019-09-07,216,0,1558,1,1775
871,2019-09-08,257,0,1548,0,1805
871,2019-09-09,832,0,1783,2,2617
871,2019-09-10,140,0,1985,1,2126
871,2019-09-11,198,0,1088,4,1290
871,2019-09-12,207,0,1756,4,1967
871,2019-09-13,122,0,1803,1,1926
871,2019-09-14,132,0,1572,1,1705
871,2019-09-15,1024,0,2593,4,3621
871,2019-09-16,949,0,1982,2,2933
871,2019-09-17,93,0,1980,3,2076
871,2019-09-18,90,0,1864,0,1954
871,2019-09-19,265,0,1441,1,1707
871,2019-09-20,201,0,1513,6,1720
871,2019-09-21,98,0,2161,1,2260
871,2019-09-22,94,0,1692,0,1786
871,2019-09-23,996,0,1365,2,2363
871,2019-09-24,978,0,1505,2,2485
871,2019-09-25,86,0,1361,3,1450
871,2019-09-26,332,0,1923,1,2256
871,2019-09-27,904,0,1924,6,2834
871,2019-09-28,799,0,1396,4,2199
871,2019-09-29,191,0,1950,1,2142
871,2019-09-30,941,0,1826,2,2769
871,2019-10-01,84,0,2142,0,2226
871,2019-10-02,138,0,1358,2,1498
871,2019-10-03,148,0,965,2,1115
871,2019-10-04,1041,0,2338,2,3381
871,2019-10-05,1341,0,1836,1877,5054
871,2019-10-06,652,0,1454,0,2106
871,2019-10-07,355,0,2253,4,2612
871,2019-10-08,1038,0,1483,1,2522
871,2019-10-09,107,0,2454,4,2565
871,2019-10-10,1003,0,3977,0,4980
871,2019-10-11,102,0,4341,4,4447
871,2019-10-12,110,0,3913,5,4028
871,2019-10-13,1227,0,3747,3,4977
871,2019-10-14,1089,0,4182,2,5273
871,2019-10-15,986,0,3628,0,4614
871,2019-10-16,116,0,2826,2,2944
871,2019-10-17,66,0,3730,3,3799
871,2019-10-18,1291,0,3499,2,4792
871,2019-10-19,224,0,4760,0,4984
871,2019-10-20,183,0,1453,1,1637
871,2019-10-21,84,0,1926,2,2012
871,2019-10-22,1103,0,1841,1,2945
871,2019-10-23,276,0,1442,1,1719
871,2019-10-24,182,0,1653,3,1838
871,2019-10-25,118,0,1491,3,1612
871,2019-10-26,114,0,1053,0,1167
871,2019-10-27,127,0,1298,0,1425
871,2019-10-28,74,0,1107,1,1182
871,2019-10-29,130,0,1144,1,1275
871,2019-10-30,109,0,1428,0,1537
871,2019-10-31,177,0,1558,2,1737
871,2019-11-01,925,0,1030,3,1958
871,2019-11-02,693,0,1879,0,2572
871,2019-11-03,68,0,1590,0,1658
871,2019-11-04,115,0,1608,1,1724
871,2019-11-05,603,0,1322,2,1927
871,2019-11-06,105,0,1219,2,1326
871,2019-11-07,473,0,1071,0,1544
871,2019-11-08,93,0,942,0,1035
871,2019-11-09,180,0,1641,0,1821
871,2019-11-10,94,0,1513,0,1607
871,2019-11-11,114,0,870,0,984
871,2019-11-12,69,0,2137,0,2206
871,2019-11-13,589,0,1341,0,1930
871,2019-11-14,72,0,1726,0,1798
871,2019-11-15,1166,0,2600,0,3766
871,2019-11-16,1023,0,2268,0,3291
871,2019-11-17,1097,0,2834,0,3931
871,2019-11-18,113,0,2259,0,2372
871,2019-11-19,109,0,2527,0,2636
871,2019-11-20,1086,0,2094,0,3180
871,2019-11-21,115,0,1659,0,1774
871,2019-11-22,124,0,1071,0,1195
871,2019-11-23,95,0,2167,0,2262
871,2019-11-24,223,0,1322,0,1545
871,2019-11-25,133,0,1508,0,1641
871,2019-11-26,14,0,0,0,14
871,2019-09-04,21,0,1465,0,1486
871,2019-09-05,234,0,1884,2,2120
871,2019-09-06,221,0,1329,2,1552
871,2019-09-07,216,0,1558,1,1775
871,2019-09-08,257,0,1548,0,1805
871,2019-09-09,832,0,1783,2,2617
871,2019-09-10,140,0,1985,1,2126
871,2019-09-11,198,0,1088,4,1290
871,2019-09-12,207,0,1756,4,1967
871,2019-09-13,122,0,1803,1,1926
871,2019-09-14,132,0,1572,1,1705
871,2019-09-15,1024,0,2593,4,3621
871,2019-09-16,949,0,1982,2,2933
871,2019-09-17,93,0,1980,3,2076
871,2019-09-18,90,0,1864,0,1954
871,2019-09-19,265,0,1441,1,1707
871,2019-09-20,201,0,1513,6,1720
871,2019-09-21,98,0,2161,1,2260
871,2019-09-22,94,0,1692,0,1786
871,2019-09-23,996,0,1365,2,2363
871,2019-09-24,978,0,1505,2,2485
871,2019-09-25,86,0,1361,3,1450
871,2019-09-26,332,0,1923,1,2256
871,2019-09-27,904,0,1924,6,2834
871,2019-09-28,799,0,1396,4,2199
871,2019-09-29,191,0,1950,1,2142
871,2019-09-30,941,0,1826,2,2769
871,2019-10-01,84,0,2142,0,2226
871,2019-10-02,138,0,1358,2,1498
871,2019-10-03,148,0,965,2,1115
871,2019-10-04,1041,0,2338,2,3381
871,2019-10-05,1341,0,1836,1877,5054
871,2019-10-06,652,0,1454,0,2106
871,2019-10-07,355,0,2253,4,2612
871,2019-10-08,1038,0,1483,1,2522
871,2019-10-09,107,0,2454,4,2565
871,2019-10-10,1003,0,3977,0,4980
871,2019-10-11,102,0,4341,4,4447
871,2019-10-12,110,0,3913,5,4028
871,2019-10-13,1227,0,3747,3,4977
871,2019-10-14,1089,0,4182,2,5273
871,2019-10-15,986,0,3628,0,4614
871,2019-10-16,116,0,2826,2,2944
871,2019-10-17,66,0,3730,3,3799
871,2019-10-18,1291,0,3499,2,4792
871,2019-10-19,224,0,4760,0,4984
871,2019-10-20,183,0,1453,1,1637
871,2019-10-21,84,0,1926,2,2012
871,2019-10-22,1103,0,1841,1,2945
871,2019-10-23,276,0,1442,1,1719
871,2019-10-24,182,0,1653,3,1838
871,2019-10-25,118,0,1491,3,1612
871,2019-10-26,114,0,1053,0,1167
871,2019-10-27,127,0,1298,0,1425
871,2019-10-28,74,0,1107,1,1182
871,2019-10-29,130,0,1144,1,1275
871,2019-10-30,109,0,1428,0,1537
871,2019-10-31,177,0,1558,2,1737
871,2019-11-01,925,0,1030,3,1958
871,2019-11-02,693,0,1879,0,2572
871,2019-11-03,68,0,1590,0,1658
871,2019-11-04,115,0,1608,1,1724
871,2019-11-05,603,0,1322,2,1927
871,2019-11-06,105,0,1219,2,1326
871,2019-11-07,473,0,1071,0,1544
871,2019-11-08,93,0,942,0,1035
871,2019-11-09,180,0,1641,0,1821
871,2019-11-10,94,0,1513,0,1607
871,2019-11-11,114,0,870,0,984
871,2019-11-12,69,0,2137,0,2206
871,2019-11-13,589,0,1341,0,1930
871,2019-11-14,72,0,1726,0,1798
871,2019-11-15,1166,0,2600,0,3766
871,2019-11-16,1023,0,2268,0,3291
871,2019-11-17,1097,0,2834,0,3931
871,2019-11-18,113,0,2259,0,2372
871,2019-11-19,109,0,2527,0,2636
871,2019-11-20,1086,0,2094,0,3180
871,2019-11-21,115,0,1659,0,1774
871,2019-11-22,124,0,1071,0,1195
871,2019-11-23,95,0,2167,0,2262
871,2019-11-24,223,0,1322,0,1545
871,2019-11-25,133,0,1508,0,1641
871,2019-09-05,234,0,1884,2,2120
871,2019-09-06,221,0,1329,2,1552
871,2019-09-07,216,0,1558,1,1775
871,2019-09-08,257,0,1548,0,1805
871,2019-09-09,832,0,1783,2,2617
871,2019-09-10,140,0,1985,1,2126
871,2019-09-11,198,0,1088,4,1290
871,2019-09-12,207,0,1756,4,1967
871,2019-09-13,122,0,1803,1,1926
871,2019-09-14,132,0,1572,1,1705
871,2019-09-15,1024,0,2593,4,3621
871,2019-09-16,949,0,1982,2,2933
871,2019-09-17,93,0,1980,3,2076
871,2019-09-18,90,0,1864,0,1954
871,2019-09-19,265,0,1441,1,1707
871,2019-09-20,201,0,1513,6,1720
871,2019-09-21,98,0,2161,1,2260
871,2019-09-22,94,0,1692,0,1786
871,2019-09-23,996,0,1365,2,2363
871,2019-09-24,978,0,1505,2,2485
871,2019-09-25,86,0,1361,3,1450
871,2019-09-26,332,0,1923,1,2256
871,2019-09-27,904,0,1924,6,2834
871,2019-09-28,799,0,1396,4,2199
871,2019-09-29,191,0,1950,1,2142
871,2019-09-30,941,0,1826,2,2769
871,2019-10-01,84,0,2142,0,2226
871,2019-10-02,138,0,1358,2,1498
871,2019-10-03,148,0,965,2,1115
871,2019-10-04,1041,0,2338,2,3381
871,2019-10-05,1341,0,1836,1877,5054
871,2019-10-06,652,0,1454,0,2106
871,2019-10-07,355,0,2253,4,2612
871,2019-10-08,1038,0,1483,1,2522
871,2019-10-09,107,0,2454,4,2565
871,2019-10-10,1003,0,3977,0,4980
871,2019-10-11,102,0,4341,4,4447
871,2019-10-12,110,0,3913,5,4028
871,2019-10-13,1227,0,3747,3,4977
871,2019-10-14,1089,0,4182,2,5273
871,2019-10-15,986,0,3628,0,4614
871,2019-10-16,116,0,2826,2,2944
871,2019-10-17,66,0,3730,3,3799
871,2019-10-18,1291,0,3499,2,4792
871,2019-10-19,224,0,4760,0,4984
871,2019-10-20,183,0,1453,1,1637
871,2019-10-21,84,0,1926,2,2012
871,2019-10-22,1103,0,1841,1,2945
871,2019-10-23,276,0,1442,1,1719
871,2019-10-24,182,0,1653,3,1838
871,2019-10-25,118,0,1491,3,1612
871,2019-10-26,114,0,1053,0,1167
871,2019-10-27,127,0,1298,0,1425
871,2019-10-28,74,0,1107,1,1182
871,2019-10-29,130,0,1144,1,1275
871,2019-10-30,109,0,1428,0,1537
871,2019-10-31,177,0,1558,2,1737
871,2019-11-01,925,0,1030,3,1958
871,2019-11-02,693,0,1879,0,2572
871,2019-11-03,68,0,1590,0,1658
871,2019-11-04,115,0,1608,1,1724
871,2019-11-05,603,0,1322,2,1927
871,2019-11-06,105,0,1219,2,1326
872,2019-09-04,41,0,1248,0,1289
872,2019-09-05,1447,0,1662,0,3109
872,2019-09-06,1819,0,1364,2,3185
872,2019-09-07,2331,0,1927,0,4258
872,2019-09-08,839,0,1580,0,2419
872,2019-09-09,986,0,1990,1,2977
872,2019-09-10,1208,0,1722,1,2931
872,2019-09-11,970,0,1886,1,2857
872,2019-09-12,887,0,1713,3,2603
872,2019-09-13,842,0,2237,1,3080
872,2019-09-14,535,0,1453,0,1988
872,2019-09-15,1236,0,2601,3,3840
872,2019-09-16,1226,0,1681,0,2907
872,2019-09-17,615,0,2427,2,3044
872,2019-09-18,910,0,1521,0,2431
872,2019-09-19,1141,0,1746,0,2887
872,2019-09-20,294,0,1298,0,1592
872,2019-09-21,294,0,1800,1,2095
872,2019-09-22,973,0,1692,1,2666
872,2019-09-23,1576,0,1786,1,3363
872,2019-09-24,649,0,1610,3,2262
872,2019-09-25,192,0,1832,2,2026
872,2019-09-26,241,0,2277,0,2518
872,2019-09-27,2148,0,1527,3,3678
872,2019-09-28,1196,0,1464,1,2661
872,2019-09-29,355,0,1860,1,2216
872,2019-09-30,416,0,1316,0,1732
872,2019-10-01,221,0,1572,1,1794
872,2019-10-02,1986,0,1425,2,3413
872,2019-10-03,305,0,1139,0,1444
872,2019-10-04,1210,0,1120,215,2545
872,2019-10-05,285,0,745,2,1032
872,2019-10-06,1066,0,1438,0,2504
872,2019-10-07,514,0,1539,3,2056
872,2019-10-08,1687,0,1358,0,3045
872,2019-10-09,1503,0,2115,0,3618
872,2019-10-10,1409,0,1966,6273,9648
872,2019-10-11,1289,0,1648,3,2940
872,2019-10-12,476,0,1976,4,2456
872,2019-10-13,1148,0,2144,1,3293
872,2019-10-14,283,0,1868,0,2151
872,2019-10-15,399,0,994,1,1394
872,2019-10-16,1365,0,1077,1,2443
872,2019-10-17,722,0,1250,3,1975
872,2019-10-18,1234,0,1483,0,2717
872,2019-10-19,1226,0,2086,0,3312
872,2019-10-20,1196,0,1706,0,2902
872,2019-10-21,1513,0,1358,1,2872
872,2019-10-22,314,0,2119,3,2436
872,2019-10-23,1025,0,1839,1,2865
872,2019-10-24,970,0,2186,0,3156
872,2019-10-25,1662,0,1496,2,3160
872,2019-10-26,272,0,2448,0,2720
872,2019-10-27,296,0,2547,71,2914
872,2019-10-28,330,0,2766,0,3096
872,2019-10-29,466,0,1602,1,2069
872,2019-10-30,699,0,1027,1,1727
872,2019-10-31,283,0,1246,2,1531
872,2019-11-01,299,0,1512,2,1813
872,2019-11-02,243,0,1059,1,1303
872,2019-11-03,1378,0,1323,0,2701
872,2019-11-04,314,0,1260,0,1574
872,2019-11-05,400,0,2867,0,3267
872,2019-11-06,340,0,1848,1,2189
872,2019-11-07,995,0,1733,2,2730
872,2019-11-08,389,0,1923,0,2312
872,2019-11-09,340,0,1526,0,1866
872,2019-11-10,253,0,1228,0,1481
872,2019-11-11,482,0,2267,4,2753
872,2019-11-12,314,0,2425,0,2739
872,2019-11-13,390,0,1896,0,2286
872,2019-11-14,307,0,2142,1,2450
872,2019-11-15,261,0,2172,1,2434
872,2019-11-16,528,0,1996,2,2526
872,2019-11-17,940,0,1982,1,2923
872,2019-11-18,1742,0,1996,0,3738
872,2019-11-19,1282,0,2257,0,3539
872,2019-11-20,352,0,1916,2,2270
872,2019-11-21,391,0,1214,2,1607
872,2019-11-22,326,0,1453,3,1782
872,2019-11-23,277,0,1860,0,2137
872,2019-11-24,296,0,1773,60,2129
872,2019-11-25,1227,0,1471,1,2699
872,2019-11-26,280,0,1130,2,1412
872,2019-11-27,307,0,1279,0,1586
872,2019-11-28,265,0,925,1,1191
872,2019-11-29,90,0,1,0,91
872,2019-09-04,41,0,1248,0,1289
872,2019-09-05,1447,0,1662,0,3109
872,2019-09-06,1819,0,1364,2,3185
872,2019-09-07,2331,0,1927,0,4258
872,2019-09-08,839,0,1580,0,2419
872,2019-09-09,986,0,1990,1,2977
872,2019-09-10,1208,0,1722,1,2931
872,2019-09-11,970,0,1886,1,2857
872,2019-09-12,887,0,1713,3,2603
872,2019-09-13,842,0,2237,1,3080
872,2019-09-14,535,0,1453,0,1988
872,2019-09-15,1236,0,2601,3,3840
872,2019-09-16,1226,0,1681,0,2907
872,2019-09-17,615,0,2427,2,3044
872,2019-09-18,910,0,1521,0,2431
872,2019-09-19,1141,0,1746,0,2887
872,2019-09-20,294,0,1298,0,1592
872,2019-09-21,294,0,1800,1,2095
872,2019-09-22,973,0,1692,1,2666
872,2019-09-23,1576,0,1786,1,3363
872,2019-09-24,649,0,1610,3,2262
872,2019-09-25,192,0,1832,2,2026
872,2019-09-26,241,0,2277,0,2518
872,2019-09-27,2148,0,1527,3,3678
872,2019-09-28,1196,0,1464,1,2661
872,2019-09-29,355,0,1860,1,2216
872,2019-09-30,416,0,1316,0,1732
872,2019-10-01,221,0,1572,1,1794
872,2019-10-02,1986,0,1425,2,3413
872,2019-10-03,305,0,1139,0,1444
872,2019-10-04,1210,0,1120,215,2545
872,2019-10-05,285,0,745,2,1032
872,2019-10-06,1066,0,1438,0,2504
872,2019-10-07,514,0,1539,3,2056
872,2019-10-08,1687,0,1358,0,3045
872,2019-10-09,1503,0,2115,0,3618
872,2019-10-10,1409,0,1966,6273,9648
872,2019-10-11,1289,0,1648,3,2940
872,2019-10-12,476,0,1976,4,2456
872,2019-10-13,1148,0,2144,1,3293
872,2019-10-14,283,0,1868,0,2151
872,2019-10-15,399,0,994,1,1394
872,2019-10-16,1365,0,1077,1,2443
872,2019-10-17,722,0,1250,3,1975
872,2019-10-18,1234,0,1483,0,2717
872,2019-10-19,1226,0,2086,0,3312
872,2019-10-20,1196,0,1706,0,2902
872,2019-10-21,1513,0,1358,1,2872
872,2019-10-22,314,0,2119,3,2436
872,2019-10-23,1025,0,1839,1,2865
872,2019-10-24,970,0,2186,0,3156
872,2019-10-25,1662,0,1496,2,3160
872,2019-10-26,272,0,2448,0,2720
872,2019-10-27,296,0,2547,71,2914
872,2019-10-28,330,0,2766,0,3096
872,2019-10-29,466,0,1602,1,2069
872,2019-10-30,699,0,1027,1,1727
872,2019-10-31,283,0,1246,2,1531
872,2019-11-01,299,0,1512,2,1813
872,2019-11-02,243,0,1059,1,1303
872,2019-11-03,1378,0,1323,0,2701
872,2019-11-04,314,0,1260,0,1574
872,2019-11-05,400,0,2867,0,3267
872,2019-11-06,340,0,1848,1,2189
872,2019-11-07,995,0,1733,2,2730
872,2019-11-08,389,0,1923,0,2312
872,2019-11-09,340,0,1526,0,1866
872,2019-11-10,253,0,1228,0,1481
872,2019-11-11,482,0,2267,4,2753
872,2019-11-12,314,0,2425,0,2739
872,2019-11-13,390,0,1896,0,2286
872,2019-11-14,307,0,2142,1,2450
872,2019-11-15,261,0,2172,1,2434
872,2019-11-16,528,0,1996,2,2526
872,2019-11-17,940,0,1982,1,2923
872,2019-11-18,1742,0,1996,0,3738
872,2019-11-19,1282,0,2257,0,3539
872,2019-11-20,352,0,1916,2,2270
872,2019-11-21,391,0,1214,2,1607
872,2019-11-22,326,0,1453,3,1782
872,2019-11-23,277,0,1860,0,2137
872,2019-11-24,296,0,1773,60,2129
872,2019-11-25,1227,0,1471,1,2699
872,2019-11-26,280,0,1130,2,1412
872,2019-11-27,307,0,1279,0,1586
872,2019-11-28,265,0,925,1,1191
872,2019-11-29,90,0,1,0,91
872,2019-09-06,1819,0,1364,2,3185
872,2019-09-07,2331,0,1927,0,4258
872,2019-09-08,839,0,1580,0,2419
872,2019-09-09,986,0,1990,1,2977
872,2019-09-10,1208,0,1722,1,2931
872,2019-09-11,970,0,1886,1,2857
872,2019-09-12,887,0,1713,3,2603
872,2019-09-13,842,0,2237,1,3080
872,2019-09-14,535,0,1453,0,1988
872,2019-09-15,1236,0,2601,3,3840
872,2019-09-16,1226,0,1681,0,2907
872,2019-09-17,615,0,2427,2,3044
872,2019-09-18,910,0,1521,0,2431
872,2019-09-19,1141,0,1746,0,2887
872,2019-09-20,294,0,1298,0,1592
872,2019-09-21,294,0,1800,1,2095
872,2019-09-22,973,0,1692,1,2666
872,2019-09-23,1576,0,1786,1,3363
872,2019-09-24,649,0,1610,3,2262
872,2019-09-25,192,0,1832,2,2026
872,2019-09-26,241,0,2277,0,2518
872,2019-09-27,2148,0,1527,3,3678
872,2019-09-28,1196,0,1464,1,2661
872,2019-09-29,355,0,1860,1,2216
872,2019-09-30,416,0,1316,0,1732
872,2019-10-01,221,0,1572,1,1794
872,2019-10-02,1986,0,1425,2,3413
872,2019-10-03,305,0,1139,0,1444
872,2019-10-04,1210,0,1120,215,2545
872,2019-10-05,285,0,745,2,1032
872,2019-10-06,1066,0,1438,0,2504
872,2019-10-07,514,0,1539,3,2056
872,2019-10-08,1687,0,1358,0,3045
872,2019-10-09,1503,0,2115,0,3618
872,2019-10-10,1409,0,1966,6273,9648
872,2019-10-11,1289,0,1648,3,2940
872,2019-10-12,476,0,1976,4,2456
872,2019-10-13,1148,0,2144,1,3293
872,2019-10-14,283,0,1868,0,2151
872,2019-10-15,399,0,994,1,1394
872,2019-10-16,1365,0,1077,1,2443
872,2019-10-17,722,0,1250,3,1975
872,2019-10-18,1234,0,1483,0,2717
872,2019-10-19,1226,0,2086,0,3312
872,2019-10-20,1196,0,1706,0,2902
872,2019-10-21,1513,0,1358,1,2872
872,2019-10-22,314,0,2119,3,2436
872,2019-10-23,1025,0,1839,1,2865
872,2019-10-24,970,0,2186,0,3156
872,2019-10-25,1662,0,1496,2,3160
872,2019-10-26,272,0,2448,0,2720
872,2019-10-27,296,0,2547,71,2914
872,2019-10-28,330,0,2766,0,3096
872,2019-10-29,466,0,1602,1,2069
872,2019-10-30,699,0,1027,1,1727
872,2019-10-31,283,0,1246,2,1531
872,2019-11-01,299,0,1512,2,1813
872,2019-11-02,243,0,1059,1,1303
872,2019-11-03,1378,0,1323,0,2701
872,2019-11-04,314,0,1260,0,1574
872,2019-11-05,400,0,2867,0,3267
872,2019-11-06,340,0,1848,1,2189
872,2019-11-07,995,0,1733,2,2730
872,2019-11-08,389,0,1923,0,2312
872,2019-11-09,340,0,1526,0,1866
872,2019-11-10,253,0,1228,0,1481
872,2019-11-11,482,0,2267,4,2753
872,2019-11-12,314,0,2425,0,2739
872,2019-11-13,390,0,1896,0,2286
872,2019-11-14,307,0,2142,1,2450
872,2019-11-15,261,0,2172,1,2434
872,2019-11-16,528,0,1996,2,2526
872,2019-11-17,940,0,1982,1,2923
872,2019-11-18,1742,0,1996,0,3738
872,2019-11-19,1282,0,2257,0,3539
872,2019-11-20,352,0,1916,2,2270
872,2019-11-21,391,0,1214,2,1607
872,2019-11-22,326,0,1453,3,1782
872,2019-11-23,277,0,1860,0,2137
872,2019-11-24,296,0,1773,60,2129
872,2019-11-25,1227,0,1471,1,2699
872,2019-11-26,280,0,1130,2,1412
872,2019-11-27,307,0,1279,0,1586
872,2019-11-28,265,0,925,1,1191
873,2019-09-04,168,0,846,0,1014
873,2019-09-05,3171,0,2254,2,5427
873,2019-09-06,1458,0,1767,2,3227
873,2019-09-07,1931,0,1804,0,3735
873,2019-09-08,6669,0,1575,1,8245
873,2019-09-09,2158,0,1661,0,3819
873,2019-09-10,2555,0,2764,0,5319
873,2019-09-11,2279,0,2857,3,5139
873,2019-09-12,2694,0,2048,1,4743
873,2019-09-13,2248,0,1898,1,4147
873,2019-09-14,938,0,1876,0,2814
873,2019-09-15,1861,0,1827,2,3690
873,2019-09-16,2496,0,2434,0,4930
873,2019-09-17,814,0,1533,2,2349
873,2019-09-18,868,0,1858,1,2727
873,2019-09-19,3207,0,1732,0,4939
873,2019-09-20,804,0,1954,0,2758
873,2019-09-21,877,0,1170,3,2050
873,2019-09-22,2343,0,2212,1,4556
873,2019-09-23,2052,0,1578,1,3631
873,2019-09-24,792,0,1854,3,2649
873,2019-09-25,1267,0,1676,2,2945
873,2019-09-26,739,0,2121,15,2875
873,2019-09-27,471,0,1678,3,2152
873,2019-09-28,636,0,1230,2,1868
873,2019-09-29,1408,0,1239,131,2778
873,2019-09-30,2302,0,1913,0,4215
873,2019-10-01,973,0,1404,0,2377
873,2019-10-02,2189,0,2207,0,4396
873,2019-10-03,829,0,1192,0,2021
873,2019-10-04,1592,0,2084,2,3678
873,2019-10-05,424,0,1338,1,1763
873,2019-10-06,956,0,3147,0,4103
873,2019-10-07,1779,0,1623,3,3405
873,2019-10-08,1336,0,2390,0,3726
873,2019-10-09,442,0,1214,0,1656
873,2019-10-10,688,0,1744,0,2432
873,2019-10-11,774,0,1617,1,2392
873,2019-10-12,1072,0,1816,6,2894
873,2019-10-13,1075,0,2531,0,3606
873,2019-10-14,1027,0,2556,2,3585
873,2019-10-15,1092,0,2598,1,3691
873,2019-10-16,1162,0,2218,1,3381
873,2019-10-17,1275,0,2398,3,3676
873,2019-10-18,897,0,1049,0,1946
873,2019-10-19,1270,0,1643,28,2941
873,2019-10-20,1994,0,2043,1,4038
873,2019-10-21,2322,0,1306,1,3629
873,2019-10-22,3471,0,1692,3,5166
873,2019-10-23,1661,0,1689,0,3350
873,2019-10-24,856,0,1232,0,2088
873,2019-10-25,925,0,2211,1,3137
873,2019-10-26,1904,0,2436,0,4340
873,2019-10-27,1708,0,2873,1,4582
873,2019-10-28,1453,0,2600,1,4054
873,2019-10-29,1234,0,2051,2,3287
873,2019-10-30,968,0,1652,0,2620
873,2019-10-31,1080,0,1512,3,2595
873,2019-11-01,882,0,1461,3,2346
873,2019-11-02,1360,0,1237,0,2597
873,2019-11-03,790,0,965,0,1755
873,2019-11-04,1148,0,1927,0,3075
873,2019-11-05,1438,0,2176,0,3614
873,2019-11-06,1133,0,1968,5,3106
873,2019-11-07,956,0,2144,1,3101
873,2019-11-08,775,0,1683,0,2458
873,2019-11-09,858,0,2488,1,3347
873,2019-11-10,1091,0,2166,0,3257
873,2019-11-11,1219,0,1809,4,3032
873,2019-11-12,2111,0,2527,0,4638
873,2019-11-13,872,0,983,2,1857
873,2019-11-14,688,0,1607,0,2295
873,2019-11-15,647,0,2044,1,2692
873,2019-11-16,814,0,2750,2,3566
873,2019-11-17,1175,0,2208,0,3383
873,2019-11-18,1334,0,2299,759,4392
873,2019-11-19,1049,0,2521,1,3571
873,2019-11-20,1633,0,1977,2,3612
873,2019-11-21,721,0,1716,1,2438
873,2019-11-22,674,0,1205,2,1881
873,2019-11-23,1025,0,2241,0,3266
873,2019-11-24,1049,0,1261,2,2312
873,2019-11-25,1739,0,1599,1,3339
873,2019-11-26,725,0,903,2,1630
873,2019-11-27,806,0,1144,1,1951
873,2019-11-28,1313,0,574,0,1887
873,2019-11-29,218,0,1,0,219
873,2019-09-04,168,0,846,0,1014
873,2019-09-05,3171,0,2254,2,5427
873,2019-09-06,1458,0,1767,2,3227
873,2019-09-07,1931,0,1804,0,3735
873,2019-09-08,6669,0,1575,1,8245
873,2019-09-09,2158,0,1661,0,3819
873,2019-09-10,2555,0,2764,0,5319
873,2019-09-11,2279,0,2857,3,5139
873,2019-09-12,2694,0,2048,1,4743
873,2019-09-13,2248,0,1898,1,4147
873,2019-09-14,938,0,1876,0,2814
873,2019-09-15,1861,0,1827,2,3690
873,2019-09-16,2496,0,2434,0,4930
873,2019-09-17,814,0,1533,2,2349
873,2019-09-18,868,0,1858,1,2727
873,2019-09-19,3207,0,1732,0,4939
873,2019-09-20,804,0,1954,0,2758
873,2019-09-21,877,0,1170,3,2050
873,2019-09-22,2343,0,2212,1,4556
873,2019-09-23,2052,0,1578,1,3631
873,2019-09-24,792,0,1854,3,2649
873,2019-09-25,1267,0,1676,2,2945
873,2019-09-26,739,0,2121,15,2875
873,2019-09-27,471,0,1678,3,2152
873,2019-09-28,636,0,1230,2,1868
873,2019-09-29,1408,0,1239,131,2778
873,2019-09-30,2302,0,1913,0,4215
873,2019-10-01,973,0,1404,0,2377
873,2019-10-02,2189,0,2207,0,4396
873,2019-10-03,829,0,1192,0,2021
873,2019-10-04,1592,0,2084,2,3678
873,2019-10-05,424,0,1338,1,1763
873,2019-10-06,956,0,3147,0,4103
873,2019-10-07,1779,0,1623,3,3405
873,2019-10-08,1336,0,2390,0,3726
873,2019-10-09,442,0,1214,0,1656
873,2019-10-10,688,0,1744,0,2432
873,2019-10-11,774,0,1617,1,2392
873,2019-10-12,1072,0,1816,6,2894
873,2019-10-13,1075,0,2531,0,3606
873,2019-10-14,1027,0,2556,2,3585
873,2019-10-15,1092,0,2598,1,3691
873,2019-10-16,1162,0,2218,1,3381
873,2019-10-17,1275,0,2398,3,3676
873,2019-10-18,897,0,1049,0,1946
873,2019-10-19,1270,0,1643,28,2941
873,2019-10-20,1994,0,2043,1,4038
873,2019-10-21,2322,0,1306,1,3629
873,2019-10-22,3471,0,1692,3,5166
873,2019-10-23,1661,0,1689,0,3350
873,2019-10-24,856,0,1232,0,2088
873,2019-10-25,925,0,2211,1,3137
873,2019-10-26,1904,0,2436,0,4340
873,2019-10-27,1708,0,2873,1,4582
873,2019-10-28,1453,0,2600,1,4054
873,2019-10-29,1234,0,2051,2,3287
873,2019-10-30,968,0,1652,0,2620
873,2019-10-31,1080,0,1512,3,2595
873,2019-11-01,882,0,1461,3,2346
873,2019-11-02,1360,0,1237,0,2597
873,2019-11-03,790,0,965,0,1755
873,2019-11-04,1148,0,1927,0,3075
873,2019-11-05,1438,0,2176,0,3614
873,2019-11-06,1133,0,1968,5,3106
873,2019-11-07,956,0,2144,1,3101
873,2019-11-08,775,0,1683,0,2458
873,2019-11-09,858,0,2488,1,3347
873,2019-11-10,1091,0,2166,0,3257
873,2019-11-11,1219,0,1809,4,3032
873,2019-11-12,2111,0,2527,0,4638
873,2019-11-13,872,0,983,2,1857
873,2019-11-14,688,0,1607,0,2295
873,2019-11-15,647,0,2044,1,2692
873,2019-11-16,814,0,2750,2,3566
873,2019-11-17,1175,0,2208,0,3383
873,2019-11-18,1334,0,2299,759,4392
873,2019-11-19,1049,0,2521,1,3571
873,2019-11-20,1633,0,1977,2,3612
873,2019-11-21,721,0,1716,1,2438
873,2019-11-22,674,0,1205,2,1881
873,2019-11-23,1025,0,2241,0,3266
873,2019-11-24,1049,0,1261,2,2312
873,2019-11-25,1739,0,1599,1,3339
873,2019-11-26,725,0,903,2,1630
873,2019-11-27,806,0,1144,1,1951
873,2019-11-28,1313,0,574,0,1887
873,2019-11-29,218,0,1,0,219
873,2019-09-05,3171,0,2254,2,5427
873,2019-09-06,1458,0,1767,2,3227
873,2019-09-07,1931,0,1804,0,3735
873,2019-09-08,6669,0,1575,1,8245
873,2019-09-09,2158,0,1661,0,3819
873,2019-09-10,2555,0,2764,0,5319
873,2019-09-11,2279,0,2857,3,5139
873,2019-09-12,2694,0,2048,1,4743
873,2019-09-13,2248,0,1898,1,4147
873,2019-09-14,938,0,1876,0,2814
873,2019-09-15,1861,0,1827,2,3690
873,2019-09-16,2496,0,2434,0,4930
873,2019-09-17,814,0,1533,2,2349
873,2019-09-18,868,0,1858,1,2727
873,2019-09-19,3207,0,1732,0,4939
873,2019-09-20,804,0,1954,0,2758
873,2019-09-21,877,0,1170,3,2050
873,2019-09-22,2343,0,2212,1,4556
873,2019-09-23,2052,0,1578,1,3631
873,2019-09-24,792,0,1854,3,2649
873,2019-09-25,1267,0,1676,2,2945
873,2019-09-26,739,0,2121,15,2875
873,2019-09-27,471,0,1678,3,2152
873,2019-09-28,636,0,1230,2,1868
873,2019-09-29,1408,0,1239,131,2778
873,2019-09-30,2302,0,1913,0,4215
873,2019-10-01,973,0,1404,0,2377
873,2019-10-02,2189,0,2207,0,4396
873,2019-10-03,829,0,1192,0,2021
873,2019-10-04,1592,0,2084,2,3678
873,2019-10-05,424,0,1338,1,1763
873,2019-10-06,956,0,3147,0,4103
873,2019-10-07,1779,0,1623,3,3405
873,2019-10-08,1336,0,2390,0,3726
873,2019-10-09,442,0,1214,0,1656
873,2019-10-10,688,0,1744,0,2432
873,2019-10-11,774,0,1617,1,2392
873,2019-10-12,1072,0,1816,6,2894
873,2019-10-13,1075,0,2531,0,3606
873,2019-10-14,1027,0,2556,2,3585
873,2019-10-15,1092,0,2598,1,3691
873,2019-10-16,1162,0,2218,1,3381
873,2019-10-17,1275,0,2398,3,3676
873,2019-10-18,897,0,1049,0,1946
873,2019-10-19,1270,0,1643,28,2941
873,2019-10-20,1994,0,2043,1,4038
873,2019-10-21,2322,0,1306,1,3629
873,2019-10-22,3471,0,1692,3,5166
873,2019-10-23,1661,0,1689,0,3350
873,2019-10-24,856,0,1232,0,2088
873,2019-10-25,925,0,2211,1,3137
873,2019-10-26,1904,0,2436,0,4340
873,2019-10-27,1708,0,2873,1,4582
873,2019-10-28,1453,0,2600,1,4054
873,2019-10-29,1234,0,2051,2,3287
873,2019-10-30,968,0,1652,0,2620
873,2019-10-31,1080,0,1512,3,2595
873,2019-11-01,882,0,1461,3,2346
873,2019-11-02,1360,0,1237,0,2597
873,2019-11-03,790,0,965,0,1755
873,2019-11-04,1148,0,1927,0,3075
873,2019-11-05,1438,0,2176,0,3614
873,2019-11-06,1133,0,1968,5,3106
873,2019-11-07,956,0,2144,1,3101
873,2019-11-08,775,0,1683,0,2458
873,2019-11-09,858,0,2488,1,3347
873,2019-11-10,1091,0,2166,0,3257
873,2019-11-11,1219,0,1809,4,3032
873,2019-11-12,2111,0,2527,0,4638
873,2019-11-13,872,0,983,2,1857
873,2019-11-14,688,0,1607,0,2295
873,2019-11-15,647,0,2044,1,2692
873,2019-11-16,814,0,2750,2,3566
873,2019-11-17,1175,0,2208,0,3383
873,2019-11-18,1334,0,2299,759,4392
873,2019-11-19,1049,0,2521,1,3571
873,2019-11-20,1633,0,1977,2,3612
873,2019-11-21,721,0,1716,1,2438
873,2019-11-22,674,0,1205,2,1881
873,2019-11-23,1025,0,2241,0,3266
873,2019-11-24,1049,0,1261,2,2312
873,2019-11-25,1739,0,1599,1,3339
873,2019-11-26,725,0,903,2,1630
873,2019-11-27,806,0,1144,1,1951
874,2019-09-04,42,0,878,0,920
874,2019-09-05,188,0,2136,3,2327
874,2019-09-06,729,0,2294,0,3023
874,2019-09-07,1236,0,2374,0,3610
874,2019-09-08,376,0,2348,924,3648
874,2019-09-09,1231,0,1564,0,2795
874,2019-09-10,378,0,2559,1,2938
874,2019-09-11,3243,0,1448,2,4693
874,2019-09-12,1153,0,1811,3,2967
874,2019-09-13,223,0,2117,0,2340
874,2019-09-14,303,0,2773,0,3076
874,2019-09-15,1141,0,1940,1,3082
874,2019-09-16,349,0,1693,1,2043
874,2019-09-17,280,0,2162,1,2443
874,2019-09-18,285,0,1701,1,1987
874,2019-09-19,307,0,1620,0,1927
874,2019-09-20,365,0,1710,1,2076
874,2019-09-21,167,0,3159,1,3327
874,2019-09-22,1826,0,2020,0,3846
874,2019-09-23,209,0,2572,0,2781
874,2019-09-24,196,0,1435,3,1634
874,2019-09-25,227,0,1678,2,1907
874,2019-09-26,268,0,2035,0,2303
874,2019-09-27,119,0,2138,4,2261
874,2019-09-28,264,0,2264,1,2529
874,2019-09-29,199,0,1367,2,1568
874,2019-09-30,116,0,1501,0,1617
874,2019-10-01,1005,0,1514,1,2520
874,2019-10-02,1390,0,1326,0,2716
874,2019-10-03,1513,0,1618,0,3131
874,2019-10-04,418,0,1043,2,1463
874,2019-10-05,480,0,1395,0,1875
874,2019-10-06,675,0,2178,1,2854
874,2019-10-07,1694,0,1893,3,3590
874,2019-10-08,275,0,2204,0,2479
874,2019-10-09,178,0,1870,0,2048
874,2019-10-10,168,0,1915,0,2083
874,2019-10-11,175,0,2057,2,2234
874,2019-10-12,1010,0,2414,2,3426
874,2019-10-13,1539,0,1859,1,3399
874,2019-10-14,186,0,1899,0,2085
874,2019-10-15,351,0,1788,0,2139
874,2019-10-16,575,0,1582,2,2159
874,2019-10-17,185,0,1748,2,1935
874,2019-10-18,1092,0,2738,1,3831
874,2019-10-19,170,0,2058,1,2229
874,2019-10-20,185,0,1589,0,1774
874,2019-10-21,1136,0,1236,1,2373
874,2019-10-22,489,0,947,4,1440
874,2019-10-23,321,0,2556,0,2877
874,2019-10-24,1935,0,1703,0,3638
874,2019-10-25,348,0,1582,2,1932
874,2019-10-26,172,0,2097,0,2269
874,2019-10-27,162,0,2299,1,2462
874,2019-10-28,143,0,1456,1,1600
874,2019-10-29,237,0,1800,1,2038
874,2019-10-30,1168,0,1892,1,3061
874,2019-10-31,385,0,1047,1,1433
874,2019-11-01,264,0,1465,2,1731
874,2019-11-02,136,0,1633,1,1770
874,2019-11-03,1118,0,1403,0,2521
874,2019-11-04,717,0,1592,0,2309
874,2019-11-05,301,0,2376,0,2677
874,2019-11-06,387,0,2010,6,2403
874,2019-11-07,235,0,1912,3,2150
874,2019-11-08,381,0,2881,0,3262
874,2019-11-09,242,0,1643,0,1885
874,2019-11-10,253,0,2648,0,2901
874,2019-11-11,864,0,1546,2,2412
874,2019-11-12,159,0,2333,0,2492
874,2019-11-13,125,0,1763,0,1888
874,2019-11-14,162,0,1872,1,2035
874,2019-11-15,235,0,2427,0,2662
874,2019-11-16,129,0,2168,1,2298
874,2019-11-17,240,0,2570,0,2810
874,2019-11-18,119,0,2358,0,2477
874,2019-11-19,455,0,2023,0,2478
874,2019-11-20,1091,0,1813,0,2904
874,2019-11-21,145,0,1477,0,1622
874,2019-11-22,250,0,1201,0,1451
874,2019-11-23,257,0,1837,0,2094
874,2019-11-24,1037,0,1744,0,2781
874,2019-11-25,108,0,2109,0,2217
874,2019-11-26,509,0,998,0,1507
874,2019-11-27,208,0,2135,0,2343
874,2019-11-28,802,0,603,0,1405
874,2019-11-29,30,0,1,0,31
874,2019-09-04,42,0,878,0,920
874,2019-09-05,188,0,2136,3,2327
874,2019-09-06,729,0,2294,0,3023
874,2019-09-07,1236,0,2374,0,3610
874,2019-09-08,376,0,2348,924,3648
874,2019-09-09,1231,0,1564,0,2795
874,2019-09-10,378,0,2559,1,2938
874,2019-09-11,3243,0,1448,2,4693
874,2019-09-12,1153,0,1811,3,2967
874,2019-09-13,223,0,2117,0,2340
874,2019-09-14,303,0,2773,0,3076
874,2019-09-15,1141,0,1940,1,3082
874,2019-09-16,349,0,1693,1,2043
874,2019-09-17,280,0,2162,1,2443
874,2019-09-18,285,0,1701,1,1987
874,2019-09-19,307,0,1620,0,1927
874,2019-09-20,365,0,1710,1,2076
874,2019-09-21,167,0,3159,1,3327
874,2019-09-22,1826,0,2020,0,3846
874,2019-09-23,209,0,2572,0,2781
874,2019-09-24,196,0,1435,3,1634
874,2019-09-25,227,0,1678,2,1907
874,2019-09-26,268,0,2035,0,2303
874,2019-09-27,119,0,2138,4,2261
874,2019-09-28,264,0,2264,1,2529
874,2019-09-29,199,0,1367,2,1568
874,2019-09-30,116,0,1501,0,1617
874,2019-10-01,1005,0,1514,1,2520
874,2019-10-02,1390,0,1326,0,2716
874,2019-10-03,1513,0,1618,0,3131
874,2019-10-04,418,0,1043,2,1463
874,2019-10-05,480,0,1395,0,1875
874,2019-10-06,675,0,2178,1,2854
874,2019-10-07,1694,0,1893,3,3590
874,2019-10-08,275,0,2204,0,2479
874,2019-10-09,178,0,1870,0,2048
874,2019-10-10,168,0,1915,0,2083
874,2019-10-11,175,0,2057,2,2234
874,2019-10-12,1010,0,2414,2,3426
874,2019-10-13,1539,0,1859,1,3399
874,2019-10-14,186,0,1899,0,2085
874,2019-10-15,351,0,1788,0,2139
874,2019-10-16,575,0,1582,2,2159
874,2019-10-17,185,0,1748,2,1935
874,2019-10-18,1092,0,2738,1,3831
874,2019-10-19,170,0,2058,1,2229
874,2019-10-20,185,0,1589,0,1774
874,2019-10-21,1136,0,1236,1,2373
874,2019-10-22,489,0,947,4,1440
874,2019-10-23,321,0,2556,0,2877
874,2019-10-24,1935,0,1703,0,3638
874,2019-10-25,348,0,1582,2,1932
874,2019-10-26,172,0,2097,0,2269
874,2019-10-27,162,0,2299,1,2462
874,2019-10-28,143,0,1456,1,1600
874,2019-10-29,237,0,1800,1,2038
874,2019-10-30,1168,0,1892,1,3061
874,2019-10-31,385,0,1047,1,1433
874,2019-11-01,264,0,1465,2,1731
874,2019-11-02,136,0,1633,1,1770
874,2019-11-03,1118,0,1403,0,2521
874,2019-11-04,717,0,1592,0,2309
874,2019-11-05,301,0,2376,0,2677
874,2019-11-06,387,0,2010,6,2403
874,2019-11-07,235,0,1912,3,2150
874,2019-11-08,381,0,2881,0,3262
874,2019-11-09,242,0,1643,0,1885
874,2019-11-10,253,0,2648,0,2901
874,2019-11-11,864,0,1546,2,2412
874,2019-11-12,159,0,2333,0,2492
874,2019-11-13,125,0,1763,0,1888
874,2019-11-14,162,0,1872,1,2035
874,2019-11-15,235,0,2427,0,2662
874,2019-11-16,129,0,2168,1,2298
874,2019-11-17,240,0,2570,0,2810
874,2019-11-18,119,0,2358,0,2477
874,2019-11-19,455,0,2023,0,2478
874,2019-11-20,1091,0,1813,0,2904
874,2019-11-21,145,0,1477,0,1622
874,2019-11-22,250,0,1201,0,1451
874,2019-11-23,257,0,1837,0,2094
874,2019-11-24,1037,0,1744,0,2781
874,2019-11-25,108,0,2109,0,2217
874,2019-11-26,509,0,998,0,1507
874,2019-11-27,208,0,2135,0,2343
874,2019-11-28,802,0,603,0,1405
874,2019-11-29,30,0,1,0,31
874,2019-09-05,188,0,2136,3,2327
874,2019-09-06,729,0,2294,0,3023
874,2019-09-07,1236,0,2374,0,3610
874,2019-09-08,376,0,2348,924,3648
874,2019-09-09,1231,0,1564,0,2795
874,2019-09-10,378,0,2559,1,2938
874,2019-09-11,3243,0,1448,2,4693
874,2019-09-12,1153,0,1811,3,2967
874,2019-09-13,223,0,2117,0,2340
874,2019-09-14,303,0,2773,0,3076
874,2019-09-15,1141,0,1940,1,3082
874,2019-09-16,349,0,1693,1,2043
874,2019-09-17,280,0,2162,1,2443
874,2019-09-18,285,0,1701,1,1987
874,2019-09-19,307,0,1620,0,1927
874,2019-09-20,365,0,1710,1,2076
874,2019-09-21,167,0,3159,1,3327
874,2019-09-22,1826,0,2020,0,3846
874,2019-09-23,209,0,2572,0,2781
874,2019-09-24,196,0,1435,3,1634
874,2019-09-25,227,0,1678,2,1907
874,2019-09-26,268,0,2035,0,2303
874,2019-09-27,119,0,2138,4,2261
874,2019-09-28,264,0,2264,1,2529
874,2019-09-29,199,0,1367,2,1568
874,2019-09-30,116,0,1501,0,1617
874,2019-10-01,1005,0,1514,1,2520
874,2019-10-02,1390,0,1326,0,2716
874,2019-10-03,1513,0,1618,0,3131
874,2019-10-04,418,0,1043,2,1463
874,2019-10-05,480,0,1395,0,1875
874,2019-10-06,675,0,2178,1,2854
874,2019-10-07,1694,0,1893,3,3590
874,2019-10-08,275,0,2204,0,2479
874,2019-10-09,178,0,1870,0,2048
874,2019-10-10,168,0,1915,0,2083
874,2019-10-11,175,0,2057,2,2234
874,2019-10-12,1010,0,2414,2,3426
874,2019-10-13,1539,0,1859,1,3399
874,2019-10-14,186,0,1899,0,2085
874,2019-10-15,351,0,1788,0,2139
874,2019-10-16,575,0,1582,2,2159
874,2019-10-17,185,0,1748,2,1935
874,2019-10-18,1092,0,2738,1,3831
874,2019-10-19,170,0,2058,1,2229
874,2019-10-20,185,0,1589,0,1774
874,2019-10-21,1136,0,1236,1,2373
874,2019-10-22,489,0,947,4,1440
874,2019-10-23,321,0,2556,0,2877
874,2019-10-24,1935,0,1703,0,3638
874,2019-10-25,348,0,1582,2,1932
874,2019-10-26,172,0,2097,0,2269
874,2019-10-27,162,0,2299,1,2462
874,2019-10-28,143,0,1456,1,1600
874,2019-10-29,237,0,1800,1,2038
874,2019-10-30,1168,0,1892,1,3061
874,2019-10-31,385,0,1047,1,1433
874,2019-11-01,264,0,1465,2,1731
874,2019-11-02,136,0,1633,1,1770
874,2019-11-03,1118,0,1403,0,2521
874,2019-11-04,717,0,1592,0,2309
874,2019-11-05,301,0,2376,0,2677
874,2019-11-06,387,0,2010,6,2403
874,2019-11-07,235,0,1912,3,2150
874,2019-11-08,381,0,2881,0,3262
874,2019-11-09,242,0,1643,0,1885
874,2019-11-10,253,0,2648,0,2901
874,2019-11-11,864,0,1546,2,2412
874,2019-11-12,159,0,2333,0,2492
874,2019-11-13,125,0,1763,0,1888
874,2019-11-14,162,0,1872,1,2035
874,2019-11-15,235,0,2427,0,2662
874,2019-11-16,129,0,2168,1,2298
875,2019-09-04,34,0,1119,0,1153
875,2019-09-05,554,0,2431,0,2985
875,2019-09-06,1371,0,3540,1,4912
875,2019-09-07,1592,0,2723,3,4318
875,2019-09-08,657,0,1781,0,2438
875,2019-09-09,724,0,2099,15,2838
875,2019-09-10,1746,0,2426,0,4172
875,2019-09-11,1727,0,1840,2,3569
875,2019-09-12,518,0,1271,2,1791
875,2019-09-13,1521,0,1503,0,3024
875,2019-09-14,1073,0,1926,0,2999
875,2019-09-15,961,0,1986,4,2951
875,2019-09-16,2597,0,2038,0,4635
875,2019-09-17,1153,0,2499,1,3653
875,2019-09-18,712,0,1682,0,2394
875,2019-09-19,1006,0,1711,0,2717
875,2019-09-20,1478,0,2016,2,3496
875,2019-09-21,753,0,1737,1,2491
875,2019-09-22,1845,0,2506,0,4351
875,2019-09-23,498,0,2369,0,2867
875,2019-09-24,1287,0,1899,4,3190
875,2019-09-25,688,0,1793,3,2484
875,2019-09-26,1046,0,1621,0,2667
875,2019-09-27,1342,0,1960,1,3303
875,2019-09-28,1195,0,2243,1,3439
875,2019-09-29,705,0,1990,1,2696
875,2019-09-30,525,0,1904,3,2432
875,2019-10-01,710,0,1542,1,2253
875,2019-10-02,1850,0,934,1675,4459
875,2019-10-03,1151,0,1471,0,2622
875,2019-10-04,1113,0,1612,29,2754
875,2019-10-05,654,0,1938,72,2664
875,2019-10-06,2060,0,1527,28,3615
875,2019-10-07,1794,0,2182,0,3976
875,2019-10-08,1487,0,2098,1,3586
875,2019-10-09,1256,0,2107,1,3364
875,2019-10-10,726,0,2460,3,3189
875,2019-10-11,975,0,1231,2,2208
875,2019-10-12,526,0,1968,1,2495
875,2019-10-13,2020,0,1810,2,3832
875,2019-10-14,2063,0,1581,1,3645
875,2019-10-15,1684,0,1466,2,3152
875,2019-10-16,781,0,1663,0,2444
875,2019-10-17,1373,0,1450,0,2823
875,2019-10-18,718,0,1646,0,2364
875,2019-10-19,1794,0,2102,0,3896
875,2019-10-20,1924,0,1891,1,3816
875,2019-10-21,568,0,1348,2,1918
875,2019-10-22,1263,0,1618,1,2882
875,2019-10-23,1632,0,1163,3,2798
875,2019-10-24,910,0,1547,1,2458
875,2019-10-25,1284,0,1993,3,3280
875,2019-10-26,2474,0,2813,0,5287
875,2019-10-27,2480,0,2538,0,5018
875,2019-10-28,1137,0,2380,1,3518
875,2019-10-29,934,0,1966,2,2902
875,2019-10-30,1233,0,1424,3,2660
875,2019-10-31,2691,0,2172,0,4863
875,2019-11-01,1338,0,2014,0,3352
875,2019-11-02,1020,0,1527,0,2547
875,2019-11-03,1025,0,1303,1,2329
875,2019-11-04,1182,0,2167,2,3351
875,2019-11-05,852,0,2274,0,3126
875,2019-11-06,698,0,1546,2,2246
875,2019-11-07,625,0,1058,74,1757
875,2019-11-08,1132,0,1089,0,2221
875,2019-11-09,1340,0,1356,2,2698
875,2019-11-10,1484,0,642,0,2126
875,2019-11-11,1884,0,1682,1,3567
875,2019-11-12,1630,0,1804,18,3452
875,2019-11-13,519,0,1449,1,1969
875,2019-11-14,660,0,1573,4,2237
875,2019-11-15,711,0,1731,2,2444
875,2019-11-16,1315,0,1266,1,2582
875,2019-11-17,1319,0,2398,403,4120
875,2019-11-18,907,0,2146,618,3671
875,2019-11-19,953,0,1682,0,2635
875,2019-11-20,529,0,1967,0,2496
875,2019-11-21,1945,0,1706,0,3651
875,2019-11-22,1038,0,1392,0,2430
875,2019-11-23,584,0,1417,0,2001
875,2019-11-24,458,0,1651,0,2109
875,2019-11-25,527,0,1313,0,1840
875,2019-11-26,920,0,995,0,1915
875,2019-11-27,792,0,1439,0,2231
875,2019-11-28,484,0,419,0,903
875,2019-11-29,9,0,1,0,10
875,2019-09-04,34,0,1119,0,1153
875,2019-09-05,554,0,2431,0,2985
875,2019-09-06,1371,0,3540,1,4912
875,2019-09-07,1592,0,2723,3,4318
875,2019-09-08,657,0,1781,0,2438
875,2019-09-09,724,0,2099,15,2838
875,2019-09-10,1746,0,2426,0,4172
875,2019-09-11,1727,0,1840,2,3569
875,2019-09-12,518,0,1271,2,1791
875,2019-09-13,1521,0,1503,0,3024
875,2019-09-14,1073,0,1926,0,2999
875,2019-09-15,961,0,1986,4,2951
875,2019-09-16,2597,0,2038,0,4635
875,2019-09-17,1153,0,2499,1,3653
875,2019-09-18,712,0,1682,0,2394
875,2019-09-19,1006,0,1711,0,2717
875,2019-09-20,1478,0,2016,2,3496
875,2019-09-21,753,0,1737,1,2491
875,2019-09-22,1845,0,2506,0,4351
875,2019-09-23,498,0,2369,0,2867
875,2019-09-24,1287,0,1899,4,3190
875,2019-09-25,688,0,1793,3,2484
875,2019-09-26,1046,0,1621,0,2667
875,2019-09-27,1342,0,1960,1,3303
875,2019-09-28,1195,0,2243,1,3439
875,2019-09-29,705,0,1990,1,2696
875,2019-09-30,525,0,1904,3,2432
875,2019-10-01,710,0,1542,1,2253
875,2019-10-02,1850,0,934,1675,4459
875,2019-10-03,1151,0,1471,0,2622
875,2019-10-04,1113,0,1612,29,2754
875,2019-10-05,654,0,1938,72,2664
875,2019-10-06,2060,0,1527,28,3615
875,2019-10-07,1794,0,2182,0,3976
875,2019-10-08,1487,0,2098,1,3586
875,2019-10-09,1256,0,2107,1,3364
875,2019-10-10,726,0,2460,3,3189
875,2019-10-11,975,0,1231,2,2208
875,2019-10-12,526,0,1968,1,2495
875,2019-10-13,2020,0,1810,2,3832
875,2019-10-14,2063,0,1581,1,3645
875,2019-10-15,1684,0,1466,2,3152
875,2019-10-16,781,0,1663,0,2444
875,2019-10-17,1373,0,1450,0,2823
875,2019-10-18,718,0,1646,0,2364
875,2019-10-19,1794,0,2102,0,3896
875,2019-10-20,1924,0,1891,1,3816
875,2019-10-21,568,0,1348,2,1918
875,2019-10-22,1263,0,1618,1,2882
875,2019-10-23,1632,0,1163,3,2798
875,2019-10-24,910,0,1547,1,2458
875,2019-10-25,1284,0,1993,3,3280
875,2019-10-26,2474,0,2813,0,5287
875,2019-10-27,2480,0,2538,0,5018
875,2019-10-28,1137,0,2380,1,3518
875,2019-10-29,934,0,1966,2,2902
875,2019-10-30,1233,0,1424,3,2660
875,2019-10-31,2691,0,2172,0,4863
875,2019-11-01,1338,0,2014,0,3352
875,2019-11-02,1020,0,1527,0,2547
875,2019-11-03,1025,0,1303,1,2329
875,2019-11-04,1182,0,2167,2,3351
875,2019-11-05,852,0,2274,0,3126
875,2019-11-06,698,0,1546,2,2246
875,2019-11-07,625,0,1058,74,1757
875,2019-11-08,1132,0,1089,0,2221
875,2019-11-09,1340,0,1356,2,2698
875,2019-11-10,1484,0,642,0,2126
875,2019-11-11,1884,0,1682,1,3567
875,2019-11-12,1630,0,1804,18,3452
875,2019-11-13,519,0,1449,1,1969
875,2019-11-14,660,0,1573,4,2237
875,2019-11-15,711,0,1731,2,2444
875,2019-11-16,1315,0,1266,1,2582
875,2019-11-17,1319,0,2398,403,4120
875,2019-11-18,907,0,2146,618,3671
875,2019-11-19,953,0,1682,0,2635
875,2019-11-20,529,0,1967,0,2496
875,2019-11-21,1945,0,1706,0,3651
875,2019-11-22,1038,0,1392,0,2430
875,2019-11-23,584,0,1417,0,2001
875,2019-11-24,458,0,1651,0,2109
875,2019-11-25,527,0,1313,0,1840
875,2019-11-26,920,0,995,0,1915
875,2019-11-27,792,0,1439,0,2231
875,2019-11-28,484,0,419,0,903
875,2019-11-29,9,0,1,0,10
875,2019-09-06,1371,0,3540,1,4912
875,2019-09-07,1592,0,2723,3,4318
875,2019-09-08,657,0,1781,0,2438
875,2019-09-09,724,0,2099,15,2838
875,2019-09-10,1746,0,2426,0,4172
875,2019-09-11,1727,0,1840,2,3569
875,2019-09-12,518,0,1271,2,1791
875,2019-09-13,1521,0,1503,0,3024
875,2019-09-14,1073,0,1926,0,2999
875,2019-09-15,961,0,1986,4,2951
875,2019-09-16,2597,0,2038,0,4635
875,2019-09-17,1153,0,2499,1,3653
875,2019-09-18,712,0,1682,0,2394
875,2019-09-19,1006,0,1711,0,2717
875,2019-09-20,1478,0,2016,2,3496
875,2019-09-21,753,0,1737,1,2491
875,2019-09-22,1845,0,2506,0,4351
875,2019-09-23,498,0,2369,0,2867
875,2019-09-24,1287,0,1899,4,3190
875,2019-09-25,688,0,1793,3,2484
875,2019-09-26,1046,0,1621,0,2667
875,2019-09-27,1342,0,1960,1,3303
875,2019-09-28,1195,0,2243,1,3439
875,2019-09-29,705,0,1990,1,2696
875,2019-09-30,525,0,1904,3,2432
875,2019-10-01,710,0,1542,1,2253
875,2019-10-02,1850,0,934,1675,4459
875,2019-10-03,1151,0,1471,0,2622
875,2019-10-04,1113,0,1612,29,2754
875,2019-10-05,654,0,1938,72,2664
875,2019-10-06,2060,0,1527,28,3615
875,2019-10-07,1794,0,2182,0,3976
875,2019-10-08,1487,0,2098,1,3586
875,2019-10-09,1256,0,2107,1,3364
875,2019-10-10,726,0,2460,3,3189
875,2019-10-11,975,0,1231,2,2208
875,2019-10-12,526,0,1968,1,2495
875,2019-10-13,2020,0,1810,2,3832
875,2019-10-14,2063,0,1581,1,3645
875,2019-10-15,1684,0,1466,2,3152
875,2019-10-16,781,0,1663,0,2444
875,2019-10-17,1373,0,1450,0,2823
875,2019-10-18,718,0,1646,0,2364
875,2019-10-19,1794,0,2102,0,3896
875,2019-10-20,1924,0,1891,1,3816
875,2019-10-21,568,0,1348,2,1918
875,2019-10-22,1263,0,1618,1,2882
875,2019-10-23,1632,0,1163,3,2798
875,2019-10-24,910,0,1547,1,2458
875,2019-10-25,1284,0,1993,3,3280
875,2019-10-26,2474,0,2813,0,5287
875,2019-10-27,2480,0,2538,0,5018
875,2019-10-28,1137,0,2380,1,3518
875,2019-10-29,934,0,1966,2,2902
875,2019-10-30,1233,0,1424,3,2660
875,2019-10-31,2691,0,2172,0,4863
875,2019-11-01,1338,0,2014,0,3352
875,2019-11-02,1020,0,1527,0,2547
875,2019-11-03,1025,0,1303,1,2329
875,2019-11-04,1182,0,2167,2,3351
875,2019-11-05,852,0,2274,0,3126
875,2019-11-06,698,0,1546,2,2246
875,2019-11-07,625,0,1058,74,1757
875,2019-11-08,1132,0,1089,0,2221
875,2019-11-09,1340,0,1356,2,2698
875,2019-11-10,1484,0,642,0,2126
875,2019-11-11,1884,0,1682,1,3567
875,2019-11-12,1630,0,1804,18,3452
875,2019-11-13,519,0,1449,1,1969
875,2019-11-14,660,0,1573,4,2237
875,2019-11-15,711,0,1731,2,2444
875,2019-11-16,1315,0,1266,1,2582
875,2019-11-17,1319,0,2398,403,4120
875,2019-11-18,907,0,2146,618,3671
876,2019-09-04,14,0,668,1,683
876,2019-09-05,145,0,2160,1,2306
876,2019-09-06,231,0,2083,2,2316
876,2019-09-07,2838,0,1760,0,4598
876,2019-09-08,1123,0,2711,1,3835
876,2019-09-09,1095,0,1800,0,2895
876,2019-09-10,2856,0,2130,1,4987
876,2019-09-11,228,0,2885,2,3115
876,2019-09-12,132,0,2471,2,2605
876,2019-09-13,2750,0,2155,1,4906
876,2019-09-14,102,0,1924,1,2027
876,2019-09-15,77,0,1547,1,1625
876,2019-09-16,2740,0,2261,1,5002
876,2019-09-17,1819,0,1802,2,3623
876,2019-09-18,575,0,1992,1,2568
876,2019-09-19,2895,0,1958,0,4853
876,2019-09-20,1052,0,1309,3,2364
876,2019-09-21,131,0,1825,1,1957
876,2019-09-22,3510,0,2045,2,5557
876,2019-09-23,102,0,1255,2,1359
876,2019-09-24,147,0,1577,3,1727
876,2019-09-25,2338,0,1328,2,3668
876,2019-09-26,279,0,1900,0,2179
876,2019-09-27,120,0,1817,3,1940
876,2019-09-28,2726,0,2349,2,5077
876,2019-09-29,118,0,2482,1,2601
876,2019-09-30,956,0,1522,0,2478
876,2019-10-01,2952,0,1403,1,4356
876,2019-10-02,1012,0,2092,0,3104
876,2019-10-03,108,0,1439,0,1547
876,2019-10-04,2767,0,1559,1,4327
876,2019-10-05,1849,0,1530,1,3380
876,2019-10-06,96,0,1420,0,1516
876,2019-10-07,3517,0,1585,4,5106
876,2019-10-08,1284,0,1272,1,2557
876,2019-10-09,548,0,1683,1,2232
876,2019-10-10,2454,0,1857,2,4313
876,2019-10-11,4146,0,921,1,5068
876,2019-10-12,336,0,2420,3,2759
876,2019-10-13,822,0,1366,1,2189
876,2019-10-14,3810,0,2356,1,6167
876,2019-10-15,84,0,1270,0,1354
876,2019-10-16,100,0,1452,3,1555
876,2019-10-17,2097,0,2269,2,4368
876,2019-10-18,691,0,1498,0,2189
876,2019-10-19,101,0,1473,0,1574
876,2019-10-20,1875,0,2016,0,3891
876,2019-10-21,199,0,821,1,1021
876,2019-10-22,112,0,1590,1,1703
876,2019-10-23,2472,0,2152,1,4625
876,2019-10-24,132,0,1898,1,2031
876,2019-10-25,184,0,1204,1,1389
876,2019-10-26,2595,0,1859,0,4454
876,2019-10-27,92,0,902,0,994
876,2019-10-28,48,0,949,1,998
876,2019-10-29,3181,0,1516,0,4697
876,2019-10-30,90,0,1142,0,1232
876,2019-10-31,728,0,1941,1,2670
876,2019-11-01,2300,0,1299,2,3601
876,2019-11-02,371,0,1248,0,1619
876,2019-11-03,98,0,1785,0,1883
876,2019-11-04,2384,0,1944,0,4328
876,2019-11-05,170,0,1170,0,1340
876,2019-11-06,111,0,1512,2,1625
876,2019-11-07,1818,0,1132,3,2953
876,2019-11-08,768,0,1099,0,1867
876,2019-11-09,1958,0,1888,0,3846
876,2019-11-10,2171,0,2276,1,4448
876,2019-11-11,988,0,922,5,1915
876,2019-11-12,95,0,2473,0,2568
876,2019-11-13,1725,0,1511,2,3238
876,2019-11-14,685,0,2543,0,3228
876,2019-11-15,81,0,2079,1,2161
876,2019-11-16,3977,0,2544,3,6524
876,2019-11-17,1070,0,2097,0,3167
876,2019-11-18,96,0,3078,0,3174
876,2019-11-19,3165,0,2596,0,5761
876,2019-11-20,617,0,2168,1,2786
876,2019-11-21,118,0,1766,2,1886
876,2019-11-22,1568,0,1152,1,2721
876,2019-11-23,669,0,1924,1,2594
876,2019-11-24,108,0,1251,1,1360
876,2019-11-25,1574,0,1780,0,3354
876,2019-11-26,1656,0,1521,2,3179
876,2019-11-27,73,0,2058,666,2797
876,2019-11-28,243,0,419,0,662
876,2019-11-29,119,0,0,0,119
876,2019-09-04,14,0,668,1,683
876,2019-09-05,145,0,2160,1,2306
876,2019-09-06,231,0,2083,2,2316
876,2019-09-07,2838,0,1760,0,4598
876,2019-09-08,1123,0,2711,1,3835
876,2019-09-09,1095,0,1800,0,2895
876,2019-09-10,2856,0,2130,1,4987
876,2019-09-11,228,0,2885,2,3115
876,2019-09-12,132,0,2471,2,2605
876,2019-09-13,2750,0,2155,1,4906
876,2019-09-14,102,0,1924,1,2027
876,2019-09-15,77,0,1547,1,1625
876,2019-09-16,2740,0,2261,1,5002
876,2019-09-17,1819,0,1802,2,3623
876,2019-09-18,575,0,1992,1,2568
876,2019-09-19,2895,0,1958,0,4853
876,2019-09-20,1052,0,1309,3,2364
876,2019-09-21,131,0,1825,1,1957
876,2019-09-22,3510,0,2045,2,5557
876,2019-09-23,102,0,1255,2,1359
876,2019-09-24,147,0,1577,3,1727
876,2019-09-25,2338,0,1328,2,3668
876,2019-09-26,279,0,1900,0,2179
876,2019-09-27,120,0,1817,3,1940
876,2019-09-28,2726,0,2349,2,5077
876,2019-09-29,118,0,2482,1,2601
876,2019-09-30,956,0,1522,0,2478
876,2019-10-01,2952,0,1403,1,4356
876,2019-10-02,1012,0,2092,0,3104
876,2019-10-03,108,0,1439,0,1547
876,2019-10-04,2767,0,1559,1,4327
876,2019-10-05,1849,0,1530,1,3380
876,2019-10-06,96,0,1420,0,1516
876,2019-10-07,3517,0,1585,4,5106
876,2019-10-08,1284,0,1272,1,2557
876,2019-10-09,548,0,1683,1,2232
876,2019-10-10,2454,0,1857,2,4313
876,2019-10-11,4146,0,921,1,5068
876,2019-10-12,336,0,2420,3,2759
876,2019-10-13,822,0,1366,1,2189
876,2019-10-14,3810,0,2356,1,6167
876,2019-10-15,84,0,1270,0,1354
876,2019-10-16,100,0,1452,3,1555
876,2019-10-17,2097,0,2269,2,4368
876,2019-10-18,691,0,1498,0,2189
876,2019-10-19,101,0,1473,0,1574
876,2019-10-20,1875,0,2016,0,3891
876,2019-10-21,199,0,821,1,1021
876,2019-10-22,112,0,1590,1,1703
876,2019-10-23,2472,0,2152,1,4625
876,2019-10-24,132,0,1898,1,2031
876,2019-10-25,184,0,1204,1,1389
876,2019-10-26,2595,0,1859,0,4454
876,2019-10-27,92,0,902,0,994
876,2019-10-28,48,0,949,1,998
876,2019-10-29,3181,0,1516,0,4697
876,2019-10-30,90,0,1142,0,1232
876,2019-10-31,728,0,1941,1,2670
876,2019-11-01,2300,0,1299,2,3601
876,2019-11-02,371,0,1248,0,1619
876,2019-11-03,98,0,1785,0,1883
876,2019-11-04,2384,0,1944,0,4328
876,2019-11-05,170,0,1170,0,1340
876,2019-11-06,111,0,1512,2,1625
876,2019-11-07,1818,0,1132,3,2953
876,2019-11-08,768,0,1099,0,1867
876,2019-11-09,1958,0,1888,0,3846
876,2019-11-10,2171,0,2276,1,4448
876,2019-11-11,988,0,922,5,1915
876,2019-11-12,95,0,2473,0,2568
876,2019-11-13,1725,0,1511,2,3238
876,2019-11-14,685,0,2543,0,3228
876,2019-11-15,81,0,2079,1,2161
876,2019-11-16,3977,0,2544,3,6524
876,2019-11-17,1070,0,2097,0,3167
876,2019-11-18,96,0,3078,0,3174
876,2019-11-19,3165,0,2596,0,5761
876,2019-11-20,617,0,2168,1,2786
876,2019-11-21,118,0,1766,2,1886
876,2019-11-22,1568,0,1152,1,2721
876,2019-11-23,669,0,1924,1,2594
876,2019-11-24,108,0,1251,1,1360
876,2019-11-25,1574,0,1780,0,3354
876,2019-11-26,1656,0,1521,2,3179
876,2019-11-27,73,0,2058,666,2797
876,2019-11-28,243,0,419,0,662
876,2019-09-04,14,0,668,1,683
876,2019-09-05,145,0,2160,1,2306
876,2019-09-06,231,0,2083,2,2316
876,2019-09-07,2838,0,1760,0,4598
876,2019-09-08,1123,0,2711,1,3835
876,2019-09-09,1095,0,1800,0,2895
876,2019-09-10,2856,0,2130,1,4987
876,2019-09-11,228,0,2885,2,3115
876,2019-09-12,132,0,2471,2,2605
876,2019-09-13,2750,0,2155,1,4906
876,2019-09-14,102,0,1924,1,2027
876,2019-09-15,77,0,1547,1,1625
876,2019-09-16,2740,0,2261,1,5002
876,2019-09-17,1819,0,1802,2,3623
876,2019-09-18,575,0,1992,1,2568
876,2019-09-19,2895,0,1958,0,4853
876,2019-09-20,1052,0,1309,3,2364
876,2019-09-21,131,0,1825,1,1957
876,2019-09-22,3510,0,2045,2,5557
876,2019-09-23,102,0,1255,2,1359
876,2019-09-24,147,0,1577,3,1727
876,2019-09-25,2338,0,1328,2,3668
876,2019-09-26,279,0,1900,0,2179
876,2019-09-27,120,0,1817,3,1940
876,2019-09-28,2726,0,2349,2,5077
876,2019-09-29,118,0,2482,1,2601
876,2019-09-30,956,0,1522,0,2478
876,2019-10-01,2952,0,1403,1,4356
876,2019-10-02,1012,0,2092,0,3104
876,2019-10-03,108,0,1439,0,1547
876,2019-10-04,2767,0,1559,1,4327
876,2019-10-05,1849,0,1530,1,3380
876,2019-10-06,96,0,1420,0,1516
876,2019-10-07,3517,0,1585,4,5106
876,2019-10-08,1284,0,1272,1,2557
876,2019-10-09,548,0,1683,1,2232
876,2019-10-10,2454,0,1857,2,4313
876,2019-10-11,4146,0,921,1,5068
876,2019-10-12,336,0,2420,3,2759
876,2019-10-13,822,0,1366,1,2189
876,2019-10-14,3810,0,2356,1,6167
876,2019-10-15,84,0,1270,0,1354
876,2019-10-16,100,0,1452,3,1555
876,2019-10-17,2097,0,2269,2,4368
876,2019-10-18,691,0,1498,0,2189
876,2019-10-19,101,0,1473,0,1574
876,2019-10-20,1875,0,2016,0,3891
876,2019-10-21,199,0,821,1,1021
876,2019-10-22,112,0,1590,1,1703
876,2019-10-23,2472,0,2152,1,4625
876,2019-10-24,132,0,1898,1,2031
876,2019-10-25,184,0,1204,1,1389
876,2019-10-26,2595,0,1859,0,4454
876,2019-10-27,92,0,902,0,994
876,2019-10-28,48,0,949,1,998
876,2019-10-29,3181,0,1516,0,4697
876,2019-10-30,90,0,1142,0,1232
876,2019-10-31,728,0,1941,1,2670
876,2019-11-01,2300,0,1299,2,3601
876,2019-11-02,371,0,1248,0,1619
876,2019-11-03,98,0,1785,0,1883
876,2019-11-04,2384,0,1944,0,4328
876,2019-11-05,170,0,1170,0,1340
876,2019-11-06,111,0,1512,2,1625
876,2019-11-07,1818,0,1132,3,2953
876,2019-11-08,768,0,1099,0,1867
876,2019-11-09,1958,0,1888,0,3846
876,2019-11-10,2171,0,2276,1,4448
876,2019-11-11,988,0,922,5,1915
876,2019-11-12,95,0,2473,0,2568
876,2019-11-13,1725,0,1511,2,3238
876,2019-11-14,685,0,2543,0,3228
876,2019-11-15,81,0,2079,1,2161
876,2019-11-16,3977,0,2544,3,6524
876,2019-11-17,1070,0,2097,0,3167
876,2019-11-18,96,0,3078,0,3174
876,2019-11-19,3165,0,2596,0,5761
876,2019-11-20,617,0,2168,1,2786
876,2019-11-21,118,0,1766,2,1886
876,2019-11-22,1568,0,1152,1,2721
876,2019-11-23,669,0,1924,1,2594
876,2019-11-24,108,0,1251,1,1360
876,2019-11-25,1574,0,1780,0,3354
876,2019-11-26,1656,0,1521,2,3179
876,2019-11-27,73,0,2058,666,2797
877,2019-09-04,112,0,523,0,635
877,2019-09-05,1570,0,2269,1,3840
877,2019-09-06,2753,0,2102,1,4856
877,2019-09-07,656,0,2315,1,2972
877,2019-09-08,747,0,1565,0,2312
877,2019-09-09,695,0,2457,0,3152
877,2019-09-10,356,0,1946,1,2303
877,2019-09-11,515,0,1986,2,2503
877,2019-09-12,469,0,2039,0,2508
877,2019-09-13,2291,0,1666,1,3958
877,2019-09-14,452,0,1508,1,1961
877,2019-09-15,462,0,2016,1,2479
877,2019-09-16,437,0,1779,1,2217
877,2019-09-17,1256,0,2360,0,3616
877,2019-09-18,626,0,1285,0,1911
877,2019-09-19,761,0,993,1,1755
877,2019-09-20,503,0,2777,1,3281
877,2019-09-21,480,0,1885,0,2365
877,2019-09-22,714,0,1656,1,2371
877,2019-09-23,522,0,1748,0,2270
877,2019-09-24,605,0,1690,98,2393
877,2019-09-25,328,0,1294,2,1624
877,2019-09-26,370,0,1257,3,1630
877,2019-09-27,306,0,1184,2,1492
877,2019-09-28,1034,0,1352,3,2389
877,2019-09-29,337,0,1366,0,1703
877,2019-09-30,322,0,1148,0,1470
877,2019-10-01,298,0,1876,2,2176
877,2019-10-02,1827,0,1720,0,3547
877,2019-10-03,1196,0,1223,0,2419
877,2019-10-04,363,0,1839,2,2204
877,2019-10-05,391,0,1825,1,2217
877,2019-10-06,530,0,1441,2,1973
877,2019-10-07,453,0,1939,0,2392
877,2019-10-08,354,0,1588,1,1943
877,2019-10-09,353,0,1861,1,2215
877,2019-10-10,1448,0,2084,1,3533
877,2019-10-11,522,0,1890,5,2417
877,2019-10-12,776,0,1800,2,2578
877,2019-10-13,399,0,2152,1,2552
877,2019-10-14,382,0,1591,0,1973
877,2019-10-15,2605,0,1510,0,4115
877,2019-10-16,931,0,1458,3,2392
877,2019-10-17,450,0,1395,0,1845
877,2019-10-18,465,0,1796,0,2261
877,2019-10-19,443,0,1489,0,1932
877,2019-10-20,1315,0,1534,0,2849
877,2019-10-21,970,0,1530,9,2509
877,2019-10-22,1350,0,1773,0,3123
877,2019-10-23,435,0,1546,0,1981
877,2019-10-24,824,0,803,0,1627
877,2019-10-25,476,0,1247,0,1723
877,2019-10-26,421,0,1786,0,2207
877,2019-10-27,482,0,1319,0,1801
877,2019-10-28,618,0,1824,0,2442
877,2019-10-29,1654,0,1552,0,3206
877,2019-10-30,468,0,1678,0,2146
877,2019-10-31,1069,0,952,0,2021
877,2019-11-01,1796,0,1601,0,3397
877,2019-11-02,1392,0,1607,0,2999
877,2019-11-03,704,0,734,0,1438
877,2019-11-04,1336,0,1741,0,3077
877,2019-11-05,1343,0,1099,0,2442
877,2019-11-06,897,0,1356,0,2253
877,2019-11-07,588,0,983,0,1571
877,2019-11-08,905,0,859,0,1764
877,2019-11-09,441,0,1848,0,2289
877,2019-11-10,449,0,2330,0,2779
877,2019-11-11,482,0,2167,0,2649
877,2019-11-12,432,0,2788,0,3220
877,2019-11-13,549,0,1622,0,2171
877,2019-11-14,425,0,2027,0,2452
877,2019-11-15,1460,0,2529,0,3989
877,2019-11-16,415,0,1772,0,2187
877,2019-11-17,2008,0,2925,0,4933
877,2019-11-18,445,0,2768,0,3213
877,2019-11-19,1048,0,2035,0,3083
877,2019-11-20,437,0,2932,0,3369
877,2019-11-21,435,0,2055,0,2490
877,2019-11-22,524,0,27,0,551
877,2019-11-23,466,0,0,0,466
877,2019-11-24,505,0,0,0,505
877,2019-11-25,831,0,0,0,831
877,2019-11-26,443,0,0,0,443
877,2019-11-27,325,0,0,0,325
877,2019-09-04,112,0,523,0,635
877,2019-09-05,1570,0,2269,1,3840
877,2019-09-06,2753,0,2102,1,4856
877,2019-09-07,656,0,2315,1,2972
877,2019-09-08,747,0,1565,0,2312
877,2019-09-09,695,0,2457,0,3152
877,2019-09-10,356,0,1946,1,2303
877,2019-09-11,515,0,1986,2,2503
877,2019-09-12,469,0,2039,0,2508
877,2019-09-13,2291,0,1666,1,3958
877,2019-09-14,452,0,1508,1,1961
877,2019-09-15,462,0,2016,1,2479
877,2019-09-16,437,0,1779,1,2217
877,2019-09-17,1256,0,2360,0,3616
877,2019-09-18,626,0,1285,0,1911
877,2019-09-19,761,0,993,1,1755
877,2019-09-20,503,0,2777,1,3281
877,2019-09-21,480,0,1885,0,2365
877,2019-09-22,714,0,1656,1,2371
877,2019-09-23,522,0,1748,0,2270
877,2019-09-24,605,0,1690,98,2393
877,2019-09-25,328,0,1294,2,1624
877,2019-09-26,370,0,1257,3,1630
877,2019-09-27,306,0,1184,2,1492
877,2019-09-28,1034,0,1352,3,2389
877,2019-09-29,337,0,1366,0,1703
877,2019-09-30,322,0,1148,0,1470
877,2019-10-01,298,0,1876,2,2176
877,2019-10-02,1827,0,1720,0,3547
877,2019-10-03,1196,0,1223,0,2419
877,2019-10-04,363,0,1839,2,2204
877,2019-10-05,391,0,1825,1,2217
877,2019-10-06,530,0,1441,2,1973
877,2019-10-07,453,0,1939,0,2392
877,2019-10-08,354,0,1588,1,1943
877,2019-10-09,353,0,1861,1,2215
877,2019-10-10,1448,0,2084,1,3533
877,2019-10-11,522,0,1890,5,2417
877,2019-10-12,776,0,1800,2,2578
877,2019-10-13,399,0,2152,1,2552
877,2019-10-14,382,0,1591,0,1973
877,2019-10-15,2605,0,1510,0,4115
877,2019-10-16,931,0,1458,3,2392
877,2019-10-17,450,0,1395,0,1845
877,2019-10-18,465,0,1796,0,2261
877,2019-10-19,443,0,1489,0,1932
877,2019-10-20,1315,0,1534,0,2849
877,2019-10-21,970,0,1530,9,2509
877,2019-10-22,1350,0,1773,0,3123
877,2019-10-23,435,0,1546,0,1981
877,2019-10-24,824,0,803,0,1627
877,2019-10-25,476,0,1247,0,1723
877,2019-10-26,421,0,1786,0,2207
877,2019-10-27,482,0,1319,0,1801
877,2019-10-28,618,0,1824,0,2442
877,2019-10-29,1654,0,1552,0,3206
877,2019-10-30,468,0,1678,0,2146
877,2019-10-31,1069,0,952,0,2021
877,2019-11-01,1796,0,1601,0,3397
877,2019-11-02,1392,0,1607,0,2999
877,2019-11-03,704,0,734,0,1438
877,2019-11-04,1336,0,1741,0,3077
877,2019-11-05,1343,0,1099,0,2442
877,2019-11-06,897,0,1356,0,2253
877,2019-11-07,588,0,983,0,1571
877,2019-11-08,905,0,859,0,1764
877,2019-11-09,441,0,1848,0,2289
877,2019-11-10,449,0,2330,0,2779
877,2019-11-11,482,0,2167,0,2649
877,2019-11-12,432,0,2788,0,3220
877,2019-11-13,549,0,1622,0,2171
877,2019-11-14,425,0,2027,0,2452
877,2019-11-15,1460,0,2529,0,3989
877,2019-11-16,415,0,1772,0,2187
877,2019-11-17,2008,0,2925,0,4933
877,2019-11-18,445,0,2768,0,3213
877,2019-11-19,1048,0,2035,0,3083
877,2019-11-20,437,0,2932,0,3369
877,2019-11-21,435,0,2055,0,2490
877,2019-11-22,524,0,27,0,551
877,2019-09-05,1570,0,2269,1,3840
877,2019-09-06,2753,0,2102,1,4856
877,2019-09-07,656,0,2315,1,2972
877,2019-09-08,747,0,1565,0,2312
877,2019-09-09,695,0,2457,0,3152
877,2019-09-10,356,0,1946,1,2303
877,2019-09-11,515,0,1986,2,2503
877,2019-09-12,469,0,2039,0,2508
877,2019-09-13,2291,0,1666,1,3958
877,2019-09-14,452,0,1508,1,1961
877,2019-09-15,462,0,2016,1,2479
877,2019-09-16,437,0,1779,1,2217
877,2019-09-17,1256,0,2360,0,3616
877,2019-09-18,626,0,1285,0,1911
877,2019-09-19,761,0,993,1,1755
877,2019-09-20,503,0,2777,1,3281
877,2019-09-21,480,0,1885,0,2365
877,2019-09-22,714,0,1656,1,2371
877,2019-09-23,522,0,1748,0,2270
877,2019-09-24,605,0,1690,98,2393
877,2019-09-25,328,0,1294,2,1624
877,2019-09-26,370,0,1257,3,1630
877,2019-09-27,306,0,1184,2,1492
877,2019-09-28,1034,0,1352,3,2389
877,2019-09-29,337,0,1366,0,1703
877,2019-09-30,322,0,1148,0,1470
877,2019-10-01,298,0,1876,2,2176
877,2019-10-02,1827,0,1720,0,3547
877,2019-10-03,1196,0,1223,0,2419
877,2019-10-04,363,0,1839,2,2204
877,2019-10-05,391,0,1825,1,2217
877,2019-10-06,530,0,1441,2,1973
877,2019-10-07,453,0,1939,0,2392
877,2019-10-08,354,0,1588,1,1943
877,2019-10-09,353,0,1861,1,2215
877,2019-10-10,1448,0,2084,1,3533
877,2019-10-11,522,0,1890,5,2417
877,2019-10-12,776,0,1800,2,2578
877,2019-10-13,399,0,2152,1,2552
877,2019-10-14,382,0,1591,0,1973
877,2019-10-15,2605,0,1510,0,4115
877,2019-10-16,931,0,1458,3,2392
877,2019-10-17,450,0,1395,0,1845
877,2019-10-18,465,0,1796,0,2261
877,2019-10-19,443,0,1489,0,1932
877,2019-10-20,1315,0,1534,0,2849
877,2019-10-21,970,0,1530,9,2509
878,2019-09-04,33,0,1286,0,1319
878,2019-09-05,941,0,2036,2,2979
878,2019-09-06,163,0,1795,0,1958
878,2019-09-07,224,0,2378,1,2603
878,2019-09-08,1004,0,1971,0,2975
878,2019-09-09,124,0,2011,2,2137
878,2019-09-10,1046,0,2114,0,3160
878,2019-09-11,221,0,2794,5795,8810
878,2019-09-12,1769,0,1007,4,2780
878,2019-09-13,986,0,1693,3,2682
878,2019-09-14,280,0,2268,1,2549
878,2019-09-15,226,0,2337,2,2565
878,2019-09-16,1823,0,1668,3,3494
878,2019-09-17,158,0,1971,8,2137
878,2019-09-18,93,0,1410,8,1511
878,2019-09-19,1103,0,1801,9,2913
878,2019-09-20,195,0,1632,9,1836
878,2019-09-21,120,0,1875,9,2004
878,2019-09-22,1811,0,1963,10,3784
878,2019-09-23,984,0,1445,10,2439
878,2019-09-24,109,0,1885,12,2006
878,2019-09-25,949,0,1961,11,2921
878,2019-09-26,176,0,1818,840,2834
878,2019-09-27,96,0,1561,4,1661
878,2019-09-28,161,0,1964,3,2128
878,2019-09-29,82,0,2978,0,3060
878,2019-09-30,978,0,1930,0,2908
878,2019-10-01,1837,0,2284,2,4123
878,2019-10-02,1036,0,1919,6,2961
878,2019-10-03,203,0,840,9,1052
878,2019-10-04,181,0,1569,10,1760
878,2019-10-05,410,0,1632,11,2053
878,2019-10-06,2115,0,1493,10,3618
878,2019-10-07,256,0,1923,12,2191
878,2019-10-08,361,0,1251,10,1622
878,2019-10-09,137,0,1673,10,1820
878,2019-10-10,158,0,2168,9,2335
878,2019-10-11,557,0,953,10,1520
878,2019-10-12,75,0,1917,3,1995
878,2019-10-13,123,0,1897,3,2023
878,2019-10-14,1869,0,2165,1,4035
878,2019-10-15,1145,0,1891,1,3037
878,2019-10-16,128,0,914,1,1043
878,2019-10-17,1138,0,2487,509,4134
878,2019-10-18,313,0,2182,0,2495
878,2019-10-19,187,0,2204,1,2392
878,2019-10-20,1040,0,2316,0,3356
878,2019-10-21,394,0,1062,0,1456
878,2019-10-22,1038,0,1970,1,3009
878,2019-10-23,212,0,2090,0,2302
878,2019-10-24,737,0,1698,1,2436
878,2019-10-25,175,0,1197,2,1374
878,2019-10-26,202,0,2771,3,2976
878,2019-10-27,133,0,2741,1,2875
878,2019-10-28,1682,0,2748,1,4431
878,2019-10-29,734,0,2262,2,2998
878,2019-10-30,377,0,1077,1,1455
878,2019-10-31,581,0,2026,2,2609
878,2019-11-01,975,0,1318,2,2295
878,2019-11-02,148,0,1110,0,1258
878,2019-11-03,258,0,1256,0,1514
878,2019-11-04,140,0,1444,0,1584
878,2019-11-05,624,0,2383,0,3007
878,2019-11-06,599,0,2205,3,2807
878,2019-11-07,278,0,1993,3,2274
878,2019-11-08,165,0,2148,0,2313
878,2019-11-09,1022,0,2647,0,3669
878,2019-11-10,788,0,867,0,1655
878,2019-11-11,202,0,1784,4,1990
878,2019-11-12,871,0,1834,0,2705
878,2019-11-13,1059,0,1673,1,2733
878,2019-11-14,1027,0,2632,1,3660
878,2019-11-15,1148,0,2529,2,3679
878,2019-11-16,236,0,2196,3,2435
878,2019-11-17,125,0,2648,0,2773
878,2019-11-18,166,0,2299,1,2466
878,2019-11-19,246,0,2000,0,2246
878,2019-11-20,183,0,2120,1,2304
878,2019-11-21,122,0,1902,3,2027
878,2019-11-22,310,0,1745,2,2057
878,2019-11-23,176,0,2136,0,2312
878,2019-11-24,345,0,1823,1,2169
878,2019-11-25,113,0,1827,1,1941
878,2019-11-26,1091,0,1075,3,2169
878,2019-11-27,185,0,1307,1,1493
878,2019-11-28,58,0,628,0,686
878,2019-11-29,28,0,9,0,37
878,2019-09-04,33,0,1286,0,1319
878,2019-09-05,941,0,2036,2,2979
878,2019-09-06,163,0,1795,0,1958
878,2019-09-07,224,0,2378,1,2603
878,2019-09-08,1004,0,1971,0,2975
878,2019-09-09,124,0,2011,2,2137
878,2019-09-10,1046,0,2114,0,3160
878,2019-09-11,221,0,2794,5795,8810
878,2019-09-12,1769,0,1007,4,2780
878,2019-09-13,986,0,1693,3,2682
878,2019-09-14,280,0,2268,1,2549
878,2019-09-15,226,0,2337,2,2565
878,2019-09-16,1823,0,1668,3,3494
878,2019-09-17,158,0,1971,8,2137
878,2019-09-18,93,0,1410,8,1511
878,2019-09-19,1103,0,1801,9,2913
878,2019-09-20,195,0,1632,9,1836
878,2019-09-21,120,0,1875,9,2004
878,2019-09-22,1811,0,1963,10,3784
878,2019-09-23,984,0,1445,10,2439
878,2019-09-24,109,0,1885,12,2006
878,2019-09-25,949,0,1961,11,2921
878,2019-09-26,176,0,1818,840,2834
878,2019-09-27,96,0,1561,4,1661
878,2019-09-28,161,0,1964,3,2128
878,2019-09-29,82,0,2978,0,3060
878,2019-09-30,978,0,1930,0,2908
878,2019-10-01,1837,0,2284,2,4123
878,2019-10-02,1036,0,1919,6,2961
878,2019-10-03,203,0,840,9,1052
878,2019-10-04,181,0,1569,10,1760
878,2019-10-05,410,0,1632,11,2053
878,2019-10-06,2115,0,1493,10,3618
878,2019-10-07,256,0,1923,12,2191
878,2019-10-08,361,0,1251,10,1622
878,2019-10-09,137,0,1673,10,1820
878,2019-10-10,158,0,2168,9,2335
878,2019-10-11,557,0,953,10,1520
878,2019-10-12,75,0,1917,3,1995
878,2019-10-13,123,0,1897,3,2023
878,2019-10-14,1869,0,2165,1,4035
878,2019-10-15,1145,0,1891,1,3037
878,2019-10-16,128,0,914,1,1043
878,2019-10-17,1138,0,2487,509,4134
878,2019-10-18,313,0,2182,0,2495
878,2019-10-19,187,0,2204,1,2392
878,2019-10-20,1040,0,2316,0,3356
878,2019-10-21,394,0,1062,0,1456
878,2019-10-22,1038,0,1970,1,3009
878,2019-10-23,212,0,2090,0,2302
878,2019-10-24,737,0,1698,1,2436
878,2019-10-25,175,0,1197,2,1374
878,2019-10-26,202,0,2771,3,2976
878,2019-10-27,133,0,2741,1,2875
878,2019-10-28,1682,0,2748,1,4431
878,2019-10-29,734,0,2262,2,2998
878,2019-10-30,377,0,1077,1,1455
878,2019-10-31,581,0,2026,2,2609
878,2019-11-01,975,0,1318,2,2295
878,2019-11-02,148,0,1110,0,1258
878,2019-11-03,258,0,1256,0,1514
878,2019-11-04,140,0,1444,0,1584
878,2019-11-05,624,0,2383,0,3007
878,2019-11-06,599,0,2205,3,2807
878,2019-11-07,278,0,1993,3,2274
878,2019-11-08,165,0,2148,0,2313
878,2019-11-09,1022,0,2647,0,3669
878,2019-11-10,788,0,867,0,1655
878,2019-11-11,202,0,1784,4,1990
878,2019-11-12,871,0,1834,0,2705
878,2019-11-13,1059,0,1673,1,2733
878,2019-11-14,1027,0,2632,1,3660
878,2019-11-15,1148,0,2529,2,3679
878,2019-11-16,236,0,2196,3,2435
878,2019-11-17,125,0,2648,0,2773
878,2019-11-18,166,0,2299,1,2466
878,2019-11-19,246,0,2000,0,2246
878,2019-11-20,183,0,2120,1,2304
878,2019-11-21,122,0,1902,3,2027
878,2019-11-22,310,0,1745,2,2057
878,2019-11-23,176,0,2136,0,2312
878,2019-11-24,345,0,1823,1,2169
878,2019-11-25,113,0,1827,1,1941
878,2019-11-26,1091,0,1075,3,2169
878,2019-11-27,185,0,1307,1,1493
878,2019-11-28,58,0,628,0,686
878,2019-11-29,28,0,9,0,37
878,2019-09-05,941,0,2036,2,2979
878,2019-09-06,163,0,1795,0,1958
878,2019-09-07,224,0,2378,1,2603
878,2019-09-08,1004,0,1971,0,2975
878,2019-09-09,124,0,2011,2,2137
878,2019-09-10,1046,0,2114,0,3160
878,2019-09-11,221,0,2794,5795,8810
878,2019-09-12,1769,0,1007,4,2780
878,2019-09-13,986,0,1693,3,2682
878,2019-09-14,280,0,2268,1,2549
878,2019-09-15,226,0,2337,2,2565
878,2019-09-16,1823,0,1668,3,3494
878,2019-09-17,158,0,1971,8,2137
878,2019-09-18,93,0,1410,8,1511
878,2019-09-19,1103,0,1801,9,2913
878,2019-09-20,195,0,1632,9,1836
878,2019-09-21,120,0,1875,9,2004
878,2019-09-22,1811,0,1963,10,3784
878,2019-09-23,984,0,1445,10,2439
878,2019-09-24,109,0,1885,12,2006
878,2019-09-25,949,0,1961,11,2921
878,2019-09-26,176,0,1818,840,2834
878,2019-09-27,96,0,1561,4,1661
878,2019-09-28,161,0,1964,3,2128
878,2019-09-29,82,0,2978,0,3060
878,2019-09-30,978,0,1930,0,2908
878,2019-10-01,1837,0,2284,2,4123
878,2019-10-02,1036,0,1919,6,2961
878,2019-10-03,203,0,840,9,1052
878,2019-10-04,181,0,1569,10,1760
878,2019-10-05,410,0,1632,11,2053
878,2019-10-06,2115,0,1493,10,3618
878,2019-10-07,256,0,1923,12,2191
878,2019-10-08,361,0,1251,10,1622
878,2019-10-09,137,0,1673,10,1820
878,2019-10-10,158,0,2168,9,2335
878,2019-10-11,557,0,953,10,1520
878,2019-10-12,75,0,1917,3,1995
878,2019-10-13,123,0,1897,3,2023
878,2019-10-14,1869,0,2165,1,4035
878,2019-10-15,1145,0,1891,1,3037
878,2019-10-16,128,0,914,1,1043
878,2019-10-17,1138,0,2487,509,4134
878,2019-10-18,313,0,2182,0,2495
878,2019-10-19,187,0,2204,1,2392
878,2019-10-20,1040,0,2316,0,3356
878,2019-10-21,394,0,1062,0,1456
878,2019-10-22,1038,0,1970,1,3009
878,2019-10-23,212,0,2090,0,2302
878,2019-10-24,737,0,1698,1,2436
878,2019-10-25,175,0,1197,2,1374
878,2019-10-26,202,0,2771,3,2976
878,2019-10-27,133,0,2741,1,2875
878,2019-10-28,1682,0,2748,1,4431
878,2019-10-29,734,0,2262,2,2998
878,2019-10-30,377,0,1077,1,1455
878,2019-10-31,581,0,2026,2,2609
878,2019-11-01,975,0,1318,2,2295
878,2019-11-02,148,0,1110,0,1258
878,2019-11-03,258,0,1256,0,1514
878,2019-11-04,140,0,1444,0,1584
878,2019-11-05,624,0,2383,0,3007
878,2019-11-06,599,0,2205,3,2807
878,2019-11-07,278,0,1993,3,2274
878,2019-11-08,165,0,2148,0,2313
878,2019-11-09,1022,0,2647,0,3669
878,2019-11-10,788,0,867,0,1655
878,2019-11-11,202,0,1784,4,1990
878,2019-11-12,871,0,1834,0,2705
878,2019-11-13,1059,0,1673,1,2733
878,2019-11-14,1027,0,2632,1,3660
878,2019-11-15,1148,0,2529,2,3679
878,2019-11-16,236,0,2196,3,2435
878,2019-11-17,125,0,2648,0,2773
878,2019-11-18,166,0,2299,1,2466
878,2019-11-19,246,0,2000,0,2246
878,2019-11-20,183,0,2120,1,2304
878,2019-11-21,122,0,1902,3,2027
878,2019-11-22,310,0,1745,2,2057
878,2019-11-23,176,0,2136,0,2312
878,2019-11-24,345,0,1823,1,2169
878,2019-11-25,113,0,1827,1,1941
878,2019-11-26,1091,0,1075,3,2169
878,2019-11-27,185,0,1307,1,1493
879,2019-09-04,44,0,1052,0,1096
879,2019-09-05,1217,0,1349,0,2566
879,2019-09-06,453,0,1932,1,2386
879,2019-09-07,484,0,1878,0,2362
879,2019-09-08,493,0,1771,0,2264
879,2019-09-09,539,0,2452,1,2992
879,2019-09-10,335,0,1567,0,1902
879,2019-09-11,223,0,1375,2,1600
879,2019-09-12,254,0,1634,2,1890
879,2019-09-13,1402,0,1812,0,3214
879,2019-09-14,1240,0,2111,1,3352
879,2019-09-15,326,0,2071,1,2398
879,2019-09-16,492,0,2060,1,2553
879,2019-09-17,281,0,1629,0,1910
879,2019-09-18,589,0,1934,0,2523
879,2019-09-19,558,0,1804,0,2362
879,2019-09-20,380,0,2190,1,2571
879,2019-09-21,712,0,2340,0,3052
879,2019-09-22,265,0,2112,1,2378
879,2019-09-23,366,0,1633,0,1999
879,2019-09-24,420,0,1976,3,2399
879,2019-09-25,170,0,927,2,1099
879,2019-09-26,220,0,1458,1,1679
879,2019-09-27,147,0,2032,1,2180
879,2019-09-28,1057,0,2123,5,3185
879,2019-09-29,155,0,1583,3,1741
879,2019-09-30,144,0,1599,1,1744
879,2019-10-01,147,0,1478,1,1626
879,2019-10-02,209,0,1066,0,1275
879,2019-10-03,170,0,821,2,993
879,2019-10-04,207,0,1207,2,1416
879,2019-10-05,1305,0,1520,2,2827
879,2019-10-06,157,0,2224,0,2381
879,2019-10-07,415,0,1654,1,2070
879,2019-10-08,778,0,1119,2,1899
879,2019-10-09,150,0,660,2,812
879,2019-10-10,283,0,2272,0,2555
879,2019-10-11,367,0,1491,1,1859
879,2019-10-12,1242,0,1651,0,2893
879,2019-10-13,845,0,2259,3,3107
879,2019-10-14,1131,0,1368,0,2499
879,2019-10-15,269,0,2161,1,2431
879,2019-10-16,253,0,1596,1,1850
879,2019-10-17,1186,0,1604,0,2790
879,2019-10-18,482,0,832,0,1314
879,2019-10-19,1198,0,1828,0,3026
879,2019-10-20,1243,0,2331,0,3574
879,2019-10-21,923,0,872,2,1797
879,2019-10-22,320,0,2708,2,3030
879,2019-10-23,248,0,1507,1,1756
879,2019-10-24,309,0,1565,3,1877
879,2019-10-25,1155,0,1305,2,2462
879,2019-10-26,985,0,1358,0,2343
879,2019-10-27,1146,0,1516,0,2662
879,2019-10-28,251,0,1782,0,2033
879,2019-10-29,620,0,1724,3,2347
879,2019-10-30,772,0,1538,1,2311
879,2019-10-31,1183,0,2511,1,3695
879,2019-11-01,244,0,1231,0,1475
879,2019-11-02,437,0,982,0,1419
879,2019-11-03,602,0,1292,2,1896
879,2019-11-04,1099,0,1254,0,2353
879,2019-11-05,772,0,1671,0,2443
879,2019-11-06,269,0,1192,1,1462
879,2019-11-07,1161,0,1262,1,2424
879,2019-11-08,357,0,846,1,1204
879,2019-11-09,256,0,1315,0,1571
879,2019-11-10,303,0,2192,0,2495
879,2019-11-11,274,0,1384,1,1659
879,2019-11-12,288,0,2664,11,2963
879,2019-11-13,1425,0,2128,2,3555
879,2019-11-14,1150,0,2191,1,3342
879,2019-11-15,267,0,1962,0,2229
879,2019-11-16,1161,0,2119,0,3280
879,2019-11-17,1321,0,2166,1,3488
879,2019-11-18,278,0,2492,3,2773
879,2019-11-19,1231,0,1700,1,2932
879,2019-11-20,320,0,1993,0,2313
879,2019-11-21,296,0,1432,0,1728
879,2019-11-22,290,0,1503,2,1795
879,2019-11-23,1177,0,2516,2,3695
879,2019-11-24,773,0,1761,1,2535
879,2019-11-25,1447,0,1640,1,3088
879,2019-11-26,584,0,1314,0,1898
879,2019-11-27,266,0,1200,0,1466
879,2019-11-28,440,0,421,1,862
879,2019-11-29,142,0,2,0,144
879,2019-09-04,44,0,1052,0,1096
879,2019-09-05,1217,0,1349,0,2566
879,2019-09-06,453,0,1932,1,2386
879,2019-09-07,484,0,1878,0,2362
879,2019-09-08,493,0,1771,0,2264
879,2019-09-09,539,0,2452,1,2992
879,2019-09-10,335,0,1567,0,1902
879,2019-09-11,223,0,1375,2,1600
879,2019-09-12,254,0,1634,2,1890
879,2019-09-13,1402,0,1812,0,3214
879,2019-09-14,1240,0,2111,1,3352
879,2019-09-15,326,0,2071,1,2398
879,2019-09-16,492,0,2060,1,2553
879,2019-09-17,281,0,1629,0,1910
879,2019-09-18,589,0,1934,0,2523
879,2019-09-19,558,0,1804,0,2362
879,2019-09-20,380,0,2190,1,2571
879,2019-09-21,712,0,2340,0,3052
879,2019-09-22,265,0,2112,1,2378
879,2019-09-23,366,0,1633,0,1999
879,2019-09-24,420,0,1976,3,2399
879,2019-09-25,170,0,927,2,1099
879,2019-09-26,220,0,1458,1,1679
879,2019-09-27,147,0,2032,1,2180
879,2019-09-28,1057,0,2123,5,3185
879,2019-09-29,155,0,1583,3,1741
879,2019-09-30,144,0,1599,1,1744
879,2019-10-01,147,0,1478,1,1626
879,2019-10-02,209,0,1066,0,1275
879,2019-10-03,170,0,821,2,993
879,2019-10-04,207,0,1207,2,1416
879,2019-10-05,1305,0,1520,2,2827
879,2019-10-06,157,0,2224,0,2381
879,2019-10-07,415,0,1654,1,2070
879,2019-10-08,778,0,1119,2,1899
879,2019-10-09,150,0,660,2,812
879,2019-10-10,283,0,2272,0,2555
879,2019-10-11,367,0,1491,1,1859
879,2019-10-12,1242,0,1651,0,2893
879,2019-10-13,845,0,2259,3,3107
879,2019-10-14,1131,0,1368,0,2499
879,2019-10-15,269,0,2161,1,2431
879,2019-10-16,253,0,1596,1,1850
879,2019-10-17,1186,0,1604,0,2790
879,2019-10-18,482,0,832,0,1314
879,2019-10-19,1198,0,1828,0,3026
879,2019-10-20,1243,0,2331,0,3574
879,2019-10-21,923,0,872,2,1797
879,2019-10-22,320,0,2708,2,3030
879,2019-10-23,248,0,1507,1,1756
879,2019-10-24,309,0,1565,3,1877
879,2019-10-25,1155,0,1305,2,2462
879,2019-10-26,985,0,1358,0,2343
879,2019-10-27,1146,0,1516,0,2662
879,2019-10-28,251,0,1782,0,2033
879,2019-10-29,620,0,1724,3,2347
879,2019-10-30,772,0,1538,1,2311
879,2019-10-31,1183,0,2511,1,3695
879,2019-11-01,244,0,1231,0,1475
879,2019-11-02,437,0,982,0,1419
879,2019-11-03,602,0,1292,2,1896
879,2019-11-04,1099,0,1254,0,2353
879,2019-11-05,772,0,1671,0,2443
879,2019-11-06,269,0,1192,1,1462
879,2019-11-07,1161,0,1262,1,2424
879,2019-11-08,357,0,846,1,1204
879,2019-11-09,256,0,1315,0,1571
879,2019-11-10,303,0,2192,0,2495
879,2019-11-11,274,0,1384,1,1659
879,2019-11-12,288,0,2664,11,2963
879,2019-11-13,1425,0,2128,2,3555
879,2019-11-14,1150,0,2191,1,3342
879,2019-11-15,267,0,1962,0,2229
879,2019-11-16,1161,0,2119,0,3280
879,2019-11-17,1321,0,2166,1,3488
879,2019-11-18,278,0,2492,3,2773
879,2019-11-19,1231,0,1700,1,2932
879,2019-11-20,320,0,1993,0,2313
879,2019-11-21,296,0,1432,0,1728
879,2019-11-22,290,0,1503,2,1795
879,2019-11-23,1177,0,2516,2,3695
879,2019-11-24,773,0,1761,1,2535
879,2019-11-25,1447,0,1640,1,3088
879,2019-11-26,584,0,1314,0,1898
879,2019-11-27,266,0,1200,0,1466
879,2019-11-28,440,0,421,1,862
879,2019-11-29,142,0,2,0,144
879,2019-09-06,453,0,1932,1,2386
879,2019-09-07,484,0,1878,0,2362
879,2019-09-08,493,0,1771,0,2264
879,2019-09-09,539,0,2452,1,2992
879,2019-09-10,335,0,1567,0,1902
879,2019-09-11,223,0,1375,2,1600
879,2019-09-12,254,0,1634,2,1890
879,2019-09-13,1402,0,1812,0,3214
879,2019-09-14,1240,0,2111,1,3352
879,2019-09-15,326,0,2071,1,2398
879,2019-09-16,492,0,2060,1,2553
879,2019-09-17,281,0,1629,0,1910
879,2019-09-18,589,0,1934,0,2523
879,2019-09-19,558,0,1804,0,2362
879,2019-09-20,380,0,2190,1,2571
879,2019-09-21,712,0,2340,0,3052
879,2019-09-22,265,0,2112,1,2378
879,2019-09-23,366,0,1633,0,1999
879,2019-09-24,420,0,1976,3,2399
879,2019-09-25,170,0,927,2,1099
879,2019-09-26,220,0,1458,1,1679
879,2019-09-27,147,0,2032,1,2180
879,2019-09-28,1057,0,2123,5,3185
879,2019-09-29,155,0,1583,3,1741
879,2019-09-30,144,0,1599,1,1744
879,2019-10-01,147,0,1478,1,1626
879,2019-10-02,209,0,1066,0,1275
879,2019-10-03,170,0,821,2,993
879,2019-10-04,207,0,1207,2,1416
879,2019-10-05,1305,0,1520,2,2827
879,2019-10-06,157,0,2224,0,2381
879,2019-10-07,415,0,1654,1,2070
879,2019-10-08,778,0,1119,2,1899
879,2019-10-09,150,0,660,2,812
879,2019-10-10,283,0,2272,0,2555
879,2019-10-11,367,0,1491,1,1859
879,2019-10-12,1242,0,1651,0,2893
879,2019-10-13,845,0,2259,3,3107
879,2019-10-14,1131,0,1368,0,2499
879,2019-10-15,269,0,2161,1,2431
879,2019-10-16,253,0,1596,1,1850
879,2019-10-17,1186,0,1604,0,2790
879,2019-10-18,482,0,832,0,1314
879,2019-10-19,1198,0,1828,0,3026
879,2019-10-20,1243,0,2331,0,3574
879,2019-10-21,923,0,872,2,1797
879,2019-10-22,320,0,2708,2,3030
879,2019-10-23,248,0,1507,1,1756
879,2019-10-24,309,0,1565,3,1877
879,2019-10-25,1155,0,1305,2,2462
879,2019-10-26,985,0,1358,0,2343
879,2019-10-27,1146,0,1516,0,2662
879,2019-10-28,251,0,1782,0,2033
879,2019-10-29,620,0,1724,3,2347
879,2019-10-30,772,0,1538,1,2311
879,2019-10-31,1183,0,2511,1,3695
879,2019-11-01,244,0,1231,0,1475
879,2019-11-02,437,0,982,0,1419
879,2019-11-03,602,0,1292,2,1896
879,2019-11-04,1099,0,1254,0,2353
879,2019-11-05,772,0,1671,0,2443
879,2019-11-06,269,0,1192,1,1462
879,2019-11-07,1161,0,1262,1,2424
879,2019-11-08,357,0,846,1,1204
879,2019-11-09,256,0,1315,0,1571
879,2019-11-10,303,0,2192,0,2495
879,2019-11-11,274,0,1384,1,1659
879,2019-11-12,288,0,2664,11,2963
879,2019-11-13,1425,0,2128,2,3555
879,2019-11-14,1150,0,2191,1,3342
879,2019-11-15,267,0,1962,0,2229
879,2019-11-16,1161,0,2119,0,3280
879,2019-11-17,1321,0,2166,1,3488
879,2019-11-18,278,0,2492,3,2773
879,2019-11-19,1231,0,1700,1,2932
879,2019-11-20,320,0,1993,0,2313
879,2019-11-21,296,0,1432,0,1728
879,2019-11-22,290,0,1503,2,1795
879,2019-11-23,1177,0,2516,2,3695
879,2019-11-24,773,0,1761,1,2535
879,2019-11-25,1447,0,1640,1,3088
879,2019-11-26,584,0,1314,0,1898
879,2019-11-27,266,0,1200,0,1466
879,2019-11-28,440,0,421,1,862
880,2019-09-04,33,0,762,1,796
880,2019-09-05,884,0,1680,1,2565
880,2019-09-06,149,0,2532,0,2681
880,2019-09-07,209,0,1404,0,1613
880,2019-09-08,1288,0,1867,1,3156
880,2019-09-09,170,0,937,1,1108
880,2019-09-10,190,0,2061,1,2252
880,2019-09-11,324,0,1826,2,2152
880,2019-09-12,361,0,1174,2,1537
880,2019-09-13,1060,0,1085,0,2145
880,2019-09-14,159,0,2495,0,2654
880,2019-09-15,1045,0,2555,1,3601
880,2019-09-16,169,0,1467,0,1636
880,2019-09-17,163,0,2430,0,2593
880,2019-09-18,578,0,1197,1,1776
880,2019-09-19,342,0,2160,0,2502
880,2019-09-20,245,0,2187,2,2434
880,2019-09-21,141,0,1711,1,1853
880,2019-09-22,127,0,1503,1,1631
880,2019-09-23,1680,0,1584,2,3266
880,2019-09-24,185,0,1906,3,2094
880,2019-09-25,1103,0,1866,1,2970
880,2019-09-26,207,0,1792,2,2001
880,2019-09-27,183,0,2125,3,2311
880,2019-09-28,252,0,1566,3,1821
880,2019-09-29,1003,0,1811,1,2815
880,2019-09-30,81,0,1612,1,1694
880,2019-10-01,132,0,1858,1,1991
880,2019-10-02,562,0,1499,0,2061
880,2019-10-03,963,0,1017,0,1980
880,2019-10-04,544,0,815,1,1360
880,2019-10-05,227,0,2251,0,2478
880,2019-10-06,205,0,1397,2,1604
880,2019-10-07,125,0,2295,0,2420
880,2019-10-08,1369,0,1574,0,2943
880,2019-10-09,224,0,1488,0,1712
880,2019-10-10,138,0,1371,0,1509
880,2019-10-11,107,0,1498,2,1607
880,2019-10-12,327,0,1956,0,2283
880,2019-10-13,1110,0,1422,1,2533
880,2019-10-14,139,0,1767,1,1907
880,2019-10-15,176,0,1506,0,1682
880,2019-10-16,165,0,1578,4,1747
880,2019-10-17,1010,0,2442,2,3454
880,2019-10-18,180,0,2040,0,2220
880,2019-10-19,1127,0,1592,0,2719
880,2019-10-20,184,0,1054,0,1238
880,2019-10-21,169,0,1228,4,1401
880,2019-10-22,163,0,1525,2,1690
880,2019-10-23,140,0,1561,1,1702
880,2019-10-24,136,0,1578,1,1715
880,2019-10-25,253,0,981,0,1234
880,2019-10-26,285,0,2854,0,3139
880,2019-10-27,215,0,2094,0,2309
880,2019-10-28,100,0,2576,0,2676
880,2019-10-29,220,0,2102,1,2323
880,2019-10-30,127,0,1799,0,1926
880,2019-10-31,75,0,1849,4,1928
880,2019-11-01,81,0,1283,0,1364
880,2019-11-02,130,0,1490,1,1621
880,2019-11-03,450,0,1300,0,1750
880,2019-11-04,776,0,1600,0,2376
880,2019-11-05,782,0,2155,0,2937
880,2019-11-06,177,0,1899,1,2077
880,2019-11-07,771,0,1502,3,2276
880,2019-11-08,524,0,1991,0,2515
880,2019-11-09,897,0,1964,1,2862
880,2019-11-10,135,0,1975,1,2111
880,2019-11-11,198,0,1105,4,1307
880,2019-11-12,445,0,2912,1,3358
880,2019-11-13,133,0,1795,3,1931
880,2019-11-14,127,0,2413,2,2542
880,2019-11-15,139,0,2027,0,2166
880,2019-11-16,1063,0,2616,1,3680
880,2019-11-17,1078,0,2221,0,3299
880,2019-11-18,696,0,2535,0,3231
880,2019-11-19,2029,0,1633,3,3665
880,2019-11-20,158,0,1703,1,1862
880,2019-11-21,1069,0,1593,0,2662
880,2019-11-22,221,0,889,2,1112
880,2019-11-23,571,0,2560,1,3132
880,2019-11-24,1216,0,1942,2,3160
880,2019-11-25,411,0,929,0,1340
880,2019-11-26,187,0,1236,1,1424
880,2019-11-27,111,0,1134,0,1245
880,2019-11-28,105,0,687,1,793
880,2019-11-29,65,0,1,0,66
880,2019-09-04,33,0,762,1,796
880,2019-09-05,884,0,1680,1,2565
880,2019-09-06,149,0,2532,0,2681
880,2019-09-07,209,0,1404,0,1613
880,2019-09-08,1288,0,1867,1,3156
880,2019-09-09,170,0,937,1,1108
880,2019-09-10,190,0,2061,1,2252
880,2019-09-11,324,0,1826,2,2152
880,2019-09-12,361,0,1174,2,1537
880,2019-09-13,1060,0,1085,0,2145
880,2019-09-14,159,0,2495,0,2654
880,2019-09-15,1045,0,2555,1,3601
880,2019-09-16,169,0,1467,0,1636
880,2019-09-17,163,0,2430,0,2593
880,2019-09-18,578,0,1197,1,1776
880,2019-09-19,342,0,2160,0,2502
880,2019-09-20,245,0,2187,2,2434
880,2019-09-21,141,0,1711,1,1853
880,2019-09-22,127,0,1503,1,1631
880,2019-09-23,1680,0,1584,2,3266
880,2019-09-24,185,0,1906,3,2094
880,2019-09-25,1103,0,1866,1,2970
880,2019-09-26,207,0,1792,2,2001
880,2019-09-27,183,0,2125,3,2311
880,2019-09-28,252,0,1566,3,1821
880,2019-09-29,1003,0,1811,1,2815
880,2019-09-30,81,0,1612,1,1694
880,2019-10-01,132,0,1858,1,1991
880,2019-10-02,562,0,1499,0,2061
880,2019-10-03,963,0,1017,0,1980
880,2019-10-04,544,0,815,1,1360
880,2019-10-05,227,0,2251,0,2478
880,2019-10-06,205,0,1397,2,1604
880,2019-10-07,125,0,2295,0,2420
880,2019-10-08,1369,0,1574,0,2943
880,2019-10-09,224,0,1488,0,1712
880,2019-10-10,138,0,1371,0,1509
880,2019-10-11,107,0,1498,2,1607
880,2019-10-12,327,0,1956,0,2283
880,2019-10-13,1110,0,1422,1,2533
880,2019-10-14,139,0,1767,1,1907
880,2019-10-15,176,0,1506,0,1682
880,2019-10-16,165,0,1578,4,1747
880,2019-10-17,1010,0,2442,2,3454
880,2019-10-18,180,0,2040,0,2220
880,2019-10-19,1127,0,1592,0,2719
880,2019-10-20,184,0,1054,0,1238
880,2019-10-21,169,0,1228,4,1401
880,2019-10-22,163,0,1525,2,1690
880,2019-10-23,140,0,1561,1,1702
880,2019-10-24,136,0,1578,1,1715
880,2019-10-25,253,0,981,0,1234
880,2019-10-26,285,0,2854,0,3139
880,2019-10-27,215,0,2094,0,2309
880,2019-10-28,100,0,2576,0,2676
880,2019-10-29,220,0,2102,1,2323
880,2019-10-30,127,0,1799,0,1926
880,2019-10-31,75,0,1849,4,1928
880,2019-11-01,81,0,1283,0,1364
880,2019-11-02,130,0,1490,1,1621
880,2019-11-03,450,0,1300,0,1750
880,2019-11-04,776,0,1600,0,2376
880,2019-11-05,782,0,2155,0,2937
880,2019-11-06,177,0,1899,1,2077
880,2019-11-07,771,0,1502,3,2276
880,2019-11-08,524,0,1991,0,2515
880,2019-11-09,897,0,1964,1,2862
880,2019-11-10,135,0,1975,1,2111
880,2019-11-11,198,0,1105,4,1307
880,2019-11-12,445,0,2912,1,3358
880,2019-11-13,133,0,1795,3,1931
880,2019-11-14,127,0,2413,2,2542
880,2019-11-15,139,0,2027,0,2166
880,2019-11-16,1063,0,2616,1,3680
880,2019-11-17,1078,0,2221,0,3299
880,2019-11-18,696,0,2535,0,3231
880,2019-11-19,2029,0,1633,3,3665
880,2019-11-20,158,0,1703,1,1862
880,2019-11-21,1069,0,1593,0,2662
880,2019-11-22,221,0,889,2,1112
880,2019-11-23,571,0,2560,1,3132
880,2019-11-24,1216,0,1942,2,3160
880,2019-11-25,411,0,929,0,1340
880,2019-11-26,187,0,1236,1,1424
880,2019-11-27,111,0,1134,0,1245
880,2019-11-28,105,0,687,1,793
880,2019-11-29,65,0,1,0,66
880,2019-09-04,33,0,762,1,796
880,2019-09-05,884,0,1680,1,2565
880,2019-09-06,149,0,2532,0,2681
880,2019-09-07,209,0,1404,0,1613
880,2019-09-08,1288,0,1867,1,3156
880,2019-09-09,170,0,937,1,1108
880,2019-09-10,190,0,2061,1,2252
880,2019-09-11,324,0,1826,2,2152
880,2019-09-12,361,0,1174,2,1537
880,2019-09-13,1060,0,1085,0,2145
880,2019-09-14,159,0,2495,0,2654
880,2019-09-15,1045,0,2555,1,3601
880,2019-09-16,169,0,1467,0,1636
880,2019-09-17,163,0,2430,0,2593
880,2019-09-18,578,0,1197,1,1776
880,2019-09-19,342,0,2160,0,2502
880,2019-09-20,245,0,2187,2,2434
880,2019-09-21,141,0,1711,1,1853
880,2019-09-22,127,0,1503,1,1631
880,2019-09-23,1680,0,1584,2,3266
880,2019-09-24,185,0,1906,3,2094
880,2019-09-25,1103,0,1866,1,2970
880,2019-09-26,207,0,1792,2,2001
880,2019-09-27,183,0,2125,3,2311
880,2019-09-28,252,0,1566,3,1821
880,2019-09-29,1003,0,1811,1,2815
880,2019-09-30,81,0,1612,1,1694
880,2019-10-01,132,0,1858,1,1991
880,2019-10-02,562,0,1499,0,2061
880,2019-10-03,963,0,1017,0,1980
880,2019-10-04,544,0,815,1,1360
880,2019-10-05,227,0,2251,0,2478
880,2019-10-06,205,0,1397,2,1604
880,2019-10-07,125,0,2295,0,2420
880,2019-10-08,1369,0,1574,0,2943
880,2019-10-09,224,0,1488,0,1712
880,2019-10-10,138,0,1371,0,1509
880,2019-10-11,107,0,1498,2,1607
880,2019-10-12,327,0,1956,0,2283
880,2019-10-13,1110,0,1422,1,2533
880,2019-10-14,139,0,1767,1,1907
880,2019-10-15,176,0,1506,0,1682
880,2019-10-16,165,0,1578,4,1747
880,2019-10-17,1010,0,2442,2,3454
880,2019-10-18,180,0,2040,0,2220
880,2019-10-19,1127,0,1592,0,2719
880,2019-10-20,184,0,1054,0,1238
880,2019-10-21,169,0,1228,4,1401
880,2019-10-22,163,0,1525,2,1690
880,2019-10-23,140,0,1561,1,1702
880,2019-10-24,136,0,1578,1,1715
880,2019-10-25,253,0,981,0,1234
880,2019-10-26,285,0,2854,0,3139
880,2019-10-27,215,0,2094,0,2309
880,2019-10-28,100,0,2576,0,2676
880,2019-10-29,220,0,2102,1,2323
880,2019-10-30,127,0,1799,0,1926
880,2019-10-31,75,0,1849,4,1928
880,2019-11-01,81,0,1283,0,1364
880,2019-11-02,130,0,1490,1,1621
880,2019-11-03,450,0,1300,0,1750
880,2019-11-04,776,0,1600,0,2376
880,2019-11-05,782,0,2155,0,2937
880,2019-11-06,177,0,1899,1,2077
880,2019-11-07,771,0,1502,3,2276
880,2019-11-08,524,0,1991,0,2515
880,2019-11-09,897,0,1964,1,2862
880,2019-11-10,135,0,1975,1,2111
880,2019-11-11,198,0,1105,4,1307
880,2019-11-12,445,0,2912,1,3358
880,2019-11-13,133,0,1795,3,1931
880,2019-11-14,127,0,2413,2,2542
880,2019-11-15,139,0,2027,0,2166
880,2019-11-16,1063,0,2616,1,3680
880,2019-11-17,1078,0,2221,0,3299
880,2019-11-18,696,0,2535,0,3231
880,2019-11-19,2029,0,1633,3,3665
880,2019-11-20,158,0,1703,1,1862
880,2019-11-21,1069,0,1593,0,2662
880,2019-11-22,221,0,889,2,1112
880,2019-11-23,571,0,2560,1,3132
880,2019-11-24,1216,0,1942,2,3160
880,2019-11-25,411,0,929,0,1340
880,2019-11-26,187,0,1236,1,1424
880,2019-11-27,111,0,1134,0,1245
880,2019-11-28,105,0,687,1,793
881,2019-09-04,11,0,941,0,952
881,2019-09-05,1794,0,2225,1,4020
881,2019-09-06,190,0,2515,1,2706
881,2019-09-07,143,0,2349,0,2492
881,2019-09-08,1156,0,2634,0,3790
881,2019-09-09,131,0,2344,1,2476
881,2019-09-10,1885,0,2279,0,4164
881,2019-09-11,143,0,3161,3,3307
881,2019-09-12,979,0,2358,2,3339
881,2019-09-13,134,0,2225,1,2360
881,2019-09-14,125,0,1985,0,2110
881,2019-09-15,1751,0,2106,3,3860
881,2019-09-16,136,0,2071,0,2207
881,2019-09-17,85,0,2185,0,2270
881,2019-09-18,879,0,1015,0,1894
881,2019-09-19,370,0,1356,1,1727
881,2019-09-20,275,0,984,1,1260
881,2019-09-21,995,0,1599,1,2595
881,2019-09-22,1549,0,2263,0,3812
881,2019-09-23,180,0,1443,2,1625
881,2019-09-24,2016,0,1526,4,3546
881,2019-09-25,71,0,1386,3,1460
881,2019-09-26,56,0,1497,1,1554
881,2019-09-27,157,0,1746,3,1906
881,2019-09-28,134,0,1485,1,1620
881,2019-09-29,44,0,1892,0,1936
881,2019-09-30,857,0,1630,3,2490
881,2019-10-01,938,0,2076,1,3015
881,2019-10-02,469,0,2223,1,2693
881,2019-10-03,87,0,1554,1,1642
881,2019-10-04,963,0,1405,0,2368
881,2019-10-05,551,0,518,2,1071
881,2019-10-06,47,0,4087,2,4136
881,2019-10-07,1822,0,3353,1,5176
881,2019-10-08,926,0,1729,1,2656
881,2019-10-09,75,0,1791,4,1870
881,2019-10-10,91,0,2367,3,2461
881,2019-10-11,934,0,2360,0,3294
881,2019-10-12,886,0,2436,1,3323
881,2019-10-13,46,0,2285,0,2331
881,2019-10-14,60,0,1775,1,1836
881,2019-10-15,172,0,1305,3,1480
881,2019-10-16,36,0,1736,2,1774
881,2019-10-17,918,0,1596,1,2515
881,2019-10-18,73,0,1721,2,1796
881,2019-10-19,924,0,1127,0,2051
881,2019-10-20,1039,0,2280,2,3321
881,2019-10-21,721,0,1675,1,2397
881,2019-10-22,56,0,1843,1,1900
881,2019-10-23,894,0,2108,1,3003
881,2019-10-24,79,0,1279,1,1359
881,2019-10-25,1859,0,956,2,2817
881,2019-10-26,48,0,1597,2,1647
881,2019-10-27,400,0,1403,0,1803
881,2019-10-28,45,0,944,0,989
881,2019-10-29,859,0,1175,2,2036
881,2019-10-30,27,0,1287,2,1316
881,2019-10-31,404,0,1753,0,2157
881,2019-11-01,909,0,1257,0,2166
881,2019-11-02,135,0,2316,0,2451
881,2019-11-03,59,0,1371,1,1431
881,2019-11-04,73,0,1495,2,1570
881,2019-11-05,1859,0,1541,0,3400
881,2019-11-06,59,0,1293,2,1354
881,2019-11-07,148,0,804,2,954
881,2019-11-08,420,0,921,0,1341
881,2019-11-09,633,0,1249,2,1884
881,2019-11-10,69,0,1883,1,1953
881,2019-11-11,75,0,2287,1,2363
881,2019-11-12,62,0,2583,1,2646
881,2019-11-13,1064,0,1824,0,2888
881,2019-11-14,2077,0,2069,4,4150
881,2019-11-15,89,0,2197,0,2286
881,2019-11-16,731,0,1911,0,2642
881,2019-11-17,133,0,2324,0,2457
881,2019-11-18,150,0,2380,0,2530
881,2019-11-19,88,0,2701,0,2789
881,2019-11-20,80,0,1459,0,1539
881,2019-11-21,161,0,1564,0,1725
881,2019-11-22,273,0,1761,0,2034
881,2019-11-23,43,0,2271,0,2314
881,2019-11-24,148,0,1737,0,1885
881,2019-11-25,52,0,1541,0,1593
881,2019-11-26,958,0,1348,0,2306
881,2019-11-27,711,0,1545,0,2256
881,2019-11-28,39,0,678,0,717
881,2019-09-04,11,0,941,0,952
881,2019-09-05,1794,0,2225,1,4020
881,2019-09-06,190,0,2515,1,2706
881,2019-09-07,143,0,2349,0,2492
881,2019-09-08,1156,0,2634,0,3790
881,2019-09-09,131,0,2344,1,2476
881,2019-09-10,1885,0,2279,0,4164
881,2019-09-11,143,0,3161,3,3307
881,2019-09-12,979,0,2358,2,3339
881,2019-09-13,134,0,2225,1,2360
881,2019-09-14,125,0,1985,0,2110
881,2019-09-15,1751,0,2106,3,3860
881,2019-09-16,136,0,2071,0,2207
881,2019-09-17,85,0,2185,0,2270
881,2019-09-18,879,0,1015,0,1894
881,2019-09-19,370,0,1356,1,1727
881,2019-09-20,275,0,984,1,1260
881,2019-09-21,995,0,1599,1,2595
881,2019-09-22,1549,0,2263,0,3812
881,2019-09-23,180,0,1443,2,1625
881,2019-09-24,2016,0,1526,4,3546
881,2019-09-25,71,0,1386,3,1460
881,2019-09-26,56,0,1497,1,1554
881,2019-09-27,157,0,1746,3,1906
881,2019-09-28,134,0,1485,1,1620
881,2019-09-29,44,0,1892,0,1936
881,2019-09-30,857,0,1630,3,2490
881,2019-10-01,938,0,2076,1,3015
881,2019-10-02,469,0,2223,1,2693
881,2019-10-03,87,0,1554,1,1642
881,2019-10-04,963,0,1405,0,2368
881,2019-10-05,551,0,518,2,1071
881,2019-10-06,47,0,4087,2,4136
881,2019-10-07,1822,0,3353,1,5176
881,2019-10-08,926,0,1729,1,2656
881,2019-10-09,75,0,1791,4,1870
881,2019-10-10,91,0,2367,3,2461
881,2019-10-11,934,0,2360,0,3294
881,2019-10-12,886,0,2436,1,3323
881,2019-10-13,46,0,2285,0,2331
881,2019-10-14,60,0,1775,1,1836
881,2019-10-15,172,0,1305,3,1480
881,2019-10-16,36,0,1736,2,1774
881,2019-10-17,918,0,1596,1,2515
881,2019-10-18,73,0,1721,2,1796
881,2019-10-19,924,0,1127,0,2051
881,2019-10-20,1039,0,2280,2,3321
881,2019-10-21,721,0,1675,1,2397
881,2019-10-22,56,0,1843,1,1900
881,2019-10-23,894,0,2108,1,3003
881,2019-10-24,79,0,1279,1,1359
881,2019-10-25,1859,0,956,2,2817
881,2019-10-26,48,0,1597,2,1647
881,2019-10-27,400,0,1403,0,1803
881,2019-10-28,45,0,944,0,989
881,2019-10-29,859,0,1175,2,2036
881,2019-10-30,27,0,1287,2,1316
881,2019-10-31,404,0,1753,0,2157
881,2019-11-01,909,0,1257,0,2166
881,2019-11-02,135,0,2316,0,2451
881,2019-11-03,59,0,1371,1,1431
881,2019-11-04,73,0,1495,2,1570
881,2019-11-05,1859,0,1541,0,3400
881,2019-11-06,59,0,1293,2,1354
881,2019-11-07,148,0,804,2,954
881,2019-11-08,420,0,921,0,1341
881,2019-11-09,633,0,1249,2,1884
881,2019-11-10,69,0,1883,1,1953
881,2019-11-11,75,0,2287,1,2363
881,2019-11-12,62,0,2583,1,2646
881,2019-11-13,1064,0,1824,0,2888
881,2019-11-14,2077,0,2069,4,4150
881,2019-11-15,89,0,2197,0,2286
881,2019-11-16,731,0,1911,0,2642
881,2019-11-17,133,0,2324,0,2457
881,2019-11-18,150,0,2380,0,2530
881,2019-11-19,88,0,2701,0,2789
881,2019-11-20,80,0,1459,0,1539
881,2019-11-21,161,0,1564,0,1725
881,2019-11-22,273,0,1761,0,2034
881,2019-11-23,43,0,2271,0,2314
881,2019-11-24,148,0,1737,0,1885
881,2019-11-25,52,0,1541,0,1593
881,2019-11-26,958,0,1348,0,2306
881,2019-11-27,711,0,1545,0,2256
881,2019-11-28,39,0,678,0,717
881,2019-09-05,1794,0,2225,1,4020
881,2019-09-06,190,0,2515,1,2706
881,2019-09-07,143,0,2349,0,2492
881,2019-09-08,1156,0,2634,0,3790
881,2019-09-09,131,0,2344,1,2476
881,2019-09-10,1885,0,2279,0,4164
881,2019-09-11,143,0,3161,3,3307
881,2019-09-12,979,0,2358,2,3339
881,2019-09-13,134,0,2225,1,2360
881,2019-09-14,125,0,1985,0,2110
881,2019-09-15,1751,0,2106,3,3860
881,2019-09-16,136,0,2071,0,2207
881,2019-09-17,85,0,2185,0,2270
881,2019-09-18,879,0,1015,0,1894
881,2019-09-19,370,0,1356,1,1727
881,2019-09-20,275,0,984,1,1260
881,2019-09-21,995,0,1599,1,2595
881,2019-09-22,1549,0,2263,0,3812
881,2019-09-23,180,0,1443,2,1625
881,2019-09-24,2016,0,1526,4,3546
881,2019-09-25,71,0,1386,3,1460
881,2019-09-26,56,0,1497,1,1554
881,2019-09-27,157,0,1746,3,1906
881,2019-09-28,134,0,1485,1,1620
881,2019-09-29,44,0,1892,0,1936
881,2019-09-30,857,0,1630,3,2490
881,2019-10-01,938,0,2076,1,3015
881,2019-10-02,469,0,2223,1,2693
881,2019-10-03,87,0,1554,1,1642
881,2019-10-04,963,0,1405,0,2368
881,2019-10-05,551,0,518,2,1071
881,2019-10-06,47,0,4087,2,4136
881,2019-10-07,1822,0,3353,1,5176
881,2019-10-08,926,0,1729,1,2656
881,2019-10-09,75,0,1791,4,1870
881,2019-10-10,91,0,2367,3,2461
881,2019-10-11,934,0,2360,0,3294
881,2019-10-12,886,0,2436,1,3323
881,2019-10-13,46,0,2285,0,2331
881,2019-10-14,60,0,1775,1,1836
881,2019-10-15,172,0,1305,3,1480
881,2019-10-16,36,0,1736,2,1774
881,2019-10-17,918,0,1596,1,2515
881,2019-10-18,73,0,1721,2,1796
881,2019-10-19,924,0,1127,0,2051
881,2019-10-20,1039,0,2280,2,3321
881,2019-10-21,721,0,1675,1,2397
881,2019-10-22,56,0,1843,1,1900
881,2019-10-23,894,0,2108,1,3003
881,2019-10-24,79,0,1279,1,1359
881,2019-10-25,1859,0,956,2,2817
881,2019-10-26,48,0,1597,2,1647
881,2019-10-27,400,0,1403,0,1803
881,2019-10-28,45,0,944,0,989
881,2019-10-29,859,0,1175,2,2036
881,2019-10-30,27,0,1287,2,1316
881,2019-10-31,404,0,1753,0,2157
881,2019-11-01,909,0,1257,0,2166
881,2019-11-02,135,0,2316,0,2451
881,2019-11-03,59,0,1371,1,1431
881,2019-11-04,73,0,1495,2,1570
881,2019-11-05,1859,0,1541,0,3400
881,2019-11-06,59,0,1293,2,1354
881,2019-11-07,148,0,804,2,954
881,2019-11-08,420,0,921,0,1341
881,2019-11-09,633,0,1249,2,1884
881,2019-11-10,69,0,1883,1,1953
881,2019-11-11,75,0,2287,1,2363
881,2019-11-12,62,0,2583,1,2646
881,2019-11-13,1064,0,1824,0,2888
881,2019-11-14,2077,0,2069,4,4150
883,2019-09-05,163,1574,1686,0,3423
883,2019-09-06,1028,10422,2090,2,13542
883,2019-09-07,289,7515,1718,0,9522
883,2019-09-08,286,5873,1896,0,8055
883,2019-09-09,118,9171,1019,0,10308
883,2019-09-10,219,11860,2169,2,14250
883,2019-09-11,232,9017,1791,3,11043
883,2019-09-12,971,5649,2417,231,9268
883,2019-09-13,961,4568,2970,0,8499
883,2019-09-14,1023,6499,2104,0,9626
883,2019-09-15,198,11090,1801,1,13090
883,2019-09-16,1128,16240,1897,1,19266
883,2019-09-17,264,14944,1914,3,17125
883,2019-09-18,95,11472,1027,1,12595
883,2019-09-19,357,8242,1692,1,10292
883,2019-09-20,340,8691,1447,0,10478
883,2019-09-21,1022,7075,1768,1,9866
883,2019-09-22,352,14683,2364,2,17401
883,2019-09-23,580,10628,1962,2,13172
883,2019-09-24,347,9728,3284,4,13363
883,2019-09-25,1044,9486,1966,1,12497
883,2019-09-26,163,9656,1775,1,11595
883,2019-09-27,297,9931,1803,3,12034
883,2019-09-28,174,15323,1390,2,16889
883,2019-09-29,87,18347,1666,3,20103
883,2019-09-30,130,18034,1119,1,19284
883,2019-10-01,177,16597,1391,0,18165
883,2019-10-02,155,13265,2346,0,15766
883,2019-10-03,151,14602,1622,1,16376
883,2019-10-04,100,19013,2095,1,21209
883,2019-10-05,948,23561,1597,1,26107
883,2019-10-06,2211,16999,1795,1,21006
883,2019-10-07,1975,6757,1470,3,10205
883,2019-10-08,2897,18027,1558,0,22482
883,2019-10-09,1039,17452,1757,1,20249
883,2019-10-10,659,11551,1818,0,14028
883,2019-10-11,142,17665,2127,1,19935
883,2019-10-12,190,9628,2236,3,12057
883,2019-10-13,1836,12884,2258,1,16979
883,2019-10-14,225,7158,1647,1,9031
883,2019-10-15,1820,8495,2223,1,12539
883,2019-10-16,473,24040,1190,1,25704
883,2019-10-17,207,11507,1599,3,13316
883,2019-10-18,816,14798,1396,1,17011
883,2019-10-19,238,8813,1522,0,10573
883,2019-10-20,209,2815,2601,1,5626
883,2019-10-21,243,11016,1434,2,12695
883,2019-10-22,468,6553,2346,2,9369
883,2019-10-23,236,8868,1803,1,10908
883,2019-10-24,1056,13702,1512,0,16270
883,2019-10-25,1592,11106,1002,2,13702
883,2019-10-26,217,13803,1388,713,16121
883,2019-10-27,754,16798,2000,2,19554
883,2019-10-28,1040,23583,1422,1,26046
883,2019-10-29,228,18130,1266,0,19624
883,2019-10-30,273,16044,1031,1,17349
883,2019-10-31,189,12711,2014,1,14915
883,2019-11-01,105,15635,2242,3,17985
883,2019-11-02,487,14682,812,0,15981
883,2019-11-03,167,22935,989,0,24091
883,2019-11-04,385,8156,1754,0,10295
883,2019-11-05,1078,3493,1339,2,5912
883,2019-11-06,556,8626,1579,3,10764
883,2019-11-07,952,23205,1503,4,25664
883,2019-11-08,184,12236,1466,0,13886
883,2019-11-09,1106,9316,2297,3350,16069
883,2019-11-10,654,24486,2198,0,27338
883,2019-11-11,138,16739,1565,0,18442
883,2019-11-12,158,23260,2792,0,26210
883,2019-11-13,220,14997,1379,0,16596
883,2019-11-14,441,8488,1786,0,10715
883,2019-11-15,100,3777,2094,0,5971
883,2019-11-16,590,2654,2484,0,5728
883,2019-11-17,63,4221,3918,0,8202
883,2019-11-18,165,2741,2798,0,5704
883,2019-11-19,151,3129,2658,0,5938
883,2019-11-20,112,1338,1997,0,3447
883,2019-11-21,98,5549,1821,0,7468
883,2019-11-22,114,5296,1339,0,6749
883,2019-11-23,106,9696,2551,0,12353
883,2019-11-24,177,8741,1223,0,10141
883,2019-11-25,60,10420,1440,0,11920
883,2019-11-26,381,8460,878,0,9719
883,2019-11-27,199,11012,1677,0,12888
883,2019-11-28,98,12104,553,0,12755
883,2019-11-29,23,625,92,0,740
883,2019-09-05,163,1574,1686,0,3423
883,2019-09-06,1028,10422,2090,2,13542
883,2019-09-07,289,7515,1718,0,9522
883,2019-09-08,286,5873,1896,0,8055
883,2019-09-09,118,9171,1019,0,10308
883,2019-09-10,219,11860,2169,2,14250
883,2019-09-11,232,9017,1791,3,11043
883,2019-09-12,971,5649,2417,231,9268
883,2019-09-13,961,4568,2970,0,8499
883,2019-09-14,1023,6499,2104,0,9626
883,2019-09-15,198,11090,1801,1,13090
883,2019-09-16,1128,16240,1897,1,19266
883,2019-09-17,264,14944,1914,3,17125
883,2019-09-18,95,11472,1027,1,12595
883,2019-09-19,357,8242,1692,1,10292
883,2019-09-20,340,8691,1447,0,10478
883,2019-09-21,1022,7075,1768,1,9866
883,2019-09-22,352,14683,2364,2,17401
883,2019-09-23,580,10628,1962,2,13172
883,2019-09-24,347,9728,3284,4,13363
883,2019-09-25,1044,9486,1966,1,12497
883,2019-09-26,163,9656,1775,1,11595
883,2019-09-27,297,9931,1803,3,12034
883,2019-09-28,174,15323,1390,2,16889
883,2019-09-29,87,18347,1666,3,20103
883,2019-09-30,130,18034,1119,1,19284
883,2019-10-01,177,16597,1391,0,18165
883,2019-10-02,155,13265,2346,0,15766
883,2019-10-03,151,14602,1622,1,16376
883,2019-10-04,100,19013,2095,1,21209
883,2019-10-05,948,23561,1597,1,26107
883,2019-10-06,2211,16999,1795,1,21006
883,2019-10-07,1975,6757,1470,3,10205
883,2019-10-08,2897,18027,1558,0,22482
883,2019-10-09,1039,17452,1757,1,20249
883,2019-10-10,659,11551,1818,0,14028
883,2019-10-11,142,17665,2127,1,19935
883,2019-10-12,190,9628,2236,3,12057
883,2019-10-13,1836,12884,2258,1,16979
883,2019-10-14,225,7158,1647,1,9031
883,2019-10-15,1820,8495,2223,1,12539
883,2019-10-16,473,24040,1190,1,25704
883,2019-10-17,207,11507,1599,3,13316
883,2019-10-18,816,14798,1396,1,17011
883,2019-10-19,238,8813,1522,0,10573
883,2019-10-20,209,2815,2601,1,5626
883,2019-10-21,243,11016,1434,2,12695
883,2019-10-22,468,6553,2346,2,9369
883,2019-10-23,236,8868,1803,1,10908
883,2019-10-24,1056,13702,1512,0,16270
883,2019-10-25,1592,11106,1002,2,13702
883,2019-10-26,217,13803,1388,713,16121
883,2019-10-27,754,16798,2000,2,19554
883,2019-10-28,1040,23583,1422,1,26046
883,2019-10-29,228,18130,1266,0,19624
883,2019-10-30,273,16044,1031,1,17349
883,2019-10-31,189,12711,2014,1,14915
883,2019-11-01,105,15635,2242,3,17985
883,2019-11-02,487,14682,812,0,15981
883,2019-11-03,167,22935,989,0,24091
883,2019-11-04,385,8156,1754,0,10295
883,2019-11-05,1078,3493,1339,2,5912
883,2019-11-06,556,8626,1579,3,10764
883,2019-11-07,952,23205,1503,4,25664
883,2019-11-08,184,12236,1466,0,13886
883,2019-11-09,1106,9316,2297,3350,16069
883,2019-11-10,654,24486,2198,0,27338
883,2019-11-11,138,16739,1565,0,18442
883,2019-11-12,158,23260,2792,0,26210
883,2019-11-13,220,14997,1379,0,16596
883,2019-11-14,441,8488,1786,0,10715
883,2019-11-15,100,3777,2094,0,5971
883,2019-11-16,590,2654,2484,0,5728
883,2019-11-17,63,4221,3918,0,8202
883,2019-11-18,165,2741,2798,0,5704
883,2019-11-19,151,3129,2658,0,5938
883,2019-11-20,112,1338,1997,0,3447
883,2019-11-21,98,5549,1821,0,7468
883,2019-11-22,114,5296,1339,0,6749
883,2019-11-23,106,9696,2551,0,12353
883,2019-11-24,177,8741,1223,0,10141
883,2019-11-25,60,10420,1440,0,11920
883,2019-11-26,381,8460,878,0,9719
883,2019-11-27,199,11012,1677,0,12888
883,2019-11-28,98,12104,553,0,12755
883,2019-11-29,23,625,92,0,740
883,2019-09-04,0,0,180,0,180
883,2019-09-05,163,1574,1686,0,3423
883,2019-09-06,1028,10422,2090,2,13542
883,2019-09-07,289,7515,1718,0,9522
883,2019-09-08,286,5873,1896,0,8055
883,2019-09-09,118,9171,1019,0,10308
883,2019-09-10,219,11860,2169,2,14250
883,2019-09-11,232,9017,1791,3,11043
883,2019-09-12,971,5649,2417,231,9268
883,2019-09-13,961,4568,2970,0,8499
883,2019-09-14,1023,6499,2104,0,9626
883,2019-09-15,198,11090,1801,1,13090
883,2019-09-16,1128,16240,1897,1,19266
883,2019-09-17,264,14944,1914,3,17125
883,2019-09-18,95,11472,1027,1,12595
883,2019-09-19,357,8242,1692,1,10292
883,2019-09-20,340,8691,1447,0,10478
883,2019-09-21,1022,7075,1768,1,9866
883,2019-09-22,352,14683,2364,2,17401
883,2019-09-23,580,10628,1962,2,13172
883,2019-09-24,347,9728,3284,4,13363
883,2019-09-25,1044,9486,1966,1,12497
883,2019-09-26,163,9656,1775,1,11595
883,2019-09-27,297,9931,1803,3,12034
883,2019-09-28,174,15323,1390,2,16889
883,2019-09-29,87,18347,1666,3,20103
883,2019-09-30,130,18034,1119,1,19284
883,2019-10-01,177,16597,1391,0,18165
883,2019-10-02,155,13265,2346,0,15766
883,2019-10-03,151,14602,1622,1,16376
883,2019-10-04,100,19013,2095,1,21209
883,2019-10-05,948,23561,1597,1,26107
883,2019-10-06,2211,16999,1795,1,21006
883,2019-10-07,1975,6757,1470,3,10205
883,2019-10-08,2897,18027,1558,0,22482
883,2019-10-09,1039,17452,1757,1,20249
883,2019-10-10,659,11551,1818,0,14028
883,2019-10-11,142,17665,2127,1,19935
883,2019-10-12,190,9628,2236,3,12057
883,2019-10-13,1836,12884,2258,1,16979
883,2019-10-14,225,7158,1647,1,9031
883,2019-10-15,1820,8495,2223,1,12539
883,2019-10-16,473,24040,1190,1,25704
883,2019-10-17,207,11507,1599,3,13316
883,2019-10-18,816,14798,1396,1,17011
883,2019-10-19,238,8813,1522,0,10573
883,2019-10-20,209,2815,2601,1,5626
883,2019-10-21,243,11016,1434,2,12695
883,2019-10-22,468,6553,2346,2,9369
883,2019-10-23,236,8868,1803,1,10908
883,2019-10-24,1056,13702,1512,0,16270
883,2019-10-25,1592,11106,1002,2,13702
883,2019-10-26,217,13803,1388,713,16121
883,2019-10-27,754,16798,2000,2,19554
883,2019-10-28,1040,23583,1422,1,26046
883,2019-10-29,228,18130,1266,0,19624
883,2019-10-30,273,16044,1031,1,17349
883,2019-10-31,189,12711,2014,1,14915
883,2019-11-01,105,15635,2242,3,17985
883,2019-11-02,487,14682,812,0,15981
883,2019-11-03,167,22935,989,0,24091
883,2019-11-04,385,8156,1754,0,10295
883,2019-11-05,1078,3493,1339,2,5912
883,2019-11-06,556,8626,1579,3,10764
883,2019-11-07,952,23205,1503,4,25664
883,2019-11-08,184,12236,1466,0,13886
883,2019-11-09,1106,9316,2297,3350,16069
883,2019-11-10,654,24486,2198,0,27338
883,2019-11-11,138,16739,1565,0,18442
883,2019-11-12,158,23260,2792,0,26210
883,2019-11-13,220,14997,1379,0,16596
883,2019-11-14,441,8488,1786,0,10715
883,2019-11-15,100,3777,2094,0,5971
883,2019-11-16,590,2654,2484,0,5728
883,2019-11-17,63,4221,3918,0,8202
883,2019-11-18,165,2741,2798,0,5704
883,2019-11-19,151,3129,2658,0,5938
883,2019-11-20,112,1338,1997,0,3447
883,2019-11-21,98,5549,1821,0,7468
883,2019-11-22,114,5296,1339,0,6749
883,2019-11-23,106,9696,2551,0,12353
883,2019-11-24,177,8741,1223,0,10141
883,2019-11-25,60,10420,1440,0,11920
883,2019-11-26,381,8460,878,0,9719
883,2019-11-27,199,11012,1677,0,12888
883,2019-11-28,98,12104,553,0,12755
883,2019-11-29,23,625,92,0,740
883,2019-09-06,1028,10422,2090,2,13542
883,2019-09-07,289,7515,1718,0,9522
883,2019-09-08,286,5873,1896,0,8055
883,2019-09-09,118,9171,1019,0,10308
883,2019-09-10,219,11860,2169,2,14250
883,2019-09-11,232,9017,1791,3,11043
883,2019-09-12,971,5649,2417,231,9268
883,2019-09-13,961,4568,2970,0,8499
883,2019-09-14,1023,6499,2104,0,9626
883,2019-09-15,198,11090,1801,1,13090
883,2019-09-16,1128,16240,1897,1,19266
883,2019-09-17,264,14944,1914,3,17125
883,2019-09-18,95,11472,1027,1,12595
883,2019-09-19,357,8242,1692,1,10292
883,2019-09-20,340,8691,1447,0,10478
883,2019-09-21,1022,7075,1768,1,9866
883,2019-09-22,352,14683,2364,2,17401
883,2019-09-23,580,10628,1962,2,13172
883,2019-09-24,347,9728,3284,4,13363
883,2019-09-25,1044,9486,1966,1,12497
883,2019-09-26,163,9656,1775,1,11595
883,2019-09-27,297,9931,1803,3,12034
883,2019-09-28,174,15323,1390,2,16889
883,2019-09-29,87,18347,1666,3,20103
883,2019-09-30,130,18034,1119,1,19284
883,2019-10-01,177,16597,1391,0,18165
883,2019-10-02,155,13265,2346,0,15766
883,2019-10-03,151,14602,1622,1,16376
883,2019-10-04,100,19013,2095,1,21209
883,2019-10-05,948,23561,1597,1,26107
883,2019-10-06,2211,16999,1795,1,21006
883,2019-10-07,1975,6757,1470,3,10205
883,2019-10-08,2897,18027,1558,0,22482
883,2019-10-09,1039,17452,1757,1,20249
883,2019-10-10,659,11551,1818,0,14028
883,2019-10-11,142,17665,2127,1,19935
883,2019-10-12,190,9628,2236,3,12057
883,2019-10-13,1836,12884,2258,1,16979
883,2019-10-14,225,7158,1647,1,9031
883,2019-10-15,1820,8495,2223,1,12539
883,2019-10-16,473,24040,1190,1,25704
883,2019-10-17,207,11507,1599,3,13316
883,2019-10-18,816,14798,1396,1,17011
883,2019-10-19,238,8813,1522,0,10573
883,2019-10-20,209,2815,2601,1,5626
883,2019-10-21,243,11016,1434,2,12695
883,2019-10-22,468,6553,2346,2,9369
883,2019-10-23,236,8868,1803,1,10908
883,2019-10-24,1056,13702,1512,0,16270
883,2019-10-25,1592,11106,1002,2,13702
883,2019-10-26,217,13803,1388,713,16121
883,2019-10-27,754,16798,2000,2,19554
883,2019-10-28,1040,23583,1422,1,26046
883,2019-10-29,228,18130,1266,0,19624
883,2019-10-30,273,16044,1031,1,17349
883,2019-10-31,189,12711,2014,1,14915
883,2019-11-01,105,15635,2242,3,17985
883,2019-11-02,487,14682,812,0,15981
883,2019-11-03,167,22935,989,0,24091
883,2019-11-04,385,8156,1754,0,10295
883,2019-11-05,1078,3493,1339,2,5912
883,2019-11-06,556,8626,1579,3,10764
883,2019-11-07,952,23205,1503,4,25664
883,2019-11-08,184,12236,1466,0,13886
883,2019-11-09,1106,9316,2297,3350,16069
884,2019-09-05,291,4474,2076,0,6841
884,2019-09-06,678,10161,2557,0,13396
884,2019-09-07,745,7820,2169,2,10736
884,2019-09-08,4116,4207,2505,0,10828
884,2019-09-09,1194,5473,1640,1,8308
884,2019-09-10,1856,7354,2733,1,11944
884,2019-09-11,1968,7038,1757,3,10766
884,2019-09-12,2261,6553,2110,2,10926
884,2019-09-13,2070,3057,1191,0,6318
884,2019-09-14,5191,6151,2104,0,13446
884,2019-09-15,2647,9018,1482,2,13149
884,2019-09-16,1800,11349,2319,0,15468
884,2019-09-17,1307,10704,2247,2,14260
884,2019-09-18,2004,11275,1599,1,14879
884,2019-09-19,2297,8900,1710,1,12908
884,2019-09-20,1090,17335,1801,1,20227
884,2019-09-21,2057,5810,1440,0,9307
884,2019-09-22,2981,14720,1424,1,19126
884,2019-09-23,2759,10441,2100,1,15301
884,2019-09-24,1574,12446,2261,2,16283
884,2019-09-25,1989,10207,1611,6,13813
884,2019-09-26,4111,10052,1266,0,15429
884,2019-09-27,1374,10860,1525,1,13760
884,2019-09-28,1034,15551,1846,1,18432
884,2019-09-29,683,27493,1233,3,29412
884,2019-09-30,1426,27939,2221,4,31590
884,2019-10-01,1455,21951,1362,1,24769
884,2019-10-02,2472,15220,2245,1,19938
884,2019-10-03,2002,13634,1539,1,17176
884,2019-10-04,2065,11660,1184,0,14909
884,2019-10-05,1507,21112,1608,2,24229
884,2019-10-06,2355,33602,1863,2,37822
884,2019-10-07,7129,10292,1763,1,19185
884,2019-10-08,3031,18419,1112,2,22564
884,2019-10-09,1208,25540,1225,1,27974
884,2019-10-10,948,17916,2528,2,21394
884,2019-10-11,1623,18980,1653,0,22256
884,2019-10-12,1186,8027,2051,0,11264
884,2019-10-13,731,16088,2190,2,19011
884,2019-10-14,1540,8910,2110,0,12560
884,2019-10-15,1574,15005,1804,2,18385
884,2019-10-16,990,23744,1324,0,26058
884,2019-10-17,688,8629,1822,2,11141
884,2019-10-18,798,8955,1964,0,11717
884,2019-10-19,757,5723,3376,0,9856
884,2019-10-20,546,2917,2132,2,5597
884,2019-10-21,3672,19210,1408,0,24290
884,2019-10-22,433,10597,1693,1,12724
884,2019-10-23,533,8590,1152,0,10275
884,2019-10-24,781,19987,1589,2,22359
884,2019-10-25,1453,23825,1957,3,27238
884,2019-10-26,611,21016,876,0,22503
884,2019-10-27,1320,16545,1525,0,19390
884,2019-10-28,414,14410,1588,1,16413
884,2019-10-29,2023,26778,1409,1,30211
884,2019-10-30,426,20283,1493,5,22207
884,2019-10-31,836,20448,1893,0,23177
884,2019-11-01,387,27249,982,0,28618
884,2019-11-02,406,26056,1678,1,28141
884,2019-11-03,487,24199,870,0,25556
884,2019-11-04,514,10748,1857,2,13121
884,2019-11-05,621,3719,1633,0,5973
884,2019-11-06,446,14655,1216,1,16318
884,2019-11-07,581,26240,1060,3,27884
884,2019-11-08,444,17745,1311,0,19500
884,2019-11-09,355,15969,1065,1,17390
884,2019-11-10,1543,24846,1740,1,28130
884,2019-11-11,494,16138,1699,2,18333
884,2019-11-12,1402,18574,3276,1,23253
884,2019-11-13,520,16005,2080,3,18608
884,2019-11-14,526,8546,1761,3,10836
884,2019-11-15,942,3855,2251,2,7050
884,2019-11-16,574,2866,2849,900,7189
884,2019-11-17,406,4130,2801,0,7337
884,2019-11-18,511,3175,3392,0,7078
884,2019-11-19,651,3183,2890,3,6727
884,2019-11-20,664,1376,2691,0,4731
884,2019-11-21,560,5402,1724,1,7687
884,2019-11-22,696,8722,1526,2,10946
884,2019-11-23,769,7054,1788,1,9612
884,2019-11-24,779,6464,1535,30,8808
884,2019-11-25,804,10404,1898,0,13106
884,2019-11-26,524,7327,1295,0,9146
884,2019-11-27,405,6446,1787,2,8640
884,2019-11-28,367,10874,520,0,11761
884,2019-11-29,85,0,2,0,87
884,2019-09-05,291,4474,2076,0,6841
884,2019-09-06,678,10161,2557,0,13396
884,2019-09-07,745,7820,2169,2,10736
884,2019-09-08,4116,4207,2505,0,10828
884,2019-09-09,1194,5473,1640,1,8308
884,2019-09-10,1856,7354,2733,1,11944
884,2019-09-11,1968,7038,1757,3,10766
884,2019-09-12,2261,6553,2110,2,10926
884,2019-09-13,2070,3057,1191,0,6318
884,2019-09-14,5191,6151,2104,0,13446
884,2019-09-15,2647,9018,1482,2,13149
884,2019-09-16,1800,11349,2319,0,15468
884,2019-09-17,1307,10704,2247,2,14260
884,2019-09-18,2004,11275,1599,1,14879
884,2019-09-19,2297,8900,1710,1,12908
884,2019-09-20,1090,17335,1801,1,20227
884,2019-09-21,2057,5810,1440,0,9307
884,2019-09-22,2981,14720,1424,1,19126
884,2019-09-23,2759,10441,2100,1,15301
884,2019-09-24,1574,12446,2261,2,16283
884,2019-09-25,1989,10207,1611,6,13813
884,2019-09-26,4111,10052,1266,0,15429
884,2019-09-27,1374,10860,1525,1,13760
884,2019-09-28,1034,15551,1846,1,18432
884,2019-09-29,683,27493,1233,3,29412
884,2019-09-30,1426,27939,2221,4,31590
884,2019-10-01,1455,21951,1362,1,24769
884,2019-10-02,2472,15220,2245,1,19938
884,2019-10-03,2002,13634,1539,1,17176
884,2019-10-04,2065,11660,1184,0,14909
884,2019-10-05,1507,21112,1608,2,24229
884,2019-10-06,2355,33602,1863,2,37822
884,2019-10-07,7129,10292,1763,1,19185
884,2019-10-08,3031,18419,1112,2,22564
884,2019-10-09,1208,25540,1225,1,27974
884,2019-10-10,948,17916,2528,2,21394
884,2019-10-11,1623,18980,1653,0,22256
884,2019-10-12,1186,8027,2051,0,11264
884,2019-10-13,731,16088,2190,2,19011
884,2019-10-14,1540,8910,2110,0,12560
884,2019-10-15,1574,15005,1804,2,18385
884,2019-10-16,990,23744,1324,0,26058
884,2019-10-17,688,8629,1822,2,11141
884,2019-10-18,798,8955,1964,0,11717
884,2019-10-19,757,5723,3376,0,9856
884,2019-10-20,546,2917,2132,2,5597
884,2019-10-21,3672,19210,1408,0,24290
884,2019-10-22,433,10597,1693,1,12724
884,2019-10-23,533,8590,1152,0,10275
884,2019-10-24,781,19987,1589,2,22359
884,2019-10-25,1453,23825,1957,3,27238
884,2019-10-26,611,21016,876,0,22503
884,2019-10-27,1320,16545,1525,0,19390
884,2019-10-28,414,14410,1588,1,16413
884,2019-10-29,2023,26778,1409,1,30211
884,2019-10-30,426,20283,1493,5,22207
884,2019-10-31,836,20448,1893,0,23177
884,2019-11-01,387,27249,982,0,28618
884,2019-11-02,406,26056,1678,1,28141
884,2019-11-03,487,24199,870,0,25556
884,2019-11-04,514,10748,1857,2,13121
884,2019-11-05,621,3719,1633,0,5973
884,2019-11-06,446,14655,1216,1,16318
884,2019-11-07,581,26240,1060,3,27884
884,2019-11-08,444,17745,1311,0,19500
884,2019-11-09,355,15969,1065,1,17390
884,2019-11-10,1543,24846,1740,1,28130
884,2019-11-11,494,16138,1699,2,18333
884,2019-11-12,1402,18574,3276,1,23253
884,2019-11-13,520,16005,2080,3,18608
884,2019-11-14,526,8546,1761,3,10836
884,2019-11-15,942,3855,2251,2,7050
884,2019-11-16,574,2866,2849,900,7189
884,2019-11-17,406,4130,2801,0,7337
884,2019-11-18,511,3175,3392,0,7078
884,2019-11-19,651,3183,2890,3,6727
884,2019-11-20,664,1376,2691,0,4731
884,2019-11-21,560,5402,1724,1,7687
884,2019-11-22,696,8722,1526,2,10946
884,2019-11-23,769,7054,1788,1,9612
884,2019-11-24,779,6464,1535,30,8808
884,2019-11-25,804,10404,1898,0,13106
884,2019-11-26,524,7327,1295,0,9146
884,2019-11-27,405,6446,1787,2,8640
884,2019-11-28,367,10874,520,0,11761
884,2019-09-04,0,0,36,0,36
884,2019-09-05,291,4474,2076,0,6841
884,2019-09-06,678,10161,2557,0,13396
884,2019-09-07,745,7820,2169,2,10736
884,2019-09-08,4116,4207,2505,0,10828
884,2019-09-09,1194,5473,1640,1,8308
884,2019-09-10,1856,7354,2733,1,11944
884,2019-09-11,1968,7038,1757,3,10766
884,2019-09-12,2261,6553,2110,2,10926
884,2019-09-13,2070,3057,1191,0,6318
884,2019-09-14,5191,6151,2104,0,13446
884,2019-09-15,2647,9018,1482,2,13149
884,2019-09-16,1800,11349,2319,0,15468
884,2019-09-17,1307,10704,2247,2,14260
884,2019-09-18,2004,11275,1599,1,14879
884,2019-09-19,2297,8900,1710,1,12908
884,2019-09-20,1090,17335,1801,1,20227
884,2019-09-21,2057,5810,1440,0,9307
884,2019-09-22,2981,14720,1424,1,19126
884,2019-09-23,2759,10441,2100,1,15301
884,2019-09-24,1574,12446,2261,2,16283
884,2019-09-25,1989,10207,1611,6,13813
884,2019-09-26,4111,10052,1266,0,15429
884,2019-09-27,1374,10860,1525,1,13760
884,2019-09-28,1034,15551,1846,1,18432
884,2019-09-29,683,27493,1233,3,29412
884,2019-09-30,1426,27939,2221,4,31590
884,2019-10-01,1455,21951,1362,1,24769
884,2019-10-02,2472,15220,2245,1,19938
884,2019-10-03,2002,13634,1539,1,17176
884,2019-10-04,2065,11660,1184,0,14909
884,2019-10-05,1507,21112,1608,2,24229
884,2019-10-06,2355,33602,1863,2,37822
884,2019-10-07,7129,10292,1763,1,19185
884,2019-10-08,3031,18419,1112,2,22564
884,2019-10-09,1208,25540,1225,1,27974
884,2019-10-10,948,17916,2528,2,21394
884,2019-10-11,1623,18980,1653,0,22256
884,2019-10-12,1186,8027,2051,0,11264
884,2019-10-13,731,16088,2190,2,19011
884,2019-10-14,1540,8910,2110,0,12560
884,2019-10-15,1574,15005,1804,2,18385
884,2019-10-16,990,23744,1324,0,26058
884,2019-10-17,688,8629,1822,2,11141
884,2019-10-18,798,8955,1964,0,11717
884,2019-10-19,757,5723,3376,0,9856
884,2019-10-20,546,2917,2132,2,5597
884,2019-10-21,3672,19210,1408,0,24290
884,2019-10-22,433,10597,1693,1,12724
884,2019-10-23,533,8590,1152,0,10275
884,2019-10-24,781,19987,1589,2,22359
884,2019-10-25,1453,23825,1957,3,27238
884,2019-10-26,611,21016,876,0,22503
884,2019-10-27,1320,16545,1525,0,19390
884,2019-10-28,414,14410,1588,1,16413
884,2019-10-29,2023,26778,1409,1,30211
884,2019-10-30,426,20283,1493,5,22207
884,2019-10-31,836,20448,1893,0,23177
884,2019-11-01,387,27249,982,0,28618
884,2019-11-02,406,26056,1678,1,28141
884,2019-11-03,487,24199,870,0,25556
884,2019-11-04,514,10748,1857,2,13121
884,2019-11-05,621,3719,1633,0,5973
884,2019-11-06,446,14655,1216,1,16318
884,2019-11-07,581,26240,1060,3,27884
884,2019-11-08,444,17745,1311,0,19500
884,2019-11-09,355,15969,1065,1,17390
884,2019-11-10,1543,24846,1740,1,28130
884,2019-11-11,494,16138,1699,2,18333
884,2019-11-12,1402,18574,3276,1,23253
884,2019-11-13,520,16005,2080,3,18608
884,2019-11-14,526,8546,1761,3,10836
884,2019-11-15,942,3855,2251,2,7050
884,2019-11-16,574,2866,2849,900,7189
884,2019-11-17,406,4130,2801,0,7337
884,2019-11-18,511,3175,3392,0,7078
884,2019-11-19,651,3183,2890,3,6727
884,2019-11-20,664,1376,2691,0,4731
884,2019-11-21,560,5402,1724,1,7687
884,2019-11-22,696,8722,1526,2,10946
884,2019-11-23,769,7054,1788,1,9612
884,2019-11-24,779,6464,1535,30,8808
884,2019-11-25,804,10404,1898,0,13106
884,2019-11-26,524,7327,1295,0,9146
884,2019-11-27,405,6446,1787,2,8640
884,2019-11-28,367,10874,520,0,11761
884,2019-11-29,85,0,2,0,87
884,2019-09-07,745,7820,2169,2,10736
884,2019-09-08,4116,4207,2505,0,10828
884,2019-09-09,1194,5473,1640,1,8308
884,2019-09-10,1856,7354,2733,1,11944
884,2019-09-11,1968,7038,1757,3,10766
884,2019-09-12,2261,6553,2110,2,10926
884,2019-09-13,2070,3057,1191,0,6318
884,2019-09-14,5191,6151,2104,0,13446
884,2019-09-15,2647,9018,1482,2,13149
884,2019-09-16,1800,11349,2319,0,15468
884,2019-09-17,1307,10704,2247,2,14260
884,2019-09-18,2004,11275,1599,1,14879
884,2019-09-19,2297,8900,1710,1,12908
884,2019-09-20,1090,17335,1801,1,20227
884,2019-09-21,2057,5810,1440,0,9307
884,2019-09-22,2981,14720,1424,1,19126
884,2019-09-23,2759,10441,2100,1,15301
884,2019-09-24,1574,12446,2261,2,16283
884,2019-09-25,1989,10207,1611,6,13813
884,2019-09-26,4111,10052,1266,0,15429
884,2019-09-27,1374,10860,1525,1,13760
884,2019-09-28,1034,15551,1846,1,18432
884,2019-09-29,683,27493,1233,3,29412
884,2019-09-30,1426,27939,2221,4,31590
884,2019-10-01,1455,21951,1362,1,24769
884,2019-10-02,2472,15220,2245,1,19938
884,2019-10-03,2002,13634,1539,1,17176
884,2019-10-04,2065,11660,1184,0,14909
884,2019-10-05,1507,21112,1608,2,24229
884,2019-10-06,2355,33602,1863,2,37822
884,2019-10-07,7129,10292,1763,1,19185
884,2019-10-08,3031,18419,1112,2,22564
884,2019-10-09,1208,25540,1225,1,27974
884,2019-10-10,948,17916,2528,2,21394
884,2019-10-11,1623,18980,1653,0,22256
884,2019-10-12,1186,8027,2051,0,11264
884,2019-10-13,731,16088,2190,2,19011
884,2019-10-14,1540,8910,2110,0,12560
884,2019-10-15,1574,15005,1804,2,18385
884,2019-10-16,990,23744,1324,0,26058
884,2019-10-17,688,8629,1822,2,11141
884,2019-10-18,798,8955,1964,0,11717
884,2019-10-19,757,5723,3376,0,9856
884,2019-10-20,546,2917,2132,2,5597
884,2019-10-21,3672,19210,1408,0,24290
884,2019-10-22,433,10597,1693,1,12724
884,2019-10-23,533,8590,1152,0,10275
884,2019-10-24,781,19987,1589,2,22359
884,2019-10-25,1453,23825,1957,3,27238
884,2019-10-26,611,21016,876,0,22503
884,2019-10-27,1320,16545,1525,0,19390
884,2019-10-28,414,14410,1588,1,16413
884,2019-10-29,2023,26778,1409,1,30211
884,2019-10-30,426,20283,1493,5,22207
884,2019-10-31,836,20448,1893,0,23177
884,2019-11-01,387,27249,982,0,28618
884,2019-11-02,406,26056,1678,1,28141
884,2019-11-03,487,24199,870,0,25556
884,2019-11-04,514,10748,1857,2,13121
884,2019-11-05,621,3719,1633,0,5973
884,2019-11-06,446,14655,1216,1,16318
884,2019-11-07,581,26240,1060,3,27884
884,2019-11-08,444,17745,1311,0,19500
884,2019-11-09,355,15969,1065,1,17390
884,2019-11-10,1543,24846,1740,1,28130
884,2019-11-11,494,16138,1699,2,18333
884,2019-11-12,1402,18574,3276,1,23253
884,2019-11-13,520,16005,2080,3,18608
884,2019-11-14,526,8546,1761,3,10836
884,2019-11-15,942,3855,2251,2,7050
884,2019-11-16,574,2866,2849,900,7189
884,2019-11-17,406,4130,2801,0,7337
884,2019-11-18,511,3175,3392,0,7078
884,2019-11-19,651,3183,2890,3,6727
884,2019-11-20,664,1376,2691,0,4731
884,2019-11-21,560,5402,1724,1,7687
884,2019-11-22,696,8722,1526,2,10946
884,2019-11-23,769,7054,1788,1,9612
884,2019-11-24,779,6464,1535,30,8808
884,2019-11-25,804,10404,1898,0,13106
884,2019-11-26,524,7327,1295,0,9146
884,2019-11-27,405,6446,1787,2,8640
885,2019-09-05,542,3373,1622,0,5537
885,2019-09-06,1891,14549,2466,2,18908
885,2019-09-07,2064,10742,1418,1,14225
885,2019-09-08,1384,6307,2177,1,9869
885,2019-09-09,1440,5548,3372,0,10360
885,2019-09-10,2897,8243,2139,0,13279
885,2019-09-11,835,8429,1949,2,11215
885,2019-09-12,989,6322,1507,1,8819
885,2019-09-13,954,4361,1737,0,7052
885,2019-09-14,1505,6266,2095,0,9866
885,2019-09-15,716,8184,1632,1,10533
885,2019-09-16,633,14576,1910,0,17119
885,2019-09-17,523,9089,1935,2,11549
885,2019-09-18,694,19093,1417,1,21205
885,2019-09-19,1299,3256,1754,0,6309
885,2019-09-20,789,2423,2258,1,5471
885,2019-09-21,537,30961,1170,1,32669
885,2019-09-22,1886,28905,1886,0,32677
885,2019-09-23,767,11745,1530,0,14042
885,2019-09-24,883,9767,1907,5,12562
885,2019-09-25,302,8498,1485,11,10296
885,2019-09-26,348,9830,1441,0,11619
885,2019-09-27,290,10240,1550,3,12083
885,2019-09-28,397,20930,1744,0,23071
885,2019-09-29,1554,27863,904,0,30321
885,2019-09-30,1180,17017,1635,4,19836
885,2019-10-01,593,15456,1779,0,17828
885,2019-10-02,341,9326,1441,2,11110
885,2019-10-03,1769,12975,1434,0,16178
885,2019-10-04,751,12854,1364,1,14970
885,2019-10-05,350,20196,911,2,21459
885,2019-10-06,1371,33379,1550,0,36300
885,2019-10-07,3078,30026,1717,0,34821
885,2019-10-08,1212,35289,1499,1,38001
885,2019-10-09,384,24433,1284,2,26103
885,2019-10-10,476,10819,1552,4,12851
885,2019-10-11,1476,11163,1956,0,14595
885,2019-10-12,568,3753,1318,1,5640
885,2019-10-13,679,24997,1334,0,27010
885,2019-10-14,533,6863,1941,1,9338
885,2019-10-15,1047,6831,1857,2,9737
885,2019-10-16,511,17756,1716,2,19985
885,2019-10-17,483,7205,1667,0,9355
885,2019-10-18,568,7394,2107,0,10069
885,2019-10-19,1008,3716,1784,0,6508
885,2019-10-20,1421,745,1308,3,3477
885,2019-10-21,570,17915,1793,3,20281
885,2019-10-22,948,8364,1418,0,10730
885,2019-10-23,423,13057,1679,1,15160
885,2019-10-24,1246,18039,2473,0,21758
885,2019-10-25,479,29684,1532,2,31697
885,2019-10-26,493,19461,1225,1,21180
885,2019-10-27,788,15260,1321,0,17369
885,2019-10-28,488,22536,1082,1,24107
885,2019-10-29,596,27940,1563,0,30099
885,2019-10-30,491,28154,1382,3,30030
885,2019-10-31,1365,21439,1606,0,24410
885,2019-11-01,466,26518,1428,1,28413
885,2019-11-02,386,25405,1336,1,27128
885,2019-11-03,421,52933,992,0,54346
885,2019-11-04,1048,12539,1963,2,15552
885,2019-11-05,519,1020,1440,1,2980
885,2019-11-06,569,7232,1205,0,9006
885,2019-11-07,552,14390,1090,3,16035
885,2019-11-08,488,8699,1152,0,10339
885,2019-11-09,475,7630,1806,1,9912
885,2019-11-10,444,11950,1642,1,14037
885,2019-11-11,479,7727,2319,4,10529
885,2019-11-12,479,8872,2655,2,12008
885,2019-11-13,459,13008,2120,0,15587
885,2019-11-14,458,11274,1357,3,13092
885,2019-11-15,437,3324,2340,2,6103
885,2019-11-16,484,819,2748,0,4051
885,2019-11-17,1588,1927,3124,0,6639
885,2019-11-18,521,1174,3372,2,5069
885,2019-11-19,555,2509,1870,4,4938
885,2019-11-20,642,618,2659,2,3921
885,2019-11-21,505,4606,1941,0,7052
885,2019-11-22,553,8066,1351,2,9972
885,2019-11-23,500,10167,1961,4,12632
885,2019-11-24,566,7767,2074,1,10408
885,2019-11-25,555,5388,1453,1,7397
885,2019-11-26,454,6084,237,0,6775
885,2019-11-27,466,4516,0,0,4982
885,2019-11-28,397,9018,0,0,9415
885,2019-11-29,99,162,0,0,261
885,2019-09-05,542,3373,1622,0,5537
885,2019-09-06,1891,14549,2466,2,18908
885,2019-09-07,2064,10742,1418,1,14225
885,2019-09-08,1384,6307,2177,1,9869
885,2019-09-09,1440,5548,3372,0,10360
885,2019-09-10,2897,8243,2139,0,13279
885,2019-09-11,835,8429,1949,2,11215
885,2019-09-12,989,6322,1507,1,8819
885,2019-09-13,954,4361,1737,0,7052
885,2019-09-14,1505,6266,2095,0,9866
885,2019-09-15,716,8184,1632,1,10533
885,2019-09-16,633,14576,1910,0,17119
885,2019-09-17,523,9089,1935,2,11549
885,2019-09-18,694,19093,1417,1,21205
885,2019-09-19,1299,3256,1754,0,6309
885,2019-09-20,789,2423,2258,1,5471
885,2019-09-21,537,30961,1170,1,32669
885,2019-09-22,1886,28905,1886,0,32677
885,2019-09-23,767,11745,1530,0,14042
885,2019-09-24,883,9767,1907,5,12562
885,2019-09-25,302,8498,1485,11,10296
885,2019-09-26,348,9830,1441,0,11619
885,2019-09-27,290,10240,1550,3,12083
885,2019-09-28,397,20930,1744,0,23071
885,2019-09-29,1554,27863,904,0,30321
885,2019-09-30,1180,17017,1635,4,19836
885,2019-10-01,593,15456,1779,0,17828
885,2019-10-02,341,9326,1441,2,11110
885,2019-10-03,1769,12975,1434,0,16178
885,2019-10-04,751,12854,1364,1,14970
885,2019-10-05,350,20196,911,2,21459
885,2019-10-06,1371,33379,1550,0,36300
885,2019-10-07,3078,30026,1717,0,34821
885,2019-10-08,1212,35289,1499,1,38001
885,2019-10-09,384,24433,1284,2,26103
885,2019-10-10,476,10819,1552,4,12851
885,2019-10-11,1476,11163,1956,0,14595
885,2019-10-12,568,3753,1318,1,5640
885,2019-10-13,679,24997,1334,0,27010
885,2019-10-14,533,6863,1941,1,9338
885,2019-10-15,1047,6831,1857,2,9737
885,2019-10-16,511,17756,1716,2,19985
885,2019-10-17,483,7205,1667,0,9355
885,2019-10-18,568,7394,2107,0,10069
885,2019-10-19,1008,3716,1784,0,6508
885,2019-10-20,1421,745,1308,3,3477
885,2019-10-21,570,17915,1793,3,20281
885,2019-10-22,948,8364,1418,0,10730
885,2019-10-23,423,13057,1679,1,15160
885,2019-10-24,1246,18039,2473,0,21758
885,2019-10-25,479,29684,1532,2,31697
885,2019-10-26,493,19461,1225,1,21180
885,2019-10-27,788,15260,1321,0,17369
885,2019-10-28,488,22536,1082,1,24107
885,2019-10-29,596,27940,1563,0,30099
885,2019-10-30,491,28154,1382,3,30030
885,2019-10-31,1365,21439,1606,0,24410
885,2019-11-01,466,26518,1428,1,28413
885,2019-11-02,386,25405,1336,1,27128
885,2019-11-03,421,52933,992,0,54346
885,2019-11-04,1048,12539,1963,2,15552
885,2019-11-05,519,1020,1440,1,2980
885,2019-11-06,569,7232,1205,0,9006
885,2019-11-07,552,14390,1090,3,16035
885,2019-11-08,488,8699,1152,0,10339
885,2019-11-09,475,7630,1806,1,9912
885,2019-11-10,444,11950,1642,1,14037
885,2019-11-11,479,7727,2319,4,10529
885,2019-11-12,479,8872,2655,2,12008
885,2019-11-13,459,13008,2120,0,15587
885,2019-11-14,458,11274,1357,3,13092
885,2019-11-15,437,3324,2340,2,6103
885,2019-11-16,484,819,2748,0,4051
885,2019-11-17,1588,1927,3124,0,6639
885,2019-11-18,521,1174,3372,2,5069
885,2019-11-19,555,2509,1870,4,4938
885,2019-11-20,642,618,2659,2,3921
885,2019-11-21,505,4606,1941,0,7052
885,2019-11-22,553,8066,1351,2,9972
885,2019-11-23,500,10167,1961,4,12632
885,2019-11-24,566,7767,2074,1,10408
885,2019-11-25,555,5388,1453,1,7397
885,2019-11-26,454,6084,237,0,6775
885,2019-11-27,466,4516,0,0,4982
885,2019-11-28,397,9018,0,0,9415
885,2019-11-29,99,162,0,0,261
885,2019-09-04,0,0,6,0,6
885,2019-09-05,542,3373,1622,0,5537
885,2019-09-06,1891,14549,2466,2,18908
885,2019-09-07,2064,10742,1418,1,14225
885,2019-09-08,1384,6307,2177,1,9869
885,2019-09-09,1440,5548,3372,0,10360
885,2019-09-10,2897,8243,2139,0,13279
885,2019-09-11,835,8429,1949,2,11215
885,2019-09-12,989,6322,1507,1,8819
885,2019-09-13,954,4361,1737,0,7052
885,2019-09-14,1505,6266,2095,0,9866
885,2019-09-15,716,8184,1632,1,10533
885,2019-09-16,633,14576,1910,0,17119
885,2019-09-17,523,9089,1935,2,11549
885,2019-09-18,694,19093,1417,1,21205
885,2019-09-19,1299,3256,1754,0,6309
885,2019-09-20,789,2423,2258,1,5471
885,2019-09-21,537,30961,1170,1,32669
885,2019-09-22,1886,28905,1886,0,32677
885,2019-09-23,767,11745,1530,0,14042
885,2019-09-24,883,9767,1907,5,12562
885,2019-09-25,302,8498,1485,11,10296
885,2019-09-26,348,9830,1441,0,11619
885,2019-09-27,290,10240,1550,3,12083
885,2019-09-28,397,20930,1744,0,23071
885,2019-09-29,1554,27863,904,0,30321
885,2019-09-30,1180,17017,1635,4,19836
885,2019-10-01,593,15456,1779,0,17828
885,2019-10-02,341,9326,1441,2,11110
885,2019-10-03,1769,12975,1434,0,16178
885,2019-10-04,751,12854,1364,1,14970
885,2019-10-05,350,20196,911,2,21459
885,2019-10-06,1371,33379,1550,0,36300
885,2019-10-07,3078,30026,1717,0,34821
885,2019-10-08,1212,35289,1499,1,38001
885,2019-10-09,384,24433,1284,2,26103
885,2019-10-10,476,10819,1552,4,12851
885,2019-10-11,1476,11163,1956,0,14595
885,2019-10-12,568,3753,1318,1,5640
885,2019-10-13,679,24997,1334,0,27010
885,2019-10-14,533,6863,1941,1,9338
885,2019-10-15,1047,6831,1857,2,9737
885,2019-10-16,511,17756,1716,2,19985
885,2019-10-17,483,7205,1667,0,9355
885,2019-10-18,568,7394,2107,0,10069
885,2019-10-19,1008,3716,1784,0,6508
885,2019-10-20,1421,745,1308,3,3477
885,2019-10-21,570,17915,1793,3,20281
885,2019-10-22,948,8364,1418,0,10730
885,2019-10-23,423,13057,1679,1,15160
885,2019-10-24,1246,18039,2473,0,21758
885,2019-10-25,479,29684,1532,2,31697
885,2019-10-26,493,19461,1225,1,21180
885,2019-10-27,788,15260,1321,0,17369
885,2019-10-28,488,22536,1082,1,24107
885,2019-10-29,596,27940,1563,0,30099
885,2019-10-30,491,28154,1382,3,30030
885,2019-10-31,1365,21439,1606,0,24410
885,2019-11-01,466,26518,1428,1,28413
885,2019-11-02,386,25405,1336,1,27128
885,2019-11-03,421,52933,992,0,54346
885,2019-11-04,1048,12539,1963,2,15552
885,2019-11-05,519,1020,1440,1,2980
885,2019-11-06,569,7232,1205,0,9006
885,2019-11-07,552,14390,1090,3,16035
885,2019-11-08,488,8699,1152,0,10339
885,2019-11-09,475,7630,1806,1,9912
885,2019-11-10,444,11950,1642,1,14037
885,2019-11-11,479,7727,2319,4,10529
885,2019-11-12,479,8872,2655,2,12008
885,2019-11-13,459,13008,2120,0,15587
885,2019-11-14,458,11274,1357,3,13092
885,2019-11-15,437,3324,2340,2,6103
885,2019-11-16,484,819,2748,0,4051
885,2019-11-17,1588,1927,3124,0,6639
885,2019-11-18,521,1174,3372,2,5069
885,2019-11-19,555,2509,1870,4,4938
885,2019-11-20,642,618,2659,2,3921
885,2019-11-21,505,4606,1941,0,7052
885,2019-11-22,553,8066,1351,2,9972
885,2019-11-23,500,10167,1961,4,12632
885,2019-11-24,566,7767,2074,1,10408
885,2019-11-25,555,5388,1453,1,7397
885,2019-11-26,454,6084,237,0,6775
885,2019-09-06,1891,14549,2466,2,18908
885,2019-09-07,2064,10742,1418,1,14225
885,2019-09-08,1384,6307,2177,1,9869
885,2019-09-09,1440,5548,3372,0,10360
885,2019-09-10,2897,8243,2139,0,13279
885,2019-09-11,835,8429,1949,2,11215
885,2019-09-12,989,6322,1507,1,8819
885,2019-09-13,954,4361,1737,0,7052
885,2019-09-14,1505,6266,2095,0,9866
885,2019-09-15,716,8184,1632,1,10533
885,2019-09-16,633,14576,1910,0,17119
885,2019-09-17,523,9089,1935,2,11549
885,2019-09-18,694,19093,1417,1,21205
885,2019-09-19,1299,3256,1754,0,6309
885,2019-09-20,789,2423,2258,1,5471
885,2019-09-21,537,30961,1170,1,32669
885,2019-09-22,1886,28905,1886,0,32677
885,2019-09-23,767,11745,1530,0,14042
885,2019-09-24,883,9767,1907,5,12562
885,2019-09-25,302,8498,1485,11,10296
885,2019-09-26,348,9830,1441,0,11619
885,2019-09-27,290,10240,1550,3,12083
885,2019-09-28,397,20930,1744,0,23071
885,2019-09-29,1554,27863,904,0,30321
885,2019-09-30,1180,17017,1635,4,19836
885,2019-10-01,593,15456,1779,0,17828
885,2019-10-02,341,9326,1441,2,11110
885,2019-10-03,1769,12975,1434,0,16178
885,2019-10-04,751,12854,1364,1,14970
885,2019-10-05,350,20196,911,2,21459
885,2019-10-06,1371,33379,1550,0,36300
885,2019-10-07,3078,30026,1717,0,34821
885,2019-10-08,1212,35289,1499,1,38001
885,2019-10-09,384,24433,1284,2,26103
885,2019-10-10,476,10819,1552,4,12851
885,2019-10-11,1476,11163,1956,0,14595
885,2019-10-12,568,3753,1318,1,5640
885,2019-10-13,679,24997,1334,0,27010
885,2019-10-14,533,6863,1941,1,9338
885,2019-10-15,1047,6831,1857,2,9737
885,2019-10-16,511,17756,1716,2,19985
885,2019-10-17,483,7205,1667,0,9355
885,2019-10-18,568,7394,2107,0,10069
885,2019-10-19,1008,3716,1784,0,6508
885,2019-10-20,1421,745,1308,3,3477
885,2019-10-21,570,17915,1793,3,20281
885,2019-10-22,948,8364,1418,0,10730
885,2019-10-23,423,13057,1679,1,15160
885,2019-10-24,1246,18039,2473,0,21758
885,2019-10-25,479,29684,1532,2,31697
885,2019-10-26,493,19461,1225,1,21180
885,2019-10-27,788,15260,1321,0,17369
885,2019-10-28,488,22536,1082,1,24107
885,2019-10-29,596,27940,1563,0,30099
885,2019-10-30,491,28154,1382,3,30030
885,2019-10-31,1365,21439,1606,0,24410
885,2019-11-01,466,26518,1428,1,28413
885,2019-11-02,386,25405,1336,1,27128
885,2019-11-03,421,52933,992,0,54346
885,2019-11-04,1048,12539,1963,2,15552
885,2019-11-05,519,1020,1440,1,2980
885,2019-11-06,569,7232,1205,0,9006
885,2019-11-07,552,14390,1090,3,16035
885,2019-11-08,488,8699,1152,0,10339
885,2019-11-09,475,7630,1806,1,9912
885,2019-11-10,444,11950,1642,1,14037
885,2019-11-11,479,7727,2319,4,10529
885,2019-11-12,479,8872,2655,2,12008
885,2019-11-13,459,13008,2120,0,15587
885,2019-11-14,458,11274,1357,3,13092
885,2019-11-15,437,3324,2340,2,6103
885,2019-11-16,484,819,2748,0,4051
885,2019-11-17,1588,1927,3124,0,6639
885,2019-11-18,521,1174,3372,2,5069
885,2019-11-19,555,2509,1870,4,4938
885,2019-11-20,642,618,2659,2,3921
885,2019-11-21,505,4606,1941,0,7052
885,2019-11-22,553,8066,1351,2,9972
885,2019-11-23,500,10167,1961,4,12632
885,2019-11-24,566,7767,2074,1,10408
885,2019-11-25,555,5388,1453,1,7397
886,2019-09-05,332,2136,1610,0,4078
886,2019-09-06,507,12527,1782,0,14816
886,2019-09-07,560,6259,1806,0,8625
886,2019-09-08,582,4720,2757,0,8059
886,2019-09-09,1186,4838,2162,0,8186
886,2019-09-10,247,9595,2086,0,11928
886,2019-09-11,204,5782,1263,0,7249
886,2019-09-12,1172,6621,2350,0,10143
886,2019-09-13,545,3333,2144,0,6022
886,2019-09-14,1119,6043,1991,0,9153
886,2019-09-15,310,9044,1490,0,10844
886,2019-09-16,1144,13589,1750,0,16483
886,2019-09-17,305,11129,1385,0,12819
886,2019-09-18,535,19778,1555,0,21868
886,2019-09-19,539,5082,2171,0,7792
886,2019-09-20,333,8211,1540,0,10084
886,2019-09-21,327,5622,2431,0,8380
886,2019-09-22,258,9380,1710,0,11348
886,2019-09-23,1230,7368,1099,0,9697
886,2019-09-24,394,7426,1142,0,8962
886,2019-09-25,143,4679,71,0,4893
886,2019-09-26,149,4106,120,0,4375
886,2019-09-27,134,7509,180,0,7823
886,2019-09-28,256,14018,0,0,14274
886,2019-09-29,577,16236,0,0,16813
886,2019-09-30,171,14149,0,0,14320
886,2019-10-01,201,14487,0,0,14688
886,2019-10-02,178,8613,0,0,8791
886,2019-10-03,19,255,0,0,274
886,2019-10-04,12,58,0,0,70
886,2019-09-05,332,2136,1610,0,4078
886,2019-09-06,507,12527,1782,0,14816
886,2019-09-07,560,6259,1806,0,8625
886,2019-09-08,582,4720,2757,0,8059
886,2019-09-09,1186,4838,2162,0,8186
886,2019-09-10,247,9595,2086,0,11928
886,2019-09-11,204,5782,1263,0,7249
886,2019-09-12,1172,6621,2350,0,10143
886,2019-09-13,545,3333,2144,0,6022
886,2019-09-14,1119,6043,1991,0,9153
886,2019-09-15,310,9044,1490,0,10844
886,2019-09-16,1144,13589,1750,0,16483
886,2019-09-17,305,11129,1385,0,12819
886,2019-09-18,535,19778,1555,0,21868
886,2019-09-19,539,5082,2171,0,7792
886,2019-09-20,333,8211,1540,0,10084
886,2019-09-21,327,5622,2431,0,8380
886,2019-09-22,258,9380,1710,0,11348
886,2019-09-23,1230,7368,1099,0,9697
886,2019-09-24,394,7426,1142,0,8962
886,2019-09-25,143,4679,71,0,4893
886,2019-09-26,149,4106,120,0,4375
886,2019-09-27,134,7509,180,0,7823
886,2019-09-28,256,14018,0,0,14274
886,2019-09-29,577,16236,0,0,16813
886,2019-09-30,171,14149,0,0,14320
886,2019-10-01,201,14487,0,0,14688
886,2019-10-02,178,8613,0,0,8791
886,2019-10-03,19,255,0,0,274
886,2019-10-04,12,58,0,0,70
886,2019-09-04,0,0,3,0,3
886,2019-09-05,332,2136,1610,0,4078
886,2019-09-06,507,12527,1782,0,14816
886,2019-09-07,560,6259,1806,0,8625
886,2019-09-08,582,4720,2757,0,8059
886,2019-09-09,1186,4838,2162,0,8186
886,2019-09-10,247,9595,2086,0,11928
886,2019-09-11,204,5782,1263,0,7249
886,2019-09-12,1172,6621,2350,0,10143
886,2019-09-13,545,3333,2144,0,6022
886,2019-09-14,1119,6043,1991,0,9153
886,2019-09-15,310,9044,1490,0,10844
886,2019-09-16,1144,13589,1750,0,16483
886,2019-09-17,305,11129,1385,0,12819
886,2019-09-18,535,19778,1555,0,21868
886,2019-09-19,539,5082,2171,0,7792
886,2019-09-20,333,8211,1540,0,10084
886,2019-09-21,327,5622,2431,0,8380
886,2019-09-22,258,9380,1710,0,11348
886,2019-09-23,1230,7368,1099,0,9697
886,2019-09-24,394,7426,1142,0,8962
886,2019-09-25,143,4679,71,0,4893
886,2019-09-26,149,4106,120,0,4375
886,2019-09-27,134,7509,180,0,7823
887,2019-09-05,242,1640,1785,2,3669
887,2019-09-06,392,11895,2520,1,14808
887,2019-09-07,465,11352,1296,0,13113
887,2019-09-08,1365,8391,1899,0,11655
887,2019-09-09,375,5169,2214,1,7759
887,2019-09-10,231,12713,1279,0,14223
887,2019-09-11,195,9040,2564,2,11801
887,2019-09-12,205,8550,1175,0,9930
887,2019-09-13,1390,3907,2341,0,7638
887,2019-09-14,1119,10542,1297,1,12959
887,2019-09-15,270,10732,1599,1,12602
887,2019-09-16,276,13567,1594,0,15437
887,2019-09-17,1101,5629,2008,0,8738
887,2019-09-18,331,11272,1282,0,12885
887,2019-09-19,1285,10220,1095,0,12600
887,2019-09-20,302,12635,2338,3,15278
887,2019-09-21,303,7051,1980,3,9337
887,2019-09-22,222,9452,987,0,10661
887,2019-09-23,351,9846,1805,0,12002
887,2019-09-24,1117,11652,1529,3,14301
887,2019-09-25,180,10227,1565,1,11973
887,2019-09-26,448,11289,1620,4,13361
887,2019-09-27,159,10042,1821,2,12024
887,2019-09-28,194,23894,1984,2,26074
887,2019-09-29,154,18540,2146,2,20842
887,2019-09-30,125,23962,1225,0,25312
887,2019-10-01,148,21137,2421,1,23707
887,2019-10-02,482,9459,2256,0,12197
887,2019-10-03,188,11248,1270,1,12707
887,2019-10-04,227,16980,1447,1,18655
887,2019-10-05,755,22406,1148,0,24309
887,2019-10-06,131,15732,2244,2,18109
887,2019-10-07,1138,11514,1613,0,14265
887,2019-10-08,237,22371,1968,0,24576
887,2019-10-09,168,23872,2179,2,26221
887,2019-10-10,288,10875,1812,1,12976
887,2019-10-11,777,10153,2068,2,13000
887,2019-10-12,1107,4474,1771,1,7353
887,2019-10-13,230,7464,2196,0,9890
887,2019-10-14,222,6616,1609,1,8448
887,2019-10-15,1127,7390,1855,0,10372
887,2019-10-16,248,22756,1157,3,24164
887,2019-10-17,243,12750,1891,2,14886
887,2019-10-18,1395,13541,1644,0,16580
887,2019-10-19,1723,10206,2032,0,13961
887,2019-10-20,275,7076,1006,0,8357
887,2019-10-21,1226,23315,1246,5,25792
887,2019-10-22,247,14220,1562,1,16030
887,2019-10-23,313,12367,1557,1,14238
887,2019-10-24,371,25161,983,0,26515
887,2019-10-25,1265,28131,1864,1,31261
887,2019-10-26,232,18012,1884,1,20129
887,2019-10-27,218,20420,1262,0,21900
887,2019-10-28,238,27386,1504,0,29128
887,2019-10-29,325,22148,1496,0,23969
887,2019-10-30,248,20425,1497,1,22171
887,2019-10-31,250,16867,1858,2,18977
887,2019-11-01,236,29907,1656,1,31800
887,2019-11-02,636,30613,1803,0,33052
887,2019-11-03,1142,29078,1548,1,31769
887,2019-11-04,706,11943,1988,0,14637
887,2019-11-05,274,6427,1833,0,8534
887,2019-11-06,1539,18323,890,634,21386
887,2019-11-07,352,20908,1224,2,22486
887,2019-11-08,658,16876,1542,1,19077
887,2019-11-09,1181,21791,1848,0,24820
887,2019-11-10,237,17199,1998,2,19436
887,2019-11-11,372,12847,2403,4,15626
887,2019-11-12,245,14348,2025,0,16618
887,2019-11-13,782,17422,1311,2,19517
887,2019-11-14,235,17349,2509,3,20096
887,2019-11-15,241,10207,2301,1,12750
887,2019-11-16,245,7737,2114,1,10097
887,2019-11-17,749,8676,2069,0,11494
887,2019-11-18,1197,8677,2718,0,12592
887,2019-11-19,1182,9115,2655,1,12953
887,2019-11-20,1229,6999,2116,2,10346
887,2019-11-21,251,9727,1342,1,11321
887,2019-11-22,278,10495,1584,1,12358
887,2019-11-23,248,11355,1796,1,13400
887,2019-11-24,234,12554,1785,4,14577
887,2019-11-25,245,12050,2119,1,14415
887,2019-11-26,1170,13076,931,2,15179
887,2019-11-27,287,11900,1810,0,13997
887,2019-11-28,239,16995,998,0,18232
887,2019-11-29,245,913,0,0,1158
887,2019-09-05,242,1640,1785,2,3669
887,2019-09-06,392,11895,2520,1,14808
887,2019-09-07,465,11352,1296,0,13113
887,2019-09-08,1365,8391,1899,0,11655
887,2019-09-09,375,5169,2214,1,7759
887,2019-09-10,231,12713,1279,0,14223
887,2019-09-11,195,9040,2564,2,11801
887,2019-09-12,205,8550,1175,0,9930
887,2019-09-13,1390,3907,2341,0,7638
887,2019-09-14,1119,10542,1297,1,12959
887,2019-09-15,270,10732,1599,1,12602
887,2019-09-16,276,13567,1594,0,15437
887,2019-09-17,1101,5629,2008,0,8738
887,2019-09-18,331,11272,1282,0,12885
887,2019-09-19,1285,10220,1095,0,12600
887,2019-09-20,302,12635,2338,3,15278
887,2019-09-21,303,7051,1980,3,9337
887,2019-09-22,222,9452,987,0,10661
887,2019-09-23,351,9846,1805,0,12002
887,2019-09-24,1117,11652,1529,3,14301
887,2019-09-25,180,10227,1565,1,11973
887,2019-09-26,448,11289,1620,4,13361
887,2019-09-27,159,10042,1821,2,12024
887,2019-09-28,194,23894,1984,2,26074
887,2019-09-29,154,18540,2146,2,20842
887,2019-09-30,125,23962,1225,0,25312
887,2019-10-01,148,21137,2421,1,23707
887,2019-10-02,482,9459,2256,0,12197
887,2019-10-03,188,11248,1270,1,12707
887,2019-10-04,227,16980,1447,1,18655
887,2019-10-05,755,22406,1148,0,24309
887,2019-10-06,131,15732,2244,2,18109
887,2019-10-07,1138,11514,1613,0,14265
887,2019-10-08,237,22371,1968,0,24576
887,2019-10-09,168,23872,2179,2,26221
887,2019-10-10,288,10875,1812,1,12976
887,2019-10-11,777,10153,2068,2,13000
887,2019-10-12,1107,4474,1771,1,7353
887,2019-10-13,230,7464,2196,0,9890
887,2019-10-14,222,6616,1609,1,8448
887,2019-10-15,1127,7390,1855,0,10372
887,2019-10-16,248,22756,1157,3,24164
887,2019-10-17,243,12750,1891,2,14886
887,2019-10-18,1395,13541,1644,0,16580
887,2019-10-19,1723,10206,2032,0,13961
887,2019-10-20,275,7076,1006,0,8357
887,2019-10-21,1226,23315,1246,5,25792
887,2019-10-22,247,14220,1562,1,16030
887,2019-10-23,313,12367,1557,1,14238
887,2019-10-24,371,25161,983,0,26515
887,2019-10-25,1265,28131,1864,1,31261
887,2019-10-26,232,18012,1884,1,20129
887,2019-10-27,218,20420,1262,0,21900
887,2019-10-28,238,27386,1504,0,29128
887,2019-10-29,325,22148,1496,0,23969
887,2019-10-30,248,20425,1497,1,22171
887,2019-10-31,250,16867,1858,2,18977
887,2019-11-01,236,29907,1656,1,31800
887,2019-11-02,636,30613,1803,0,33052
887,2019-11-03,1142,29078,1548,1,31769
887,2019-11-04,706,11943,1988,0,14637
887,2019-11-05,274,6427,1833,0,8534
887,2019-11-06,1539,18323,890,634,21386
887,2019-11-07,352,20908,1224,2,22486
887,2019-11-08,658,16876,1542,1,19077
887,2019-11-09,1181,21791,1848,0,24820
887,2019-11-10,237,17199,1998,2,19436
887,2019-11-11,372,12847,2403,4,15626
887,2019-11-12,245,14348,2025,0,16618
887,2019-11-13,782,17422,1311,2,19517
887,2019-11-14,235,17349,2509,3,20096
887,2019-11-15,241,10207,2301,1,12750
887,2019-11-16,245,7737,2114,1,10097
887,2019-11-17,749,8676,2069,0,11494
887,2019-11-18,1197,8677,2718,0,12592
887,2019-11-19,1182,9115,2655,1,12953
887,2019-11-20,1229,6999,2116,2,10346
887,2019-11-21,251,9727,1342,1,11321
887,2019-11-22,278,10495,1584,1,12358
887,2019-11-23,248,11355,1796,1,13400
887,2019-11-24,234,12554,1785,4,14577
887,2019-11-25,245,12050,2119,1,14415
887,2019-11-26,1170,13076,931,2,15179
887,2019-11-27,287,11900,1810,0,13997
887,2019-11-28,239,16995,998,0,18232
887,2019-11-29,245,913,0,0,1158
887,2019-09-05,242,1640,1785,2,3669
887,2019-09-06,392,11895,2520,1,14808
887,2019-09-07,465,11352,1296,0,13113
887,2019-09-08,1365,8391,1899,0,11655
887,2019-09-09,375,5169,2214,1,7759
887,2019-09-10,231,12713,1279,0,14223
887,2019-09-11,195,9040,2564,2,11801
887,2019-09-12,205,8550,1175,0,9930
887,2019-09-13,1390,3907,2341,0,7638
887,2019-09-14,1119,10542,1297,1,12959
887,2019-09-15,270,10732,1599,1,12602
887,2019-09-16,276,13567,1594,0,15437
887,2019-09-17,1101,5629,2008,0,8738
887,2019-09-18,331,11272,1282,0,12885
887,2019-09-19,1285,10220,1095,0,12600
887,2019-09-20,302,12635,2338,3,15278
887,2019-09-21,303,7051,1980,3,9337
887,2019-09-22,222,9452,987,0,10661
887,2019-09-23,351,9846,1805,0,12002
887,2019-09-24,1117,11652,1529,3,14301
887,2019-09-25,180,10227,1565,1,11973
887,2019-09-26,448,11289,1620,4,13361
887,2019-09-27,159,10042,1821,2,12024
887,2019-09-28,194,23894,1984,2,26074
887,2019-09-29,154,18540,2146,2,20842
887,2019-09-30,125,23962,1225,0,25312
887,2019-10-01,148,21137,2421,1,23707
887,2019-10-02,482,9459,2256,0,12197
887,2019-10-03,188,11248,1270,1,12707
887,2019-10-04,227,16980,1447,1,18655
887,2019-10-05,755,22406,1148,0,24309
887,2019-10-06,131,15732,2244,2,18109
887,2019-10-07,1138,11514,1613,0,14265
887,2019-10-08,237,22371,1968,0,24576
887,2019-10-09,168,23872,2179,2,26221
887,2019-10-10,288,10875,1812,1,12976
887,2019-10-11,777,10153,2068,2,13000
887,2019-10-12,1107,4474,1771,1,7353
887,2019-10-13,230,7464,2196,0,9890
887,2019-10-14,222,6616,1609,1,8448
887,2019-10-15,1127,7390,1855,0,10372
887,2019-10-16,248,22756,1157,3,24164
887,2019-10-17,243,12750,1891,2,14886
887,2019-10-18,1395,13541,1644,0,16580
887,2019-10-19,1723,10206,2032,0,13961
887,2019-10-20,275,7076,1006,0,8357
887,2019-10-21,1226,23315,1246,5,25792
887,2019-10-22,247,14220,1562,1,16030
887,2019-10-23,313,12367,1557,1,14238
887,2019-10-24,371,25161,983,0,26515
887,2019-10-25,1265,28131,1864,1,31261
887,2019-10-26,232,18012,1884,1,20129
887,2019-10-27,218,20420,1262,0,21900
887,2019-10-28,238,27386,1504,0,29128
887,2019-10-29,325,22148,1496,0,23969
887,2019-10-30,248,20425,1497,1,22171
887,2019-10-31,250,16867,1858,2,18977
887,2019-11-01,236,29907,1656,1,31800
887,2019-11-02,636,30613,1803,0,33052
887,2019-11-03,1142,29078,1548,1,31769
887,2019-11-04,706,11943,1988,0,14637
887,2019-11-05,274,6427,1833,0,8534
887,2019-11-06,1539,18323,890,634,21386
887,2019-11-07,352,20908,1224,2,22486
887,2019-11-08,658,16876,1542,1,19077
887,2019-11-09,1181,21791,1848,0,24820
887,2019-11-10,237,17199,1998,2,19436
887,2019-11-11,372,12847,2403,4,15626
887,2019-11-12,245,14348,2025,0,16618
887,2019-11-13,782,17422,1311,2,19517
887,2019-11-14,235,17349,2509,3,20096
887,2019-11-15,241,10207,2301,1,12750
887,2019-11-16,245,7737,2114,1,10097
887,2019-11-17,749,8676,2069,0,11494
887,2019-11-18,1197,8677,2718,0,12592
887,2019-11-19,1182,9115,2655,1,12953
887,2019-11-20,1229,6999,2116,2,10346
887,2019-11-21,251,9727,1342,1,11321
887,2019-11-22,278,10495,1584,1,12358
887,2019-11-23,248,11355,1796,1,13400
887,2019-11-24,234,12554,1785,4,14577
887,2019-11-25,245,12050,2119,1,14415
887,2019-11-26,1170,13076,931,2,15179
887,2019-11-27,287,11900,1810,0,13997
887,2019-11-28,239,16995,998,0,18232
887,2019-09-05,242,1640,1785,2,3669
887,2019-09-06,392,11895,2520,1,14808
887,2019-09-07,465,11352,1296,0,13113
887,2019-09-08,1365,8391,1899,0,11655
887,2019-09-09,375,5169,2214,1,7759
887,2019-09-10,231,12713,1279,0,14223
887,2019-09-11,195,9040,2564,2,11801
887,2019-09-12,205,8550,1175,0,9930
887,2019-09-13,1390,3907,2341,0,7638
887,2019-09-14,1119,10542,1297,1,12959
887,2019-09-15,270,10732,1599,1,12602
887,2019-09-16,276,13567,1594,0,15437
887,2019-09-17,1101,5629,2008,0,8738
887,2019-09-18,331,11272,1282,0,12885
887,2019-09-19,1285,10220,1095,0,12600
887,2019-09-20,302,12635,2338,3,15278
887,2019-09-21,303,7051,1980,3,9337
887,2019-09-22,222,9452,987,0,10661
887,2019-09-23,351,9846,1805,0,12002
887,2019-09-24,1117,11652,1529,3,14301
887,2019-09-25,180,10227,1565,1,11973
887,2019-09-26,448,11289,1620,4,13361
887,2019-09-27,159,10042,1821,2,12024
887,2019-09-28,194,23894,1984,2,26074
887,2019-09-29,154,18540,2146,2,20842
887,2019-09-30,125,23962,1225,0,25312
887,2019-10-01,148,21137,2421,1,23707
887,2019-10-02,482,9459,2256,0,12197
887,2019-10-03,188,11248,1270,1,12707
887,2019-10-04,227,16980,1447,1,18655
887,2019-10-05,755,22406,1148,0,24309
887,2019-10-06,131,15732,2244,2,18109
887,2019-10-07,1138,11514,1613,0,14265
887,2019-10-08,237,22371,1968,0,24576
887,2019-10-09,168,23872,2179,2,26221
887,2019-10-10,288,10875,1812,1,12976
887,2019-10-11,777,10153,2068,2,13000
887,2019-10-12,1107,4474,1771,1,7353
887,2019-10-13,230,7464,2196,0,9890
887,2019-10-14,222,6616,1609,1,8448
887,2019-10-15,1127,7390,1855,0,10372
887,2019-10-16,248,22756,1157,3,24164
887,2019-10-17,243,12750,1891,2,14886
887,2019-10-18,1395,13541,1644,0,16580
887,2019-10-19,1723,10206,2032,0,13961
887,2019-10-20,275,7076,1006,0,8357
887,2019-10-21,1226,23315,1246,5,25792
887,2019-10-22,247,14220,1562,1,16030
887,2019-10-23,313,12367,1557,1,14238
887,2019-10-24,371,25161,983,0,26515
887,2019-10-25,1265,28131,1864,1,31261
887,2019-10-26,232,18012,1884,1,20129
887,2019-10-27,218,20420,1262,0,21900
887,2019-10-28,238,27386,1504,0,29128
887,2019-10-29,325,22148,1496,0,23969
887,2019-10-30,248,20425,1497,1,22171
887,2019-10-31,250,16867,1858,2,18977
887,2019-11-01,236,29907,1656,1,31800
887,2019-11-02,636,30613,1803,0,33052
887,2019-11-03,1142,29078,1548,1,31769
887,2019-11-04,706,11943,1988,0,14637
887,2019-11-05,274,6427,1833,0,8534
887,2019-11-06,1539,18323,890,634,21386
887,2019-11-07,352,20908,1224,2,22486
887,2019-11-08,658,16876,1542,1,19077
887,2019-11-09,1181,21791,1848,0,24820
887,2019-11-10,237,17199,1998,2,19436
887,2019-11-11,372,12847,2403,4,15626
887,2019-11-12,245,14348,2025,0,16618
887,2019-11-13,782,17422,1311,2,19517
887,2019-11-14,235,17349,2509,3,20096
887,2019-11-15,241,10207,2301,1,12750
887,2019-11-16,245,7737,2114,1,10097
887,2019-11-17,749,8676,2069,0,11494
887,2019-11-18,1197,8677,2718,0,12592
887,2019-11-19,1182,9115,2655,1,12953
887,2019-11-20,1229,6999,2116,2,10346
887,2019-11-21,251,9727,1342,1,11321
887,2019-11-22,278,10495,1584,1,12358
887,2019-11-23,248,11355,1796,1,13400
887,2019-11-24,234,12554,1785,4,14577
887,2019-11-25,245,12050,2119,1,14415
887,2019-11-26,1170,13076,931,2,15179
888,2019-09-05,108795,1517,1985,2,112299
888,2019-09-06,142451,10263,1882,0,154596
888,2019-09-07,142109,10089,1259,0,153457
888,2019-09-08,148044,4090,1894,2,154030
888,2019-09-09,159787,5389,1849,0,167025
888,2019-09-10,156226,6460,1827,0,164513
888,2019-09-11,161419,6373,3031,1,170824
888,2019-09-12,159883,6139,1255,2,167279
888,2019-09-13,148136,2596,2591,3,153326
888,2019-09-14,140347,6056,1532,0,147935
888,2019-09-15,142153,5983,3636,1,151773
888,2019-09-16,156350,7111,1955,1,165417
888,2019-09-17,158139,10851,2778,1,171769
888,2019-09-18,153515,19311,597,0,173423
888,2019-09-19,153652,3473,1460,0,158585
888,2019-09-20,142932,14521,1814,2,159269
888,2019-09-21,136078,9773,2216,4,148071
888,2019-09-22,135566,13683,1800,0,151049
888,2019-09-23,150976,10162,2138,1,163277
888,2019-09-24,157642,11119,1943,1,170705
888,2019-09-25,153224,11642,2025,0,166891
888,2019-09-26,155950,11670,2331,3,169954
888,2019-09-27,145132,5888,1873,3,152896
888,2019-09-28,140626,14285,2011,2,156924
888,2019-09-29,148270,15771,1957,2,166000
888,2019-09-30,158851,23275,2464,0,184590
888,2019-10-01,152835,21238,1712,2,175787
888,2019-10-02,155230,14622,1465,0,171317
888,2019-10-03,151182,13581,1274,0,166037
888,2019-10-04,147610,12343,1276,4,161233
888,2019-10-05,138024,20625,932,0,159581
888,2019-10-06,137371,16263,1547,3,155184
888,2019-10-07,154925,5600,1766,1,162292
888,2019-10-08,153923,17830,1807,0,173560
888,2019-10-09,153314,24388,1650,0,179352
888,2019-10-10,155415,17428,2115,1,174959
888,2019-10-11,143876,10876,1027,2,155781
888,2019-10-12,139713,5419,2357,2,147491
888,2019-10-13,136613,11571,1645,1,149830
888,2019-10-14,155212,8368,2399,1,165980
888,2019-10-15,153339,8496,1127,0,162962
888,2019-10-16,151804,13196,762,5,165767
888,2019-10-17,149827,5465,1460,0,156752
888,2019-10-18,140723,8771,1505,1,151000
888,2019-10-19,137470,5300,2049,0,144819
888,2019-10-20,136469,3135,2569,1,142174
888,2019-10-21,149902,9928,1449,4,161283
888,2019-10-22,150822,6594,2166,919,160501
888,2019-10-23,146300,8099,1742,1,156142
888,2019-10-24,145315,13006,1376,0,159697
888,2019-10-25,140371,15656,2114,1,158142
888,2019-10-26,128304,24599,2017,0,154920
888,2019-10-27,131137,18139,1165,0,150441
888,2019-10-28,147021,13732,1409,0,162162
888,2019-10-29,147127,15282,1008,0,163417
888,2019-10-30,146439,15416,1244,3,163102
888,2019-10-31,143947,19727,1096,2,164772
888,2019-11-01,139807,26899,1216,1,167923
888,2019-11-02,134908,17596,1450,2,153956
888,2019-11-03,132189,21706,2008,1,155904
888,2019-11-04,143146,10200,1351,1,154698
888,2019-11-05,144857,2894,2630,1,150382
888,2019-11-06,147974,14106,1792,0,163872
888,2019-11-07,143852,16018,1117,3,160990
888,2019-11-08,138024,9811,900,0,148735
888,2019-11-09,129939,8433,1262,0,139634
888,2019-11-10,132496,14377,713,3,147589
888,2019-11-11,149531,9466,1137,2,160136
888,2019-11-12,149369,10176,2504,2,162051
888,2019-11-13,123237,14052,1457,2,138748
888,2019-11-14,137532,8044,1357,1,146934
888,2019-11-15,133392,4428,1470,1,139291
888,2019-11-16,133668,2218,2025,2,137913
888,2019-11-17,134568,3167,1970,2,139707
888,2019-11-18,141763,2800,3265,1,147829
888,2019-11-19,128041,3101,2286,0,133428
888,2019-11-20,117147,1378,1181,3,119709
888,2019-11-21,120147,5157,1732,0,127036
888,2019-11-22,113831,5392,1034,1,120258
888,2019-11-23,118422,5643,1341,1,125407
888,2019-11-24,118303,5519,1148,2,124972
888,2019-11-25,129911,6130,1306,0,137347
888,2019-11-26,75643,6780,809,0,83232
888,2019-11-27,129917,5655,1098,0,136670
888,2019-11-28,96015,7052,737,0,103804
888,2019-11-29,365,199,3,0,567
888,2019-09-05,108795,1517,1985,2,112299
888,2019-09-06,142451,10263,1882,0,154596
888,2019-09-07,142109,10089,1259,0,153457
888,2019-09-08,148044,4090,1894,2,154030
888,2019-09-09,159787,5389,1849,0,167025
888,2019-09-10,156226,6460,1827,0,164513
888,2019-09-11,161419,6373,3031,1,170824
888,2019-09-12,159883,6139,1255,2,167279
888,2019-09-13,148136,2596,2591,3,153326
888,2019-09-14,140347,6056,1532,0,147935
888,2019-09-15,142153,5983,3636,1,151773
888,2019-09-16,156350,7111,1955,1,165417
888,2019-09-17,158139,10851,2778,1,171769
888,2019-09-18,153515,19311,597,0,173423
888,2019-09-19,153652,3473,1460,0,158585
888,2019-09-20,142932,14521,1814,2,159269
888,2019-09-21,136078,9773,2216,4,148071
888,2019-09-22,135566,13683,1800,0,151049
888,2019-09-23,150976,10162,2138,1,163277
888,2019-09-24,157642,11119,1943,1,170705
888,2019-09-25,153224,11642,2025,0,166891
888,2019-09-26,155950,11670,2331,3,169954
888,2019-09-27,145132,5888,1873,3,152896
888,2019-09-28,140626,14285,2011,2,156924
888,2019-09-29,148270,15771,1957,2,166000
888,2019-09-30,158851,23275,2464,0,184590
888,2019-10-01,152835,21238,1712,2,175787
888,2019-10-02,155230,14622,1465,0,171317
888,2019-10-03,151182,13581,1274,0,166037
888,2019-10-04,147610,12343,1276,4,161233
888,2019-10-05,138024,20625,932,0,159581
888,2019-10-06,137371,16263,1547,3,155184
888,2019-10-07,154925,5600,1766,1,162292
888,2019-10-08,153923,17830,1807,0,173560
888,2019-10-09,153314,24388,1650,0,179352
888,2019-10-10,155415,17428,2115,1,174959
888,2019-10-11,143876,10876,1027,2,155781
888,2019-10-12,139713,5419,2357,2,147491
888,2019-10-13,136613,11571,1645,1,149830
888,2019-10-14,155212,8368,2399,1,165980
888,2019-10-15,153339,8496,1127,0,162962
888,2019-10-16,151804,13196,762,5,165767
888,2019-10-17,149827,5465,1460,0,156752
888,2019-10-18,140723,8771,1505,1,151000
888,2019-10-19,137470,5300,2049,0,144819
888,2019-10-20,136469,3135,2569,1,142174
888,2019-10-21,149902,9928,1449,4,161283
888,2019-10-22,150822,6594,2166,919,160501
888,2019-10-23,146300,8099,1742,1,156142
888,2019-10-24,145315,13006,1376,0,159697
888,2019-10-25,140371,15656,2114,1,158142
888,2019-10-26,128304,24599,2017,0,154920
888,2019-10-27,131137,18139,1165,0,150441
888,2019-10-28,147021,13732,1409,0,162162
888,2019-10-29,147127,15282,1008,0,163417
888,2019-10-30,146439,15416,1244,3,163102
888,2019-10-31,143947,19727,1096,2,164772
888,2019-11-01,139807,26899,1216,1,167923
888,2019-11-02,134908,17596,1450,2,153956
888,2019-11-03,132189,21706,2008,1,155904
888,2019-11-04,143146,10200,1351,1,154698
888,2019-11-05,144857,2894,2630,1,150382
888,2019-11-06,147974,14106,1792,0,163872
888,2019-11-07,143852,16018,1117,3,160990
888,2019-11-08,138024,9811,900,0,148735
888,2019-11-09,129939,8433,1262,0,139634
888,2019-11-10,132496,14377,713,3,147589
888,2019-11-11,149531,9466,1137,2,160136
888,2019-11-12,149369,10176,2504,2,162051
888,2019-11-13,123237,14052,1457,2,138748
888,2019-11-14,137532,8044,1357,1,146934
888,2019-11-15,133392,4428,1470,1,139291
888,2019-11-16,133668,2218,2025,2,137913
888,2019-11-17,134568,3167,1970,2,139707
888,2019-11-18,141763,2800,3265,1,147829
888,2019-11-19,128041,3101,2286,0,133428
888,2019-11-20,117147,1378,1181,3,119709
888,2019-11-21,120147,5157,1732,0,127036
888,2019-11-22,113831,5392,1034,1,120258
888,2019-11-23,118422,5643,1341,1,125407
888,2019-11-24,118303,5519,1148,2,124972
888,2019-11-25,129911,6130,1306,0,137347
888,2019-11-26,75643,6780,809,0,83232
888,2019-11-27,129917,5655,1098,0,136670
888,2019-11-28,96015,7052,737,0,103804
888,2019-11-29,365,199,3,0,567
888,2019-09-05,108795,1517,1985,2,112299
888,2019-09-06,142451,10263,1882,0,154596
888,2019-09-07,142109,10089,1259,0,153457
888,2019-09-08,148044,4090,1894,2,154030
888,2019-09-09,159787,5389,1849,0,167025
888,2019-09-10,156226,6460,1827,0,164513
888,2019-09-11,161419,6373,3031,1,170824
888,2019-09-12,159883,6139,1255,2,167279
888,2019-09-13,148136,2596,2591,3,153326
888,2019-09-14,140347,6056,1532,0,147935
888,2019-09-15,142153,5983,3636,1,151773
888,2019-09-16,156350,7111,1955,1,165417
888,2019-09-17,158139,10851,2778,1,171769
888,2019-09-18,153515,19311,597,0,173423
888,2019-09-19,153652,3473,1460,0,158585
888,2019-09-20,142932,14521,1814,2,159269
888,2019-09-21,136078,9773,2216,4,148071
888,2019-09-22,135566,13683,1800,0,151049
888,2019-09-23,150976,10162,2138,1,163277
888,2019-09-24,157642,11119,1943,1,170705
888,2019-09-25,153224,11642,2025,0,166891
888,2019-09-26,155950,11670,2331,3,169954
888,2019-09-27,145132,5888,1873,3,152896
888,2019-09-28,140626,14285,2011,2,156924
888,2019-09-29,148270,15771,1957,2,166000
888,2019-09-30,158851,23275,2464,0,184590
888,2019-10-01,152835,21238,1712,2,175787
888,2019-10-02,155230,14622,1465,0,171317
888,2019-10-03,151182,13581,1274,0,166037
888,2019-10-04,147610,12343,1276,4,161233
888,2019-10-05,138024,20625,932,0,159581
888,2019-10-06,137371,16263,1547,3,155184
888,2019-10-07,154925,5600,1766,1,162292
888,2019-10-08,153923,17830,1807,0,173560
888,2019-10-09,153314,24388,1650,0,179352
888,2019-10-10,155415,17428,2115,1,174959
888,2019-10-11,143876,10876,1027,2,155781
888,2019-10-12,139713,5419,2357,2,147491
888,2019-10-13,136613,11571,1645,1,149830
888,2019-10-14,155212,8368,2399,1,165980
888,2019-10-15,153339,8496,1127,0,162962
888,2019-10-16,151804,13196,762,5,165767
888,2019-10-17,149827,5465,1460,0,156752
888,2019-10-18,140723,8771,1505,1,151000
888,2019-10-19,137470,5300,2049,0,144819
888,2019-10-20,136469,3135,2569,1,142174
888,2019-10-21,149902,9928,1449,4,161283
888,2019-10-22,150822,6594,2166,919,160501
888,2019-10-23,146300,8099,1742,1,156142
888,2019-10-24,145315,13006,1376,0,159697
888,2019-10-25,140371,15656,2114,1,158142
888,2019-10-26,128304,24599,2017,0,154920
888,2019-10-27,131137,18139,1165,0,150441
888,2019-10-28,147021,13732,1409,0,162162
888,2019-10-29,147127,15282,1008,0,163417
888,2019-10-30,146439,15416,1244,3,163102
888,2019-10-31,143947,19727,1096,2,164772
888,2019-11-01,139807,26899,1216,1,167923
888,2019-11-02,134908,17596,1450,2,153956
888,2019-11-03,132189,21706,2008,1,155904
888,2019-11-04,143146,10200,1351,1,154698
888,2019-11-05,144857,2894,2630,1,150382
888,2019-11-06,147974,14106,1792,0,163872
888,2019-11-07,143852,16018,1117,3,160990
888,2019-11-08,138024,9811,900,0,148735
888,2019-11-09,129939,8433,1262,0,139634
888,2019-11-10,132496,14377,713,3,147589
888,2019-11-11,149531,9466,1137,2,160136
888,2019-11-12,149369,10176,2504,2,162051
888,2019-11-13,123237,14052,1457,2,138748
888,2019-11-14,137532,8044,1357,1,146934
888,2019-11-15,133392,4428,1470,1,139291
888,2019-11-16,133668,2218,2025,2,137913
888,2019-11-17,134568,3167,1970,2,139707
888,2019-11-18,141763,2800,3265,1,147829
888,2019-11-19,128041,3101,2286,0,133428
888,2019-11-20,117147,1378,1181,3,119709
888,2019-11-21,120147,5157,1732,0,127036
888,2019-11-22,113831,5392,1034,1,120258
888,2019-11-23,118422,5643,1341,1,125407
888,2019-11-24,118303,5519,1148,2,124972
888,2019-11-25,129911,6130,1306,0,137347
888,2019-11-26,75643,6780,809,0,83232
888,2019-11-27,129917,5655,1098,0,136670
888,2019-11-28,96015,7052,737,0,103804
888,2019-11-29,365,199,3,0,567
888,2019-09-05,108795,1517,1985,2,112299
888,2019-09-06,142451,10263,1882,0,154596
888,2019-09-07,142109,10089,1259,0,153457
888,2019-09-08,148044,4090,1894,2,154030
888,2019-09-09,159787,5389,1849,0,167025
888,2019-09-10,156226,6460,1827,0,164513
888,2019-09-11,161419,6373,3031,1,170824
888,2019-09-12,159883,6139,1255,2,167279
888,2019-09-13,148136,2596,2591,3,153326
888,2019-09-14,140347,6056,1532,0,147935
888,2019-09-15,142153,5983,3636,1,151773
888,2019-09-16,156350,7111,1955,1,165417
888,2019-09-17,158139,10851,2778,1,171769
888,2019-09-18,153515,19311,597,0,173423
888,2019-09-19,153652,3473,1460,0,158585
888,2019-09-20,142932,14521,1814,2,159269
888,2019-09-21,136078,9773,2216,4,148071
888,2019-09-22,135566,13683,1800,0,151049
888,2019-09-23,150976,10162,2138,1,163277
888,2019-09-24,157642,11119,1943,1,170705
888,2019-09-25,153224,11642,2025,0,166891
888,2019-09-26,155950,11670,2331,3,169954
888,2019-09-27,145132,5888,1873,3,152896
888,2019-09-28,140626,14285,2011,2,156924
888,2019-09-29,148270,15771,1957,2,166000
888,2019-09-30,158851,23275,2464,0,184590
888,2019-10-01,152835,21238,1712,2,175787
888,2019-10-02,155230,14622,1465,0,171317
888,2019-10-03,151182,13581,1274,0,166037
888,2019-10-04,147610,12343,1276,4,161233
888,2019-10-05,138024,20625,932,0,159581
888,2019-10-06,137371,16263,1547,3,155184
888,2019-10-07,154925,5600,1766,1,162292
888,2019-10-08,153923,17830,1807,0,173560
888,2019-10-09,153314,24388,1650,0,179352
888,2019-10-10,155415,17428,2115,1,174959
888,2019-10-11,143876,10876,1027,2,155781
888,2019-10-12,139713,5419,2357,2,147491
888,2019-10-13,136613,11571,1645,1,149830
888,2019-10-14,155212,8368,2399,1,165980
888,2019-10-15,153339,8496,1127,0,162962
888,2019-10-16,151804,13196,762,5,165767
888,2019-10-17,149827,5465,1460,0,156752
888,2019-10-18,140723,8771,1505,1,151000
888,2019-10-19,137470,5300,2049,0,144819
888,2019-10-20,136469,3135,2569,1,142174
888,2019-10-21,149902,9928,1449,4,161283
888,2019-10-22,150822,6594,2166,919,160501
888,2019-10-23,146300,8099,1742,1,156142
888,2019-10-24,145315,13006,1376,0,159697
888,2019-10-25,140371,15656,2114,1,158142
888,2019-10-26,128304,24599,2017,0,154920
888,2019-10-27,131137,18139,1165,0,150441
888,2019-10-28,147021,13732,1409,0,162162
888,2019-10-29,147127,15282,1008,0,163417
888,2019-10-30,146439,15416,1244,3,163102
888,2019-10-31,143947,19727,1096,2,164772
888,2019-11-01,139807,26899,1216,1,167923
888,2019-11-02,134908,17596,1450,2,153956
888,2019-11-03,132189,21706,2008,1,155904
888,2019-11-04,143146,10200,1351,1,154698
888,2019-11-05,144857,2894,2630,1,150382
888,2019-11-06,147974,14106,1792,0,163872
888,2019-11-07,143852,16018,1117,3,160990
888,2019-11-08,138024,9811,900,0,148735
888,2019-11-09,129939,8433,1262,0,139634
888,2019-11-10,132496,14377,713,3,147589
888,2019-11-11,149531,9466,1137,2,160136
888,2019-11-12,149369,10176,2504,2,162051
888,2019-11-13,123237,14052,1457,2,138748
888,2019-11-14,137532,8044,1357,1,146934
888,2019-11-15,133392,4428,1470,1,139291
888,2019-11-16,133668,2218,2025,2,137913
888,2019-11-17,134568,3167,1970,2,139707
888,2019-11-18,141763,2800,3265,1,147829
888,2019-11-19,128041,3101,2286,0,133428
888,2019-11-20,117147,1378,1181,3,119709
888,2019-11-21,120147,5157,1732,0,127036
888,2019-11-22,113831,5392,1034,1,120258
888,2019-11-23,118422,5643,1341,1,125407
888,2019-11-24,118303,5519,1148,2,124972
